id,Arrival,Start,Completion,No_of_expansion,No_of_shrinkage,Wait_time,Turn_around_time
15002,19399133,19399133,19399249,0,0,0,116
15003,19401618,19401618,19402080,0,0,0,462
15004,19402386,19402386,19402632,0,0,0,246
15005,19402940,19402940,19403024,0,0,0,84
15006,19403044,19403044,19403127,0,0,0,83
15007,19403080,19403080,19403307,0,0,0,227
15008,19403254,19403254,19403349,0,0,0,95
15009,19403398,19403398,19403500,0,0,0,102
15010,19403436,19403436,19403684,0,0,0,248
15011,19403570,19403570,19403811,0,0,0,241
15012,19403803,19403803,19403950,0,0,0,147
15015,19404009,19404009,19404407,0,0,0,398
15014,19403975,19403975,19404484,0,0,0,509
15013,19403957,19403957,19405653,0,0,0,1696
15016,19404111,19404111,19405841,0,0,0,1730
15021,19405871,19405871,19406017,0,0,0,146
15018,19404460,19404460,19406051,0,0,0,1591
15020,19405681,19405681,19406086,0,0,0,405
15017,19404443,19404443,19406109,0,0,0,1666
15022,19406472,19406472,19406971,0,0,0,499
15023,19406748,19406748,19407048,0,0,0,300
15024,19407496,19407496,19407642,0,0,0,146
15025,19407807,19407807,19407911,0,0,0,104
15026,19408190,19408190,19408486,0,0,0,296
15028,19408519,19408519,19408602,0,0,0,83
15027,19408207,19408207,19408665,0,0,0,458
15031,19408572,19408572,19408674,0,0,0,102
15030,19408546,19408546,19408681,0,0,0,135
15033,19408769,19408769,19409831,0,0,0,1062
15042,19409889,19409889,19409936,0,0,0,47
15048,19409890,19409890,19409994,0,0,0,104
15032,19408766,19408766,19409995,0,0,0,1229
15034,19408783,19408783,19410010,0,0,0,1227
15050,19409891,19409891,19410013,0,0,0,122
15049,19409891,19409891,19410034,0,0,0,143
15035,19408821,19408821,19410050,0,0,0,1229
15036,19408947,19408947,19410080,0,0,0,1133
15043,19409890,19409890,19410490,0,0,0,600
15044,19409890,19409890,19410490,0,0,0,600
15045,19409890,19409890,19410490,0,0,0,600
15046,19409890,19409890,19410490,0,0,0,600
15047,19409890,19409890,19410490,0,0,0,600
15040,19409869,19409869,19410712,0,0,0,843
15039,19409371,19409371,19410771,0,0,0,1400
15055,19410064,19410064,19411264,0,0,0,1200
15107,19411583,19411583,19411802,0,0,0,219
15109,19411801,19411801,19411848,0,0,0,47
15057,19410347,19410347,19411898,0,0,0,1551
15108,19411794,19411794,19411898,0,0,0,104
15059,19410348,19410348,19411899,0,0,0,1551
15060,19410348,19410348,19411899,0,0,0,1551
15061,19410348,19410348,19411899,0,0,0,1551
15063,19410349,19410349,19411900,0,0,0,1551
15068,19410350,19410350,19411901,0,0,0,1551
15069,19410350,19410350,19411901,0,0,0,1551
15056,19410341,19410341,19411908,0,0,0,1567
15058,19410347,19410347,19411910,0,0,0,1563
15062,19410348,19410348,19411911,0,0,0,1563
15064,19410349,19410349,19411912,0,0,0,1563
15065,19410349,19410349,19411912,0,0,0,1563
15066,19410349,19410349,19411912,0,0,0,1563
15067,19410349,19410349,19411912,0,0,0,1563
15070,19410350,19410350,19411913,0,0,0,1563
15071,19410350,19410350,19411913,0,0,0,1563
15072,19410351,19410351,19411914,0,0,0,1563
15073,19410351,19410351,19411914,0,0,0,1563
15074,19410351,19410351,19411914,0,0,0,1563
15075,19410352,19410352,19411915,0,0,0,1563
15076,19410352,19410352,19411915,0,0,0,1563
15077,19410352,19410352,19411915,0,0,0,1563
15078,19410352,19410352,19411915,0,0,0,1563
15079,19410352,19410352,19411915,0,0,0,1563
15080,19410352,19410352,19411915,0,0,0,1563
15081,19410352,19410352,19411915,0,0,0,1563
15082,19410353,19410353,19411916,0,0,0,1563
15083,19410353,19410353,19411916,0,0,0,1563
15084,19410353,19410353,19411916,0,0,0,1563
15085,19410353,19410353,19411916,0,0,0,1563
15086,19410353,19410353,19411916,0,0,0,1563
15087,19410353,19410353,19411916,0,0,0,1563
15088,19410353,19410353,19411916,0,0,0,1563
15089,19410354,19410354,19411917,0,0,0,1563
15090,19410354,19410354,19411917,0,0,0,1563
15091,19410354,19410354,19411917,0,0,0,1563
15092,19410354,19410354,19411917,0,0,0,1563
15093,19410354,19410354,19411917,0,0,0,1563
15094,19410354,19410354,19411917,0,0,0,1563
15095,19410354,19410354,19411917,0,0,0,1563
15096,19410355,19410355,19411918,0,0,0,1563
15097,19410355,19410355,19411918,0,0,0,1563
15098,19410355,19410355,19411918,0,0,0,1563
15099,19410355,19410355,19411918,0,0,0,1563
15100,19410355,19410355,19411918,0,0,0,1563
15101,19410355,19410355,19411918,0,0,0,1563
15102,19410355,19410355,19411918,0,0,0,1563
15103,19410356,19410356,19411919,0,0,0,1563
15104,19410356,19410356,19411919,0,0,0,1563
15110,19411886,19411886,19411988,0,0,0,102
15111,19411903,19411903,19412003,0,0,0,100
15114,19411957,19411957,19412032,0,0,0,75
15112,19411929,19411929,19412037,0,0,0,108
15113,19411948,19411948,19412070,0,0,0,122
15115,19411970,19411970,19412121,0,0,0,151
15116,19412372,19412372,19412474,0,0,0,102
15117,19412378,19412378,19412501,0,0,0,123
15118,19412378,19412378,19412512,0,0,0,134
15119,19412379,19412379,19412513,0,0,0,134
15120,19412379,19412379,19412513,0,0,0,134
15123,19412380,19412380,19412546,0,0,0,166
15124,19412380,19412380,19412551,0,0,0,171
15121,19412379,19412379,19412555,0,0,0,176
15122,19412379,19412379,19412555,0,0,0,176
15019,19405647,19405647,19414804,0,0,0,9157
15106,19410796,19410796,19415347,0,0,0,4551
15037,19409017,19409017,19415946,0,0,0,6929
15135,19427166,19427166,19427281,0,0,0,115
15105,19410775,19410775,19437373,0,0,0,26598
15137,19437547,19437547,19437665,0,0,0,118
15054,19410035,19410035,19469126,0,0,0,59091
15052,19409982,19409982,19469216,0,0,0,59234
15053,19410009,19410009,19469221,0,0,0,59212
15192,19470687,19470687,19471201,0,0,0,514
15193,19470801,19470801,19471238,0,0,0,437
15195,19470948,19470948,19471415,0,0,0,467
15196,19471384,19471384,19471872,0,0,0,488
15197,19471390,19471390,19471878,0,0,0,488
15190,19470285,19470285,19471882,0,0,0,1597
15191,19470302,19470302,19471962,0,0,0,1660
15194,19470878,19470878,19472036,0,0,0,1158
15001,19397347,19397347,19472047,0,0,0,74700
15051,19409958,19409958,19472054,0,0,0,62096
15038,19409331,19409331,19472058,0,0,0,62727
15041,19409869,19409869,19472067,0,0,0,62198
15198,19472221,19472221,19473421,0,0,0,1200
15210,19473716,19473716,19473786,0,0,0,70
15213,19474740,19474740,19474830,0,0,0,90
15214,19474740,19474740,19474830,0,0,0,90
15208,19473533,19473533,19474840,0,0,0,1307
15220,19474742,19474742,19474861,0,0,0,119
15215,19474740,19474740,19474863,0,0,0,123
15216,19474741,19474741,19474864,0,0,0,123
15217,19474741,19474741,19474875,0,0,0,134
15219,19474741,19474741,19474886,0,0,0,145
15218,19474741,19474741,19474906,0,0,0,165
15222,19474872,19474886,19475030,0,0,14,158
15225,19475326,19475326,19475445,0,0,0,119
15223,19475218,19475218,19475548,0,0,0,330
15224,19475224,19475224,19475724,0,0,0,500
15227,19476026,19476026,19476145,0,0,0,119
15226,19475775,19475775,19476237,0,0,0,462
15228,19476373,19476373,19476457,0,0,0,84
15221,19474742,19474861,19476661,0,0,119,1919
15230,19476564,19476564,19476705,0,0,0,141
15229,19476457,19476457,19476862,0,0,0,405
15238,19477407,19477407,19477519,0,0,0,112
15231,19477400,19477400,19477557,0,0,0,157
15233,19477406,19477406,19477586,0,0,0,180
15232,19477405,19477405,19477601,0,0,0,196
15234,19477406,19477406,19477602,0,0,0,196
15235,19477406,19477406,19477634,0,0,0,228
15236,19477406,19477406,19477634,0,0,0,228
15237,19477407,19477407,19477635,0,0,0,228
15239,19477407,19477519,19477707,0,0,112,300
15240,19478281,19478281,19478525,0,0,0,244
15241,19478609,19478609,19478793,0,0,0,184
15249,19478687,19478687,19478844,0,0,0,157
15242,19478686,19478686,19478938,0,0,0,252
15243,19478686,19478686,19478991,0,0,0,305
15244,19478687,19478687,19478992,0,0,0,305
15245,19478687,19478687,19478992,0,0,0,305
15248,19478687,19478687,19479033,0,0,0,346
15246,19478687,19478687,19479045,0,0,0,358
15247,19478687,19478687,19479045,0,0,0,358
15258,19478784,19478844,19479083,0,0,60,299
15251,19478777,19478777,19479131,0,0,0,354
15252,19478783,19478783,19479160,0,0,0,377
15253,19478783,19478783,19479160,0,0,0,377
15254,19478783,19478783,19479191,0,0,0,408
15261,19479115,19479131,19479218,0,0,16,103
15257,19478784,19478784,19479229,0,0,0,445
15255,19478783,19478783,19479234,0,0,0,451
15256,19478784,19478784,19479255,0,0,0,471
15262,19479204,19479204,19479278,0,0,0,74
15250,19478687,19479083,19479351,0,0,396,664
15260,19479047,19479047,19479368,0,0,0,321
15263,19479267,19479267,19479374,0,0,0,107
15259,19478784,19479351,19479789,0,0,567,1005
15264,19479427,19479427,19479862,0,0,0,435
15189,19469983,19469983,19480783,0,0,0,10800
15128,19417814,19417814,19481398,0,0,0,63584
15266,19482263,19482263,19482476,0,0,0,213
15267,19482330,19482330,19482645,0,0,0,315
15268,19482592,19482592,19482673,0,0,0,81
15270,19482703,19482703,19482773,0,0,0,70
15269,19482645,19482645,19482971,0,0,0,326
15272,19483092,19483092,19483170,0,0,0,78
15271,19483053,19483053,19483227,0,0,0,174
15273,19483278,19483278,19483572,0,0,0,294
15275,19483749,19483749,19483827,0,0,0,78
15281,19483756,19483756,19483845,0,0,0,89
15276,19483755,19483755,19483854,0,0,0,99
15277,19483755,19483755,19483854,0,0,0,99
15278,19483755,19483755,19483868,0,0,0,113
15279,19483755,19483755,19483868,0,0,0,113
15280,19483756,19483756,19483869,0,0,0,113
15291,19483804,19483804,19483872,0,0,0,68
15282,19483794,19483794,19483878,0,0,0,84
15287,19483800,19483800,19483887,0,0,0,87
15288,19483801,19483801,19483909,0,0,0,108
15289,19483801,19483801,19483910,0,0,0,109
15283,19483794,19483794,19483911,0,0,0,117
15284,19483794,19483794,19483911,0,0,0,117
15285,19483794,19483794,19483911,0,0,0,117
15286,19483794,19483794,19483911,0,0,0,117
15292,19483816,19483816,19483926,0,0,0,110
15293,19483816,19483816,19483937,0,0,0,121
15294,19483817,19483817,19483969,0,0,0,152
15299,19483822,19483822,19483980,0,0,0,158
15295,19483817,19483845,19483982,0,0,28,165
15300,19483822,19483822,19483992,0,0,0,170
15296,19483817,19483845,19484003,0,0,28,186
15297,19483817,19483845,19484025,0,0,28,208
15301,19483822,19483845,19484043,0,0,23,221
15306,19483832,19483832,19484064,0,0,0,232
15302,19483822,19483868,19484066,0,0,46,244
15304,19483822,19483869,19484090,0,0,47,268
15298,19483818,19483909,19484090,0,0,91,272
15307,19483832,19483845,19484099,0,0,13,267
15303,19483822,19483868,19484100,0,0,46,278
15308,19483833,19483854,19484139,0,0,21,306
15309,19483833,19483887,19484139,0,0,54,306
15312,19483834,19483911,19484144,0,0,77,310
15305,19483823,19483910,19484146,0,0,87,323
15310,19483833,19483887,19484193,0,0,54,360
15311,19483833,19483910,19484257,0,0,77,424
15313,19484285,19484285,19484366,0,0,0,81
15133,19422298,19422298,19484543,0,0,0,62245
15132,19422261,19422261,19484608,0,0,0,62347
15134,19422345,19422345,19484743,0,0,0,62398
15314,19484697,19484697,19484786,0,0,0,89
15315,19484787,19484787,19484992,0,0,0,205
15316,19485015,19485015,19485128,0,0,0,113
15317,19485069,19485069,19485148,0,0,0,79
15140,19440132,19440132,19485387,0,0,0,45255
15318,19485489,19485489,19485602,0,0,0,113
15139,19440126,19440126,19485766,0,0,0,45640
15319,19485710,19485710,19485818,0,0,0,108
15141,19440132,19440132,19485903,0,0,0,45771
15290,19483801,19484144,19485944,0,0,343,2143
15142,19440132,19440132,19486110,0,0,0,45978
15320,19486063,19486063,19486407,0,0,0,344
15209,19473617,19473617,19487177,0,0,0,13560
15321,19487596,19487596,19487793,0,0,0,197
15143,19440133,19440133,19487961,0,0,0,47828
15265,19479809,19479809,19490609,0,0,0,10800
15125,19413342,19413342,19491438,0,0,0,78096
15131,19421331,19421331,19492955,0,0,0,71624
15326,19493866,19493866,19493993,0,0,0,127
15173,19440139,19440139,19494449,0,0,0,54310
15029,19408540,19408540,19494940,0,0,0,86400
15174,19440139,19440139,19495747,0,0,0,55608
15175,19440139,19440139,19495747,0,0,0,55608
15166,19440138,19440138,19495934,0,0,0,55796
15180,19440140,19440140,19496009,0,0,0,55869
15176,19440139,19440139,19496112,0,0,0,55973
15333,19495980,19495980,19496130,0,0,0,150
15167,19440138,19440138,19496196,0,0,0,56058
15334,19496078,19496078,19496233,0,0,0,155
15322,19492747,19492747,19496382,0,0,0,3635
15330,19495076,19495076,19496394,0,0,0,1318
15323,19492877,19492877,19496416,0,0,0,3539
15177,19440139,19440139,19496418,0,0,0,56279
15324,19492923,19492923,19496455,0,0,0,3532
15325,19492977,19492977,19496461,0,0,0,3484
15338,19496388,19496388,19496544,0,0,0,156
15186,19440141,19440141,19496924,0,0,0,56783
15342,19496761,19496761,19496969,0,0,0,208
15181,19440140,19440140,19496983,0,0,0,56843
15182,19440140,19440140,19496983,0,0,0,56843
15183,19440140,19440140,19497118,0,0,0,56978
15343,19496979,19496979,19497138,0,0,0,159
15187,19440141,19440141,19497551,0,0,0,57410
15184,19440140,19440140,19497612,0,0,0,57472
15188,19440141,19440141,19497858,0,0,0,57717
15127,19417005,19417005,19498159,0,0,0,81154
15344,19497637,19497637,19498181,0,0,0,544
15345,19498192,19498192,19498318,0,0,0,126
15346,19498207,19498207,19498343,0,0,0,136
15347,19498218,19498218,19498397,0,0,0,179
15349,19498228,19498343,19498461,0,0,115,233
15348,19498222,19498318,19498770,0,0,96,548
15147,19440134,19440134,19502734,0,0,0,62600
15159,19440137,19440137,19502885,0,0,0,62748
15160,19440137,19440137,19503237,0,0,0,63100
15148,19440134,19440134,19503400,0,0,0,63266
15151,19440135,19440135,19503463,0,0,0,63328
15152,19440135,19440135,19503580,0,0,0,63445
15178,19440139,19440139,19503847,0,0,0,63708
15161,19440137,19440137,19503887,0,0,0,63750
15153,19440135,19440135,19503958,0,0,0,63823
15156,19440136,19440136,19503990,0,0,0,63854
15129,19417852,19417852,19504252,0,0,0,86400
15352,19504101,19504101,19504380,0,0,0,279
15355,19504262,19504262,19504400,0,0,0,138
15185,19440140,19440140,19504442,0,0,0,64302
15356,19504288,19504380,19504475,0,0,92,187
15168,19440138,19440138,19504922,0,0,0,64784
15149,19440134,19440134,19505104,0,0,0,64970
15358,19505354,19505354,19505485,0,0,0,131
15359,19505378,19505378,19505630,0,0,0,252
15179,19440139,19440139,19505751,0,0,0,65612
15353,19504167,19504167,19505967,0,0,0,1800
15360,19505841,19505841,19506012,0,0,0,171
15361,19506056,19506056,19506151,0,0,0,95
15354,19504230,19504475,19506275,0,0,245,2045
15362,19506301,19506301,19506374,0,0,0,73
15363,19506447,19506447,19506517,0,0,0,70
15357,19504304,19505967,19506567,0,0,1663,2263
15364,19506512,19506512,19506570,0,0,0,58
15365,19506575,19506575,19508243,0,0,0,1668
15369,19508200,19508200,19508283,0,0,0,83
15370,19508281,19508281,19508354,0,0,0,73
15274,19483513,19483513,19508546,0,0,0,25033
15366,19507774,19507774,19509574,0,0,0,1800
15367,19507787,19507787,19509587,0,0,0,1800
15371,19509776,19509776,19509882,0,0,0,106
15372,19509828,19509828,19509989,0,0,0,161
15373,19509937,19509937,19510136,0,0,0,199
15374,19510133,19510133,19510366,0,0,0,233
15375,19510551,19510551,19510604,0,0,0,53
15376,19510603,19510603,19511002,0,0,0,399
15377,19510993,19510993,19512611,0,0,0,1618
15212,19473850,19473850,19513337,0,0,0,39487
15211,19473743,19473743,19513750,0,0,0,40007
15379,19514648,19514648,19517247,0,0,0,2599
15380,19517191,19517191,19517762,0,0,0,571
15378,19514468,19514468,19519077,0,0,0,4609
15154,19440135,19440135,19519138,0,0,0,79003
15331,19495098,19495098,19519395,0,0,0,24297
15144,19440133,19440133,19519612,0,0,0,79479
15157,19440136,19440136,19519863,0,0,0,79727
15162,19440137,19440137,19519980,0,0,0,79843
15145,19440133,19440133,19520122,0,0,0,79989
15146,19440133,19440133,19520122,0,0,0,79989
15155,19440135,19440135,19520238,0,0,0,80103
15350,19499426,19499426,19520514,0,0,0,21088
15163,19440137,19440137,19520740,0,0,0,80603
15150,19440134,19440134,19520790,0,0,0,80656
15158,19440136,19440136,19520823,0,0,0,80687
15169,19440138,19440138,19520974,0,0,0,80836
15164,19440137,19440137,19521051,0,0,0,80914
15170,19440138,19440138,19521177,0,0,0,81039
15171,19440138,19440138,19521726,0,0,0,81588
15165,19440137,19440137,19521798,0,0,0,81661
15172,19440138,19440138,19523227,0,0,0,83089
15382,19528537,19528537,19528716,0,0,0,179
15383,19528645,19528645,19528835,0,0,0,190
15384,19528714,19528714,19539657,0,0,0,10943
15385,19554378,19554378,19555274,0,0,0,896
15386,19555733,19555733,19555893,0,0,0,160
15387,19555754,19555754,19555922,0,0,0,168
15391,19556594,19556594,19556794,0,0,0,200
15392,19556794,19556794,19556952,0,0,0,158
15393,19556871,19556871,19557151,0,0,0,280
15388,19556182,19556182,19557200,0,0,0,1018
15394,19557235,19557235,19557370,0,0,0,135
15397,19557463,19557463,19557661,0,0,0,198
15405,19557740,19557740,19557845,0,0,0,105
15398,19557463,19557661,19558004,0,0,198,541
15399,19557463,19558004,19558205,0,0,541,742
15407,19558122,19558122,19558234,0,0,0,112
15408,19558223,19558223,19558338,0,0,0,115
15409,19558370,19558370,19558474,0,0,0,104
15396,19557461,19557461,19558683,0,0,0,1222
15400,19557463,19558205,19559075,0,0,742,1612
15410,19558541,19558541,19559168,0,0,0,627
15402,19557497,19559075,19559306,0,0,1578,1809
15412,19559312,19559312,19559379,0,0,0,67
15401,19557464,19558683,19559380,0,0,1219,1916
15403,19557509,19559075,19559422,0,0,1566,1913
15413,19559481,19559481,19559568,0,0,0,87
15414,19559579,19559579,19559815,0,0,0,236
15416,19559901,19559901,19560111,0,0,0,210
15411,19558631,19559380,19560211,0,0,749,1580
15404,19557522,19560211,19562011,0,0,2689,4489
15419,19562148,19562148,19562279,0,0,0,131
15389,19556398,19556398,19564024,0,0,0,7626
15390,19556406,19556406,19564194,0,0,0,7788
15422,19564570,19564570,19564654,0,0,0,84
15423,19564721,19564721,19564797,0,0,0,76
15428,19564930,19564930,19565049,0,0,0,119
15429,19565017,19565017,19565101,0,0,0,84
15432,19565519,19565519,19565675,0,0,0,156
15415,19559695,19559695,19565772,0,0,0,6077
15433,19565805,19565805,19565911,0,0,0,106
15434,19565867,19565867,19565983,0,0,0,116
15435,19566051,19566051,19566167,0,0,0,116
15436,19566833,19566833,19566958,0,0,0,125
15437,19567021,19567021,19567109,0,0,0,88
15439,19567297,19567297,19567386,0,0,0,89
15440,19567408,19567408,19567766,0,0,0,358
15417,19560661,19562011,19568211,0,0,1350,7550
15442,19570668,19570668,19571067,0,0,0,399
15418,19561198,19561198,19571998,0,0,0,10800
15441,19570592,19570592,19572146,0,0,0,1554
15444,19571638,19571638,19572254,0,0,0,616
15199,19473071,19473071,19572365,0,0,0,99294
15443,19571397,19571397,19572420,0,0,0,1023
15445,19572516,19572516,19572625,0,0,0,109
15446,19572723,19572723,19572818,0,0,0,95
15448,19572838,19572838,19572948,0,0,0,110
15447,19572769,19572769,19573037,0,0,0,268
15449,19572953,19572953,19573062,0,0,0,109
15451,19573041,19573041,19573150,0,0,0,109
15452,19573154,19573154,19573263,0,0,0,109
15453,19573348,19573348,19573418,0,0,0,70
15454,19573440,19573440,19573510,0,0,0,70
15455,19573542,19573542,19573611,0,0,0,69
15456,19573621,19573621,19573733,0,0,0,112
15450,19572965,19572965,19573930,0,0,0,965
15457,19573685,19573685,19573946,0,0,0,261
15460,19573988,19573988,19574609,0,0,0,621
15459,19573957,19573957,19574672,0,0,0,715
15461,19574419,19574419,19574701,0,0,0,282
15462,19574634,19574634,19574712,0,0,0,78
15464,19574792,19574792,19574897,0,0,0,105
15465,19574880,19574880,19575063,0,0,0,183
15463,19574747,19574747,19576110,0,0,0,1363
15467,19575773,19575773,19576492,0,0,0,719
15468,19575920,19575920,19576545,0,0,0,625
15340,19496417,19496417,19578142,0,0,0,81725
15341,19496431,19496431,19578167,0,0,0,81736
15332,19495099,19495099,19578725,0,0,0,83626
15470,19578722,19578722,19578853,0,0,0,131
15471,19579065,19579065,19579285,0,0,0,220
15336,19496351,19496351,19579763,0,0,0,83412
15335,19496339,19496339,19579773,0,0,0,83434
15337,19496369,19496369,19579781,0,0,0,83412
15339,19496406,19496406,19579818,0,0,0,83412
15472,19579351,19579351,19579941,0,0,0,590
15473,19579666,19579666,19580194,0,0,0,528
15424,19564847,19564847,19580341,0,0,0,15494
15426,19564887,19564887,19580366,0,0,0,15479
15427,19564913,19564913,19580371,0,0,0,15458
15430,19565056,19565056,19580389,0,0,0,15333
15431,19565111,19565111,19580402,0,0,0,15291
15487,19580640,19580640,19580843,0,0,0,203
15486,19580370,19580370,19580876,0,0,0,506
15491,19581726,19581726,19581855,0,0,0,129
15492,19581726,19581855,19582228,0,0,129,502
15488,19580866,19580866,19583282,0,0,0,2416
15207,19473292,19473292,19583323,0,0,0,110031
15493,19581726,19582228,19584028,0,0,502,2302
15498,19583158,19583158,19584057,0,0,0,899
15458,19573912,19573912,19584712,0,0,0,10800
15425,19564859,19564859,19585529,0,0,0,20670
15494,19581727,19584028,19585828,0,0,2301,4101
15503,19586526,19586526,19586631,0,0,0,105
15495,19581727,19585828,19587628,0,0,4101,5901
15496,19581727,19587628,19587746,0,0,5901,6019
15395,19557257,19557257,19588445,0,0,0,31188
15466,19575291,19575291,19596614,0,0,0,21323
15505,19592628,19592628,19599571,0,0,0,6943
15483,19580332,19580332,19600424,0,0,0,20092
15484,19580348,19580348,19600480,0,0,0,20132
15485,19580355,19580355,19600685,0,0,0,20330
15508,19599362,19599362,19600800,0,0,0,1438
15481,19580307,19580307,19600914,0,0,0,20607
15480,19580297,19580297,19601015,0,0,0,20718
15482,19580321,19580321,19601332,0,0,0,21011
15205,19473285,19473285,19601770,0,0,0,128485
15490,19581331,19581331,19602126,0,0,0,20795
15420,19562237,19562237,19603286,0,0,0,41049
15499,19583359,19583359,19604806,0,0,0,21447
15201,19473140,19473140,19615793,0,0,0,142653
15489,19581009,19581009,19617009,0,0,0,36000
15381,19517642,19517642,19625942,0,0,0,108300
15203,19473201,19473201,19637040,0,0,0,163839
15438,19567075,19567075,19644028,0,0,0,76953
15512,19600973,19600973,19644345,0,0,0,43372
15516,19601604,19601604,19644993,0,0,0,43389
15517,19601908,19601908,19645275,0,0,0,43367
15518,19601916,19602126,19645504,0,0,210,43588
15136,19437371,19437371,19667131,0,0,0,229760
15204,19473283,19473283,19671287,0,0,0,198004
15202,19473173,19473173,19671332,0,0,0,198159
15206,19473289,19473289,19671605,0,0,0,198316
15200,19473102,19473102,19672418,0,0,0,199316
15351,19501529,19501529,19672752,0,0,0,171223
15509,19600874,19672752,19672884,0,0,71878,72010
15510,19600956,19672884,19673145,0,0,71928,72189
15511,19600968,19673145,19674945,0,0,72177,73977
15126,19416808,19416808,19676008,0,0,0,259200
15513,19601009,19674945,19676745,0,0,73936,75736
15514,19601031,19676745,19677006,0,0,75714,75975
15130,19417883,19417883,19677083,0,0,0,259200
15515,19601043,19677006,19677606,0,0,75963,76563
15507,19592852,19600800,19680219,0,0,7948,87367
15519,19677964,19677964,19681342,0,0,0,3378
15138,19437961,19437961,19697161,0,0,0,259200
15501,19583958,19587746,19720399,0,0,3788,136441
15478,19579845,19579845,19727063,0,0,0,147218
15500,19583936,19583936,19727781,0,0,0,143845
15523,19734669,19734669,19734901,0,0,0,232
15421,19562503,19562503,19735303,0,0,0,172800
15479,19579862,19579862,19737980,0,0,0,158118
15522,19734578,19734578,19746287,0,0,0,11709
15521,19734545,19734545,19746607,0,0,0,12062
15327,19494609,19494609,19747209,0,0,0,252600
15328,19494629,19494629,19747229,0,0,0,252600
15329,19494643,19494643,19747243,0,0,0,252600
15475,19579812,19579812,19747874,0,0,0,168062
15502,19583972,19587746,19747944,0,0,3774,163972
15477,19579833,19579833,19750338,0,0,0,170505
15497,19582392,19582392,19755125,0,0,0,172733
15504,19586682,19586682,19759440,0,0,0,172758
15368,19507850,19507850,19767050,0,0,0,259200
15406,19557945,19557945,19768632,0,0,0,210687
15469,19576511,19576511,19770726,0,0,0,194215
15520,19693669,19693669,19770806,0,0,0,77137
15476,19579822,19579822,19774982,0,0,0,195160
15529,19775898,19775898,19799280,0,0,0,23382
15531,19785770,19785770,19802802,0,0,0,17032
15528,19775623,19775623,19811711,0,0,0,36088
15474,19579803,19579803,19813373,0,0,0,233570
15539,19813391,19813391,19815151,0,0,0,1760
15543,19816418,19816418,19816524,0,0,0,106
15544,19816435,19816435,19816549,0,0,0,114
15546,19816738,19816738,19817048,0,0,0,310
15545,19816731,19816731,19817053,0,0,0,322
15547,19816766,19816766,19817130,0,0,0,364
15548,19817533,19817533,19817593,0,0,0,60
15526,19774408,19774408,19817773,0,0,0,43365
15549,19817791,19817791,19817892,0,0,0,101
15550,19817816,19817816,19817925,0,0,0,109
15551,19817841,19817841,19817983,0,0,0,142
15553,19818040,19818040,19818218,0,0,0,178
15552,19817940,19817940,19818265,0,0,0,325
15554,19818359,19818359,19818526,0,0,0,167
15527,19775183,19775183,19818531,0,0,0,43348
15556,19818442,19818442,19818535,0,0,0,93
15555,19818395,19818531,19820272,0,0,136,1877
15564,19820828,19820828,19820949,0,0,0,121
15574,19823695,19823695,19823789,0,0,0,94
15571,19822762,19822762,19826362,0,0,0,3600
15586,19830626,19830626,19831119,0,0,0,493
15558,19818691,19818691,19833142,0,0,0,14451
15587,19833330,19833330,19833408,0,0,0,78
15588,19833443,19833443,19833552,0,0,0,109
15557,19818535,19818535,19833866,0,0,0,15331
15591,19833884,19833884,19834100,0,0,0,216
15590,19833725,19833725,19834786,0,0,0,1061
15592,19834177,19834177,19835159,0,0,0,982
15589,19833637,19833637,19835182,0,0,0,1545
15593,19835277,19835277,19835499,0,0,0,222
15594,19835578,19835578,19835895,0,0,0,317
15595,19835944,19835944,19836146,0,0,0,202
15596,19836239,19836239,19836578,0,0,0,339
15597,19836888,19836888,19837112,0,0,0,224
15598,19837173,19837173,19837243,0,0,0,70
15530,19776168,19776168,19837338,0,0,0,61170
15599,19837322,19837322,19837662,0,0,0,340
15600,19837604,19837604,19837711,0,0,0,107
15602,19838503,19838503,19838652,0,0,0,149
15581,19825008,19825008,19838929,0,0,0,13921
15605,19840920,19840920,19840967,0,0,0,47
15606,19840992,19840992,19842242,0,0,0,1250
15541,19815264,19815264,19842349,0,0,0,27085
15609,19842555,19842555,19842675,0,0,0,120
15610,19842777,19842777,19842866,0,0,0,89
15603,19838635,19838635,19842910,0,0,0,4275
15604,19839621,19839621,19842979,0,0,0,3358
15612,19842958,19842958,19843043,0,0,0,85
15540,19815228,19815228,19843332,0,0,0,28104
15538,19813352,19813352,19843355,0,0,0,30003
15608,19842470,19842470,19843758,0,0,0,1288
15584,19829980,19843355,19843945,0,0,13375,13965
15621,19844046,19844046,19844178,0,0,0,132
15585,19830602,19843945,19844534,0,0,13343,13932
15559,19818790,19818790,19854790,0,0,0,36000
15623,19844910,19854790,19854874,0,0,9880,9964
15506,19592741,19599571,19858771,0,0,6830,266030
15569,19821734,19821734,19858826,0,0,0,37092
15570,19821745,19821745,19859455,0,0,0,37710
15579,19824706,19858771,19862337,0,0,34065,37631
15580,19824763,19862337,19862511,0,0,37574,37748
15611,19842935,19842935,19864555,0,0,0,21620
15613,19842984,19842984,19864592,0,0,0,21608
15620,19843563,19843563,19865222,0,0,0,21659
15607,19841775,19862511,19866029,0,0,20736,24254
15625,19845261,19866029,19866426,0,0,20768,21165
15572,19823539,19823539,19866889,0,0,0,43350
15573,19823581,19823581,19866962,0,0,0,43381
15576,19824487,19824487,19877759,0,0,0,53272
15575,19824348,19824348,19877955,0,0,0,53607
15619,19843324,19844534,19881607,0,0,1210,38283
15578,19824568,19826362,19888339,0,0,1794,63771
15525,19773438,19773438,19889529,0,0,0,116091
15601,19837765,19837765,19892773,0,0,0,55008
15631,19901658,19901658,19902695,0,0,0,1037
15634,19904364,19904364,19904464,0,0,0,100
15635,19904818,19904818,19904890,0,0,0,72
15637,19905211,19905211,19905307,0,0,0,96
15617,19843314,19843314,19905520,0,0,0,62206
15628,19899791,19899791,19905525,0,0,0,5734
15638,19905464,19905525,19905950,0,0,61,486
15636,19905124,19905124,19906174,0,0,0,1050
15618,19843320,19844534,19906718,0,0,1214,63398
15614,19843283,19844534,19906762,0,0,1251,63479
15645,19905955,19906718,19906784,0,0,763,829
15650,19906681,19906718,19906837,0,0,37,156
15647,19906112,19906718,19906918,0,0,606,806
15649,19906518,19906718,19906929,0,0,200,411
15651,19906783,19906783,19906986,0,0,0,203
15648,19906254,19906254,19907276,0,0,0,1022
15652,19907100,19907100,19907307,0,0,0,207
15653,19907513,19907513,19907839,0,0,0,326
15654,19907919,19907919,19908278,0,0,0,359
15632,19902478,19905520,19908393,0,0,3042,5915
15615,19843292,19854790,19909812,0,0,11498,66520
15642,19905508,19909812,19910321,0,0,4304,4813
15655,19908164,19908164,19910781,0,0,0,2617
15624,19844978,19854874,19911913,0,0,9896,66935
15658,19911305,19911305,19912351,0,0,0,1046
15577,19824530,19826362,19912762,0,0,1832,88232
15662,19914333,19914333,19914646,0,0,0,313
15663,19915297,19915297,19915659,0,0,0,362
15664,19915975,19915975,19916292,0,0,0,317
15665,19916373,19916373,19916465,0,0,0,92
15666,19916703,19916703,19916792,0,0,0,89
15560,19819617,19820272,19918242,0,0,655,98625
15669,19919960,19919960,19920097,0,0,0,137
15670,19920101,19920101,19920278,0,0,0,177
15616,19843306,19858771,19920977,0,0,15465,77671
15672,19920933,19920933,19921981,0,0,0,1048
15674,19922188,19922188,19922296,0,0,0,108
15673,19921215,19921215,19922778,0,0,0,1563
15678,19922750,19922778,19922852,0,0,28,102
15677,19922619,19922778,19922869,0,0,159,250
15679,19922856,19922856,19922929,0,0,0,73
15680,19922982,19922982,19923088,0,0,0,106
15681,19923089,19923089,19923186,0,0,0,97
15683,19923206,19923206,19923306,0,0,0,100
15682,19923196,19923196,19923307,0,0,0,111
15684,19924005,19924005,19924137,0,0,0,132
15685,19924089,19924089,19924162,0,0,0,73
15686,19924239,19924239,19924333,0,0,0,94
15687,19924245,19924245,19924359,0,0,0,114
15689,19924318,19924318,19924399,0,0,0,81
15690,19924366,19924366,19924436,0,0,0,70
15691,19924550,19924550,19924639,0,0,0,89
15692,19924764,19924764,19924829,0,0,0,65
15693,19924771,19924771,19924847,0,0,0,76
15695,19924914,19924914,19924994,0,0,0,80
15698,19925680,19925680,19925753,0,0,0,73
15699,19925758,19925758,19925832,0,0,0,74
15671,19920777,19920777,19925963,0,0,0,5186
15676,19922507,19922507,19925979,0,0,0,3472
15700,19925905,19925905,19926013,0,0,0,108
15675,19922253,19922253,19926240,0,0,0,3987
15701,19926145,19926145,19926805,0,0,0,660
15703,19926857,19926857,19927716,0,0,0,859
15715,19928069,19928069,19928164,0,0,0,95
15707,19927929,19927929,19928165,0,0,0,236
15716,19928222,19928222,19928368,0,0,0,146
15566,19821341,19821341,19932786,0,0,0,111445
15747,19934288,19934288,19934366,0,0,0,78
15748,19934405,19934405,19934452,0,0,0,47
15667,19917547,19918242,19936242,0,0,695,18695
15719,19930910,19930910,19936659,0,0,0,5749
15720,19930929,19936242,19938195,0,0,5313,7266
15535,19786262,19786262,19942768,0,0,0,156506
15721,19930934,19936659,19943514,0,0,5725,12580
15722,19930948,19938195,19943665,0,0,7247,12717
15702,19926838,19926838,19944838,0,0,0,18000
15524,19773415,19773415,19946215,0,0,0,172800
15723,19930955,19943514,19949336,0,0,12559,18381
15717,19928355,19928355,19949913,0,0,0,21558
15728,19931574,19946215,19949968,0,0,14641,18394
15726,19931016,19944838,19950416,0,0,13822,19400
15724,19930962,19943665,19950427,0,0,12703,19465
15727,19931023,19946215,19950567,0,0,15192,19544
15567,19821689,19821689,19951289,0,0,0,129600
15568,19821701,19821701,19951301,0,0,0,129600
15725,19930968,19944838,19951371,0,0,13870,20403
15729,19931591,19946215,19951953,0,0,14624,20362
15733,19931616,19950416,19952032,0,0,18800,20416
15743,19932005,19952032,19952955,0,0,20027,20950
15744,19932010,19952955,19953593,0,0,20945,21583
15738,19931964,19951301,19953753,0,0,19337,21789
15742,19932001,19951953,19953830,0,0,19952,21829
15740,19931981,19951301,19954668,0,0,19320,22687
15731,19931603,19949913,19954726,0,0,18310,23123
15730,19931598,19949336,19954806,0,0,17738,23208
15737,19931944,19951289,19955213,0,0,19345,23269
15732,19931610,19949968,19955578,0,0,18358,23968
15734,19931624,19950427,19955932,0,0,18803,24308
15745,19932017,19953593,19956490,0,0,21576,24473
15735,19931649,19950567,19956742,0,0,18918,25093
15536,19786422,19786422,19956805,0,0,0,170383
15714,19927968,19956805,19956916,0,0,28837,28948
15736,19931656,19951289,19956982,0,0,19633,25326
15741,19931992,19951371,19960176,0,0,19379,28184
15739,19931975,19951301,19960194,0,0,19326,28219
15706,19927921,19960176,19960311,0,0,32255,32390
15713,19927963,19960311,19960424,0,0,32348,32461
15656,19910762,19932786,19961084,0,0,22024,50322
15705,19927916,19961084,19961212,0,0,33168,33296
15708,19927934,19961212,19961586,0,0,33278,33652
15709,19927940,19961586,19961741,0,0,33646,33801
15712,19927958,19961741,19961862,0,0,33783,33904
15542,19815399,19815399,19964289,0,0,0,148890
15643,19905526,19905950,19971443,0,0,424,65917
15646,19906021,19912762,19978485,0,0,6741,72464
15630,19900671,19900671,19982587,0,0,0,81916
15752,19985383,19985383,19985466,0,0,0,83
15668,19919690,19920977,19985621,0,0,1287,65931
15753,19985669,19985669,19985777,0,0,0,108
15754,19986166,19986166,19986245,0,0,0,79
15757,19990377,19990377,19990491,0,0,0,114
15758,19990422,19990422,19990509,0,0,0,87
15764,19990437,19990437,19990519,0,0,0,82
15759,19990423,19990423,19990537,0,0,0,114
15760,19990423,19990423,19990537,0,0,0,114
15761,19990423,19990423,19990537,0,0,0,114
15765,19990437,19990437,19990546,0,0,0,109
15762,19990424,19990424,19990549,0,0,0,125
15769,19990463,19990463,19990588,0,0,0,125
15766,19990438,19990491,19990600,0,0,53,162
15770,19990469,19990519,19990627,0,0,50,158
15771,19990469,19990537,19990645,0,0,68,176
15767,19990438,19990537,19990646,0,0,99,208
15768,19990438,19990549,19990658,0,0,111,220
15784,19990521,19990546,19990699,0,0,25,178
15776,19990488,19990491,19990717,0,0,3,229
15785,19990521,19990588,19990776,0,0,67,255
15777,19990488,19990537,19990785,0,0,49,297
15772,19990469,19990646,19990799,0,0,177,330
15774,19990470,19990658,19990811,0,0,188,341
15786,19990522,19990645,19990833,0,0,123,311
15778,19990488,19990600,19990871,0,0,112,383
15787,19990522,19990799,19990982,0,0,277,460
15779,19990488,19990785,19991056,0,0,297,568
15780,19990488,19990811,19991113,0,0,323,625
15788,19990522,19990982,19991188,0,0,460,666
15793,19990817,19991113,19991200,0,0,296,383
15622,19844187,19844187,19991314,0,0,0,147127
15763,19990424,19991200,19991325,0,0,776,901
15773,19990470,19991325,19991433,0,0,855,963
15781,19990489,19991433,19991749,0,0,944,1260
15789,19990522,19991749,19991967,0,0,1227,1445
15795,19991470,19991967,19992040,0,0,497,570
15794,19991256,19991967,19992073,0,0,711,817
15796,19991677,19992040,19992113,0,0,363,436
15797,19992133,19992133,19992181,0,0,0,48
15798,19992139,19992139,19992213,0,0,0,74
15799,19992139,19992139,19992213,0,0,0,74
15800,19992140,19992140,19992256,0,0,0,116
15801,19992140,19992140,19992256,0,0,0,116
15802,19992140,19992256,19992372,0,0,116,232
15806,19992440,19992440,19992555,0,0,0,115
15807,19992601,19992601,19992706,0,0,0,105
15812,19992719,19992719,19992853,0,0,0,134
15816,19992730,19992730,19992853,0,0,0,123
15808,19992707,19992707,19992984,0,0,0,277
15815,19992725,19992853,19992987,0,0,128,262
15756,19986916,19986916,19994552,0,0,0,7636
15830,19995112,19995112,19995258,0,0,0,146
15627,19845673,19877759,19996115,0,0,32086,150442
15775,19990470,19996115,19996209,0,0,5645,5739
15811,19992719,19996115,19996218,0,0,3396,3499
15819,19992742,19996218,19996420,0,0,3476,3678
15782,19990489,19996209,19996528,0,0,5720,6039
15821,19992753,19996420,19996541,0,0,3667,3788
15790,19990523,19996528,19996639,0,0,6005,6116
15831,19996476,19996541,19996645,0,0,65,169
15803,19992140,19996639,19996755,0,0,4499,4615
15832,19996643,19996645,19996761,0,0,2,118
15823,19992900,19992984,19996805,0,0,84,3905
15833,19996732,19996732,19996842,0,0,0,110
15809,19992707,19996755,19997052,0,0,4048,4345
15834,19997005,19997005,19997140,0,0,0,135
15813,19992719,19997052,19997166,0,0,4333,4447
15817,19992730,19997166,19997249,0,0,4436,4519
15835,19997173,19997173,19997280,0,0,0,107
15837,19997284,19997284,19997388,0,0,0,104
15838,19997408,19997408,19997562,0,0,0,154
15839,19997613,19997613,19997728,0,0,0,115
15749,19934568,19954668,19997792,0,0,20100,63224
15746,19933054,19953830,19998953,0,0,20776,65899
15841,19999687,19999687,19999760,0,0,0,73
15842,19999829,19999829,19999902,0,0,0,73
15843,19999955,19999955,20000056,0,0,0,101
15845,20001610,20001610,20001757,0,0,0,147
15824,19993014,19993014,20002139,0,0,0,9125
15847,20002163,20002163,20002270,0,0,0,107
15849,20002494,20002494,20002565,0,0,0,71
15829,19994519,19994519,20002910,0,0,0,8391
15840,19999216,19999216,20003038,0,0,0,3822
15852,20004316,20004316,20004474,0,0,0,158
15853,20004562,20004562,20004678,0,0,0,116
15854,20004757,20004757,20004892,0,0,0,135
15836,19997187,19997187,20005251,0,0,0,8064
15641,19905493,19905950,20005839,0,0,457,100346
15639,19905474,19905950,20005850,0,0,476,100376
15856,20006333,20006333,20006433,0,0,0,100
15857,20006799,20006799,20006895,0,0,0,96
15858,20007912,20007912,20007982,0,0,0,70
15859,20008132,20008132,20008243,0,0,0,111
15860,20008247,20008247,20008318,0,0,0,71
15862,20008382,20008382,20008471,0,0,0,89
15861,20008366,20008366,20008477,0,0,0,111
15863,20008568,20008568,20008668,0,0,0,100
15864,20008577,20008577,20008750,0,0,0,173
15865,20008677,20008677,20008828,0,0,0,151
15866,20008870,20008870,20008981,0,0,0,111
15867,20008943,20008943,20009103,0,0,0,160
15851,20003276,20003276,20009180,0,0,0,5904
15791,19990523,20009180,20009413,0,0,18657,18890
15868,20009345,20009345,20009413,0,0,0,68
15804,19992141,20009413,20009518,0,0,17272,17377
15869,20009438,20009438,20009552,0,0,0,114
15850,20003254,20003254,20009634,0,0,0,6380
15870,20009475,20009475,20009657,0,0,0,182
15810,19992708,20009518,20009665,0,0,16810,16957
15871,20009535,20009535,20009741,0,0,0,206
15814,19992720,20009665,20009758,0,0,16945,17038
15872,20009622,20009634,20009798,0,0,12,176
15818,19992730,20009758,20009873,0,0,17028,17143
15820,19992743,20009873,20009966,0,0,17130,17223
15822,19992753,20009966,20010129,0,0,17213,17376
15873,20009784,20009784,20010188,0,0,0,404
15874,20010038,20010038,20010203,0,0,0,165
15875,20010066,20010066,20010234,0,0,0,168
15825,19993938,20010129,20010264,0,0,16191,16326
15826,19994006,20010264,20010590,0,0,16258,16584
15827,19994394,20010590,20010816,0,0,16196,16422
15828,19994403,20010816,20011044,0,0,16413,16641
15846,20002132,20011044,20011185,0,0,8912,9053
15877,20011274,20011274,20011427,0,0,0,153
15878,20011289,20011289,20011470,0,0,0,181
15882,20011592,20011592,20011723,0,0,0,131
15883,20011684,20011684,20011800,0,0,0,116
15885,20011709,20011709,20011847,0,0,0,138
15884,20011693,20011693,20011884,0,0,0,191
15718,19928436,19928436,20011959,0,0,0,83523
15886,20011711,20011711,20012044,0,0,0,333
15887,20011774,20011774,20012083,0,0,0,309
15876,20010187,20010187,20012256,0,0,0,2069
15894,20012265,20012265,20012400,0,0,0,135
15895,20012277,20012277,20012454,0,0,0,177
15892,20012058,20012058,20012898,0,0,0,840
15889,20011947,20011947,20013140,0,0,0,1193
15888,20011816,20011816,20013206,0,0,0,1390
15640,19905483,19906762,20013253,0,0,1279,107770
15890,20011970,20012898,20013792,0,0,928,1822
15899,20013166,20013792,20013895,0,0,626,729
15903,20013412,20013895,20014007,0,0,483,595
15902,20013398,20013895,20014061,0,0,497,663
15904,20013752,20014007,20014122,0,0,255,370
15905,20013768,20014061,20014238,0,0,293,470
15907,20014291,20014291,20014450,0,0,0,159
15898,20013104,20013792,20014903,0,0,688,1799
15848,20002194,20002194,20015897,0,0,0,13703
15909,20014811,20014903,20016053,0,0,92,1242
15893,20012081,20012081,20016137,0,0,0,4056
15911,20015177,20016137,20016190,0,0,960,1013
15644,19905849,19910321,20016292,0,0,4472,110443
15910,20015175,20016137,20016305,0,0,962,1130
15917,20016104,20016104,20016320,0,0,0,216
15912,20015441,20016190,20016365,0,0,749,924
15913,20015456,20016305,20016469,0,0,849,1013
15914,20015886,20016320,20016471,0,0,434,585
15915,20015903,20016365,20016505,0,0,462,602
15921,20016300,20016471,20016609,0,0,171,309
15920,20016288,20016469,20016629,0,0,181,341
15922,20016392,20016505,20016871,0,0,113,479
15891,20012019,20013140,20017236,0,0,1121,5217
15923,20016734,20016871,20017613,0,0,137,879
15925,20017584,20017613,20018410,0,0,29,826
15926,20017609,20018410,20018702,0,0,801,1093
15928,20017651,20018702,20019530,0,0,1051,1879
15949,20018595,20019530,20020238,0,0,935,1643
15633,19903701,19942768,20025576,0,0,39067,121875
15855,20005297,20005297,20026134,0,0,0,20837
15939,20017795,20026134,20026251,0,0,8339,8456
15940,20017796,20026251,20026368,0,0,8455,8572
15941,20017797,20026368,20026485,0,0,8571,8688
15942,20017798,20026485,20026602,0,0,8687,8804
15943,20017798,20026602,20026719,0,0,8804,8921
15951,20019262,20026719,20026852,0,0,7457,7590
15952,20019263,20026852,20026985,0,0,7589,7722
15953,20019264,20026985,20027118,0,0,7721,7854
15954,20019264,20027118,20027251,0,0,7854,7987
15955,20019265,20027251,20027384,0,0,7986,8119
15956,20019266,20027384,20027517,0,0,8118,8251
15626,19845648,19866426,20032187,0,0,20778,186539
15958,20036133,20036133,20036259,0,0,0,126
15959,20036379,20036379,20036486,0,0,0,107
15960,20036488,20036488,20036620,0,0,0,132
15961,20036488,20036620,20036752,0,0,132,264
15962,20036489,20036752,20036884,0,0,263,395
15963,20036489,20036884,20037016,0,0,395,527
15964,20036489,20037016,20037148,0,0,527,659
15965,20036489,20037148,20037280,0,0,659,791
15966,20036489,20037280,20037412,0,0,791,923
15967,20036489,20037412,20037506,0,0,923,1017
15968,20036489,20037506,20037653,0,0,1017,1164
15969,20036491,20037653,20037747,0,0,1162,1256
15970,20037117,20037747,20037879,0,0,630,762
15971,20037117,20037879,20038011,0,0,762,894
15972,20037117,20038011,20038143,0,0,894,1026
15973,20037117,20038143,20038275,0,0,1026,1158
15974,20037117,20038275,20038407,0,0,1158,1290
15975,20037117,20038407,20038539,0,0,1290,1422
15976,20037118,20038539,20038671,0,0,1421,1553
15977,20037118,20038671,20038765,0,0,1553,1647
15978,20037118,20038765,20038859,0,0,1647,1741
15979,20037118,20038859,20038953,0,0,1741,1835
15980,20037118,20038953,20039047,0,0,1835,1929
15981,20037118,20039047,20039141,0,0,1929,2023
15982,20037118,20039141,20039277,0,0,2023,2159
15983,20037119,20039277,20039371,0,0,2158,2252
15984,20037119,20039371,20039504,0,0,2252,2385
15985,20037119,20039504,20039637,0,0,2385,2518
15986,20037119,20039637,20039770,0,0,2518,2651
15987,20037119,20039770,20039903,0,0,2651,2784
15988,20037119,20039903,20040036,0,0,2784,2917
15989,20037119,20040036,20040169,0,0,2917,3050
15532,19785907,19785907,20045107,0,0,0,259200
15533,19785956,19785956,20045156,0,0,0,259200
15534,19785993,19785993,20045193,0,0,0,259200
15924,20017534,20045107,20045205,0,0,27573,27671
15927,20017618,20045107,20045213,0,0,27489,27595
15929,20017665,20045107,20045226,0,0,27442,27561
15930,20017666,20045156,20045263,0,0,27490,27597
15932,20017667,20045156,20045274,0,0,27489,27607
15931,20017666,20045156,20045278,0,0,27490,27612
15934,20017695,20045193,20045299,0,0,27498,27604
15933,20017668,20045193,20045311,0,0,27525,27643
15935,20017696,20045213,20045319,0,0,27517,27623
15937,20017698,20045278,20045356,0,0,27580,27658
15936,20017697,20045263,20045370,0,0,27566,27673
15938,20017699,20045299,20045406,0,0,27600,27707
15944,20018429,20045319,20045434,0,0,26890,27005
15945,20018431,20045356,20045493,0,0,26925,27062
15947,20018436,20045406,20045499,0,0,26970,27063
15946,20018434,20045370,20045504,0,0,26936,27070
15948,20018439,20045434,20045557,0,0,26995,27118
15537,19786585,19786585,20045785,0,0,0,259200
15561,19820116,20045557,20045890,0,0,225441,225774
15562,19820430,20045890,20046141,0,0,225460,225711
15563,19820679,20046141,20046261,0,0,225462,225582
15565,19821180,20046261,20046861,0,0,225081,225681
15916,20016038,20016038,20047545,0,0,0,31507
15704,19927679,20046861,20048661,0,0,119182,120982
15710,19927946,20048661,20050461,0,0,120715,122515
15711,19927953,20050461,20052261,0,0,122508,124308
15783,19990489,20052261,20052397,0,0,61772,61908
15792,19990523,20052397,20052997,0,0,61874,62474
15805,19992141,20052997,20053597,0,0,60856,61456
15844,20001483,20053597,20053716,0,0,52114,52233
15950,20018721,20026134,20062088,0,0,7413,43367
15957,20019887,20026134,20062088,0,0,6247,42201
15990,20074534,20074534,20074678,0,0,0,144
15991,20074877,20074877,20074913,0,0,0,36
15992,20074921,20074921,20074994,0,0,0,73
15993,20075129,20075129,20075274,0,0,0,145
15994,20075223,20075223,20075341,0,0,0,118
16007,20075227,20075227,20075343,0,0,0,116
15995,20075224,20075224,20075352,0,0,0,128
16000,20075225,20075225,20075353,0,0,0,128
16008,20075227,20075227,20075358,0,0,0,131
16009,20075227,20075227,20075367,0,0,0,140
16010,20075227,20075227,20075367,0,0,0,140
15996,20075224,20075224,20075383,0,0,0,159
15997,20075224,20075224,20075383,0,0,0,159
15998,20075224,20075224,20075383,0,0,0,159
15999,20075224,20075224,20075383,0,0,0,159
16001,20075225,20075225,20075384,0,0,0,159
16002,20075225,20075225,20075384,0,0,0,159
16003,20075226,20075226,20075385,0,0,0,159
16004,20075226,20075226,20075385,0,0,0,159
16005,20075226,20075226,20075385,0,0,0,159
16006,20075226,20075226,20075385,0,0,0,159
16011,20075228,20075228,20075390,0,0,0,162
16012,20075228,20075228,20075390,0,0,0,162
16013,20075228,20075228,20075390,0,0,0,162
16014,20076801,20076801,20076891,0,0,0,90
16015,20077139,20077139,20077234,0,0,0,95
16017,20077250,20077250,20077354,0,0,0,104
16016,20077244,20077244,20077606,0,0,0,362
16021,20079085,20079085,20079246,0,0,0,161
16020,20079068,20079068,20079251,0,0,0,183
16022,20079297,20079297,20079447,0,0,0,150
16023,20079311,20079311,20079471,0,0,0,160
16025,20079716,20079716,20079864,0,0,0,148
16024,20079550,20079550,20079874,0,0,0,324
16026,20079731,20079731,20079900,0,0,0,169
16027,20080323,20080323,20080416,0,0,0,93
16028,20080772,20080772,20080875,0,0,0,103
16029,20080794,20080794,20080906,0,0,0,112
16030,20081071,20081071,20081208,0,0,0,137
16031,20081083,20081083,20081209,0,0,0,126
16033,20081364,20081364,20081506,0,0,0,142
16034,20081380,20081380,20081507,0,0,0,127
16036,20081797,20081797,20081906,0,0,0,109
16037,20081814,20081814,20081931,0,0,0,117
16039,20082083,20082083,20082198,0,0,0,115
16040,20082098,20082098,20082210,0,0,0,112
16041,20082155,20082155,20082259,0,0,0,104
16042,20082274,20082274,20082400,0,0,0,126
16043,20082342,20082342,20082478,0,0,0,136
16044,20082356,20082356,20082481,0,0,0,125
16045,20082789,20082789,20082913,0,0,0,124
16046,20082803,20082803,20082915,0,0,0,112
16019,20078070,20078070,20082931,0,0,0,4861
16018,20077928,20077928,20082962,0,0,0,5034
16049,20082962,20082962,20083074,0,0,0,112
16048,20082939,20082939,20083124,0,0,0,185
16050,20083094,20083094,20083201,0,0,0,107
16047,20082912,20082912,20083214,0,0,0,302
16051,20083119,20083119,20083288,0,0,0,169
16052,20083203,20083203,20083374,0,0,0,171
16054,20083310,20083310,20083427,0,0,0,117
16053,20083304,20083304,20083451,0,0,0,147
16055,20083327,20083327,20083463,0,0,0,136
15657,19910778,19910778,20083526,0,0,0,172748
16038,20082046,20082046,20083563,0,0,0,1517
16059,20083605,20083605,20083771,0,0,0,166
16058,20083593,20083593,20083781,0,0,0,188
16060,20087425,20087425,20087758,0,0,0,333
16061,20088079,20088079,20088138,0,0,0,59
16063,20088515,20088515,20088852,0,0,0,337
16065,20089040,20089040,20089179,0,0,0,139
16064,20089027,20089027,20089188,0,0,0,161
16066,20089528,20089528,20089675,0,0,0,147
16067,20089544,20089544,20089707,0,0,0,163
16068,20089854,20089854,20090181,0,0,0,327
16069,20090104,20090104,20090254,0,0,0,150
16070,20090118,20090118,20090277,0,0,0,159
16057,20083523,20083523,20090846,0,0,0,7323
16056,20083504,20083504,20090882,0,0,0,7378
16073,20090856,20090856,20090955,0,0,0,99
16071,20090533,20090533,20091206,0,0,0,673
16075,20092794,20092794,20092929,0,0,0,135
15879,20011310,20011310,20093767,0,0,0,82457
16078,20093823,20093823,20093958,0,0,0,135
16079,20094044,20094044,20094204,0,0,0,160
16080,20094063,20094063,20094233,0,0,0,170
16082,20094343,20094343,20094394,0,0,0,51
16081,20094286,20094286,20094426,0,0,0,140
16083,20094363,20094363,20094542,0,0,0,179
16084,20094423,20094423,20094595,0,0,0,172
16085,20094491,20094491,20094668,0,0,0,177
16086,20094551,20094551,20094728,0,0,0,177
16087,20094615,20094615,20094786,0,0,0,171
16088,20094675,20094675,20094846,0,0,0,171
16089,20094739,20094739,20094906,0,0,0,167
16091,20094853,20094853,20094938,0,0,0,85
15582,19828326,19842349,20094949,0,0,14023,266623
16090,20094798,20094798,20094978,0,0,0,180
16092,20094919,20094919,20095059,0,0,0,140
16093,20094986,20094986,20095152,0,0,0,166
16077,20093501,20093501,20095540,0,0,0,2039
16094,20095593,20095593,20095931,0,0,0,338
15583,19828337,19843332,20095932,0,0,14995,267595
16062,20088159,20088159,20096593,0,0,0,8434
16095,20096767,20096767,20096830,0,0,0,63
16097,20097843,20097843,20097987,0,0,0,144
16098,20097902,20097902,20098069,0,0,0,167
16099,20097946,20097946,20098094,0,0,0,148
16101,20098057,20098057,20098198,0,0,0,141
16100,20098013,20098013,20098199,0,0,0,186
16102,20098109,20098109,20098246,0,0,0,137
16103,20098160,20098160,20098297,0,0,0,137
16104,20098213,20098213,20098374,0,0,0,161
16105,20098264,20098264,20098427,0,0,0,163
16106,20098320,20098320,20098475,0,0,0,155
16107,20098365,20098365,20098530,0,0,0,165
16108,20098417,20098417,20098567,0,0,0,150
16109,20098431,20098431,20098601,0,0,0,170
16113,20098887,20098887,20099036,0,0,0,149
16114,20098902,20098902,20099059,0,0,0,157
16115,20098959,20098959,20099116,0,0,0,157
16116,20099080,20099080,20099236,0,0,0,156
16118,20099128,20099128,20099280,0,0,0,152
16119,20099344,20099344,20099441,0,0,0,97
16120,20099381,20099381,20099469,0,0,0,88
16121,20099551,20099551,20099677,0,0,0,126
16122,20099563,20099563,20099678,0,0,0,115
16125,20099635,20099635,20099745,0,0,0,110
16124,20099633,20099633,20099754,0,0,0,121
16126,20099636,20099636,20099757,0,0,0,121
16123,20099598,20099598,20099778,0,0,0,180
16127,20099768,20099768,20099925,0,0,0,157
15880,20011337,20025576,20100024,0,0,14239,88687
16128,20099880,20099880,20100039,0,0,0,159
16129,20099986,20099986,20100136,0,0,0,150
16130,20100034,20100034,20100193,0,0,0,159
16132,20100120,20100120,20100225,0,0,0,105
16131,20100102,20100102,20100271,0,0,0,169
16133,20100153,20100153,20100278,0,0,0,125
16134,20100154,20100154,20100279,0,0,0,125
16135,20100160,20100160,20100327,0,0,0,167
15897,20012905,20013206,20100376,0,0,301,87471
15919,20016139,20016629,20100587,0,0,490,84448
15901,20013195,20013792,20100700,0,0,597,87505
16137,20101391,20101391,20101740,0,0,0,349
16138,20101830,20101830,20102168,0,0,0,338
16111,20098465,20098465,20102393,0,0,0,3928
15906,20014027,20014027,20102519,0,0,0,88492
16140,20102554,20102554,20102645,0,0,0,91
16139,20102507,20102507,20102663,0,0,0,156
16141,20102578,20102578,20102830,0,0,0,252
16142,20102653,20102653,20103022,0,0,0,369
16143,20102710,20102710,20103085,0,0,0,375
16144,20102777,20102777,20103145,0,0,0,368
16145,20103039,20103039,20103421,0,0,0,382
16146,20103084,20103084,20103424,0,0,0,340
16147,20103162,20103162,20103528,0,0,0,366
16150,20103356,20103356,20103531,0,0,0,175
16148,20103198,20103198,20103558,0,0,0,360
16110,20098456,20098456,20103584,0,0,0,5128
16149,20103223,20103223,20103597,0,0,0,374
16154,20103607,20103607,20103706,0,0,0,99
16151,20103380,20103380,20103742,0,0,0,362
16152,20103480,20103480,20103842,0,0,0,362
16155,20103743,20103743,20103842,0,0,0,99
16158,20103829,20103829,20103917,0,0,0,88
16153,20103565,20103565,20103923,0,0,0,358
15908,20014486,20014486,20104038,0,0,0,89552
16156,20103774,20103774,20104149,0,0,0,375
16157,20103820,20103820,20104188,0,0,0,368
16160,20103929,20103929,20104197,0,0,0,268
16159,20103838,20103838,20104228,0,0,0,390
16162,20104219,20104219,20104312,0,0,0,93
16167,20105484,20105484,20105643,0,0,0,159
15881,20011442,20032187,20106606,0,0,20745,95164
16164,20104337,20104337,20111722,0,0,0,7385
16072,20090832,20090832,20112057,0,0,0,21225
15629,19900593,19900593,20112385,0,0,0,211792
16074,20091028,20091028,20112780,0,0,0,21752
16175,20113492,20113492,20113596,0,0,0,104
16176,20114427,20114427,20114562,0,0,0,135
16177,20114755,20114755,20114885,0,0,0,130
16178,20114894,20114894,20115020,0,0,0,126
16179,20115056,20115056,20115181,0,0,0,125
16180,20115142,20115142,20115292,0,0,0,150
16181,20115528,20115528,20115675,0,0,0,147
16182,20115796,20115796,20115942,0,0,0,146
16183,20116230,20116230,20116357,0,0,0,127
16184,20117447,20117447,20117585,0,0,0,138
16186,20117631,20117631,20117756,0,0,0,125
16187,20118207,20118207,20118353,0,0,0,146
16188,20118437,20118437,20118584,0,0,0,147
16189,20121575,20121575,20121650,0,0,0,75
16190,20121628,20121628,20121743,0,0,0,115
16191,20121776,20121776,20121922,0,0,0,146
16192,20122017,20122017,20122617,0,0,0,600
16096,20096993,20096993,20123260,0,0,0,26267
16193,20123509,20123509,20124109,0,0,0,600
16032,20081215,20081215,20125885,0,0,0,44670
15751,19936913,19954806,20127606,0,0,17893,190693
15918,20016128,20017236,20127704,0,0,1108,111576
15750,19936803,19971443,20132972,0,0,34640,196169
16169,20108227,20108227,20150692,0,0,0,42465
16170,20108331,20108331,20150765,0,0,0,42434
16197,20156570,20156570,20156920,0,0,0,350
16198,20156985,20156985,20157125,0,0,0,140
16199,20157231,20157231,20157340,0,0,0,109
16201,20157488,20157488,20157623,0,0,0,135
16203,20157660,20157660,20157769,0,0,0,109
15755,19986482,19986482,20159282,0,0,0,172800
16204,20159393,20159393,20159955,0,0,0,562
16206,20160559,20160559,20160710,0,0,0,151
16209,20162949,20162949,20163079,0,0,0,130
16210,20163272,20163272,20163350,0,0,0,78
16205,20159971,20159971,20163589,0,0,0,3618
16211,20163584,20163584,20163699,0,0,0,115
15659,19911864,19911864,20163864,0,0,0,252000
15660,19911897,19911897,20163897,0,0,0,252000
15661,19911906,19911906,20163906,0,0,0,252000
16213,20163795,20163795,20163919,0,0,0,124
16214,20163981,20163981,20164087,0,0,0,106
16215,20164216,20164216,20164326,0,0,0,110
16216,20164293,20164293,20164433,0,0,0,140
16217,20164462,20164462,20164540,0,0,0,78
16218,20164907,20164907,20164985,0,0,0,78
16220,20165355,20165355,20165458,0,0,0,103
16221,20165845,20165845,20165934,0,0,0,89
16222,20165992,20165992,20166065,0,0,0,73
16223,20166098,20166098,20166177,0,0,0,79
16224,20166216,20166216,20166296,0,0,0,80
16225,20166248,20166248,20166331,0,0,0,83
16163,20104333,20104333,20166602,0,0,0,62269
16166,20104370,20104370,20166603,0,0,0,62233
16165,20104349,20104349,20166607,0,0,0,62258
16228,20166806,20166806,20167045,0,0,0,239
16227,20166360,20166360,20168040,0,0,0,1680
16226,20166352,20166352,20168044,0,0,0,1692
16232,20170431,20170431,20170526,0,0,0,95
16233,20170483,20170483,20170536,0,0,0,53
16234,20170696,20170696,20170935,0,0,0,239
16235,20171595,20171595,20171833,0,0,0,238
16236,20171991,20171991,20172226,0,0,0,235
16112,20098631,20098631,20172249,0,0,0,73618
16240,20172433,20172433,20172499,0,0,0,66
15900,20013170,20016292,20172543,0,0,3122,159373
16244,20172514,20172514,20172592,0,0,0,78
15896,20012885,20013253,20172763,0,0,368,159878
16245,20172694,20172694,20172783,0,0,0,89
16117,20099122,20099122,20172828,0,0,0,73706
16241,20172464,20172464,20173029,0,0,0,565
16242,20172478,20172478,20173054,0,0,0,576
16247,20172830,20172830,20173055,0,0,0,225
16246,20172821,20172821,20173057,0,0,0,236
16243,20172501,20172501,20173099,0,0,0,598
16248,20172855,20172855,20173102,0,0,0,247
16249,20172939,20173029,20173261,0,0,90,322
16237,20172375,20172375,20173379,0,0,0,1004
16238,20172390,20172390,20173394,0,0,0,1004
16239,20172404,20172404,20173419,0,0,0,1015
16230,20170024,20170024,20173966,0,0,0,3942
16229,20168973,20168973,20174031,0,0,0,5058
16231,20170232,20170232,20174032,0,0,0,3800
16251,20173020,20173029,20174394,0,0,9,1374
16266,20173827,20174394,20174480,0,0,567,653
16208,20162458,20162458,20174723,0,0,0,12265
16279,20174712,20174723,20174842,0,0,11,130
16282,20174910,20174910,20175020,0,0,0,110
16219,20165254,20165254,20175040,0,0,0,9786
16284,20175245,20175245,20175358,0,0,0,113
16285,20175310,20175310,20175369,0,0,0,59
16286,20175369,20175369,20175467,0,0,0,98
16287,20175409,20175409,20175513,0,0,0,104
16289,20175851,20175851,20175929,0,0,0,78
16291,20175981,20175981,20176082,0,0,0,101
16288,20175607,20175607,20176207,0,0,0,600
16292,20176265,20176265,20176381,0,0,0,116
16293,20176344,20176344,20176392,0,0,0,48
16262,20173632,20173632,20176607,0,0,0,2975
16263,20173708,20173708,20176672,0,0,0,2964
16261,20173547,20173547,20176849,0,0,0,3302
16264,20173758,20174032,20177006,0,0,274,3248
16267,20173900,20174394,20177377,0,0,494,3477
16268,20173986,20174480,20177460,0,0,494,3474
16076,20093223,20093223,20177752,0,0,0,84529
16276,20174470,20177752,20178004,0,0,3282,3534
16269,20174063,20175040,20178015,0,0,977,3952
16273,20174186,20174186,20178018,0,0,0,3832
16271,20174113,20176672,20179645,0,0,2559,5532
16272,20174169,20176849,20179822,0,0,2680,5653
16274,20174296,20177006,20179976,0,0,2710,5680
16290,20175942,20179822,20180042,0,0,3880,4100
16294,20176397,20180042,20180283,0,0,3645,3886
16270,20174096,20176607,20180300,0,0,2511,6204
16295,20177260,20180283,20180387,0,0,3023,3127
16275,20174341,20177377,20180404,0,0,3036,6063
16296,20177586,20180300,20180427,0,0,2714,2841
16297,20177702,20180387,20180505,0,0,2685,2803
16298,20177848,20180427,20180543,0,0,2579,2695
16300,20178387,20180543,20180594,0,0,2156,2207
16299,20178170,20180505,20180621,0,0,2335,2451
16280,20174794,20177752,20180775,0,0,2958,5981
16212,20163732,20163732,20180948,0,0,0,17216
16281,20174909,20178004,20181030,0,0,3095,6121
16305,20182037,20182037,20182084,0,0,0,47
16304,20181995,20181995,20182090,0,0,0,95
16306,20182086,20182086,20182252,0,0,0,166
16307,20182260,20182260,20182349,0,0,0,89
16303,20181887,20181887,20182487,0,0,0,600
16308,20182570,20182570,20182759,0,0,0,189
16310,20182939,20182939,20183539,0,0,0,600
16312,20183736,20183736,20183814,0,0,0,78
16313,20183928,20183928,20183974,0,0,0,46
16314,20184056,20184056,20184151,0,0,0,95
16316,20184180,20184180,20184275,0,0,0,95
16317,20184408,20184408,20184519,0,0,0,111
16315,20184151,20184151,20184647,0,0,0,496
16319,20184574,20184574,20184736,0,0,0,162
16320,20184580,20184580,20184753,0,0,0,173
16321,20184580,20184580,20184769,0,0,0,189
16322,20184580,20184580,20184769,0,0,0,189
16323,20184581,20184581,20184770,0,0,0,189
16324,20184581,20184647,20184862,0,0,66,281
16325,20184581,20184736,20184951,0,0,155,370
16326,20184582,20184753,20184968,0,0,171,386
16327,20184582,20184769,20184984,0,0,187,402
16328,20184582,20184769,20185005,0,0,187,423
16329,20184582,20184770,20185006,0,0,188,424
16330,20184583,20184862,20185098,0,0,279,515
16332,20184583,20184968,20185113,0,0,385,530
16331,20184583,20184951,20185120,0,0,368,537
16333,20184583,20184984,20185133,0,0,401,550
16334,20184584,20185005,20185201,0,0,421,617
16335,20184585,20185006,20185202,0,0,421,617
16338,20184928,20185098,20185629,0,0,170,701
16339,20184928,20185113,20185655,0,0,185,727
16341,20184929,20185133,20185675,0,0,204,746
16340,20184928,20185120,20185684,0,0,192,756
16352,20185255,20185255,20185720,0,0,0,465
16342,20184929,20185201,20185754,0,0,272,825
16343,20184929,20185202,20185755,0,0,273,826
16353,20185261,20185720,20186181,0,0,459,920
16344,20184929,20185629,20186182,0,0,700,1253
16345,20184929,20185655,20186208,0,0,726,1279
16347,20184930,20185684,20186237,0,0,754,1307
16346,20184929,20185675,20186239,0,0,746,1310
16349,20184930,20185755,20186283,0,0,825,1353
16348,20184930,20185754,20186318,0,0,824,1388
16359,20186322,20186322,20186401,0,0,0,79
16360,20186504,20186504,20186551,0,0,0,47
16355,20185262,20186208,20186691,0,0,946,1429
16354,20185261,20186181,20186695,0,0,920,1434
16350,20184930,20186182,20186710,0,0,1252,1780
16356,20185262,20186208,20186722,0,0,946,1460
16361,20186610,20186610,20186730,0,0,0,120
16357,20185262,20186237,20186751,0,0,975,1489
16358,20185262,20186237,20186793,0,0,975,1531
16362,20186684,20186684,20187010,0,0,0,326
16363,20187242,20187242,20187355,0,0,0,113
16365,20187553,20187553,20187631,0,0,0,78
16367,20187886,20187886,20187995,0,0,0,109
16207,20162261,20162261,20188283,0,0,0,26022
16161,20104030,20104030,20188915,0,0,0,84885
16370,20189473,20189473,20189551,0,0,0,78
16371,20189591,20189591,20189638,0,0,0,47
16372,20189691,20189691,20189886,0,0,0,195
16373,20190685,20190685,20190764,0,0,0,79
16374,20190968,20190968,20191046,0,0,0,78
16376,20191644,20191644,20191722,0,0,0,78
16369,20188693,20188693,20191778,0,0,0,3085
16377,20191830,20191830,20191907,0,0,0,77
16381,20191921,20191921,20192068,0,0,0,147
16382,20192031,20192031,20192116,0,0,0,85
16383,20192068,20192068,20192170,0,0,0,102
16384,20192126,20192126,20192200,0,0,0,74
16385,20192148,20192148,20192226,0,0,0,78
16283,20174977,20178015,20192389,0,0,3038,17412
16393,20192450,20192450,20192497,0,0,0,47
16388,20192285,20192389,20192519,0,0,104,234
16394,20192525,20192525,20192679,0,0,0,154
16387,20192271,20192271,20192737,0,0,0,466
16400,20192632,20192632,20192865,0,0,0,233
15688,19924291,19942768,20195368,0,0,18477,271077
16318,20184503,20195368,20195515,0,0,10865,11012
16336,20184654,20195515,20195663,0,0,10861,11009
16337,20184776,20195663,20195859,0,0,10887,11083
16278,20174706,20177460,20195890,0,0,2754,21184
16351,20185012,20195859,20196013,0,0,10847,11001
16364,20187313,20195890,20196071,0,0,8577,8758
16309,20182674,20192737,20196539,0,0,10063,13865
16368,20188060,20196013,20196613,0,0,7953,8553
16406,20194843,20196071,20197391,0,0,1228,2548
16195,20156497,20156497,20198896,0,0,0,42399
16196,20156512,20156512,20199008,0,0,0,42496
16375,20191543,20199008,20199367,0,0,7465,7824
16378,20191836,20199367,20199495,0,0,7531,7659
16379,20191837,20199495,20199619,0,0,7658,7782
16380,20191839,20199619,20199760,0,0,7780,7921
16194,20156456,20156456,20199836,0,0,0,43380
16386,20192256,20199760,20199858,0,0,7504,7602
16200,20157467,20157467,20199906,0,0,0,42439
16202,20157509,20157509,20199948,0,0,0,42439
16389,20192310,20199858,20199955,0,0,7548,7645
16390,20192312,20199906,20200045,0,0,7594,7733
16391,20192314,20199948,20200072,0,0,7634,7758
16392,20192316,20199955,20200106,0,0,7639,7790
16395,20192535,20200045,20200165,0,0,7510,7630
16396,20192538,20200072,20200198,0,0,7534,7660
16397,20192539,20200106,20200232,0,0,7567,7693
16398,20192540,20200165,20200261,0,0,7625,7721
16399,20192541,20200198,20200294,0,0,7657,7753
16401,20193268,20200232,20200338,0,0,6964,7070
16302,20181331,20196613,20200373,0,0,15282,19042
16402,20193269,20200261,20200398,0,0,6992,7129
16403,20193270,20200294,20200424,0,0,7024,7154
16404,20193271,20200338,20200437,0,0,7067,7166
16405,20193272,20200373,20200502,0,0,7101,7230
16407,20196007,20200398,20200517,0,0,4391,4510
16408,20196059,20200424,20200547,0,0,4365,4488
16409,20196060,20200437,20200560,0,0,4377,4500
16410,20196061,20200502,20200612,0,0,4441,4551
16411,20196063,20200517,20200636,0,0,4454,4573
16412,20196343,20200547,20200860,0,0,4204,4517
16413,20196344,20200560,20200864,0,0,4216,4520
16414,20196346,20200612,20200927,0,0,4266,4581
16415,20196347,20200636,20200951,0,0,4289,4604
16416,20196348,20200860,20201130,0,0,4512,4782
16417,20197545,20200864,20201218,0,0,3319,3673
16418,20197546,20200927,20201239,0,0,3381,3693
16419,20197547,20200951,20201272,0,0,3404,3725
16420,20197563,20201130,20201451,0,0,3567,3888
16424,20201183,20201272,20201459,0,0,89,276
16421,20197564,20201218,20201561,0,0,3654,3997
16422,20197566,20201239,20201613,0,0,3673,4047
16426,20201711,20201711,20201771,0,0,0,60
16425,20201491,20201491,20201782,0,0,0,291
16428,20202179,20202179,20202323,0,0,0,144
16429,20202180,20202323,20202467,0,0,143,287
16423,20199675,20201272,20202553,0,0,1597,2878
16430,20202181,20202467,20202611,0,0,286,430
16311,20183627,20198896,20202677,0,0,15269,19050
16431,20202182,20202553,20202697,0,0,371,515
16432,20202182,20202611,20202755,0,0,429,573
16433,20202329,20202677,20202814,0,0,348,485
16434,20202330,20202677,20202834,0,0,347,504
16435,20202331,20202677,20202834,0,0,346,503
16436,20202332,20202697,20202854,0,0,365,522
16437,20202333,20202755,20202912,0,0,422,579
16438,20203211,20203211,20203270,0,0,0,59
16427,20201802,20201802,20203271,0,0,0,1469
16439,20203282,20203282,20205142,0,0,0,1860
16366,20187684,20187684,20208715,0,0,0,21031
15694,19924900,19956490,20209090,0,0,31590,284190
15696,19924933,19956805,20209405,0,0,31872,284472
15697,19924958,19956805,20209405,0,0,31847,284447
16440,20205822,20205822,20210461,0,0,0,4639
16035,20081712,20081712,20211356,0,0,0,129644
16441,20211177,20211177,20213454,0,0,0,2277
16442,20249488,20249488,20252209,0,0,0,2721
16443,20252946,20252946,20253144,0,0,0,198
16444,20253280,20253280,20255942,0,0,0,2662
16445,20256078,20256078,20258097,0,0,0,2019
16451,20258076,20258076,20259578,0,0,0,1502
16453,20269402,20269402,20269519,0,0,0,117
16454,20269874,20269874,20269989,0,0,0,115
16455,20270034,20270034,20270165,0,0,0,131
16456,20270133,20270133,20270282,0,0,0,149
16457,20270371,20270371,20271812,0,0,0,1441
16458,20271756,20271756,20271889,0,0,0,133
16460,20272129,20272129,20272261,0,0,0,132
16461,20272329,20272329,20272418,0,0,0,89
16459,20272114,20272114,20272813,0,0,0,699
16462,20272795,20272795,20272884,0,0,0,89
16463,20272909,20272909,20273009,0,0,0,100
16136,20100292,20100292,20273092,0,0,0,172800
16466,20273609,20273609,20273699,0,0,0,90
16465,20273100,20273100,20273753,0,0,0,653
16464,20272961,20272961,20273765,0,0,0,804
16467,20273737,20273737,20273798,0,0,0,61
16468,20273805,20273805,20273872,0,0,0,67
16470,20274042,20274042,20274135,0,0,0,93
16469,20274004,20274004,20274202,0,0,0,198
16471,20274214,20274214,20274281,0,0,0,67
16473,20274754,20274754,20274843,0,0,0,89
16474,20274841,20274841,20274930,0,0,0,89
16475,20274998,20274998,20275074,0,0,0,76
16476,20275067,20275067,20275157,0,0,0,90
16477,20275298,20275298,20275394,0,0,0,96
16478,20275512,20275512,20275607,0,0,0,95
16479,20275689,20275689,20275778,0,0,0,89
16480,20275781,20275781,20275890,0,0,0,109
16481,20276477,20276477,20276566,0,0,0,89
16482,20276688,20276688,20276782,0,0,0,94
16483,20276930,20276930,20277025,0,0,0,95
16484,20277254,20277254,20277348,0,0,0,94
16485,20277346,20277346,20277436,0,0,0,90
16486,20277735,20277735,20277829,0,0,0,94
16487,20278103,20278103,20278192,0,0,0,89
16488,20278364,20278364,20278459,0,0,0,95
16489,20278505,20278505,20278600,0,0,0,95
16490,20278689,20278689,20278783,0,0,0,94
16491,20278789,20278789,20278856,0,0,0,67
16492,20278995,20278995,20279089,0,0,0,94
16493,20279462,20279462,20279556,0,0,0,94
16494,20279511,20279511,20279605,0,0,0,94
16495,20279620,20279620,20279715,0,0,0,95
16496,20279749,20279749,20279816,0,0,0,67
16452,20261951,20261951,20287832,0,0,0,25881
16446,20256963,20256963,20299392,0,0,0,42429
16447,20256974,20256974,20299392,0,0,0,42418
16448,20256987,20256987,20299426,0,0,0,42439
16449,20257002,20257002,20299441,0,0,0,42439
16450,20257571,20257571,20300010,0,0,0,42439
16258,20173411,20173411,20308998,0,0,0,135587
16174,20111583,20111583,20309011,0,0,0,197428
16173,20111444,20111444,20327541,0,0,0,216097
16185,20117527,20117527,20328709,0,0,0,211182
16256,20173387,20173387,20330492,0,0,0,157105
16472,20274350,20274350,20336682,0,0,0,62332
16265,20173811,20173811,20341583,0,0,0,167772
16500,20341679,20341679,20341797,0,0,0,118
16501,20341811,20341811,20342580,0,0,0,769
16260,20173431,20180948,20342811,0,0,7517,169380
16502,20342569,20342569,20343270,0,0,0,701
16503,20342670,20342670,20343278,0,0,0,608
16504,20343278,20343278,20344111,0,0,0,833
16505,20343328,20343328,20344120,0,0,0,792
16507,20344262,20344262,20345071,0,0,0,809
16506,20344191,20344191,20345084,0,0,0,893
16508,20346375,20346375,20346446,0,0,0,71
16497,20333273,20333273,20347633,0,0,0,14360
16498,20333357,20333357,20348046,0,0,0,14689
16509,20346447,20346447,20348247,0,0,0,1800
16510,20346457,20346457,20348257,0,0,0,1800
16499,20333512,20333512,20348492,0,0,0,14980
16171,20110792,20110792,20352609,0,0,0,241817
16514,20351883,20351883,20352734,0,0,0,851
16515,20352746,20352746,20353493,0,0,0,747
16516,20353491,20353491,20354339,0,0,0,848
16517,20354376,20354376,20355100,0,0,0,724
16518,20355135,20355135,20355945,0,0,0,810
16520,20356044,20356044,20356803,0,0,0,759
16519,20355950,20355950,20356824,0,0,0,874
16521,20356797,20356797,20357808,0,0,0,1011
16522,20361156,20361156,20361273,0,0,0,117
16523,20361223,20361223,20361338,0,0,0,115
16524,20361293,20361293,20361400,0,0,0,107
16525,20361362,20361362,20361457,0,0,0,95
16526,20361572,20361572,20361700,0,0,0,128
16527,20361636,20361636,20361773,0,0,0,137
16168,20106401,20106401,20365601,0,0,0,259200
16172,20111249,20111249,20370449,0,0,0,259200
16528,20371859,20371859,20371932,0,0,0,73
16254,20173213,20173213,20380598,0,0,0,207385
16252,20173195,20173195,20387017,0,0,0,213822
16513,20349378,20349378,20387928,0,0,0,38550
16253,20173204,20173204,20392924,0,0,0,219720
16532,20417353,20417353,20417453,0,0,0,100
16534,20417484,20417484,20417652,0,0,0,168
16535,20417607,20417607,20417687,0,0,0,80
16533,20417408,20417408,20417839,0,0,0,431
16536,20417890,20417890,20418014,0,0,0,124
16537,20418180,20418180,20418228,0,0,0,48
16511,20349194,20349194,20419171,0,0,0,69977
16540,20419145,20419145,20419212,0,0,0,67
16512,20349324,20349324,20419271,0,0,0,69947
16539,20419134,20419134,20419352,0,0,0,218
16541,20419154,20419154,20419366,0,0,0,212
16542,20419216,20419216,20419377,0,0,0,161
16543,20419312,20419312,20420799,0,0,0,1487
16544,20419332,20419332,20420822,0,0,0,1490
16545,20419357,20419357,20420846,0,0,0,1489
16277,20174661,20201613,20421782,0,0,26952,247121
16551,20422351,20422351,20422702,0,0,0,351
16553,20427140,20427140,20427244,0,0,0,104
16554,20427246,20427246,20427364,0,0,0,118
16550,20421966,20421966,20427982,0,0,0,6016
16556,20429333,20429333,20429468,0,0,0,135
16529,20373858,20373858,20429854,0,0,0,55996
16552,20423318,20423318,20429966,0,0,0,6648
16548,20420778,20420778,20430885,0,0,0,10107
16547,20420757,20420757,20431051,0,0,0,10294
16562,20431006,20431006,20431066,0,0,0,60
16549,20420800,20420800,20431071,0,0,0,10271
16250,20172950,20172950,20432083,0,0,0,259133
16255,20173376,20173376,20432576,0,0,0,259200
16257,20173396,20173396,20432596,0,0,0,259200
16259,20173420,20173420,20432620,0,0,0,259200
16565,20434120,20434120,20434240,0,0,0,120
16555,20427418,20427418,20436168,0,0,0,8750
16563,20431221,20431221,20437001,0,0,0,5780
16569,20436995,20436995,20437237,0,0,0,242
16557,20430018,20430018,20438067,0,0,0,8049
16572,20438925,20438925,20438989,0,0,0,64
16573,20439122,20439122,20439200,0,0,0,78
16574,20439217,20439217,20439287,0,0,0,70
16575,20439249,20439249,20439300,0,0,0,51
16576,20439299,20439299,20439366,0,0,0,67
16577,20439367,20439367,20439425,0,0,0,58
16578,20439424,20439424,20439486,0,0,0,62
16579,20439456,20439456,20439536,0,0,0,80
16580,20439463,20439463,20439543,0,0,0,80
16581,20439689,20439689,20439744,0,0,0,55
16301,20178410,20180594,20439748,0,0,2184,261338
16582,20439698,20439698,20439767,0,0,0,69
16571,20438023,20438023,20439872,0,0,0,1849
16583,20439782,20439782,20439901,0,0,0,119
16546,20420338,20420338,20440015,0,0,0,19677
16585,20439904,20439904,20440016,0,0,0,112
16592,20439907,20439907,20440025,0,0,0,118
16593,20439907,20439907,20440025,0,0,0,118
16594,20439907,20439907,20440025,0,0,0,118
16596,20439908,20439908,20440026,0,0,0,118
16597,20439908,20439908,20440026,0,0,0,118
16587,20439906,20439906,20440030,0,0,0,124
16588,20439906,20439906,20440030,0,0,0,124
16589,20439906,20439906,20440030,0,0,0,124
16591,20439907,20439907,20440031,0,0,0,124
16595,20439907,20439907,20440036,0,0,0,129
16604,20439910,20439910,20440038,0,0,0,128
16598,20439908,20439908,20440045,0,0,0,137
16599,20439908,20439908,20440045,0,0,0,137
16600,20439909,20439909,20440046,0,0,0,137
16601,20439909,20439909,20440046,0,0,0,137
16602,20439909,20439909,20440048,0,0,0,139
16603,20439909,20439909,20440048,0,0,0,139
16586,20439905,20439905,20440060,0,0,0,155
16590,20439906,20439906,20440061,0,0,0,155
16608,20441290,20441290,20441406,0,0,0,116
16609,20441538,20441538,20441611,0,0,0,73
16610,20441696,20441696,20441836,0,0,0,140
16584,20439868,20439868,20442119,0,0,0,2251
16612,20442374,20442374,20442513,0,0,0,139
16618,20442637,20442637,20442730,0,0,0,93
16617,20442636,20442636,20442751,0,0,0,115
16615,20442634,20442634,20442757,0,0,0,123
16616,20442635,20442635,20442761,0,0,0,126
16619,20442638,20442638,20442768,0,0,0,130
16605,20439975,20439975,20443150,0,0,0,3175
16561,20430865,20430865,20443353,0,0,0,12488
16621,20443329,20443329,20444006,0,0,0,677
16620,20442829,20442829,20444060,0,0,0,1231
16570,20437279,20437279,20447934,0,0,0,10655
16613,20442406,20442406,20450450,0,0,0,8044
16614,20442501,20442501,20450546,0,0,0,8045
16611,20442347,20442347,20451314,0,0,0,8967
16661,20451374,20451374,20452243,0,0,0,869
16667,20452267,20452267,20452349,0,0,0,82
16664,20451505,20451505,20452444,0,0,0,939
16665,20451509,20451509,20452490,0,0,0,981
16666,20451513,20451513,20452556,0,0,0,1043
16662,20451387,20451387,20452565,0,0,0,1178
16663,20451399,20451399,20452630,0,0,0,1231
16558,20430116,20430116,20453220,0,0,0,23104
16560,20430770,20430770,20453220,0,0,0,22450
16530,20414457,20414457,20456877,0,0,0,42420
16531,20415895,20415895,20459278,0,0,0,43383
16623,20444155,20444155,20460991,0,0,0,16836
16606,20440204,20440204,20461177,0,0,0,20973
16559,20430367,20430367,20461748,0,0,0,31381
16566,20434373,20434373,20461786,0,0,0,27413
16564,20433252,20433252,20461791,0,0,0,28539
16668,20452331,20452331,20476153,0,0,0,23822
16625,20449213,20449213,20501285,0,0,0,52072
16626,20449213,20449213,20502208,0,0,0,52995
16627,20449213,20449213,20502332,0,0,0,53119
16628,20449213,20449213,20502456,0,0,0,53243
16629,20449214,20449214,20502457,0,0,0,53243
16645,20451104,20451104,20502835,0,0,0,51731
16643,20451102,20451102,20502895,0,0,0,51793
16630,20449214,20449214,20503232,0,0,0,54018
16631,20449214,20449214,20503232,0,0,0,54018
16646,20451104,20451104,20503269,0,0,0,52165
16649,20451105,20451105,20503449,0,0,0,52344
16650,20451105,20451105,20503480,0,0,0,52375
16632,20449214,20449214,20503491,0,0,0,54277
16651,20451105,20451105,20503511,0,0,0,52406
16644,20451103,20451103,20503788,0,0,0,52685
16647,20451104,20451104,20504440,0,0,0,53336
16633,20449214,20449214,20504638,0,0,0,55424
16634,20451077,20451077,20506959,0,0,0,55882
16635,20451078,20451078,20506960,0,0,0,55882
16642,20451080,20451080,20507086,0,0,0,56006
16636,20451078,20451078,20507766,0,0,0,56688
16672,20507882,20507882,20507995,0,0,0,113
16638,20451079,20451079,20508232,0,0,0,57153
16622,20443677,20443677,20508369,0,0,0,64692
16669,20453144,20453144,20508444,0,0,0,55300
16637,20451078,20451078,20508510,0,0,0,57432
16567,20434881,20434881,20508683,0,0,0,73802
16607,20440302,20440302,20508683,0,0,0,68381
16538,20418342,20418342,20508697,0,0,0,90355
16568,20436198,20436198,20508697,0,0,0,72499
16624,20444959,20444959,20508698,0,0,0,63739
16639,20451079,20451079,20508728,0,0,0,57649
16640,20451079,20451079,20508770,0,0,0,57691
16652,20451148,20451148,20509304,0,0,0,58156
16658,20451150,20451150,20509399,0,0,0,58249
16654,20451149,20451149,20509646,0,0,0,58497
16659,20451150,20451150,20509709,0,0,0,58559
16655,20451149,20451149,20510576,0,0,0,59427
16660,20451150,20451150,20510942,0,0,0,59792
16656,20451149,20451149,20511654,0,0,0,60505
16641,20451079,20451079,20513314,0,0,0,62235
16657,20451149,20451149,20513817,0,0,0,62668
16653,20451148,20451148,20513847,0,0,0,62699
16670,20453162,20453162,20516244,0,0,0,63082
16671,20453385,20453385,20516564,0,0,0,63179
16687,20532926,20532926,20534509,0,0,0,1583
16688,20532961,20532961,20534589,0,0,0,1628
16683,20532613,20532613,20534659,0,0,0,2046
16684,20532677,20532677,20534759,0,0,0,2082
16685,20532723,20532723,20534794,0,0,0,2071
16686,20532762,20532762,20534802,0,0,0,2040
16700,20535826,20535826,20535920,0,0,0,94
16701,20535846,20535846,20535924,0,0,0,78
16689,20532969,20534509,20536224,0,0,1540,3255
16702,20536100,20536100,20536426,0,0,0,326
16704,20536538,20536538,20536590,0,0,0,52
16705,20536545,20536545,20536597,0,0,0,52
16648,20451104,20451104,20537504,0,0,0,86400
16723,20554674,20554674,20554721,0,0,0,47
16690,20533554,20533554,20554832,0,0,0,21278
16703,20536230,20554832,20554936,0,0,18602,18706
16724,20554765,20554765,20555111,0,0,0,346
16699,20535196,20535196,20555607,0,0,0,20411
16725,20563148,20563148,20563314,0,0,0,166
16726,20563530,20563530,20563654,0,0,0,124
16727,20563655,20563655,20564235,0,0,0,580
16736,20595796,20595796,20595968,0,0,0,172
16691,20534470,20534589,20598071,0,0,119,63601
16692,20534601,20534659,20598085,0,0,58,63484
16694,20534668,20534794,20598146,0,0,126,63478
16718,20544140,20598146,20598250,0,0,54006,54110
16740,20598215,20598215,20598293,0,0,0,78
16719,20544212,20598250,20598405,0,0,54038,54193
16720,20544432,20598405,20598529,0,0,53973,54097
16698,20534804,20598071,20598692,0,0,63267,63888
16721,20544629,20598529,20598808,0,0,53900,54179
16722,20544999,20598692,20599127,0,0,53693,54128
16730,20593418,20599127,20599247,0,0,5709,5829
16758,20599501,20599501,20599579,0,0,0,78
16759,20599613,20599613,20599680,0,0,0,67
16697,20534795,20536224,20600072,0,0,1429,65277
16761,20600096,20600096,20600179,0,0,0,83
16760,20600085,20600085,20600184,0,0,0,99
16763,20600182,20600182,20600229,0,0,0,47
16764,20600226,20600226,20600521,0,0,0,295
16762,20600107,20600107,20600919,0,0,0,812
16780,20602915,20602915,20603174,0,0,0,259
16693,20534633,20534759,20603364,0,0,126,68731
16783,20603890,20603890,20603957,0,0,0,67
16782,20603874,20603874,20603988,0,0,0,114
16787,20605092,20605092,20605283,0,0,0,191
16788,20605510,20605510,20605608,0,0,0,98
16789,20605901,20605901,20605968,0,0,0,67
16790,20606061,20606061,20606263,0,0,0,202
16792,20607017,20607017,20607250,0,0,0,233
16793,20607250,20607250,20607349,0,0,0,99
16794,20607354,20607354,20607547,0,0,0,193
16791,20606313,20606313,20607820,0,0,0,1507
16799,20607874,20607874,20607976,0,0,0,102
16781,20602981,20602981,20608197,0,0,0,5216
16784,20604696,20608197,20608625,0,0,3501,3929
16786,20605007,20608625,20608932,0,0,3618,3925
16796,20607555,20608932,20609274,0,0,1377,1719
16797,20607645,20609274,20609449,0,0,1629,1804
16800,20607945,20607976,20609502,0,0,31,1557
16802,20608900,20608900,20610436,0,0,0,1536
16807,20611314,20611314,20611413,0,0,0,99
16808,20611416,20611416,20611488,0,0,0,72
16809,20611472,20611472,20611559,0,0,0,87
16811,20611605,20611605,20611672,0,0,0,67
16805,20609939,20609939,20611751,0,0,0,1812
16814,20612184,20612184,20612282,0,0,0,98
16813,20612171,20612171,20612286,0,0,0,115
16815,20612850,20612850,20612922,0,0,0,72
16801,20608627,20609449,20613027,0,0,822,4400
16695,20534766,20534802,20614326,0,0,36,79560
16743,20599230,20614326,20614433,0,0,15096,15203
16744,20599231,20614433,20614537,0,0,15202,15306
16745,20599231,20614537,20614677,0,0,15306,15446
16785,20604921,20614326,20614747,0,0,9405,9826
16746,20599232,20614677,20614817,0,0,15445,15585
16747,20599233,20614817,20614910,0,0,15584,15677
16748,20599325,20614910,20615003,0,0,15585,15678
16749,20599326,20615003,20615112,0,0,15677,15786
16810,20611496,20614747,20615188,0,0,3251,3692
16750,20599327,20615112,20615221,0,0,15785,15894
16751,20599328,20615221,20615330,0,0,15893,16002
16752,20599329,20615330,20615439,0,0,16001,16110
16753,20599366,20615439,20615548,0,0,16073,16182
16812,20611719,20615188,20615592,0,0,3469,3873
16754,20599367,20615548,20615657,0,0,16181,16290
16755,20599368,20615657,20615766,0,0,16289,16398
16756,20599369,20615766,20615875,0,0,16397,16506
16757,20599369,20615875,20615999,0,0,16506,16630
16822,20616001,20616001,20616328,0,0,0,327
16765,20600310,20615999,20616371,0,0,15689,16061
16823,20616034,20616034,20616371,0,0,0,337
16766,20600311,20616371,20616743,0,0,16060,16432
16767,20600312,20616743,20617115,0,0,16431,16803
16816,20613501,20615592,20617129,0,0,2091,3628
16732,20594204,20599247,20617247,0,0,5043,23043
16768,20600312,20617115,20617487,0,0,16803,17175
16769,20600313,20617487,20617849,0,0,17174,17536
16770,20600338,20617849,20618221,0,0,17511,17883
16771,20600339,20618221,20618585,0,0,17882,18246
16826,20618604,20618604,20618697,0,0,0,93
16827,20618765,20618765,20618812,0,0,0,47
16829,20618765,20618765,20618843,0,0,0,78
16832,20618766,20618766,20618859,0,0,0,93
16833,20618766,20618843,20618936,0,0,77,170
16772,20600340,20618585,20618963,0,0,18245,18623
16773,20600340,20618963,20619366,0,0,18623,19026
16774,20600341,20619366,20619738,0,0,19025,19397
16775,20600356,20619738,20620141,0,0,19382,19785
16729,20593164,20598808,20620540,0,0,5644,27376
16776,20600358,20620141,20620544,0,0,19783,20186
16777,20600359,20620540,20620943,0,0,20181,20584
16779,20600361,20620544,20620947,0,0,20183,20586
16778,20600360,20620540,20620974,0,0,20180,20614
16828,20618765,20620947,20621025,0,0,2182,2260
16798,20607695,20620943,20621543,0,0,13248,13848
16821,20614389,20617129,20623355,0,0,2740,8966
16825,20617057,20617057,20623695,0,0,0,6638
16731,20594131,20603364,20625782,0,0,9233,31651
16834,20618766,20625782,20625875,0,0,7016,7109
16733,20594822,20600072,20625885,0,0,5250,31063
16843,20626698,20626698,20626766,0,0,0,68
16844,20627171,20627171,20627260,0,0,0,89
16845,20627179,20627179,20627268,0,0,0,89
16846,20627190,20627190,20627289,0,0,0,99
16848,20627211,20627211,20627289,0,0,0,78
16847,20627199,20627199,20627298,0,0,0,99
16851,20627342,20627342,20627415,0,0,0,73
16850,20627329,20627329,20627418,0,0,0,89
16853,20627366,20627366,20627418,0,0,0,52
16852,20627349,20627349,20627422,0,0,0,73
16849,20627320,20627320,20627425,0,0,0,105
16854,20627379,20627379,20627446,0,0,0,67
16855,20627658,20627658,20627716,0,0,0,58
16856,20627685,20627685,20627750,0,0,0,65
16857,20627705,20627705,20627931,0,0,0,226
16858,20627714,20627931,20628146,0,0,217,432
16859,20627722,20628146,20628443,0,0,424,721
16860,20627729,20628443,20628636,0,0,714,907
16861,20627748,20628636,20629035,0,0,888,1287
16870,20629672,20629672,20629776,0,0,0,104
16872,20629693,20629693,20629776,0,0,0,83
16871,20629678,20629678,20629782,0,0,0,104
16873,20629700,20629700,20629783,0,0,0,83
16869,20629659,20629659,20629810,0,0,0,151
16874,20629855,20629855,20630093,0,0,0,238
16875,20629869,20629869,20630195,0,0,0,326
16862,20627765,20629035,20630584,0,0,1270,2819
16881,20630614,20630614,20630666,0,0,0,52
16880,20630601,20630601,20630669,0,0,0,68
16879,20630587,20630587,20630672,0,0,0,85
16882,20630625,20630625,20630692,0,0,0,67
16890,20631204,20631204,20631251,0,0,0,47
16892,20631506,20631506,20631573,0,0,0,67
16863,20627824,20630584,20632668,0,0,2760,4844
16864,20627864,20632668,20634772,0,0,4804,6908
16734,20594909,20614326,20636679,0,0,19417,41770
16867,20628964,20636679,20636759,0,0,7715,7795
16735,20594932,20614326,20636817,0,0,19394,41885
16868,20628973,20636759,20636839,0,0,7786,7866
16865,20627901,20634772,20636876,0,0,6871,8975
16883,20630829,20636817,20637244,0,0,5988,6415
16885,20630850,20636817,20637253,0,0,5967,6403
16884,20630839,20636817,20637264,0,0,5978,6425
16886,20630858,20636839,20637264,0,0,5981,6406
16893,20631715,20636876,20637372,0,0,5161,5657
16682,20532394,20532394,20640605,0,0,0,108211
16824,20616873,20623355,20644611,0,0,6482,27738
16900,20642770,20644611,20644715,0,0,1841,1945
16899,20642464,20644611,20644736,0,0,2147,2272
16901,20642887,20644715,20644839,0,0,1828,1952
16902,20643010,20644736,20644851,0,0,1726,1841
16904,20644589,20644851,20644975,0,0,262,386
16903,20643066,20644839,20644994,0,0,1773,1928
16907,20646687,20646687,20646822,0,0,0,135
16909,20647281,20647281,20647405,0,0,0,124
16910,20647506,20647506,20647639,0,0,0,133
16681,20532339,20532339,20649409,0,0,0,117070
16738,20598077,20649409,20650072,0,0,51332,51995
16739,20598086,20650072,20653718,0,0,51986,55632
16795,20607460,20649409,20654287,0,0,41949,46827
16737,20598066,20640605,20656250,0,0,42539,58184
16819,20614318,20654287,20657064,0,0,39969,42746
16877,20630346,20657064,20657138,0,0,26718,26792
16741,20598673,20653718,20659493,0,0,55045,60820
16896,20633683,20657138,20660687,0,0,23455,27004
16803,20609366,20659493,20661330,0,0,50127,51964
16742,20598684,20656250,20661994,0,0,57566,63310
16804,20609420,20661330,20664371,0,0,51910,54951
16897,20637462,20660687,20664462,0,0,23225,27000
16898,20641360,20664462,20667785,0,0,23102,26425
16905,20645246,20667785,20668188,0,0,22539,22942
16906,20645697,20668188,20670074,0,0,22491,24377
16911,20647543,20670074,20673260,0,0,22531,25717
16837,20620563,20620974,20674235,0,0,411,53672
16835,20618766,20674235,20674328,0,0,55469,55562
16914,20677594,20677594,20677889,0,0,0,295
16806,20611300,20661994,20678622,0,0,50694,67322
16916,20678845,20678845,20678912,0,0,0,67
16915,20677897,20677897,20679065,0,0,0,1168
16817,20614292,20664371,20679201,0,0,50079,64909
16923,20680796,20680796,20681070,0,0,0,274
16924,20680810,20680810,20681148,0,0,0,338
16925,20680845,20681070,20681439,0,0,225,594
16927,20681070,20681070,20681771,0,0,0,701
16937,20682297,20682297,20682369,0,0,0,72
16935,20682297,20682297,20682379,0,0,0,82
16936,20682297,20682297,20682379,0,0,0,82
16934,20682291,20682291,20682386,0,0,0,95
16940,20682322,20682322,20682394,0,0,0,72
16941,20682323,20682323,20682405,0,0,0,82
16942,20682323,20682323,20682405,0,0,0,82
16943,20682323,20682323,20682421,0,0,0,98
16938,20682322,20682322,20682425,0,0,0,103
16939,20682322,20682322,20682425,0,0,0,103
16945,20682907,20682907,20683442,0,0,0,535
16818,20614305,20678622,20684082,0,0,64317,69777
16950,20684709,20684709,20684861,0,0,0,152
16952,20685332,20685332,20685430,0,0,0,98
16954,20686105,20686105,20686172,0,0,0,67
16955,20686335,20686335,20686402,0,0,0,67
16956,20686493,20686493,20686577,0,0,0,84
16957,20686535,20686535,20686631,0,0,0,96
16959,20686576,20686576,20686685,0,0,0,109
16960,20686617,20686617,20686686,0,0,0,69
16961,20686649,20686649,20686717,0,0,0,68
16964,20687616,20687616,20688317,0,0,0,701
16895,20633161,20674328,20688810,0,0,41167,55649
16965,20688710,20688810,20688903,0,0,100,193
16931,20681569,20688810,20688945,0,0,7241,7376
16932,20682052,20688945,20689100,0,0,6893,7048
16930,20681507,20688810,20689348,0,0,7303,7841
16908,20647105,20647105,20689463,0,0,0,42358
16944,20682597,20689348,20689472,0,0,6751,6875
16967,20689425,20689425,20689518,0,0,0,93
16946,20683140,20689472,20689577,0,0,6332,6437
16947,20683306,20689577,20689712,0,0,6271,6406
16948,20683871,20689712,20689765,0,0,5841,5894
16949,20683883,20689765,20689900,0,0,5882,6017
16974,20690216,20690216,20690328,0,0,0,112
16976,20690760,20690760,20690817,0,0,0,57
16951,20685180,20689900,20690892,0,0,4720,5712
16958,20686551,20690892,20691053,0,0,4341,4502
16977,20690781,20690781,20691100,0,0,0,319
16962,20686910,20691053,20691226,0,0,4143,4316
16963,20687123,20691226,20691967,0,0,4103,4844
16966,20688957,20691967,20692567,0,0,3010,3610
16978,20690861,20692567,20692661,0,0,1706,1800
16820,20614329,20679201,20693021,0,0,64872,78692
16987,20692942,20692942,20693041,0,0,0,99
16891,20631291,20636839,20693134,0,0,5548,61843
16836,20619632,20684082,20693155,0,0,64450,73523
16988,20693269,20693269,20693367,0,0,0,98
16991,20693871,20693871,20693954,0,0,0,83
16992,20694053,20694053,20694100,0,0,0,47
16917,20679092,20688810,20694531,0,0,9718,15439
16842,20623496,20693021,20695161,0,0,69525,71665
16866,20628948,20693155,20695184,0,0,64207,66236
16840,20621100,20621100,20695206,0,0,0,74106
16876,20630170,20695161,20695215,0,0,64991,65045
17004,20696605,20696605,20696745,0,0,0,140
16878,20630383,20695184,20696799,0,0,64801,66416
17002,20695145,20695206,20697084,0,0,61,1939
17005,20697213,20697213,20697306,0,0,0,93
17006,20697328,20697328,20697421,0,0,0,93
17007,20697420,20697420,20697546,0,0,0,126
17008,20697502,20697502,20697637,0,0,0,135
17009,20697635,20697637,20697772,0,0,2,137
16918,20679542,20688810,20698189,0,0,9268,18647
17010,20698063,20698063,20698218,0,0,0,155
17012,20699610,20699610,20699724,0,0,0,114
17013,20699680,20699680,20699727,0,0,0,47
17016,20699886,20699886,20699933,0,0,0,47
16680,20532335,20532335,20700326,0,0,0,167991
16933,20682055,20689100,20701448,0,0,7045,19393
17028,20704204,20704204,20704260,0,0,0,56
17029,20704358,20704358,20704441,0,0,0,83
17030,20705167,20705167,20705637,0,0,0,470
17033,20708633,20708633,20708804,0,0,0,171
17034,20708804,20708804,20708955,0,0,0,151
17035,20708961,20708961,20709029,0,0,0,68
16894,20633048,20695215,20709839,0,0,62167,76791
16953,20685481,20700326,20714360,0,0,14845,28879
16676,20532303,20532303,20715171,0,0,0,182868
16995,20694491,20715171,20715264,0,0,20680,20773
16994,20694480,20715171,20715280,0,0,20691,20800
16997,20694694,20715171,20715288,0,0,20477,20594
17001,20694920,20715171,20715295,0,0,20251,20375
16996,20694632,20715171,20715297,0,0,20539,20665
17036,20709031,20709031,20715358,0,0,0,6327
17003,20696326,20715280,20715373,0,0,18954,19047
17014,20699751,20715295,20715402,0,0,15544,15651
17018,20699997,20715297,20715433,0,0,15300,15436
17040,20715440,20715440,20715507,0,0,0,67
17015,20699826,20715288,20715521,0,0,15462,15695
17000,20694768,20715171,20715538,0,0,20403,20770
17041,20715713,20715713,20715780,0,0,0,67
17046,20716125,20716125,20716376,0,0,0,251
17047,20716355,20716376,20717219,0,0,21,864
17042,20715794,20715794,20717244,0,0,0,1450
17052,20717018,20717244,20717306,0,0,226,288
17050,20716946,20717219,20717315,0,0,273,369
17053,20717019,20717306,20717368,0,0,287,349
17054,20717020,20717315,20717377,0,0,295,357
17055,20717037,20717368,20717435,0,0,331,398
17057,20717275,20717435,20717488,0,0,160,213
17058,20717302,20717488,20717556,0,0,186,254
17059,20717416,20717556,20717809,0,0,140,393
17060,20717428,20717809,20718082,0,0,381,654
16970,20689876,20692567,20719132,0,0,2691,29256
16982,20692044,20698218,20719138,0,0,6174,27094
16973,20689904,20693134,20719165,0,0,3230,29261
16971,20689885,20692567,20719256,0,0,2682,29371
16980,20692020,20695206,20719264,0,0,3186,27244
16972,20689894,20693134,20719400,0,0,3240,29506
16969,20689867,20689867,20719820,0,0,0,29953
16968,20689857,20689857,20720422,0,0,0,30565
17021,20700656,20715402,20721491,0,0,14746,20835
16975,20690335,20714360,20721560,0,0,24025,31225
17022,20702868,20721560,20721653,0,0,18692,18785
16984,20692079,20701448,20721953,0,0,9369,29874
16981,20692031,20698189,20722232,0,0,6158,30201
16919,20679608,20709839,20724999,0,0,30231,45391
17066,20724936,20724936,20725446,0,0,0,510
17067,20725349,20725349,20725695,0,0,0,346
17062,20717646,20718082,20728159,0,0,436,10513
16979,20690975,20694531,20731001,0,0,3556,40026
17024,20703103,20722232,20732212,0,0,19129,29109
16913,20647611,20700326,20732336,0,0,52715,84725
16985,20692199,20714360,20735322,0,0,22161,43123
17037,20713500,20715521,20736060,0,0,2021,22560
17032,20707316,20715402,20736437,0,0,8086,29121
17038,20713898,20715538,20736474,0,0,1640,22576
17023,20702979,20721653,20736624,0,0,18674,33645
16921,20680247,20724999,20739565,0,0,44752,59318
16989,20693785,20739565,20739669,0,0,45780,45884
16990,20693786,20739669,20739762,0,0,45883,45976
17039,20713955,20719132,20740078,0,0,5177,26123
16922,20680317,20732336,20741484,0,0,52019,61167
16912,20647590,20696799,20742197,0,0,49209,94607
17044,20716014,20719165,20743426,0,0,3151,27412
17051,20717010,20719820,20743896,0,0,2810,26886
16983,20692071,20701448,20744648,0,0,9377,52577
17043,20715881,20719138,20745422,0,0,3257,29541
17048,20716382,20719264,20745649,0,0,2882,29267
17045,20716109,20719256,20745686,0,0,3147,29577
17049,20716509,20719400,20745799,0,0,2891,29290
17020,20700639,20732212,20746472,0,0,31573,45833
17056,20717227,20717377,20747528,0,0,150,30301
16998,20694707,20739762,20748891,0,0,45055,54184
17063,20717670,20720422,20751208,0,0,2752,33538
17065,20720360,20721560,20751701,0,0,1200,31341
17068,20733980,20735322,20755952,0,0,1342,21972
17069,20734771,20736060,20757122,0,0,1289,22351
17070,20734840,20736474,20757389,0,0,1634,22549
16993,20694354,20715171,20758371,0,0,20817,64017
17081,20760257,20760257,20760368,0,0,0,111
17082,20760302,20760368,20760484,0,0,66,182
17085,20760368,20760368,20760581,0,0,0,213
17083,20760349,20760349,20760682,0,0,0,333
17087,20762621,20762621,20762688,0,0,0,67
17088,20762718,20762718,20762834,0,0,0,116
17091,20762797,20762797,20762875,0,0,0,78
17071,20740206,20740206,20764383,0,0,0,24177
17064,20719774,20721491,20764691,0,0,1717,44917
17072,20741023,20741023,20765210,0,0,0,24187
16675,20532295,20532295,20767186,0,0,0,234891
16920,20679949,20679949,20768444,0,0,0,88495
17073,20742102,20742102,20768674,0,0,0,26572
17074,20742496,20742496,20769469,0,0,0,26973
17075,20742723,20743426,20770398,0,0,703,27675
17076,20742854,20743896,20771308,0,0,1042,28454
17084,20760350,20760484,20771527,0,0,134,11177
16674,20532290,20532290,20771940,0,0,0,239650
17093,20762936,20767186,20773039,0,0,4250,10103
17017,20699946,20715373,20773285,0,0,15427,73339
17011,20698942,20715264,20775646,0,0,16322,76704
17078,20754570,20754570,20775669,0,0,0,21099
17115,20776051,20776051,20777255,0,0,0,1204
17079,20755715,20755952,20777523,0,0,237,21808
17120,20777539,20777539,20777601,0,0,0,62
17086,20760376,20767186,20778466,0,0,6810,18090
17080,20755770,20757122,20778609,0,0,1352,22839
17077,20750438,20751208,20781640,0,0,770,31202
17126,20782068,20782068,20782173,0,0,0,105
17125,20781971,20781971,20782235,0,0,0,264
17128,20782742,20782742,20782991,0,0,0,249
17089,20762747,20764383,20784243,0,0,1636,21496
17101,20769496,20769496,20784939,0,0,0,15443
17092,20762837,20767186,20787144,0,0,4349,24307
17094,20764323,20764691,20789226,0,0,368,24903
17095,20765145,20765210,20789786,0,0,65,24641
16673,20531893,20531893,20791093,0,0,0,259200
16677,20532306,20532306,20791506,0,0,0,259200
16678,20532326,20532326,20791526,0,0,0,259200
16679,20532332,20532332,20791532,0,0,0,259200
17139,20788131,20791532,20791605,0,0,3401,3474
17135,20787646,20791532,20791658,0,0,3886,4012
17134,20787573,20791526,20791692,0,0,3953,4119
17136,20787670,20791692,20791835,0,0,4022,4165
17152,20792163,20792163,20792270,0,0,0,107
16696,20534772,20534772,20792522,0,0,0,257750
16839,20620932,20621025,20792609,0,0,93,171677
17019,20700086,20715297,20792650,0,0,15211,92564
17155,20792554,20792609,20792702,0,0,55,148
17129,20784789,20787144,20793672,0,0,2355,8883
17157,20792763,20793672,20793770,0,0,909,1007
16887,20631118,20637253,20793851,0,0,6135,162733
17158,20792950,20793770,20793858,0,0,820,908
17147,20791617,20793851,20793926,0,0,2234,2309
17160,20793434,20793851,20793944,0,0,417,510
17025,20703986,20742197,20793949,0,0,38211,89963
16888,20631123,20637372,20793970,0,0,6249,162847
17162,20793951,20793951,20794024,0,0,0,73
17161,20793755,20793755,20794030,0,0,0,275
17163,20793959,20793959,20794052,0,0,0,93
17159,20793012,20794024,20794117,0,0,1012,1105
17026,20704023,20748891,20794136,0,0,44868,90113
17107,20775142,20793949,20794199,0,0,18807,19057
17164,20794110,20794110,20794203,0,0,0,93
17166,20794220,20794220,20794313,0,0,0,93
17112,20775752,20794199,20794314,0,0,18447,18562
17165,20794210,20794210,20794314,0,0,0,104
17167,20794345,20794345,20794418,0,0,0,73
17169,20794463,20794463,20794536,0,0,0,73
17170,20794604,20794604,20794708,0,0,0,104
17099,20768611,20768611,20794745,0,0,0,26134
17172,20794869,20794869,20794962,0,0,0,93
17140,20788234,20791605,20795205,0,0,3371,6971
17173,20795205,20795205,20795298,0,0,0,93
17174,20795423,20795423,20795516,0,0,0,93
17100,20769413,20769413,20795578,0,0,0,26165
17176,20795551,20795551,20795644,0,0,0,93
17109,20775367,20775367,20795855,0,0,0,20488
17178,20795823,20795823,20795916,0,0,0,93
17179,20795956,20795956,20796018,0,0,0,62
17180,20796069,20796069,20796166,0,0,0,97
17111,20775616,20775616,20796215,0,0,0,20599
17182,20796166,20796166,20796246,0,0,0,80
17102,20769636,20769636,20796247,0,0,0,26611
17184,20796292,20796292,20796385,0,0,0,93
17185,20796625,20796625,20796718,0,0,0,93
17186,20796721,20796721,20796794,0,0,0,73
17187,20796813,20796813,20796906,0,0,0,93
17188,20796907,20796907,20796980,0,0,0,73
17190,20797007,20797007,20797088,0,0,0,81
17191,20797057,20797057,20797134,0,0,0,77
17106,20770224,20770398,20797153,0,0,174,26929
17192,20797107,20797107,20797166,0,0,0,59
16889,20631133,20640605,20797203,0,0,9472,166070
17193,20797134,20797134,20797238,0,0,0,104
17194,20797231,20797231,20797336,0,0,0,105
17118,20777202,20777202,20798163,0,0,0,20961
17197,20797375,20798163,20798227,0,0,788,852
17200,20797460,20798163,20798256,0,0,703,796
17119,20777224,20777224,20798264,0,0,0,21040
17201,20797571,20798227,20798320,0,0,656,749
17202,20797678,20798256,20798349,0,0,578,671
17203,20797806,20798264,20798357,0,0,458,551
17205,20798162,20798349,20798450,0,0,187,288
17207,20798341,20798357,20798451,0,0,16,110
16841,20623125,20625875,20798675,0,0,2750,175550
17105,20770009,20770009,20799525,0,0,0,29516
17096,20765692,20791532,20801342,0,0,25840,35650
17103,20769745,20769745,20802020,0,0,0,32275
17104,20769799,20769799,20803136,0,0,0,33337
16999,20694715,20741484,20803204,0,0,46769,108489
17150,20792085,20792085,20803979,0,0,0,11894
17110,20775499,20794136,20804156,0,0,18637,28657
17209,20798711,20804156,20804249,0,0,5445,5538
17208,20798543,20804156,20804250,0,0,5613,5707
17210,20798826,20804156,20804250,0,0,5330,5424
17211,20798937,20804249,20804342,0,0,5312,5405
17228,20804602,20804602,20804649,0,0,0,47
17229,20804731,20804731,20804799,0,0,0,68
17108,20775311,20775311,20805317,0,0,0,30006
17117,20776663,20776663,20805463,0,0,0,28800
17138,20787857,20787857,20805958,0,0,0,18101
17027,20704028,20791526,20806946,0,0,87498,102918
16706,20537045,20554936,20807536,0,0,17891,270491
17154,20792262,20792262,20807637,0,0,0,15375
17145,20791255,20792522,20810522,0,0,1267,19267
17124,20780802,20780802,20811058,0,0,0,30256
17090,20762780,20767186,20811620,0,0,4406,48840
17141,20788818,20788818,20812870,0,0,0,24052
17144,20789658,20791658,20815744,0,0,2000,26086
17177,20795813,20795813,20816350,0,0,0,20537
17181,20796145,20796145,20816734,0,0,0,20589
17204,20798098,20798320,20819664,0,0,222,21566
17171,20794682,20794682,20820698,0,0,0,26016
17175,20795540,20795540,20821992,0,0,0,26452
17183,20796184,20796184,20822605,0,0,0,26421
16728,20564231,20564231,20823431,0,0,0,259200
17198,20797381,20798451,20823437,0,0,1070,26056
17189,20796924,20796924,20823451,0,0,0,26527
17206,20798179,20803979,20824985,0,0,5800,26806
17137,20787729,20791835,20825830,0,0,4106,38101
17156,20792704,20792704,20828704,0,0,0,36000
17199,20797407,20804156,20829192,0,0,6749,31785
17148,20791639,20793926,20831513,0,0,2287,39874
17151,20792159,20797203,20832085,0,0,5044,39926
17195,20797332,20797332,20833226,0,0,0,35894
17196,20797359,20797359,20833504,0,0,0,36145
17235,20816289,20816350,20837001,0,0,61,20712
17233,20812813,20812870,20837069,0,0,57,24256
17236,20816665,20816734,20837272,0,0,69,20607
17234,20813684,20815744,20839999,0,0,2060,26315
17237,20819549,20819664,20840573,0,0,115,21024
17232,20810998,20811620,20841521,0,0,622,30523
17238,20820487,20820698,20841633,0,0,211,21146
17230,20805254,20811620,20841710,0,0,6366,36456
17153,20792201,20798675,20843776,0,0,6474,51575
17239,20820656,20821992,20848296,0,0,1336,27640
17240,20821930,20822605,20848975,0,0,675,27045
17241,20823348,20823437,20850010,0,0,89,26662
16707,20537138,20598085,20850685,0,0,60947,313547
16708,20537174,20598085,20850685,0,0,60911,313511
16709,20537205,20598085,20850685,0,0,60880,313480
16710,20537333,20598146,20850746,0,0,60813,313413
16711,20537368,20598146,20850746,0,0,60778,313378
16712,20537406,20598692,20851292,0,0,61286,313886
16713,20537431,20598692,20851292,0,0,61261,313861
17242,20824626,20824626,20851466,0,0,0,26840
16714,20538748,20600072,20852672,0,0,61324,313924
16715,20538767,20600072,20852672,0,0,61305,313905
16830,20618765,20852672,20852765,0,0,233907,234000
17097,20766357,20771527,20854327,0,0,5170,87970
16716,20538785,20603364,20855964,0,0,64579,317179
16717,20538804,20603364,20855964,0,0,64560,317160
17031,20706865,20706865,20856832,0,0,0,149967
17244,20836939,20837001,20857636,0,0,62,20697
17246,20837206,20837272,20857957,0,0,66,20751
17098,20766386,20771940,20858340,0,0,5554,91954
17218,20799626,20805463,20859755,0,0,5837,60129
17220,20800000,20807536,20859879,0,0,7536,59879
16831,20618765,20859879,20859973,0,0,241114,241208
17219,20799922,20807536,20860622,0,0,7614,60700
17245,20837008,20837069,20861178,0,0,61,24170
17221,20800040,20807536,20861574,0,0,7496,61534
17248,20840455,20840573,20861590,0,0,118,21135
17222,20800073,20807536,20862549,0,0,7463,62476
17250,20841382,20841633,20862559,0,0,251,21177
17223,20800098,20807536,20863479,0,0,7438,63381
17247,20837947,20839999,20864064,0,0,2052,26117
17225,20800173,20810522,20864109,0,0,10349,63936
17226,20800198,20810522,20864361,0,0,10324,64163
17227,20800295,20811058,20865269,0,0,10763,64974
17243,20835344,20835344,20865568,0,0,0,30224
17263,20866604,20866604,20866698,0,0,0,94
17264,20866936,20866936,20867030,0,0,0,94
17265,20867721,20867721,20867814,0,0,0,93
17266,20867863,20867863,20867957,0,0,0,94
17267,20868234,20868234,20868307,0,0,0,73
17127,20782132,20782132,20868532,0,0,0,86400
17268,20868468,20868468,20868553,0,0,0,85
17269,20868492,20868492,20868598,0,0,0,106
17270,20868589,20868589,20868664,0,0,0,75
17271,20868729,20868729,20868844,0,0,0,115
17272,20868804,20868804,20868877,0,0,0,73
17273,20868891,20868891,20869015,0,0,0,124
17274,20869019,20869019,20869143,0,0,0,124
17275,20869802,20869802,20869884,0,0,0,82
17276,20869864,20869864,20869957,0,0,0,93
17224,20800155,20807637,20871526,0,0,7482,71371
17249,20840893,20841521,20871609,0,0,628,30716
17251,20846959,20846959,20873610,0,0,0,26651
17252,20848293,20848293,20874307,0,0,0,26014
17142,20789051,20789226,20875626,0,0,175,86575
17143,20789507,20789786,20876186,0,0,279,86679
17253,20849921,20849921,20876618,0,0,0,26697
17284,20877049,20877049,20877153,0,0,0,104
17285,20877483,20877483,20877700,0,0,0,217
17286,20877787,20877787,20877894,0,0,0,107
17287,20877832,20877832,20877926,0,0,0,94
17116,20776480,20803204,20877958,0,0,26724,101478
17255,20857512,20857512,20878006,0,0,0,20494
17289,20878069,20878069,20878162,0,0,0,93
17254,20851408,20851408,20878275,0,0,0,26867
17291,20878406,20878406,20878499,0,0,0,93
17256,20857825,20857825,20878549,0,0,0,20724
17293,20878510,20878510,20878614,0,0,0,104
17294,20878744,20878744,20879299,0,0,0,555
16838,20620583,20620583,20879783,0,0,0,259200
17295,20879235,20879235,20879784,0,0,0,549
17297,20880013,20880013,20880086,0,0,0,73
17296,20879738,20879738,20880087,0,0,0,349
17298,20880028,20880028,20880152,0,0,0,124
17299,20880634,20880634,20880711,0,0,0,77
17301,20880711,20880711,20880835,0,0,0,124
17300,20880657,20880657,20880866,0,0,0,209
17282,20875908,20875908,20882196,0,0,0,6288
17259,20861410,20861410,20882525,0,0,0,21115
17261,20862246,20862246,20883281,0,0,0,21035
17306,20883450,20883450,20883543,0,0,0,93
17257,20861076,20861076,20885079,0,0,0,24003
17307,20884617,20884617,20885217,0,0,0,600
17260,20861970,20861970,20885990,0,0,0,24020
17212,20799625,20804250,20890650,0,0,4625,91025
17213,20799625,20804250,20890650,0,0,4625,91025
17214,20799625,20804342,20890742,0,0,4717,91117
17215,20799625,20805317,20891717,0,0,5692,92092
17216,20799625,20805463,20891863,0,0,5838,92238
17217,20799625,20805463,20891863,0,0,5838,92238
17262,20865500,20865500,20895533,0,0,0,30033
17288,20877943,20877943,20898524,0,0,0,20581
17292,20878504,20878504,20899056,0,0,0,20552
17278,20873548,20873548,20899909,0,0,0,26361
17279,20874245,20874245,20900450,0,0,0,26205
17277,20870923,20870923,20901218,0,0,0,30295
17122,20780559,20791506,20902649,0,0,10947,122090
17283,20876556,20876556,20903236,0,0,0,26680
17304,20882480,20882480,20903461,0,0,0,20981
17305,20883217,20883217,20904313,0,0,0,21096
17290,20878231,20878231,20905003,0,0,0,26772
17308,20885019,20885019,20908841,0,0,0,23822
17309,20885928,20885928,20909789,0,0,0,23861
17123,20780579,20804156,20910252,0,0,23577,129673
17146,20791516,20828704,20918578,0,0,37188,127062
17311,20898462,20898462,20919024,0,0,0,20562
17312,20899021,20899021,20919501,0,0,0,20480
17133,20787515,20850746,20920131,0,0,63231,132616
17149,20791650,20793970,20923570,0,0,2320,131920
17317,20903404,20903404,20924215,0,0,0,20811
17318,20904271,20904271,20925299,0,0,0,21028
17310,20895470,20895470,20925428,0,0,0,29958
17313,20899846,20899846,20926109,0,0,0,26263
17314,20900395,20900395,20927456,0,0,0,27061
17328,20927393,20927393,20929245,0,0,0,1852
17316,20903170,20903170,20929930,0,0,0,26760
17315,20901153,20901153,20931331,0,0,0,30178
17319,20904939,20904939,20931587,0,0,0,26648
17320,20908778,20908778,20932846,0,0,0,24068
17321,20909727,20909727,20933743,0,0,0,24016
16986,20692650,20692650,20936151,0,0,0,243501
17322,20918962,20918962,20939608,0,0,0,20646
17113,20775929,20794314,20939725,0,0,18385,163796
17338,20939866,20939866,20939959,0,0,0,93
17323,20919438,20919438,20940035,0,0,0,20597
16926,20681014,20681148,20940348,0,0,134,259334
16928,20681077,20681439,20940639,0,0,362,259562
17340,20940281,20940281,20940808,0,0,0,527
17341,20940755,20940755,20940932,0,0,0,177
17342,20940900,20940900,20941500,0,0,0,600
17343,20943261,20943261,20943354,0,0,0,93
17344,20943376,20943376,20943501,0,0,0,125
17345,20944041,20944041,20944165,0,0,0,124
17346,20944386,20944386,20944521,0,0,0,135
17324,20924170,20924170,20945185,0,0,0,21015
17348,20945268,20945268,20945362,0,0,0,94
17349,20945422,20945422,20945526,0,0,0,104
17325,20925237,20925237,20946067,0,0,0,20830
17351,20946655,20946655,20946759,0,0,0,104
16929,20681144,20688810,20948010,0,0,7666,266866
17352,20948357,20948357,20948450,0,0,0,93
17353,20949033,20949033,20949633,0,0,0,600
17354,20949260,20949260,20950530,0,0,0,1270
17361,20950752,20950752,20950845,0,0,0,93
17362,20950925,20950925,20951029,0,0,0,104
17363,20950992,20950992,20951085,0,0,0,93
17302,20882122,20882122,20951505,0,0,0,69383
17280,20874954,20874954,20952165,0,0,0,77211
17327,20926045,20926045,20952237,0,0,0,26192
17281,20875024,20875024,20952514,0,0,0,77490
17329,20929200,20929200,20955349,0,0,0,26149
17326,20925388,20925388,20955662,0,0,0,30274
17367,20956376,20956376,20956480,0,0,0,104
17330,20929872,20929872,20956621,0,0,0,26749
17333,20932784,20932784,20956674,0,0,0,23890
17370,20956895,20956895,20957495,0,0,0,600
17334,20933700,20933700,20957612,0,0,0,23912
17332,20931529,20931529,20958157,0,0,0,26628
17357,20949522,20949522,20959708,0,0,0,10186
17356,20949480,20949480,20959887,0,0,0,10407
17337,20939541,20939541,20960262,0,0,0,20721
17339,20939973,20939973,20960495,0,0,0,20522
17331,20931268,20931268,20961122,0,0,0,29854
17114,20776048,20801342,20965605,0,0,25294,189557
17347,20945116,20945116,20966085,0,0,0,20969
17168,20794417,20794417,20967166,0,0,0,172749
17131,20787457,20833504,20967358,0,0,46047,179901
17350,20946007,20946007,20967371,0,0,0,21364
17377,20966895,20966895,20967495,0,0,0,600
17303,20882144,20882144,20968544,0,0,0,86400
17364,20952172,20952172,20978490,0,0,0,26318
17130,20785788,20806946,20979264,0,0,21158,193476
17369,20956615,20956615,20980351,0,0,0,23736
17373,20960193,20960193,20980803,0,0,0,20610
17374,20960423,20960423,20980983,0,0,0,20560
17365,20955305,20955305,20981216,0,0,0,25911
17371,20957549,20957549,20981328,0,0,0,23779
17368,20956558,20956558,20983218,0,0,0,26660
17372,20958094,20958094,20984390,0,0,0,26296
17366,20955588,20955588,20985473,0,0,0,29885
17132,20787474,20850685,20985680,0,0,63211,198206
17376,20966032,20966032,20987034,0,0,0,21002
17378,20967308,20967308,20988207,0,0,0,20899
17375,20961069,20961069,20991239,0,0,0,30170
17258,20861386,20861386,20995592,0,0,0,134206
17383,20980815,20980815,21001297,0,0,0,20482
17384,20980992,20980992,21001685,0,0,0,20693
17382,20980292,20980292,21003208,0,0,0,22916
17386,20981274,20981274,21003846,0,0,0,22572
17381,20978450,20978450,21004882,0,0,0,26432
17061,20717567,20746472,21005672,0,0,28905,288105
17385,20981155,20981155,21007342,0,0,0,26187
17360,20949880,20949880,21007508,0,0,0,57628
17390,20986972,20986972,21008131,0,0,0,21159
17391,20988228,20988228,21009204,0,0,0,20976
17387,20983153,20983153,21009853,0,0,0,26700
17388,20984346,20984346,21011253,0,0,0,26907
17389,20985399,20985399,21015093,0,0,0,29694
17359,20949857,20949857,21015885,0,0,0,66028
17396,21007701,21007701,21018294,0,0,0,10593
17392,20991239,20991239,21020743,0,0,0,29504
17358,20949834,20949834,21022104,0,0,0,72270
17402,21023714,21023714,21023774,0,0,0,60
17403,21024222,21024222,21024476,0,0,0,254
17409,21024945,21024945,21024992,0,0,0,47
17406,21024742,21024742,21024995,0,0,0,253
17408,21024932,21024932,21024995,0,0,0,63
17410,21024996,21024996,21025268,0,0,0,272
17393,21004805,21004805,21025451,0,0,0,20646
17405,21024731,21024731,21025652,0,0,0,921
17404,21024724,21024724,21026099,0,0,0,1375
17411,21025536,21025536,21026136,0,0,0,600
17395,21006100,21006100,21026733,0,0,0,20633
17418,21026312,21026312,21027284,0,0,0,972
17416,21026049,21026049,21027375,0,0,0,1326
17422,21027497,21027497,21027564,0,0,0,67
17415,21025988,21025988,21027723,0,0,0,1735
17417,21026294,21026294,21027748,0,0,0,1454
17423,21027669,21027669,21027790,0,0,0,121
17424,21027827,21027827,21027900,0,0,0,73
17414,21025856,21025856,21027969,0,0,0,2113
17430,21027971,21027971,21028050,0,0,0,79
17425,21027925,21027925,21028061,0,0,0,136
17426,21027931,21027931,21028067,0,0,0,136
17428,21027945,21027945,21028112,0,0,0,167
17431,21028019,21028019,21028129,0,0,0,110
17433,21028226,21028226,21028311,0,0,0,85
17412,21025834,21025834,21028405,0,0,0,2571
17413,21025847,21025847,21028418,0,0,0,2571
17434,21028374,21028374,21028447,0,0,0,73
17394,21006092,21006092,21028586,0,0,0,22494
17435,21028503,21028503,21028596,0,0,0,93
17436,21028667,21028667,21028743,0,0,0,76
17438,21028710,21028710,21028816,0,0,0,106
17444,21028922,21028922,21028995,0,0,0,73
17443,21028886,21028886,21029021,0,0,0,135
17446,21029198,21029198,21029513,0,0,0,315
17442,21028778,21028778,21030419,0,0,0,1641
17441,21028773,21028773,21030706,0,0,0,1933
17440,21028763,21028763,21030707,0,0,0,1944
17455,21030921,21030921,21030988,0,0,0,67
17400,21020838,21020838,21031298,0,0,0,10460
17432,21028067,21028067,21031563,0,0,0,3496
17401,21021475,21021475,21032115,0,0,0,10640
17454,21030767,21030767,21032298,0,0,0,1531
17397,21010770,21010770,21033222,0,0,0,22452
17458,21033986,21033986,21034070,0,0,0,84
17460,21034261,21034261,21034348,0,0,0,87
17461,21034317,21034317,21034410,0,0,0,93
17462,21034468,21034468,21034572,0,0,0,104
17463,21034595,21034595,21034733,0,0,0,138
17464,21034703,21034703,21035159,0,0,0,456
17466,21035127,21035127,21035313,0,0,0,186
17467,21035450,21035450,21035606,0,0,0,156
17459,21033987,21033987,21035756,0,0,0,1769
17469,21035797,21035797,21036119,0,0,0,322
17470,21036077,21036077,21036502,0,0,0,425
17472,21036464,21036464,21036753,0,0,0,289
17477,21036761,21036761,21036958,0,0,0,197
17478,21036936,21036936,21037102,0,0,0,166
17476,21036717,21036717,21037133,0,0,0,416
17480,21037153,21037153,21037496,0,0,0,343
17483,21037443,21037443,21037508,0,0,0,65
17468,21035783,21035783,21037716,0,0,0,1933
17485,21037482,21037482,21038082,0,0,0,600
17473,21036503,21036503,21038341,0,0,0,1838
17421,21027293,21027293,21038873,0,0,0,11580
17398,21013174,21013174,21039492,0,0,0,26318
17487,21037669,21037716,21039664,0,0,47,1995
17493,21040340,21040340,21040475,0,0,0,135
17488,21038743,21038743,21040627,0,0,0,1884
17448,21030421,21030421,21041091,0,0,0,10670
17447,21030320,21030320,21041139,0,0,0,10819
17450,21030492,21030492,21041173,0,0,0,10681
17449,21030477,21030477,21041189,0,0,0,10712
17498,21041148,21041173,21041302,0,0,25,154
17501,21041242,21041242,21041320,0,0,0,78
17452,21030670,21030670,21041380,0,0,0,10710
17451,21030637,21030637,21041390,0,0,0,10753
17505,21041344,21041380,21041442,0,0,36,98
17491,21039559,21039559,21041515,0,0,0,1956
17508,21041470,21041470,21041566,0,0,0,96
17509,21041569,21041569,21041688,0,0,0,119
17502,21041325,21041325,21041809,0,0,0,484
17506,21041416,21041416,21041843,0,0,0,427
17453,21030737,21030737,21041869,0,0,0,11132
17510,21041687,21041687,21041968,0,0,0,281
17511,21041943,21041943,21042006,0,0,0,63
17499,21041172,21041809,21042014,0,0,637,842
17512,21041950,21042006,21042069,0,0,56,119
17513,21041955,21042069,21042132,0,0,114,177
17514,21042760,21042760,21043191,0,0,0,431
17518,21043007,21043007,21043280,0,0,0,273
17507,21041441,21041441,21043356,0,0,0,1915
17121,20780555,20784243,21043443,0,0,3688,262888
17520,21043496,21043496,21043563,0,0,0,67
17521,21043613,21043613,21044027,0,0,0,414
17399,21017932,21017932,21044859,0,0,0,26927
17527,21044865,21044865,21044974,0,0,0,109
17525,21044779,21044859,21045582,0,0,80,803
17503,21041329,21041329,21046615,0,0,0,5286
17445,21029031,21029031,21046659,0,0,0,17628
17529,21045857,21046615,21046708,0,0,758,851
17528,21045760,21046615,21046750,0,0,855,990
17231,20806013,20806013,21047594,0,0,0,241581
17471,21036079,21036079,21047740,0,0,0,11661
17500,21041182,21042014,21047790,0,0,832,6608
17534,21046551,21047790,21047874,0,0,1239,1323
17538,21047124,21047790,21047967,0,0,666,843
17542,21047790,21047790,21047995,0,0,0,205
17543,21047966,21047966,21048121,0,0,0,155
17380,20974066,20974066,21048122,0,0,0,74056
17496,21041103,21041103,21048197,0,0,0,7094
17497,21041145,21041145,21048218,0,0,0,7073
17523,21044169,21047790,21048224,0,0,3621,4055
17420,21027241,21027241,21048308,0,0,0,21067
17481,21037200,21037200,21048308,0,0,0,11108
17479,21037071,21037071,21048370,0,0,0,11299
17549,21048391,21048391,21048510,0,0,0,119
17530,21046348,21046615,21048764,0,0,267,2416
17551,21048692,21048692,21048790,0,0,0,98
17379,20974035,20974035,21049162,0,0,0,75127
17553,21049152,21049152,21049307,0,0,0,155
17552,21048899,21048899,21049314,0,0,0,415
17554,21049323,21049323,21049525,0,0,0,202
17555,21049451,21049451,21049768,0,0,0,317
17556,21049649,21049649,21049835,0,0,0,186
17557,21049918,21049918,21049985,0,0,0,67
17437,21028702,21028702,21050268,0,0,0,21566
17559,21050040,21050040,21050485,0,0,0,445
17489,21039120,21041189,21051224,0,0,2069,12104
17407,21024792,21024792,21051295,0,0,0,26503
17531,21046549,21046659,21052146,0,0,110,5597
17562,21052649,21052649,21052804,0,0,0,155
17495,21040590,21040590,21052877,0,0,0,12287
17536,21046551,21047790,21053074,0,0,1239,6523
17537,21046551,21047790,21053136,0,0,1239,6585
17532,21046550,21047594,21053143,0,0,1044,6593
17565,21053162,21053162,21053251,0,0,0,89
17563,21052820,21052820,21053283,0,0,0,463
17533,21046550,21047740,21053320,0,0,1190,6770
17535,21046551,21047790,21053401,0,0,1239,6850
17567,21053218,21053218,21053459,0,0,0,241
17558,21049991,21049991,21053486,0,0,0,3495
17569,21053557,21053557,21053617,0,0,0,60
17570,21053589,21053589,21053656,0,0,0,67
17568,21053492,21053492,21053906,0,0,0,414
17572,21053855,21053855,21054110,0,0,0,255
17564,21053055,21053055,21054183,0,0,0,1128
17457,21033805,21033805,21054335,0,0,0,20530
17579,21054662,21054662,21054755,0,0,0,93
17575,21054118,21054118,21054922,0,0,0,804
17578,21054547,21054547,21055081,0,0,0,534
17583,21055143,21055143,21055221,0,0,0,78
17580,21054925,21054925,21055276,0,0,0,351
17465,21034857,21034857,21055318,0,0,0,20461
17548,21048386,21048386,21055437,0,0,0,7051
17581,21055043,21055043,21055906,0,0,0,863
17593,21056633,21056633,21057084,0,0,0,451
17598,21057983,21057983,21058056,0,0,0,73
17596,21057859,21057859,21058087,0,0,0,228
17586,21055330,21055330,21058228,0,0,0,2898
17456,21031717,21031717,21058243,0,0,0,26526
17524,21044630,21044630,21058301,0,0,0,13671
17594,21056641,21056641,21058327,0,0,0,1686
17576,21054249,21054249,21058328,0,0,0,4079
17589,21055662,21055662,21058331,0,0,0,2669
17597,21057880,21058228,21058364,0,0,348,484
17566,21053204,21053204,21058392,0,0,0,5188
17571,21053797,21053797,21058429,0,0,0,4632
17574,21054018,21054018,21058429,0,0,0,4411
17522,21043837,21044027,21058490,0,0,190,14653
17595,21057495,21058327,21058772,0,0,832,1277
17603,21058804,21058804,21058902,0,0,0,98
17605,21059043,21059043,21059214,0,0,0,171
17604,21058950,21058950,21059393,0,0,0,443
17591,21055999,21055999,21059504,0,0,0,3505
17474,21036667,21036667,21059709,0,0,0,23042
17475,21036687,21036687,21059710,0,0,0,23023
17606,21059563,21059563,21060051,0,0,0,488
17610,21060107,21060107,21060174,0,0,0,67
17609,21060069,21060069,21060230,0,0,0,161
17612,21060278,21060278,21060345,0,0,0,67
17611,21060238,21060238,21060398,0,0,0,160
17492,21040277,21040277,21061629,0,0,0,21352
17588,21055452,21055452,21064354,0,0,0,8902
17613,21060572,21060572,21064800,0,0,0,4228
17615,21065402,21065402,21065589,0,0,0,187
17617,21065694,21065694,21065787,0,0,0,93
17616,21065625,21065625,21065816,0,0,0,191
17618,21066257,21066257,21066519,0,0,0,262
17619,21066594,21066594,21066865,0,0,0,271
17494,21040515,21040515,21066938,0,0,0,26423
17592,21056477,21056477,21067309,0,0,0,10832
17573,21053905,21053905,21067700,0,0,0,13795
17621,21066903,21066903,21067731,0,0,0,828
17622,21067664,21067664,21067834,0,0,0,170
17620,21066841,21066841,21068641,0,0,0,1800
17544,21048240,21048308,21069090,0,0,68,20850
17626,21070950,21070950,21071023,0,0,0,73
17625,21068989,21068989,21071051,0,0,0,2062
17599,21058015,21058243,21071150,0,0,228,13135
17628,21071152,21071152,21071245,0,0,0,93
17629,21071317,21071317,21071472,0,0,0,155
17560,21050226,21050226,21071567,0,0,0,21341
17631,21071518,21071518,21071662,0,0,0,144
17335,20937881,20937881,21071976,0,0,0,134095
17336,20938012,20938012,21072238,0,0,0,134226
17526,21044810,21045582,21072287,0,0,772,27477
17519,21043315,21043315,21073146,0,0,0,29831
17627,21071141,21071141,21073188,0,0,0,2047
17633,21071852,21071852,21073529,0,0,0,1677
17577,21054272,21054272,21074774,0,0,0,20502
17584,21055245,21055276,21075887,0,0,31,20642
17561,21051235,21051235,21077553,0,0,0,26318
17429,21027952,21027952,21077860,0,0,0,49908
17637,21075006,21075006,21078192,0,0,0,3186
17640,21078160,21078160,21081760,0,0,0,3600
17614,21061570,21061570,21082922,0,0,0,21352
17607,21059654,21059654,21083182,0,0,0,23528
17608,21059662,21059662,21083264,0,0,0,23602
17427,21027938,21027938,21083482,0,0,0,55544
17601,21058194,21058331,21084986,0,0,137,26792
17634,21072003,21072003,21086110,0,0,0,14107
17624,21068953,21068953,21089867,0,0,0,20914
17632,21071546,21071546,21092313,0,0,0,20767
17623,21067777,21067777,21094102,0,0,0,26325
17636,21074706,21074706,21095372,0,0,0,20666
17638,21075794,21075794,21096226,0,0,0,20432
17504,21041334,21043443,21098324,0,0,2109,56990
17630,21071472,21071472,21098614,0,0,0,27142
17539,21047192,21048197,21099569,0,0,1005,52377
17541,21047501,21048224,21102005,0,0,723,54504
17635,21073094,21073094,21103034,0,0,0,29940
17641,21082862,21082862,21104141,0,0,0,21279
17639,21077486,21077486,21104164,0,0,0,26678
17642,21083138,21083138,21105703,0,0,0,22565
17643,21083207,21083207,21105886,0,0,0,22679
17657,21109148,21109148,21109245,0,0,0,97
17658,21110032,21110032,21110126,0,0,0,94
17659,21110150,21110150,21110254,0,0,0,104
17660,21110210,21110210,21110325,0,0,0,115
17661,21110283,21110283,21110387,0,0,0,104
17645,21089823,21089823,21110659,0,0,0,20836
17666,21111341,21111341,21111461,0,0,0,120
17665,21111140,21111140,21111462,0,0,0,322
17667,21111471,21111471,21111587,0,0,0,116
17669,21111540,21111540,21111625,0,0,0,85
17644,21084804,21084804,21111911,0,0,0,27107
17670,21111562,21111562,21111983,0,0,0,421
17672,21111924,21111924,21112002,0,0,0,78
17673,21111960,21111960,21112168,0,0,0,208
17675,21112237,21112237,21112319,0,0,0,82
17646,21092250,21092250,21113218,0,0,0,20968
17668,21111508,21111508,21113959,0,0,0,2451
17677,21113917,21113917,21113979,0,0,0,62
17540,21047281,21048218,21114211,0,0,937,66930
17585,21055281,21072238,21114246,0,0,16957,58965
17678,21114191,21114191,21114302,0,0,0,111
17674,21112011,21112011,21114412,0,0,0,2401
17682,21114740,21114740,21114811,0,0,0,71
17515,21042976,21042976,21114851,0,0,0,71875
17683,21114806,21114806,21114884,0,0,0,78
17516,21042991,21042991,21114935,0,0,0,71944
17517,21043006,21043006,21114970,0,0,0,71964
17685,21114880,21114880,21114985,0,0,0,105
17684,21114813,21114813,21115131,0,0,0,318
17686,21114888,21114888,21115199,0,0,0,311
17687,21114913,21114913,21115217,0,0,0,304
17690,21115174,21115174,21115326,0,0,0,152
17689,21115140,21115140,21115346,0,0,0,206
17688,21115095,21115095,21115385,0,0,0,290
17695,21115468,21115468,21115572,0,0,0,104
17692,21115284,21115284,21115584,0,0,0,300
17648,21095316,21095316,21116000,0,0,0,20684
17649,21096178,21096178,21116637,0,0,0,20459
17694,21115325,21115325,21116686,0,0,0,1361
17693,21115308,21115308,21116700,0,0,0,1392
17691,21115215,21115215,21117334,0,0,0,2119
17707,21117444,21117444,21117704,0,0,0,260
17647,21094031,21094031,21120377,0,0,0,26346
17355,20949272,20949272,21122072,0,0,0,172800
17651,21102966,21102966,21123824,0,0,0,20858
17545,21048254,21051224,21125130,0,0,2970,76876
17713,21123371,21123371,21125328,0,0,0,1957
17650,21098553,21098553,21125432,0,0,0,26879
17679,21114271,21114271,21125776,0,0,0,11505
17701,21115843,21115843,21125778,0,0,0,9935
17702,21115911,21115911,21125785,0,0,0,9874
17704,21115960,21115960,21125785,0,0,0,9825
17699,21115769,21115769,21125819,0,0,0,10050
17700,21115809,21115809,21125859,0,0,0,10050
17546,21048258,21071976,21125877,0,0,23718,77619
17490,21039542,21039542,21125942,0,0,0,86400
17723,21126045,21126045,21126387,0,0,0,342
17725,21126317,21126317,21126402,0,0,0,85
17712,21123223,21123223,21126411,0,0,0,3188
17726,21126375,21126375,21126454,0,0,0,79
17697,21115567,21115567,21126467,0,0,0,10900
17727,21126406,21126406,21126467,0,0,0,61
17696,21115540,21115540,21126502,0,0,0,10962
17719,21125788,21125788,21126549,0,0,0,761
17728,21126438,21126438,21126556,0,0,0,118
17730,21126473,21126473,21126557,0,0,0,84
17731,21126504,21126504,21126613,0,0,0,109
17722,21125885,21125885,21126718,0,0,0,833
17733,21127003,21127003,21127070,0,0,0,67
17732,21126750,21126750,21127239,0,0,0,489
17734,21127206,21127206,21127276,0,0,0,70
17735,21127302,21127302,21127437,0,0,0,135
17729,21126438,21126438,21127818,0,0,0,1380
17654,21105646,21105646,21128963,0,0,0,23317
17655,21105825,21105825,21129163,0,0,0,23338
17737,21128078,21128078,21129377,0,0,0,1299
17740,21129485,21129485,21130055,0,0,0,570
17587,21055406,21098324,21130538,0,0,42918,75132
17653,21104110,21104110,21131012,0,0,0,26902
17736,21127495,21127495,21131095,0,0,0,3600
17747,21130814,21131012,21131515,0,0,198,701
17662,21110597,21110597,21131517,0,0,0,20920
17748,21130951,21131515,21132018,0,0,564,1067
17652,21104068,21104068,21133584,0,0,0,29516
17709,21117973,21125130,21133977,0,0,7157,16004
17676,21113156,21113156,21134014,0,0,0,20858
17751,21131741,21133584,21134452,0,0,1843,2711
17759,21134659,21134659,21134758,0,0,0,99
17754,21133617,21134452,21134880,0,0,835,1263
17744,21129901,21130055,21134966,0,0,154,5065
17743,21129893,21129893,21135017,0,0,0,5124
17741,21129873,21129873,21135021,0,0,0,5148
17742,21129887,21129887,21135022,0,0,0,5135
17755,21133761,21134880,21135035,0,0,1119,1274
17752,21133043,21133977,21135544,0,0,934,2501
17760,21135802,21135802,21135873,0,0,0,71
17762,21135878,21135878,21136126,0,0,0,248
17703,21115920,21115920,21136369,0,0,0,20449
17758,21134039,21135017,21136428,0,0,978,2389
17756,21133940,21134966,21136544,0,0,1026,2604
17773,21136708,21136708,21136807,0,0,0,99
17774,21136776,21136776,21136881,0,0,0,105
17775,21136807,21136807,21136885,0,0,0,78
17766,21136033,21136033,21136979,0,0,0,946
17777,21137090,21137090,21137174,0,0,0,84
17778,21137131,21137131,21137198,0,0,0,67
17768,21136344,21136369,21137340,0,0,25,996
17779,21137284,21137284,21137453,0,0,0,169
17706,21116597,21116597,21137615,0,0,0,21018
17746,21129914,21133977,21137628,0,0,4063,7714
17671,21111849,21111849,21138919,0,0,0,27070
17745,21129908,21133977,21138944,0,0,4069,9036
17796,21140931,21140931,21141029,0,0,0,98
17714,21123768,21123768,21144692,0,0,0,20924
17710,21120323,21120323,21146677,0,0,0,26354
17763,21135884,21135884,21148050,0,0,0,12166
17761,21135859,21135859,21148056,0,0,0,12197
17800,21145089,21148050,21148143,0,0,2961,3054
17764,21135906,21135906,21148149,0,0,0,12243
17765,21135923,21135923,21148212,0,0,0,12289
17772,21136633,21136633,21148860,0,0,0,12227
17770,21136595,21136595,21148906,0,0,0,12311
17769,21136581,21136581,21148939,0,0,0,12358
17771,21136619,21137628,21149948,0,0,1009,13329
17780,21137390,21137390,21151733,0,0,0,14343
17801,21146630,21151733,21151903,0,0,5103,5273
17717,21125369,21125369,21152055,0,0,0,26686
17738,21128900,21128900,21152400,0,0,0,23500
17749,21131446,21131517,21152497,0,0,71,21051
17739,21129100,21129100,21152535,0,0,0,23435
17788,21139079,21144692,21152674,0,0,5613,13595
17757,21133945,21134966,21155816,0,0,1021,21871
17797,21142498,21148906,21156106,0,0,6408,13608
17767,21136297,21136297,21156886,0,0,0,20589
17781,21137575,21137575,21158350,0,0,0,20775
17750,21131485,21132018,21158391,0,0,533,26906
17790,21139338,21144692,21159035,0,0,5354,19697
17789,21139145,21144692,21159043,0,0,5547,19898
17809,21157791,21158350,21159586,0,0,559,1795
17724,21126098,21130538,21160547,0,0,4440,34449
17791,21139404,21146677,21161020,0,0,7273,21616
17792,21139470,21146677,21161020,0,0,7207,21550
17793,21139555,21146677,21161020,0,0,7122,21465
17794,21139627,21148149,21162492,0,0,8522,22865
17753,21133523,21134014,21162564,0,0,491,29041
17815,21164558,21164558,21165426,0,0,0,868
17787,21138877,21138919,21165578,0,0,42,26701
17812,21163586,21163586,21165815,0,0,0,2229
17818,21165106,21165426,21166294,0,0,320,1188
17819,21165279,21165578,21166477,0,0,299,1198
17798,21143569,21160547,21166952,0,0,16978,23383
17821,21165552,21166294,21167218,0,0,742,1666
17799,21144646,21149948,21171032,0,0,5302,26386
17419,21027145,21027145,21171145,0,0,0,144000
17804,21152368,21152400,21173497,0,0,32,21129
17785,21137720,21149948,21175251,0,0,12228,37531
17708,21117688,21122072,21175409,0,0,4384,57721
17803,21152307,21152307,21176181,0,0,0,23874
17805,21152487,21152497,21176369,0,0,10,23882
17807,21154734,21155816,21176669,0,0,1082,21935
17813,21163740,21163740,21176982,0,0,0,13242
17814,21164247,21164247,21177110,0,0,0,12863
17808,21156817,21156886,21177416,0,0,69,20599
17816,21164705,21164705,21177817,0,0,0,13112
17802,21151994,21151994,21178900,0,0,0,26906
17820,21165367,21165578,21178907,0,0,211,13540
17806,21152642,21152642,21179169,0,0,0,26527
17817,21164941,21164941,21179286,0,0,0,14345
17822,21165607,21166477,21180230,0,0,870,14623
17810,21159635,21159635,21180301,0,0,0,20666
17718,21125781,21125781,21180837,0,0,0,55056
17782,21137695,21138944,21181467,0,0,1249,43772
17823,21165723,21166952,21181573,0,0,1229,15850
17795,21140558,21159035,21184235,0,0,18477,43677
17784,21137711,21148212,21185653,0,0,10501,47942
17681,21114491,21114491,21185907,0,0,0,71416
17783,21137703,21148212,21187074,0,0,10509,49371
17824,21165861,21165861,21187404,0,0,0,21543
17664,21111071,21111071,21189766,0,0,0,78695
17663,21111046,21111046,21190045,0,0,0,78999
17811,21162030,21162030,21190344,0,0,0,28314
17825,21173449,21173449,21194477,0,0,0,21028
17656,21109124,21109124,21195524,0,0,0,86400
17776,21136847,21136847,21196763,0,0,0,59916
17843,21197953,21197953,21198340,0,0,0,387
17845,21197963,21197963,21198350,0,0,0,387
17841,21197934,21197934,21198404,0,0,0,470
17832,21191256,21191256,21198583,0,0,0,7327
17842,21197941,21197941,21198690,0,0,0,749
17826,21178892,21178892,21200014,0,0,0,21122
17847,21199644,21199644,21200032,0,0,0,388
17846,21198314,21198314,21200114,0,0,0,1800
17849,21200110,21200110,21201047,0,0,0,937
17850,21200649,21200649,21201560,0,0,0,911
17852,21201583,21201583,21201651,0,0,0,68
17838,21197041,21197041,21202389,0,0,0,5348
17856,21202425,21202425,21202688,0,0,0,263
17830,21180696,21180696,21203217,0,0,0,22521
17859,21202761,21202761,21203419,0,0,0,658
17860,21203310,21203310,21203419,0,0,0,109
17863,21203822,21203822,21203952,0,0,0,130
17869,21204813,21204813,21205176,0,0,0,363
17870,21205135,21205135,21205233,0,0,0,98
17871,21205542,21205542,21205589,0,0,0,47
17827,21179015,21179015,21205703,0,0,0,26688
17872,21205889,21205889,21205925,0,0,0,36
17828,21179548,21179548,21206070,0,0,0,26522
17873,21206194,21206194,21206241,0,0,0,47
17829,21180143,21180143,21206634,0,0,0,26491
17874,21206810,21206810,21206865,0,0,0,55
17875,21207217,21207217,21207284,0,0,0,67
17876,21207392,21207392,21207568,0,0,0,176
17711,21122375,21122375,21208287,0,0,0,85912
17831,21185878,21185878,21208433,0,0,0,22555
17882,21208811,21208811,21208909,0,0,0,98
17883,21209045,21209045,21209422,0,0,0,377
17698,21115569,21115569,21209744,0,0,0,94175
17858,21202600,21202600,21210577,0,0,0,7977
17887,21211905,21211905,21212193,0,0,0,288
17888,21212132,21212132,21212210,0,0,0,78
17880,21208194,21208194,21212460,0,0,0,4266
17857,21202521,21202521,21212753,0,0,0,10232
17889,21212721,21212721,21212914,0,0,0,193
17890,21213037,21213037,21213104,0,0,0,67
17885,21209644,21209644,21213290,0,0,0,3646
17705,21116408,21116700,21213642,0,0,292,97234
17892,21213716,21213716,21213763,0,0,0,47
17786,21138687,21160547,21213784,0,0,21860,75097
17884,21209432,21209432,21213940,0,0,0,4508
17893,21213874,21213874,21214169,0,0,0,295
17896,21214170,21214170,21214600,0,0,0,430
17897,21214387,21214387,21214688,0,0,0,301
17898,21214640,21214640,21214886,0,0,0,246
17901,21214886,21214886,21214933,0,0,0,47
17902,21214924,21214924,21214982,0,0,0,58
17900,21214884,21214884,21214997,0,0,0,113
17899,21214854,21214854,21215027,0,0,0,173
17903,21214951,21214951,21215280,0,0,0,329
17906,21215462,21215462,21215786,0,0,0,324
17907,21215499,21215499,21215885,0,0,0,386
17908,21215519,21215519,21215936,0,0,0,417
17905,21215435,21215435,21216015,0,0,0,580
17867,21204169,21204169,21216028,0,0,0,11859
17868,21204180,21204180,21216068,0,0,0,11888
17909,21216222,21216222,21216290,0,0,0,68
17866,21204149,21204149,21216693,0,0,0,12544
17910,21216544,21216544,21216882,0,0,0,338
17836,21196410,21196410,21216920,0,0,0,20510
17911,21216561,21216561,21216925,0,0,0,364
17912,21216802,21216802,21216957,0,0,0,155
17891,21213346,21213346,21216959,0,0,0,3613
17916,21217036,21217036,21217207,0,0,0,171
17715,21124536,21124536,21217449,0,0,0,92913
17895,21214075,21214075,21217465,0,0,0,3390
17919,21217470,21217470,21217590,0,0,0,120
17920,21217497,21217497,21217591,0,0,0,94
17918,21217342,21217342,21217868,0,0,0,526
17837,21196741,21196741,21217916,0,0,0,21175
17921,21217761,21217761,21217987,0,0,0,226
17716,21124546,21125130,21218043,0,0,584,93497
17924,21218003,21218003,21218245,0,0,0,242
17926,21218140,21218140,21218408,0,0,0,268
17894,21214053,21214053,21218478,0,0,0,4425
17917,21217037,21217037,21218749,0,0,0,1712
17939,21218685,21218685,21218751,0,0,0,66
17913,21216836,21216836,21218826,0,0,0,1990
17942,21219008,21219008,21219051,0,0,0,43
17941,21218809,21218809,21219117,0,0,0,308
17943,21219074,21219074,21219168,0,0,0,94
17927,21218172,21218172,21219292,0,0,0,1120
17944,21219393,21219393,21219464,0,0,0,71
17929,21218346,21218346,21219528,0,0,0,1182
17945,21219525,21219525,21219603,0,0,0,78
17946,21219618,21219618,21219960,0,0,0,342
17848,21199681,21199681,21220333,0,0,0,20652
17886,21210542,21210542,21220462,0,0,0,9920
17915,21216898,21216898,21220510,0,0,0,3612
17949,21220080,21220080,21220691,0,0,0,611
17954,21221892,21221892,21221947,0,0,0,55
17933,21218407,21218407,21222872,0,0,0,4465
17853,21201819,21201819,21222904,0,0,0,21085
17955,21221916,21222904,21222998,0,0,988,1082
17960,21223160,21223160,21223233,0,0,0,73
17961,21223635,21223635,21223708,0,0,0,73
17952,21220509,21220509,21224165,0,0,0,3656
17968,21225338,21225338,21225461,0,0,0,123
17970,21225515,21225515,21225800,0,0,0,285
17971,21225851,21225851,21226722,0,0,0,871
17962,21223744,21223744,21226748,0,0,0,3004
17861,21203387,21203387,21227161,0,0,0,23774
17958,21222788,21222788,21227241,0,0,0,4453
17934,21218445,21218445,21227445,0,0,0,9000
17964,21224391,21227445,21227538,0,0,3054,3147
17965,21224685,21227538,21227631,0,0,2853,2946
17963,21224093,21224093,21227696,0,0,0,3603
17956,21222283,21222998,21227700,0,0,715,5417
17966,21225014,21227631,21227724,0,0,2617,2710
17967,21225209,21227700,21227793,0,0,2491,2584
17969,21225407,21227724,21227818,0,0,2317,2411
17582,21055051,21055081,21227824,0,0,30,172773
17855,21202390,21202390,21228720,0,0,0,26330
17977,21227458,21228720,21228828,0,0,1262,1370
17979,21228017,21228828,21228921,0,0,811,904
17851,21201150,21201150,21230780,0,0,0,29630
17978,21227643,21227696,21231356,0,0,53,3713
17976,21227194,21227194,21231629,0,0,0,4435
17953,21221454,21221454,21232166,0,0,0,10712
17881,21208374,21208374,21232192,0,0,0,23818
17680,21114446,21114446,21233881,0,0,0,119435
17877,21207405,21207405,21233944,0,0,0,26539
17981,21228998,21233944,21234038,0,0,4946,5040
17878,21207586,21207586,21234405,0,0,0,26819
17984,21231241,21231356,21235090,0,0,115,3849
17844,21197953,21197953,21235276,0,0,0,37323
17985,21231571,21231629,21236109,0,0,58,4538
17879,21207862,21207862,21236765,0,0,0,28903
17914,21216851,21216851,21237379,0,0,0,20528
17982,21230554,21230554,21237754,0,0,0,7200
17721,21125884,21125884,21238637,0,0,0,112753
17987,21234912,21234912,21238663,0,0,0,3751
17950,21220279,21238637,21238762,0,0,18358,18483
17922,21217854,21217854,21239040,0,0,0,21186
17992,21239009,21239040,21239147,0,0,31,138
17991,21238718,21238718,21239273,0,0,0,555
17835,21196013,21196013,21240023,0,0,0,44010
17988,21235980,21236109,21240673,0,0,129,4693
17951,21220289,21220289,21241030,0,0,0,20741
17973,21226721,21226721,21241033,0,0,0,14312
17974,21226752,21226752,21241070,0,0,0,14318
17990,21238595,21238595,21242373,0,0,0,3778
17925,21218025,21218025,21244419,0,0,0,26394
17983,21230725,21230780,21244599,0,0,55,13874
17999,21240484,21240673,21245226,0,0,189,4742
17972,21226667,21238762,21245470,0,0,12095,18803
18006,21244941,21245470,21245568,0,0,529,627
18009,21245239,21245568,21245724,0,0,329,485
17995,21239227,21245470,21246070,0,0,6243,6843
17998,21240127,21245470,21246070,0,0,5343,5943
18010,21245429,21245724,21246324,0,0,295,895
17840,21197921,21197921,21246433,0,0,0,48512
17935,21218615,21233881,21247412,0,0,15266,28797
17720,21125825,21125825,21247586,0,0,0,121761
17947,21219699,21247586,21248186,0,0,27887,28487
17959,21222842,21227161,21248201,0,0,4319,25359
18002,21242317,21244599,21248393,0,0,2282,6076
17948,21219712,21248186,21248403,0,0,28474,28691
18013,21248337,21248337,21248492,0,0,0,155
18007,21244981,21244981,21249574,0,0,0,4593
18012,21246044,21246044,21249835,0,0,0,3791
17904,21215402,21215402,21250473,0,0,0,35071
17839,21197889,21197889,21250646,0,0,0,52757
17975,21227105,21227793,21251939,0,0,688,24834
17957,21222368,21227824,21253024,0,0,5456,30656
18018,21250917,21250917,21253275,0,0,0,2358
18016,21249777,21249777,21253552,0,0,0,3775
17854,21202351,21202351,21254046,0,0,0,51695
18015,21249506,21249506,21254119,0,0,0,4613
17980,21228664,21228921,21255412,0,0,257,26748
18020,21253488,21253488,21257265,0,0,0,3777
18017,21250900,21250900,21257457,0,0,0,6557
17989,21237549,21237549,21258270,0,0,0,20721
18021,21254062,21254062,21258653,0,0,0,4591
18023,21257176,21257176,21260964,0,0,0,3788
17994,21239210,21240023,21261172,0,0,813,21962
18025,21258610,21258610,21263235,0,0,0,4625
18027,21260905,21260905,21264703,0,0,0,3798
18000,21240950,21244419,21264801,0,0,3469,23851
17997,21240093,21241030,21265401,0,0,937,25308
17993,21239085,21239147,21265741,0,0,62,26656
18004,21243881,21245470,21266202,0,0,1589,22321
17996,21239540,21240023,21266773,0,0,483,27233
18029,21263188,21263188,21267742,0,0,0,4554
18032,21264636,21264636,21268450,0,0,0,3814
18037,21271707,21271707,21271879,0,0,0,172
18008,21245214,21245470,21271948,0,0,256,26734
18038,21271827,21271827,21271995,0,0,0,168
18036,21268396,21268396,21272227,0,0,0,3831
18035,21267686,21267686,21272300,0,0,0,4614
18014,21248694,21248694,21272393,0,0,0,23699
17833,21194712,21194712,21273912,0,0,0,79200
17834,21194726,21194726,21273926,0,0,0,79200
18005,21244475,21245470,21274469,0,0,995,29994
18044,21273480,21273480,21274824,0,0,0,1344
18003,21243698,21245470,21274914,0,0,1772,31216
18019,21251189,21251189,21275373,0,0,0,24184
18040,21272164,21272164,21275957,0,0,0,3793
18045,21274753,21274753,21276085,0,0,0,1332
18041,21272257,21272257,21276911,0,0,0,4654
17865,21204073,21204073,21276930,0,0,0,72857
17862,21203435,21203435,21277272,0,0,0,73837
18001,21242262,21242373,21278373,0,0,111,36111
18024,21258199,21258199,21278909,0,0,0,20710
18047,21275890,21275890,21279681,0,0,0,3791
17439,21028754,21028754,21280885,0,0,0,252131
18022,21255091,21255091,21281354,0,0,0,26263
18054,21281293,21281293,21281443,0,0,0,150
18049,21276844,21276844,21281573,0,0,0,4729
18026,21260684,21260684,21281739,0,0,0,21055
18028,21261344,21261344,21281935,0,0,0,20591
18051,21279624,21279624,21283408,0,0,0,3784
18031,21264629,21264629,21285593,0,0,0,20964
18062,21285789,21285789,21285980,0,0,0,191
18056,21281535,21281535,21286217,0,0,0,4682
18063,21286057,21286057,21286684,0,0,0,627
18059,21283361,21283361,21287152,0,0,0,3791
18066,21286971,21286971,21287216,0,0,0,245
18068,21287224,21287224,21287601,0,0,0,377
18069,21287733,21287733,21288019,0,0,0,286
18073,21288280,21288280,21288431,0,0,0,151
18071,21288227,21288227,21288437,0,0,0,210
18076,21288442,21288442,21288588,0,0,0,146
18030,21264479,21264479,21288663,0,0,0,24184
18077,21288562,21288562,21288704,0,0,0,142
17482,21037400,21037400,21289506,0,0,0,252106
17486,21037494,21037508,21289622,0,0,14,252128
18080,21288678,21288678,21290762,0,0,0,2084
18065,21286156,21286156,21290793,0,0,0,4637
18067,21287094,21287094,21290877,0,0,0,3783
18082,21290792,21290792,21290907,0,0,0,115
18085,21290933,21290933,21291079,0,0,0,146
18086,21291038,21291038,21291173,0,0,0,135
18087,21291045,21291045,21291377,0,0,0,332
18084,21290930,21290930,21291409,0,0,0,479
18033,21265673,21265673,21292486,0,0,0,26813
18092,21292639,21292639,21292732,0,0,0,93
18088,21291178,21291178,21292905,0,0,0,1727
18093,21293021,21293021,21293131,0,0,0,110
18094,21293101,21293101,21293206,0,0,0,105
18034,21266706,21266706,21293230,0,0,0,26524
18096,21293255,21293255,21293348,0,0,0,93
18075,21288423,21288423,21293648,0,0,0,5225
18097,21293603,21293603,21293696,0,0,0,93
18098,21294039,21294039,21294174,0,0,0,135
18099,21294195,21294195,21294319,0,0,0,124
17986,21231801,21234038,21294439,0,0,2237,62638
18090,21292071,21292071,21294461,0,0,0,2390
18089,21292034,21292034,21294497,0,0,0,2463
18083,21290813,21290813,21294644,0,0,0,3831
18081,21290725,21290725,21295422,0,0,0,4697
18064,21286131,21286131,21295544,0,0,0,9413
17484,21037449,21037449,21296649,0,0,0,259200
18132,21297549,21297549,21297674,0,0,0,125
18133,21297837,21297837,21297884,0,0,0,47
18134,21298255,21298255,21298404,0,0,0,149
18119,21294577,21294577,21298419,0,0,0,3842
18136,21298386,21298386,21298480,0,0,0,94
18039,21271933,21271933,21298529,0,0,0,26596
18138,21298463,21298463,21298639,0,0,0,176
18046,21275307,21275307,21298704,0,0,0,23397
18050,21278875,21278875,21299577,0,0,0,20702
18151,21299876,21299876,21299960,0,0,0,84
18152,21299894,21299894,21300037,0,0,0,143
18128,21295366,21295366,21300076,0,0,0,4710
18154,21300038,21300038,21300097,0,0,0,59
18156,21300481,21300481,21300610,0,0,0,129
18043,21273147,21273147,21301466,0,0,0,28319
18159,21301385,21301385,21301525,0,0,0,140
18158,21300788,21300788,21301597,0,0,0,809
18135,21298382,21298382,21302266,0,0,0,3884
18057,21281676,21281676,21302444,0,0,0,20768
18058,21281883,21281883,21302561,0,0,0,20678
18072,21288234,21288234,21303193,0,0,0,14959
18074,21288351,21288351,21303246,0,0,0,14895
18070,21288218,21288218,21303463,0,0,0,15245
18048,21276032,21276032,21304642,0,0,0,28610
18155,21300076,21300076,21304723,0,0,0,4647
18178,21304533,21304533,21304816,0,0,0,283
18182,21304969,21304969,21305062,0,0,0,93
18176,21303918,21303918,21305157,0,0,0,1239
18177,21304394,21304394,21305189,0,0,0,795
18183,21305231,21305231,21305525,0,0,0,294
18185,21305432,21305432,21305525,0,0,0,93
18186,21305488,21305488,21305582,0,0,0,94
18189,21305625,21305625,21305692,0,0,0,67
18187,21305526,21305526,21305807,0,0,0,281
18190,21305949,21305949,21306017,0,0,0,68
18192,21306122,21306122,21306169,0,0,0,47
18167,21302240,21302240,21306172,0,0,0,3932
18184,21305380,21305380,21306178,0,0,0,798
18061,21285535,21285535,21306625,0,0,0,21090
18201,21306490,21306625,21306683,0,0,135,193
18206,21306660,21306683,21306750,0,0,23,90
18209,21306775,21306775,21306831,0,0,0,56
18194,21306422,21306422,21307217,0,0,0,795
18223,21307393,21307393,21307465,0,0,0,72
18224,21307439,21307439,21307506,0,0,0,67
17547,21048268,21048308,21307508,0,0,40,259240
18055,21281398,21281398,21307916,0,0,0,26518
18238,21308231,21308231,21308325,0,0,0,94
18226,21307640,21307640,21308380,0,0,0,740
18239,21308312,21308312,21308390,0,0,0,78
18240,21308541,21308541,21308604,0,0,0,63
18250,21308797,21308797,21309270,0,0,0,473
18180,21304660,21304660,21309336,0,0,0,4676
18175,21303452,21303452,21309774,0,0,0,6322
18207,21306732,21309774,21309867,0,0,3042,3135
18227,21307858,21309867,21309965,0,0,2009,2107
18191,21306119,21306119,21309987,0,0,0,3868
18181,21304929,21304929,21310146,0,0,0,5217
18219,21307035,21310146,21310239,0,0,3111,3204
18220,21307045,21310239,21310333,0,0,3194,3288
17550,21048391,21051224,21310424,0,0,2833,262033
18173,21303440,21303440,21310678,0,0,0,7238
18174,21303446,21303446,21310727,0,0,0,7281
18262,21310050,21310050,21311022,0,0,0,972
18079,21288597,21288597,21312000,0,0,0,23403
18137,21298455,21298455,21312031,0,0,0,13576
18261,21309926,21309987,21313892,0,0,61,3966
18251,21309265,21309265,21314023,0,0,0,4758
18225,21307566,21307566,21315328,0,0,0,7762
18331,21314741,21315328,21315528,0,0,587,787
17602,21058211,21058243,21317443,0,0,32,259232
18042,21272823,21272823,21317584,0,0,0,44761
18328,21313832,21313832,21317629,0,0,0,3797
18330,21314503,21314503,21319196,0,0,0,4693
18091,21292447,21292447,21319430,0,0,0,26983
18141,21299511,21299511,21320304,0,0,0,20793
18095,21293190,21293190,21320444,0,0,0,27254
18333,21317622,21317622,21321381,0,0,0,3759
18139,21298638,21298638,21321511,0,0,0,22873
18169,21302498,21302498,21323366,0,0,0,20868
18168,21302389,21302389,21323485,0,0,0,21096
18334,21319197,21319430,21324142,0,0,233,4945
18339,21321321,21321321,21325136,0,0,0,3815
18140,21299380,21299380,21326253,0,0,0,26873
18346,21327136,21327136,21327203,0,0,0,67
18347,21327199,21327199,21327246,0,0,0,47
18349,21327645,21327645,21327712,0,0,0,67
18351,21328044,21328044,21328128,0,0,0,84
18205,21306582,21307508,21328408,0,0,926,21826
18352,21328571,21328571,21328655,0,0,0,84
18344,21325073,21325136,21328917,0,0,63,3844
18341,21323846,21324142,21328952,0,0,296,5106
18357,21329625,21329625,21329692,0,0,0,67
18359,21330113,21330113,21330196,0,0,0,83
18360,21330155,21330155,21330222,0,0,0,67
18363,21330426,21330426,21330556,0,0,0,130
18369,21331041,21331041,21331108,0,0,0,67
18368,21331030,21331030,21331113,0,0,0,83
18160,21301394,21301394,21331128,0,0,0,29734
18371,21331201,21331201,21331264,0,0,0,63
18348,21327458,21331128,21331315,0,0,3670,3857
18372,21331213,21331213,21331318,0,0,0,105
18373,21331268,21331268,21331326,0,0,0,58
18350,21327802,21331315,21331439,0,0,3513,3637
18374,21331425,21331425,21331492,0,0,0,67
18354,21328626,21331439,21331532,0,0,2813,2906
18355,21328787,21328917,21332688,0,0,130,3901
18353,21328571,21328571,21333228,0,0,0,4657
18179,21304576,21304576,21333626,0,0,0,29050
18358,21329811,21331532,21334087,0,0,1721,4276
18381,21332519,21332688,21336426,0,0,169,3907
18228,21307872,21309867,21336736,0,0,1995,28864
18382,21333184,21333228,21337826,0,0,44,4642
18388,21336236,21336236,21339952,0,0,0,3716
18390,21337763,21337763,21342318,0,0,0,4555
18394,21341502,21342318,21346047,0,0,816,4545
18112,21294521,21294521,21346869,0,0,0,52348
18111,21294516,21294516,21346957,0,0,0,52441
18106,21294390,21294390,21347078,0,0,0,52688
18115,21294532,21294532,21347128,0,0,0,52596
18100,21294356,21294356,21347212,0,0,0,52856
18117,21294540,21294540,21347457,0,0,0,52917
18127,21294605,21294605,21347600,0,0,0,52995
18108,21294399,21294399,21347675,0,0,0,53276
18118,21294571,21294571,21347705,0,0,0,53134
18116,21294536,21294536,21347719,0,0,0,53183
18110,21294513,21294513,21347758,0,0,0,53245
18103,21294380,21294380,21347763,0,0,0,53383
18126,21294602,21294602,21347949,0,0,0,53347
18124,21294595,21294595,21347962,0,0,0,53367
18121,21294584,21294584,21348170,0,0,0,53586
18122,21294587,21294587,21348452,0,0,0,53865
18125,21294598,21294598,21348649,0,0,0,54051
18104,21294383,21294383,21348820,0,0,0,54437
18120,21294579,21294579,21348940,0,0,0,54361
18109,21294504,21294504,21349330,0,0,0,54826
18107,21294394,21294394,21349345,0,0,0,54951
18105,21294387,21294387,21349486,0,0,0,55099
18113,21294526,21294526,21349778,0,0,0,55252
18329,21314453,21314453,21350453,0,0,0,36000
18396,21344355,21346047,21350583,0,0,1692,6228
18102,21294375,21294375,21350716,0,0,0,56341
18161,21301698,21301698,21351402,0,0,0,49704
18143,21299656,21299656,21351655,0,0,0,51999
18163,21301909,21301909,21351861,0,0,0,49952
18162,21301812,21301812,21351936,0,0,0,50124
18171,21303100,21303100,21351990,0,0,0,48890
18123,21294592,21294592,21352150,0,0,0,57558
18327,21313648,21351655,21352167,0,0,38007,38519
18146,21299669,21299669,21352226,0,0,0,52557
18164,21301995,21301995,21352393,0,0,0,50398
18142,21299647,21299647,21352415,0,0,0,52768
18165,21302076,21302076,21352536,0,0,0,50460
18144,21299660,21299660,21352590,0,0,0,52930
18149,21299681,21299681,21352764,0,0,0,53083
18150,21299685,21299685,21352985,0,0,0,53300
18172,21303121,21303121,21353042,0,0,0,49921
18145,21299666,21299666,21353372,0,0,0,53706
18148,21299677,21299677,21353569,0,0,0,53892
18398,21345179,21350453,21354179,0,0,5274,9000
18147,21299673,21299673,21354185,0,0,0,54512
18403,21348846,21350583,21354230,0,0,1737,5384
18383,21333196,21354185,21354358,0,0,20989,21162
18170,21303076,21303076,21354667,0,0,0,51591
18166,21302178,21302178,21354731,0,0,0,52553
18385,21333562,21354667,21354839,0,0,21105,21277
18391,21339783,21354839,21355009,0,0,15056,15226
18406,21352508,21352508,21356223,0,0,0,3715
18404,21348867,21351936,21356558,0,0,3069,7691
18052,21280351,21280351,21356670,0,0,0,76319
18053,21280376,21280376,21357326,0,0,0,76950
18364,21330639,21357326,21357420,0,0,26687,26781
18365,21330734,21357420,21357523,0,0,26686,26789
18366,21330741,21357523,21357607,0,0,26782,26866
18367,21330773,21357607,21357700,0,0,26834,26927
18409,21353495,21353495,21358088,0,0,0,4593
18370,21331162,21357700,21358151,0,0,26538,26989
18412,21356202,21356223,21359990,0,0,21,3788
18101,21294368,21294368,21362319,0,0,0,67951
18195,21306448,21306448,21362411,0,0,0,55963
18395,21341651,21362319,21362490,0,0,20668,20839
18413,21358088,21358088,21362693,0,0,0,4605
18196,21306461,21306461,21362991,0,0,0,56530
18210,21306868,21307508,21363056,0,0,640,56188
18414,21359906,21359906,21363660,0,0,0,3754
18216,21306895,21307916,21363774,0,0,1021,56879
18197,21306467,21306467,21363873,0,0,0,57406
18212,21306881,21307508,21364143,0,0,627,57262
18204,21306506,21307508,21364174,0,0,1002,57668
18202,21306490,21307508,21364188,0,0,1018,57698
18199,21306474,21307217,21364437,0,0,743,57963
18200,21306479,21307217,21364549,0,0,738,58070
18203,21306500,21307508,21364763,0,0,1008,58263
18211,21306876,21307508,21364825,0,0,632,57949
18237,21308189,21310424,21365077,0,0,2235,56888
18229,21308147,21309867,21365273,0,0,1720,57126
18218,21306903,21309867,21365428,0,0,2964,58525
18214,21306888,21307508,21365620,0,0,620,58732
18213,21306885,21307508,21365682,0,0,623,58797
18157,21300722,21300722,21365753,0,0,0,65031
18249,21308617,21310678,21365768,0,0,2061,57151
18230,21308160,21309867,21365791,0,0,1707,57631
18408,21353013,21365753,21365924,0,0,12740,12911
18410,21355412,21365753,21365924,0,0,10341,10512
18416,21362768,21365768,21365939,0,0,3000,3171
18215,21306892,21307508,21366015,0,0,616,59123
18217,21306899,21309867,21366181,0,0,2968,59282
18421,21366621,21366621,21366714,0,0,0,93
18232,21308168,21309867,21366816,0,0,1699,58648
18233,21308172,21309867,21366837,0,0,1695,58665
18234,21308176,21309867,21366988,0,0,1691,58812
18241,21308571,21310424,21367069,0,0,1853,58498
18246,21308595,21310424,21367165,0,0,1829,58570
18236,21308183,21310424,21367204,0,0,2241,59021
18415,21362626,21362693,21367218,0,0,67,4592
18231,21308164,21309867,21367390,0,0,1703,59226
18235,21308179,21309965,21367396,0,0,1786,59217
18418,21363618,21363618,21367434,0,0,0,3816
18193,21306126,21306126,21367679,0,0,0,61553
18260,21309639,21310678,21367807,0,0,1039,58168
18271,21310116,21310727,21367955,0,0,611,57839
18252,21309588,21310678,21368043,0,0,1090,58455
18244,21308588,21310424,21368266,0,0,1836,59678
18272,21310422,21310727,21368328,0,0,305,57906
18264,21310083,21310727,21368332,0,0,644,58249
18245,21308592,21310424,21368390,0,0,1832,59798
18242,21308578,21310424,21368489,0,0,1846,59911
18248,21308610,21310424,21368566,0,0,1814,59956
18425,21367401,21367401,21368596,0,0,0,1195
18426,21368785,21368785,21368893,0,0,0,108
18263,21310073,21310727,21368901,0,0,654,58828
18427,21368796,21368893,21368970,0,0,97,174
18428,21368809,21368970,21369047,0,0,161,238
18243,21308582,21310424,21369305,0,0,1842,60723
18257,21309627,21310678,21369338,0,0,1051,59711
18269,21310108,21310727,21369618,0,0,619,59510
18265,21310086,21310727,21369786,0,0,641,59700
18266,21310096,21310727,21369822,0,0,631,59726
18268,21310104,21310727,21370024,0,0,623,59920
18255,21309619,21310678,21370125,0,0,1059,60506
18273,21310436,21312000,21370213,0,0,1564,59777
18277,21310463,21312031,21370349,0,0,1568,59886
18270,21310111,21310727,21370393,0,0,616,60282
18256,21309623,21310678,21370434,0,0,1055,60811
18278,21310473,21312031,21370439,0,0,1558,59966
18258,21309630,21310678,21370451,0,0,1048,60821
18279,21310481,21312031,21370563,0,0,1550,60082
18429,21368825,21369047,21371059,0,0,222,2234
18254,21309615,21310678,21371179,0,0,1063,61564
18247,21308602,21310424,21371183,0,0,1822,62581
18424,21367362,21367362,21371186,0,0,0,3824
18267,21310100,21310727,21371192,0,0,627,61092
18433,21370060,21371192,21371266,0,0,1132,1206
18282,21311001,21312031,21371343,0,0,1030,60342
18434,21370072,21371266,21371359,0,0,1194,1287
18060,21285039,21285039,21371439,0,0,0,86400
18274,21310441,21312031,21371605,0,0,1590,61164
18422,21367093,21367093,21371629,0,0,0,4536
18275,21310451,21312031,21371721,0,0,1580,61270
18290,21311680,21320444,21371764,0,0,8764,60084
18281,21310990,21312031,21371777,0,0,1041,60787
18435,21370449,21371359,21371920,0,0,910,1471
18280,21310491,21312031,21371954,0,0,1540,61463
18283,21311005,21312031,21372315,0,0,1026,61310
18276,21310457,21312031,21372326,0,0,1574,61869
18198,21306470,21306625,21372335,0,0,155,65865
18336,21320308,21352167,21372554,0,0,31859,52246
18432,21369018,21370024,21372821,0,0,1006,3803
18291,21311690,21321511,21373132,0,0,9821,61442
18431,21368836,21371059,21373144,0,0,2223,4308
18446,21372992,21372992,21373220,0,0,0,228
18342,21324332,21352764,21373345,0,0,28432,49013
18259,21309634,21310678,21373926,0,0,1044,64292
18343,21324577,21353042,21374128,0,0,28465,49551
18356,21329472,21353569,21374450,0,0,24097,44978
18308,21311937,21351990,21374764,0,0,40053,62827
18442,21371103,21371103,21374943,0,0,0,3840
18292,21311693,21323366,21375018,0,0,11673,63325
18294,21311698,21323485,21375579,0,0,11787,63881
18293,21311695,21323485,21375672,0,0,11790,63977
18453,21375803,21375803,21375871,0,0,0,68
18454,21375943,21375943,21376119,0,0,0,176
18444,21371584,21371584,21376171,0,0,0,4587
18455,21375984,21375984,21376171,0,0,0,187
18456,21376029,21376029,21376200,0,0,0,171
18457,21376089,21376089,21376264,0,0,0,175
18459,21376091,21376091,21376266,0,0,0,175
18253,21309610,21310678,21376284,0,0,1068,66674
18460,21376092,21376092,21376309,0,0,0,217
18458,21376090,21376090,21376369,0,0,0,279
18461,21376117,21376117,21376392,0,0,0,275
18463,21376118,21376118,21376393,0,0,0,275
18464,21376119,21376119,21376394,0,0,0,275
18340,21322077,21352590,21376573,0,0,30513,54496
18285,21311011,21317584,21376679,0,0,6573,65668
18286,21311016,21317584,21377022,0,0,6568,66006
18284,21311009,21317584,21377144,0,0,6575,66135
18393,21340634,21357326,21377886,0,0,16692,37252
18295,21311701,21326253,21378409,0,0,14552,66708
18452,21374881,21374881,21378770,0,0,0,3889
18392,21340454,21355009,21379014,0,0,14555,38560
18335,21319370,21352150,21379192,0,0,32780,59822
18288,21311023,21319430,21379238,0,0,8407,68215
18337,21320386,21352536,21379421,0,0,32150,59035
18470,21379845,21379845,21379959,0,0,0,114
18469,21379839,21379839,21380001,0,0,0,162
18473,21379871,21379959,21380016,0,0,88,145
18345,21326253,21353372,21380024,0,0,27119,53771
18471,21379850,21379850,21380026,0,0,0,176
18472,21379855,21379855,21380031,0,0,0,176
18296,21311704,21328408,21380099,0,0,16704,68395
18474,21379874,21380001,21380275,0,0,127,401
18289,21311033,21320304,21380277,0,0,9271,69244
18475,21379877,21380016,21380290,0,0,139,413
18478,21380445,21380445,21380616,0,0,0,171
18479,21380449,21380449,21380620,0,0,0,171
18476,21380429,21380429,21380621,0,0,0,192
18462,21376117,21376117,21380698,0,0,0,4581
18480,21380453,21380453,21380706,0,0,0,253
18477,21380433,21380433,21380707,0,0,0,274
18481,21380471,21380471,21380729,0,0,0,258
18482,21380477,21380477,21380771,0,0,0,294
18114,21294529,21294529,21380929,0,0,0,86400
18486,21380768,21380768,21380944,0,0,0,176
18487,21380771,21380771,21380947,0,0,0,176
18484,21380759,21380759,21380952,0,0,0,193
18488,21380791,21380791,21381034,0,0,0,243
18485,21380765,21380765,21381065,0,0,0,300
18489,21380795,21380795,21381069,0,0,0,274
18490,21380801,21380801,21381075,0,0,0,274
18287,21311019,21319196,21382001,0,0,8177,70982
18492,21381988,21381988,21382154,0,0,0,166
18493,21382092,21382092,21382258,0,0,0,166
18494,21382193,21382193,21382361,0,0,0,168
18498,21382487,21382487,21382569,0,0,0,82
18445,21371810,21371810,21382610,0,0,0,10800
18468,21378708,21378708,21382615,0,0,0,3907
18297,21311708,21331128,21382633,0,0,19420,70925
18500,21382572,21382572,21382800,0,0,0,228
18501,21382980,21382980,21383033,0,0,0,53
18397,21344852,21362411,21383055,0,0,17559,38203
18503,21383111,21383111,21383168,0,0,0,57
18504,21383132,21383132,21383169,0,0,0,37
18399,21345620,21362490,21383248,0,0,16870,37628
18502,21382990,21382990,21383264,0,0,0,274
18505,21383223,21383223,21383423,0,0,0,200
18506,21383418,21383418,21383683,0,0,0,265
18507,21383528,21383528,21383728,0,0,0,200
18384,21333371,21354358,21383755,0,0,20987,50384
18508,21384008,21384008,21384208,0,0,0,200
18510,21384239,21384239,21384321,0,0,0,82
18511,21384306,21384306,21384438,0,0,0,132
18386,21333740,21354731,21384622,0,0,20991,50882
18512,21384581,21384581,21384705,0,0,0,124
18078,21288583,21288583,21384709,0,0,0,96126
18513,21384790,21384790,21384889,0,0,0,99
18509,21384078,21384078,21384944,0,0,0,866
18483,21380645,21380645,21385134,0,0,0,4489
18514,21385036,21385036,21385168,0,0,0,132
18298,21311711,21333626,21386017,0,0,21915,74306
18466,21376803,21376803,21386031,0,0,0,9228
18400,21345997,21362991,21386249,0,0,16994,40252
18499,21382537,21382537,21386364,0,0,0,3827
18153,21299967,21299967,21386367,0,0,0,86400
18405,21350305,21365620,21386657,0,0,15315,36352
18441,21371060,21384709,21387188,0,0,13649,16128
18131,21296096,21296096,21388088,0,0,0,91992
18129,21296082,21296082,21388137,0,0,0,92055
18130,21296092,21296092,21388147,0,0,0,92055
18517,21386103,21386367,21388167,0,0,264,2064
18299,21311821,21336736,21388431,0,0,24915,76610
18443,21371156,21384944,21388905,0,0,13788,17749
18375,21331581,21358151,21389065,0,0,26570,57484
18420,21365656,21365924,21389210,0,0,268,23554
18515,21385061,21385134,21389681,0,0,73,4620
18518,21386300,21386300,21390182,0,0,0,3882
18377,21331627,21364143,21390842,0,0,32516,59215
18379,21331663,21364549,21391007,0,0,32886,59344
18300,21311830,21339952,21391036,0,0,28122,79206
18380,21331684,21364825,21391081,0,0,33141,59397
18437,21370847,21370847,21391562,0,0,0,20715
18523,21391483,21391483,21392022,0,0,0,539
18411,21355521,21365753,21392282,0,0,10232,36761
18407,21352842,21365682,21392286,0,0,12840,39444
18376,21331610,21363774,21392402,0,0,32164,60792
18401,21346365,21365273,21392409,0,0,18908,46044
18525,21391862,21391862,21392427,0,0,0,565
18402,21347226,21365428,21392458,0,0,18202,45232
18527,21392561,21392561,21392744,0,0,0,183
18529,21392685,21392685,21392866,0,0,0,181
18378,21331643,21364188,21393558,0,0,32545,61915
18528,21392662,21392662,21393736,0,0,0,1074
18532,21393922,21393922,21393990,0,0,0,68
18533,21393949,21393949,21394036,0,0,0,87
18534,21393961,21393961,21394047,0,0,0,86
18521,21390141,21390141,21394068,0,0,0,3927
18535,21393984,21393984,21394069,0,0,0,85
18536,21393998,21393998,21394093,0,0,0,95
18539,21394031,21394031,21394102,0,0,0,71
18538,21394010,21394010,21394133,0,0,0,123
18520,21389552,21389552,21394150,0,0,0,4598
18540,21394068,21394068,21394161,0,0,0,93
18550,21394234,21394234,21394270,0,0,0,36
18551,21394276,21394276,21394349,0,0,0,73
18552,21394298,21394298,21394378,0,0,0,80
18553,21394310,21394310,21394391,0,0,0,81
18419,21363623,21365924,21394398,0,0,2301,30775
18554,21394360,21394360,21394444,0,0,0,84
18450,21373657,21373926,21394474,0,0,269,20817
18555,21394383,21394383,21394475,0,0,0,92
18562,21394574,21394574,21394642,0,0,0,68
18516,21385387,21386031,21394719,0,0,644,9332
18522,21391377,21391562,21394863,0,0,185,3486
18338,21320960,21351861,21395061,0,0,30901,74101
18564,21395010,21395061,21395155,0,0,51,145
18451,21374557,21374557,21395412,0,0,0,20855
18417,21362876,21365791,21395522,0,0,2915,32646
18567,21396551,21396551,21396680,0,0,0,129
18465,21376270,21376270,21397234,0,0,0,20964
18301,21311833,21346869,21397619,0,0,35036,85786
18537,21394007,21394007,21397954,0,0,0,3947
18304,21311843,21347128,21398475,0,0,35285,86632
18311,21312066,21347719,21398668,0,0,35653,86602
18541,21394085,21394085,21398671,0,0,0,4586
18307,21311854,21347600,21398817,0,0,35746,86963
18309,21312057,21347675,21398830,0,0,35618,86773
18305,21311846,21347212,21398843,0,0,35366,86997
18526,21392043,21392286,21399002,0,0,243,6959
18570,21397340,21397340,21399153,0,0,0,1813
18310,21312063,21347705,21399181,0,0,35642,87118
18303,21311840,21347078,21399219,0,0,35238,87379
18312,21312069,21347758,21399276,0,0,35689,87207
18314,21312076,21347949,21399430,0,0,35873,87354
18306,21311850,21347457,21399440,0,0,35607,87590
18316,21312081,21348170,21399471,0,0,36089,87390
18315,21312078,21347962,21399551,0,0,35884,87473
18317,21312085,21348452,21399609,0,0,36367,87524
18319,21312259,21348820,21400279,0,0,36561,88020
18302,21311836,21346957,21400317,0,0,35121,88481
18320,21312262,21348940,21400461,0,0,36678,88199
18436,21370699,21371920,21400463,0,0,1221,29764
18569,21397201,21397201,21400888,0,0,0,3687
18313,21312072,21347763,21400946,0,0,35691,88874
18440,21370954,21379421,21401068,0,0,8467,30114
18324,21312276,21349778,21401208,0,0,37502,88932
17590,21055836,21055836,21401436,0,0,0,345600
18322,21312269,21349345,21401452,0,0,37076,89183
18438,21370852,21372821,21401457,0,0,1969,30605
18323,21312273,21349486,21401495,0,0,37213,89222
18439,21370876,21373144,21401662,0,0,2268,30786
18571,21397901,21397954,21401877,0,0,53,3976
18467,21378493,21378493,21401984,0,0,0,23491
18325,21312280,21350716,21402031,0,0,38436,89751
18321,21312266,21349330,21402837,0,0,37064,90571
18572,21398635,21398635,21403212,0,0,0,4577
18326,21312284,21351402,21403368,0,0,39118,91084
17600,21058173,21058173,21403773,0,0,0,345600
18556,21394391,21398671,21404205,0,0,4280,9814
18531,21393372,21400463,21404331,0,0,7091,10959
18574,21398753,21401068,21404936,0,0,2315,6183
18549,21394228,21397619,21405093,0,0,3391,10865
18575,21398770,21401457,21405325,0,0,2687,6555
18449,21373364,21373364,21405421,0,0,0,32057
18577,21401763,21401763,21405684,0,0,0,3921
18563,21394675,21400279,21406019,0,0,5604,11344
18579,21403152,21403152,21407766,0,0,0,4614
18448,21373362,21373362,21408032,0,0,0,34670
18447,21373358,21373358,21408111,0,0,0,34753
18491,21381844,21381844,21408569,0,0,0,26725
18597,21408523,21408523,21408695,0,0,0,172
18496,21382302,21382302,21408824,0,0,0,26522
18497,21382377,21382377,21408897,0,0,0,26520
18599,21408761,21408761,21408952,0,0,0,191
18601,21408952,21408952,21409103,0,0,0,151
18495,21382281,21382281,21409197,0,0,0,26916
18602,21409123,21409123,21409293,0,0,0,170
18548,21394173,21394863,21409543,0,0,690,15370
18592,21405639,21405639,21409597,0,0,0,3958
18318,21312249,21348649,21411351,0,0,36400,99102
18519,21388880,21388905,21412376,0,0,25,23496
18593,21407703,21407703,21412382,0,0,0,4679
18524,21391499,21392282,21412677,0,0,783,21178
18530,21392803,21392803,21413013,0,0,0,20210
18605,21409537,21409537,21413457,0,0,0,3920
18557,21394408,21398843,21413532,0,0,4435,19124
18559,21394422,21399276,21413768,0,0,4854,19346
18558,21394415,21399181,21413793,0,0,4766,19378
18561,21394436,21399551,21413997,0,0,5115,19561
18560,21394429,21399440,21414021,0,0,5011,19592
18543,21394115,21394115,21414376,0,0,0,20261
18544,21394125,21394150,21416170,0,0,25,22045
18546,21394150,21394719,21416241,0,0,569,22091
18565,21395369,21395369,21416360,0,0,0,20991
18608,21412317,21412317,21416988,0,0,0,4671
18547,21394161,21394719,21417027,0,0,558,22866
18610,21413414,21413414,21417341,0,0,0,3927
18542,21394100,21394100,21417584,0,0,0,23484
18568,21397160,21397160,21417721,0,0,0,20561
17864,21204029,21204029,21418314,0,0,0,214285
18362,21330256,21356670,21418547,0,0,26414,88291
18011,21245531,21246324,21419124,0,0,793,173593
18361,21330248,21356670,21419138,0,0,26422,88890
18614,21417301,21417301,21421253,0,0,0,3952
18613,21416920,21416920,21421669,0,0,0,4749
18587,21403369,21419124,21422110,0,0,15755,18741
18616,21421199,21421199,21425108,0,0,0,3909
18578,21401921,21401921,21425365,0,0,0,23444
18617,21421607,21421607,21426274,0,0,0,4667
18621,21428083,21428083,21428267,0,0,0,184
18573,21398694,21398817,21428275,0,0,123,29581
18618,21425063,21425063,21428930,0,0,0,3867
18566,21395372,21395412,21430191,0,0,40,34819
18620,21426218,21426218,21431129,0,0,0,4911
18606,21411832,21411832,21432350,0,0,0,20518
18623,21428891,21428891,21432801,0,0,0,3910
18611,21414315,21414315,21434575,0,0,0,20260
18598,21408681,21408681,21434871,0,0,0,26190
18604,21409273,21409273,21435482,0,0,0,26209
18607,21412277,21412277,21435706,0,0,0,23429
18600,21408853,21408853,21435820,0,0,0,26967
18624,21431063,21431063,21435826,0,0,0,4763
18603,21409131,21409131,21435946,0,0,0,26815
18626,21432741,21432741,21436611,0,0,0,3870
18612,21416313,21416313,21437221,0,0,0,20908
18615,21417655,21417655,21438293,0,0,0,20638
18634,21436567,21436567,21440408,0,0,0,3841
18545,21394132,21394474,21440627,0,0,342,46495
18631,21435775,21435775,21440634,0,0,0,4859
18609,21412969,21412969,21441392,0,0,0,28423
18423,21367346,21367346,21442251,0,0,0,74905
18639,21441394,21442251,21442422,0,0,857,1028
18589,21403380,21441392,21442749,0,0,38012,39369
18637,21440347,21440347,21444208,0,0,0,3861
18638,21440570,21440570,21445403,0,0,0,4833
18430,21368830,21369338,21445652,0,0,508,76822
18641,21444147,21444147,21448014,0,0,0,3867
18619,21425310,21425310,21449535,0,0,0,24225
18642,21445362,21445362,21450154,0,0,0,4792
18643,21447971,21447971,21451801,0,0,0,3830
18625,21432351,21432351,21453033,0,0,0,20682
18627,21434575,21434575,21454882,0,0,0,20307
18645,21450097,21450097,21454884,0,0,0,4787
18646,21451730,21451730,21455555,0,0,0,3825
18635,21437163,21437163,21457739,0,0,0,20576
18622,21428200,21428200,21457818,0,0,0,29618
18652,21457755,21457755,21457926,0,0,0,171
18636,21438237,21438237,21458981,0,0,0,20744
18650,21455502,21455502,21459338,0,0,0,3836
18648,21454804,21454804,21459590,0,0,0,4786
18630,21435718,21435718,21459901,0,0,0,24183
18628,21434870,21434870,21461122,0,0,0,26252
18658,21461059,21461059,21461229,0,0,0,170
18629,21435437,21435437,21461993,0,0,0,26556
18660,21461933,21461933,21462101,0,0,0,168
18632,21435798,21435798,21462702,0,0,0,26904
18633,21435918,21435918,21462706,0,0,0,26788
18655,21459275,21459275,21463030,0,0,0,3755
18656,21459531,21459531,21464429,0,0,0,4898
18664,21462967,21462967,21466765,0,0,0,3798
18665,21464362,21464362,21469225,0,0,0,4863
18666,21466693,21466693,21470423,0,0,0,3730
17923,21217965,21217965,21470565,0,0,0,252600
18667,21467596,21470565,21470669,0,0,2969,3073
18674,21470848,21470848,21470916,0,0,0,68
17928,21218332,21218332,21470932,0,0,0,252600
17930,21218353,21218353,21470953,0,0,0,252600
17931,21218372,21218372,21470972,0,0,0,252600
18675,21470956,21470956,21471023,0,0,0,67
18677,21471311,21471311,21471436,0,0,0,125
18669,21467995,21470953,21471552,0,0,2958,3557
18640,21441513,21442251,21472173,0,0,738,30660
18668,21467969,21470669,21472268,0,0,2700,4299
18678,21471374,21471374,21472385,0,0,0,1011
18676,21471036,21471036,21472576,0,0,0,1540
18644,21449465,21449465,21473215,0,0,0,23750
17932,21218394,21220691,21473291,0,0,2297,254897
18647,21452970,21452970,21473498,0,0,0,20528
18682,21471667,21471667,21473559,0,0,0,1892
18670,21469171,21469171,21473974,0,0,0,4803
18680,21471399,21471399,21474103,0,0,0,2704
18673,21470368,21470368,21474107,0,0,0,3739
18672,21470105,21472268,21474464,0,0,2163,4359
18681,21471621,21471621,21475066,0,0,0,3445
18649,21454839,21454839,21475144,0,0,0,20305
18584,21403226,21405325,21475890,0,0,2099,72664
18671,21470101,21471552,21476445,0,0,1451,6344
18685,21472857,21472857,21477378,0,0,0,4521
18689,21474039,21474039,21477761,0,0,0,3722
18651,21457676,21457676,21478276,0,0,0,20600
18583,21403217,21404936,21478647,0,0,1719,75430
18688,21473933,21473933,21478660,0,0,0,4727
18691,21477159,21477159,21478764,0,0,0,1605
18692,21477184,21477184,21479008,0,0,0,1824
18693,21477200,21477200,21479024,0,0,0,1824
18654,21458921,21458921,21479648,0,0,0,20727
18699,21479005,21479008,21479964,0,0,3,959
18700,21479040,21479040,21479965,0,0,0,925
18694,21477725,21477725,21481653,0,0,0,3928
18585,21403355,21413532,21482116,0,0,10177,78761
18696,21478594,21478594,21483421,0,0,0,4827
18657,21459838,21459838,21483594,0,0,0,23756
18705,21481593,21481593,21485289,0,0,0,3696
17936,21218650,21233881,21486481,0,0,15231,267831
18653,21457863,21457863,21487810,0,0,0,29947
17937,21218665,21235276,21487876,0,0,16611,269211
17938,21218682,21235276,21487876,0,0,16594,269194
18709,21487768,21487768,21487928,0,0,0,160
18659,21461166,21461166,21487959,0,0,0,26793
18710,21487875,21487875,21488046,0,0,0,171
18711,21487897,21487897,21488055,0,0,0,158
18706,21483357,21483357,21488080,0,0,0,4723
18661,21462039,21462039,21488933,0,0,0,26894
18708,21485247,21485247,21489012,0,0,0,3765
18663,21462663,21462663,21489271,0,0,0,26608
18662,21462648,21462648,21489692,0,0,0,27044
17940,21218699,21238637,21491237,0,0,19938,272538
18714,21488014,21488014,21492643,0,0,0,4629
18716,21488950,21488950,21492653,0,0,0,3703
18687,21473436,21473436,21493619,0,0,0,20183
18690,21475084,21475084,21495497,0,0,0,20413
18686,21473154,21473215,21496093,0,0,61,22939
18719,21492600,21492600,21496318,0,0,0,3718
18720,21492606,21492606,21497293,0,0,0,4687
18695,21478234,21478234,21498942,0,0,0,20708
18724,21496262,21496262,21499972,0,0,0,3710
18702,21479585,21479585,21500327,0,0,0,20742
18679,21471384,21471384,21501644,0,0,0,30260
18725,21497235,21497235,21501921,0,0,0,4686
18727,21499930,21499930,21503689,0,0,0,3759
18707,21483531,21483531,21506445,0,0,0,22914
18730,21501859,21501859,21506475,0,0,0,4616
18731,21503631,21503631,21507355,0,0,0,3724
18733,21506413,21506413,21511023,0,0,0,4610
18734,21507308,21507308,21511140,0,0,0,3832
18721,21493556,21493556,21513776,0,0,0,20220
18713,21488005,21488005,21514276,0,0,0,26271
18736,21511082,21511082,21514909,0,0,0,3827
18715,21488889,21488889,21515382,0,0,0,26493
18735,21510955,21510955,21515606,0,0,0,4651
18722,21495426,21495426,21515777,0,0,0,20351
18717,21489229,21489229,21515983,0,0,0,26754
18718,21489650,21489650,21516331,0,0,0,26681
18712,21487991,21487991,21516398,0,0,0,28407
18739,21514846,21514846,21518689,0,0,0,3843
18723,21495976,21495976,21518770,0,0,0,22794
18726,21498898,21498898,21519584,0,0,0,20686
18741,21515550,21515550,21520108,0,0,0,4558
18750,21520838,21520838,21520973,0,0,0,135
18728,21500262,21500262,21521310,0,0,0,21048
18746,21518646,21518646,21522496,0,0,0,3850
18591,21404230,21442749,21523224,0,0,38519,118994
18749,21520037,21520037,21524665,0,0,0,4628
18704,21479964,21482116,21525870,0,0,2152,45906
18752,21522454,21522454,21526375,0,0,0,3921
18753,21524612,21524612,21529118,0,0,0,4506
18732,21506371,21506371,21529226,0,0,0,22855
18754,21526307,21526307,21530205,0,0,0,3898
18703,21479938,21479965,21531866,0,0,27,51928
18729,21501589,21501589,21531909,0,0,0,30320
18755,21529056,21529056,21533616,0,0,0,4560
18737,21513729,21513729,21534038,0,0,0,20309
18757,21530150,21530150,21534117,0,0,0,3967
18742,21515724,21515724,21536266,0,0,0,20542
18761,21534048,21534048,21537976,0,0,0,3928
18759,21533553,21533553,21538109,0,0,0,4556
18748,21519540,21519540,21540318,0,0,0,20778
18738,21514216,21514216,21540583,0,0,0,26367
18588,21403374,21422110,21540629,0,0,18736,137255
18740,21515337,21515337,21541499,0,0,0,26162
18763,21537938,21537938,21541865,0,0,0,3927
18747,21518707,21518707,21542034,0,0,0,23327
18751,21521244,21521244,21542169,0,0,0,20925
18743,21515921,21515921,21542697,0,0,0,26776
18764,21538040,21538040,21542796,0,0,0,4756
18744,21516266,21516266,21543085,0,0,0,26819
18684,21472296,21472296,21545608,0,0,0,73312
18768,21541805,21541805,21545742,0,0,0,3937
18745,21516344,21516344,21546296,0,0,0,29952
18772,21542740,21542740,21547264,0,0,0,4524
18777,21546267,21546267,21549250,0,0,0,2983
18778,21546582,21546582,21549451,0,0,0,2869
18775,21545977,21545977,21549458,0,0,0,3481
18774,21545681,21545681,21549633,0,0,0,3952
18576,21398775,21401662,21550010,0,0,2887,151235
18781,21549396,21549396,21550024,0,0,0,628
18683,21472281,21472281,21550175,0,0,0,77894
18780,21549179,21549179,21550464,0,0,0,1285
18779,21547193,21547193,21551765,0,0,0,4572
18581,21403175,21403773,21552121,0,0,598,148946
18701,21479243,21479964,21552133,0,0,721,72890
18697,21478774,21478774,21552149,0,0,0,73375
18698,21478991,21478991,21552149,0,0,0,73158
18595,21408062,21408062,21552416,0,0,0,144354
18756,21529164,21529164,21552467,0,0,0,23303
18582,21403197,21404331,21552648,0,0,1134,149451
18782,21549570,21549570,21553470,0,0,0,3900
18760,21533981,21533981,21554315,0,0,0,20334
18596,21408112,21408112,21554807,0,0,0,146695
18785,21551711,21551711,21556201,0,0,0,4490
18783,21550023,21550023,21556357,0,0,0,6334
18762,21536188,21536188,21556647,0,0,0,20459
18784,21550472,21550472,21557235,0,0,0,6763
18793,21553404,21553404,21557274,0,0,0,3870
18786,21551779,21551779,21558062,0,0,0,6283
18790,21552100,21552100,21558091,0,0,0,5991
18787,21551788,21551788,21558206,0,0,0,6418
18788,21551801,21551801,21558250,0,0,0,6449
18791,21552115,21552115,21558283,0,0,0,6168
18789,21552082,21552082,21558464,0,0,0,6382
18795,21556160,21556160,21560704,0,0,0,4544
18594,21408043,21408043,21560832,0,0,0,152789
18765,21540260,21540260,21561005,0,0,0,20745
18758,21531850,21531850,21561078,0,0,0,29228
18797,21557232,21557232,21561172,0,0,0,3940
18809,21561033,21561033,21561204,0,0,0,171
18811,21561144,21561144,21561312,0,0,0,168
18812,21561250,21561250,21561419,0,0,0,169
18813,21561357,21561357,21561540,0,0,0,183
18770,21542115,21542115,21562948,0,0,0,20833
18798,21557803,21557803,21563267,0,0,0,5464
18799,21557908,21557908,21563793,0,0,0,5885
18817,21563708,21563708,21564260,0,0,0,552
18804,21558254,21558254,21564293,0,0,0,6039
18821,21564221,21564221,21564450,0,0,0,229
18818,21563731,21563731,21564533,0,0,0,802
18816,21563192,21563192,21564560,0,0,0,1368
18188,21305533,21305533,21564733,0,0,0,259200
18810,21561079,21561079,21565008,0,0,0,3929
18769,21541969,21541969,21565064,0,0,0,23095
18822,21564252,21564252,21565086,0,0,0,834
18807,21560652,21560652,21565203,0,0,0,4551
18801,21558036,21558036,21565380,0,0,0,7344
18766,21540526,21540526,21567075,0,0,0,26549
18767,21541442,21541442,21567895,0,0,0,26453
18826,21564945,21564945,21568864,0,0,0,3919
18771,21542635,21542635,21569318,0,0,0,26683
18222,21307222,21310333,21569533,0,0,3111,262311
18828,21565141,21565141,21569702,0,0,0,4561
18773,21543045,21543045,21569831,0,0,0,26786
18823,21564510,21564510,21572295,0,0,0,7785
18837,21568799,21568799,21572714,0,0,0,3915
18824,21564521,21564521,21573170,0,0,0,8649
18800,21558011,21558011,21574182,0,0,0,16171
18839,21569638,21569638,21574224,0,0,0,4586
18802,21558167,21558167,21574410,0,0,0,16243
18803,21558208,21558208,21574440,0,0,0,16232
18805,21558394,21558394,21574445,0,0,0,16051
18794,21554252,21554252,21574580,0,0,0,20328
18846,21574353,21574440,21574657,0,0,87,304
18847,21574356,21574657,21574750,0,0,301,394
18830,21565335,21565335,21575002,0,0,0,9667
18829,21565239,21565239,21575072,0,0,0,9833
18792,21552413,21552413,21575472,0,0,0,23059
18776,21546247,21546247,21576448,0,0,0,30201
18841,21572654,21572654,21576520,0,0,0,3866
18796,21556600,21556600,21577215,0,0,0,20615
18845,21574184,21574184,21578819,0,0,0,4635
18855,21576474,21576474,21580372,0,0,0,3898
18844,21574121,21574410,21581829,0,0,289,7708
18808,21560960,21560960,21581895,0,0,0,20935
18857,21578767,21578767,21583395,0,0,0,4628
18815,21562886,21562886,21583897,0,0,0,21011
18858,21580306,21580306,21584176,0,0,0,3870
18864,21584122,21584122,21587949,0,0,0,3827
18860,21583334,21583334,21588022,0,0,0,4688
18827,21564984,21564984,21588506,0,0,0,23522
18871,21588155,21588155,21589995,0,0,0,1840
18814,21561471,21561471,21590032,0,0,0,28561
18869,21587904,21587904,21591758,0,0,0,3854
18870,21587977,21587977,21592727,0,0,0,4750
18832,21567031,21567031,21593397,0,0,0,26366
18877,21593337,21593397,21593570,0,0,60,233
18836,21567833,21567833,21594219,0,0,0,26386
18879,21594153,21594219,21594391,0,0,66,238
18849,21574533,21574533,21594892,0,0,0,20359
18875,21591698,21591758,21595538,0,0,60,3840
18838,21569256,21569256,21595667,0,0,0,26411
18852,21575015,21575015,21596203,0,0,0,21188
18840,21569773,21569773,21596519,0,0,0,26746
18876,21592667,21592727,21597465,0,0,60,4798
18856,21577157,21577157,21597574,0,0,0,20417
18853,21575402,21575402,21598941,0,0,0,23539
18883,21595408,21595667,21599472,0,0,259,4064
18886,21597342,21597342,21602079,0,0,0,4737
18859,21581854,21581854,21602721,0,0,0,20867
18889,21599159,21599159,21602916,0,0,0,3757
18831,21566878,21566878,21603468,0,0,0,36590
18862,21583834,21583834,21604667,0,0,0,20833
18854,21576385,21576385,21606467,0,0,0,30082
18894,21606411,21606411,21606582,0,0,0,171
18892,21602853,21602853,21606627,0,0,0,3774
18890,21602016,21602016,21607076,0,0,0,5060
18896,21606579,21606579,21610381,0,0,0,3802
18332,21315484,21352393,21611536,0,0,36909,296052
18897,21607014,21607014,21611867,0,0,0,4853
18872,21588437,21588506,21612402,0,0,69,23965
18898,21610320,21610320,21614107,0,0,0,3787
18881,21594834,21594892,21615419,0,0,58,20585
18899,21611820,21611820,21616631,0,0,0,4811
18901,21614044,21614044,21617768,0,0,0,3724
18887,21597513,21597513,21618129,0,0,0,20616
18906,21619358,21619358,21619528,0,0,0,170
18878,21593448,21593570,21619543,0,0,122,26095
18907,21619468,21619468,21619638,0,0,0,170
18908,21619575,21619575,21619743,0,0,0,168
18873,21589991,21590032,21619989,0,0,41,29998
18910,21619891,21619891,21620060,0,0,0,169
18880,21594266,21594391,21620918,0,0,125,26652
18904,21617711,21617711,21621435,0,0,0,3724
18903,21616572,21616572,21621467,0,0,0,4895
18848,21574383,21574445,21621920,0,0,62,47537
18888,21598904,21598904,21622449,0,0,0,23545
18884,21595593,21596203,21622462,0,0,610,26869
18885,21596458,21596458,21622927,0,0,0,26469
18891,21602661,21602661,21623683,0,0,0,21022
18913,21621389,21621389,21625072,0,0,0,3683
18586,21403362,21416170,21625497,0,0,12808,222135
18893,21604614,21604614,21625614,0,0,0,21000
18914,21621398,21621398,21626260,0,0,0,4862
18928,21626996,21626996,21627047,0,0,0,51
18389,21336576,21367955,21627155,0,0,31379,290579
18922,21626923,21626923,21627302,0,0,0,379
18929,21627009,21627009,21627391,0,0,0,382
18931,21627053,21627053,21627400,0,0,0,347
18930,21627025,21627025,21627422,0,0,0,397
18933,21627092,21627092,21627454,0,0,0,362
18924,21626940,21626940,21627458,0,0,0,518
18932,21627084,21627084,21627462,0,0,0,378
18923,21626934,21626934,21627483,0,0,0,549
18925,21626955,21626955,21627483,0,0,0,528
18934,21627106,21627106,21627483,0,0,0,377
18927,21626976,21626976,21627514,0,0,0,538
18926,21626962,21626962,21627521,0,0,0,559
18919,21625014,21625014,21628728,0,0,0,3714
18843,21573499,21574182,21630135,0,0,683,56636
18938,21630142,21630142,21630460,0,0,0,318
18921,21626178,21626178,21630967,0,0,0,4789
18939,21630402,21630402,21631417,0,0,0,1015
18935,21628665,21628665,21632413,0,0,0,3748
18942,21632339,21632339,21633096,0,0,0,757
18945,21633685,21633685,21634101,0,0,0,416
18946,21634069,21634069,21634194,0,0,0,125
18947,21634076,21634076,21634216,0,0,0,140
18949,21634097,21634097,21634216,0,0,0,119
18948,21634082,21634082,21634222,0,0,0,140
18951,21634118,21634118,21634247,0,0,0,129
18950,21634104,21634104,21634254,0,0,0,150
18953,21634305,21634305,21634383,0,0,0,78
18955,21634326,21634326,21634383,0,0,0,57
18954,21634312,21634312,21634390,0,0,0,78
18952,21634297,21634297,21634391,0,0,0,94
18842,21573078,21573170,21634392,0,0,92,61314
18956,21634335,21634335,21634392,0,0,0,57
18957,21634347,21634347,21634414,0,0,0,67
18959,21634428,21634428,21634968,0,0,0,540
18958,21634421,21634421,21635003,0,0,0,582
18961,21634440,21634440,21635021,0,0,0,581
18963,21634455,21634455,21635036,0,0,0,581
18960,21634434,21634434,21635046,0,0,0,612
18962,21634449,21634449,21635061,0,0,0,612
18964,21634897,21634897,21635216,0,0,0,319
18940,21630906,21630906,21635627,0,0,0,4721
18902,21615317,21615317,21635768,0,0,0,20451
18895,21606522,21606522,21635875,0,0,0,29353
18970,21635876,21635876,21636005,0,0,0,129
18943,21632350,21632350,21636090,0,0,0,3740
18900,21612271,21612271,21636253,0,0,0,23982
18905,21618066,21618066,21638448,0,0,0,20382
18820,21564169,21564169,21639211,0,0,0,75042
18977,21639199,21639199,21639329,0,0,0,130
18975,21637454,21639211,21639711,0,0,1757,2257
18971,21636028,21636028,21639773,0,0,0,3745
18967,21635569,21635569,21640343,0,0,0,4774
18819,21564153,21564153,21641432,0,0,0,77279
18978,21639710,21639710,21643610,0,0,0,3900
18918,21623616,21623616,21644529,0,0,0,20913
18979,21640275,21640275,21645097,0,0,0,4822
18983,21645377,21645377,21645455,0,0,0,78
18909,21619681,21619681,21645599,0,0,0,25918
18985,21645501,21645501,21646229,0,0,0,728
18920,21625548,21625548,21646321,0,0,0,20773
18984,21645488,21645488,21646323,0,0,0,835
18987,21645604,21645604,21646337,0,0,0,733
18916,21622390,21622390,21646422,0,0,0,24032
18912,21620730,21620730,21646495,0,0,0,25765
18990,21646381,21646381,21646521,0,0,0,140
18980,21643550,21643550,21647344,0,0,0,3794
18208,21306754,21388167,21647367,0,0,81413,340613
18993,21647621,21647621,21647699,0,0,0,78
18994,21647713,21647713,21647892,0,0,0,179
18997,21647806,21647806,21647927,0,0,0,121
18998,21647824,21647824,21647929,0,0,0,105
18999,21647849,21647849,21648046,0,0,0,197
19000,21647862,21647862,21648089,0,0,0,227
18915,21621789,21621789,21648090,0,0,0,26301
19001,21648015,21648015,21648090,0,0,0,75
19003,21648042,21648042,21648121,0,0,0,79
19004,21648054,21648054,21648122,0,0,0,68
18995,21647741,21647741,21648125,0,0,0,384
19005,21648125,21648125,21648194,0,0,0,69
19006,21648129,21648129,21648237,0,0,0,108
19009,21648222,21648222,21648275,0,0,0,53
19007,21648166,21648166,21648277,0,0,0,111
19008,21648202,21648202,21648300,0,0,0,98
19010,21648240,21648240,21648307,0,0,0,67
19011,21648359,21648359,21648442,0,0,0,83
19012,21648394,21648394,21648476,0,0,0,82
19013,21648457,21648457,21648515,0,0,0,58
19014,21648478,21648478,21648545,0,0,0,67
19015,21648588,21648588,21648819,0,0,0,231
19025,21648775,21648775,21648879,0,0,0,104
18917,21622865,21622865,21649150,0,0,0,26285
19027,21648891,21648891,21649278,0,0,0,387
19016,21648639,21648639,21649356,0,0,0,717
19017,21648654,21648654,21649386,0,0,0,732
19018,21648670,21648670,21649388,0,0,0,718
19019,21648687,21648687,21649405,0,0,0,718
19020,21648703,21648703,21649425,0,0,0,722
18911,21619998,21619998,21649428,0,0,0,29430
19022,21648735,21648735,21649443,0,0,0,708
19021,21648717,21648717,21649452,0,0,0,735
19024,21648766,21648766,21649499,0,0,0,733
19026,21648787,21648787,21649500,0,0,0,713
18982,21645057,21645057,21649884,0,0,0,4827
19030,21649213,21649213,21649949,0,0,0,736
19031,21649219,21649356,21650111,0,0,137,892
19033,21649232,21649388,21650137,0,0,156,905
19023,21648751,21648751,21650173,0,0,0,1422
19038,21650128,21650128,21650252,0,0,0,124
18221,21307158,21391081,21650281,0,0,83923,343123
18944,21633149,21633149,21650376,0,0,0,17227
19029,21649203,21649203,21650652,0,0,0,1449
19039,21650602,21650602,21650731,0,0,0,129
19032,21649226,21649386,21650859,0,0,160,1633
19040,21650817,21650817,21650876,0,0,0,59
19041,21650840,21650840,21650970,0,0,0,130
18992,21647280,21647280,21651072,0,0,0,3792
19043,21651071,21651071,21651211,0,0,0,140
19044,21651678,21651678,21652050,0,0,0,372
19046,21653264,21653264,21653404,0,0,0,140
19045,21653115,21653115,21653437,0,0,0,322
19036,21649632,21649632,21654328,0,0,0,4696
19047,21654037,21654037,21654378,0,0,0,341
19037,21649825,21649825,21654669,0,0,0,4844
19042,21651029,21651029,21654877,0,0,0,3848
19051,21655579,21655579,21655692,0,0,0,113
19052,21655635,21655635,21655697,0,0,0,62
19053,21655660,21655660,21655728,0,0,0,68
19054,21655729,21655729,21655796,0,0,0,67
19034,21649324,21649405,21655855,0,0,81,6531
19055,21655804,21655804,21655882,0,0,0,78
19056,21655991,21655991,21656059,0,0,0,68
19057,21656066,21656066,21656133,0,0,0,67
19058,21656139,21656139,21656200,0,0,0,61
19059,21656173,21656173,21656252,0,0,0,79
19060,21656209,21656209,21656283,0,0,0,74
18968,21635709,21635709,21656327,0,0,0,20618
19062,21656232,21656232,21656365,0,0,0,133
19050,21655437,21655437,21656368,0,0,0,931
19061,21656230,21656230,21656938,0,0,0,708
19063,21656241,21656241,21656977,0,0,0,736
19066,21656306,21656306,21657021,0,0,0,715
19065,21656297,21656297,21657041,0,0,0,744
19069,21656694,21656694,21657053,0,0,0,359
19067,21656319,21656319,21657054,0,0,0,735
19068,21656325,21656325,21657058,0,0,0,733
19070,21657271,21657271,21657404,0,0,0,133
19072,21657377,21657377,21657444,0,0,0,67
19077,21657602,21657602,21658378,0,0,0,776
18965,21635051,21635051,21658407,0,0,0,23356
19049,21654817,21654817,21658668,0,0,0,3851
18976,21638378,21638378,21658918,0,0,0,20540
19071,21657320,21657320,21658981,0,0,0,1661
19048,21654600,21654600,21659345,0,0,0,4745
19080,21659022,21659022,21659374,0,0,0,352
18972,21636201,21636201,21660127,0,0,0,23926
18941,21631348,21631348,21660130,0,0,0,28782
19082,21660022,21660022,21660324,0,0,0,302
19084,21660437,21660437,21660685,0,0,0,248
18937,21630013,21630013,21660759,0,0,0,30746
18825,21564587,21564587,21660883,0,0,0,96296
19085,21660694,21660694,21661202,0,0,0,508
19087,21661534,21661534,21662092,0,0,0,558
19078,21658627,21658627,21662488,0,0,0,3861
19089,21662807,21662807,21663128,0,0,0,321
19081,21659285,21659285,21663960,0,0,0,4675
19090,21663791,21663791,21664253,0,0,0,462
18969,21635832,21635832,21664448,0,0,0,28616
19092,21664603,21664603,21664904,0,0,0,301
18981,21644471,21644471,21665479,0,0,0,21008
19095,21665709,21665709,21665969,0,0,0,260
19088,21662435,21662435,21666271,0,0,0,3836
19096,21665981,21665981,21666395,0,0,0,414
18988,21646254,21646254,21667205,0,0,0,20951
19093,21664830,21664830,21669520,0,0,0,4690
19098,21666448,21666448,21670048,0,0,0,3600
19097,21666229,21666229,21670168,0,0,0,3939
18989,21646375,21646375,21670507,0,0,0,24132
18986,21645536,21645536,21671556,0,0,0,26020
18861,21583655,21583655,21671836,0,0,0,88181
18865,21584326,21584326,21671836,0,0,0,87510
18867,21584868,21584868,21671836,0,0,0,86968
18866,21584636,21584636,21671856,0,0,0,87220
18850,21574931,21574931,21671865,0,0,0,96934
18868,21585100,21585100,21671866,0,0,0,86766
18863,21583974,21583974,21671897,0,0,0,87923
18874,21590406,21590406,21672115,0,0,0,81709
18882,21595171,21595538,21672166,0,0,367,76995
18991,21646429,21646429,21672555,0,0,0,26126
19105,21672558,21672558,21672729,0,0,0,171
19106,21672668,21672668,21672835,0,0,0,167
19114,21672767,21672767,21672937,0,0,0,170
19102,21670100,21670100,21673980,0,0,0,3880
19101,21669460,21669460,21674126,0,0,0,4666
19002,21648031,21648031,21674418,0,0,0,26387
19116,21673293,21673293,21674896,0,0,0,1603
19119,21673536,21673536,21675021,0,0,0,1485
19118,21673418,21673418,21675083,0,0,0,1665
19028,21649085,21649085,21675264,0,0,0,26179
19064,21656253,21656253,21676657,0,0,0,20404
19117,21673329,21673329,21677817,0,0,0,4488
19120,21673922,21673922,21677824,0,0,0,3902
19121,21674063,21674063,21678664,0,0,0,4601
19035,21649383,21649405,21679209,0,0,22,29826
19079,21658882,21658882,21679435,0,0,0,20553
18387,21335504,21335504,21681104,0,0,0,345600
19126,21677779,21677779,21681731,0,0,0,3952
19127,21678620,21678620,21683207,0,0,0,4587
19083,21660082,21660082,21684164,0,0,0,24082
19133,21683564,21683564,21684758,0,0,0,1194
19123,21675163,21675163,21684849,0,0,0,9686
19137,21685501,21685501,21685616,0,0,0,115
19130,21681665,21681665,21685619,0,0,0,3954
19094,21665418,21665418,21686188,0,0,0,20770
19135,21684765,21684765,21686342,0,0,0,1577
19139,21685596,21685596,21686746,0,0,0,1150
19073,21657512,21657512,21687328,0,0,0,29816
19076,21657570,21657570,21687344,0,0,0,29774
19131,21683146,21683146,21687757,0,0,0,4611
19100,21667209,21667209,21688165,0,0,0,20956
19075,21657527,21657527,21688800,0,0,0,31273
19138,21685577,21685577,21689532,0,0,0,3955
19074,21657520,21657520,21690066,0,0,0,32546
19142,21687690,21687690,21692285,0,0,0,4595
19144,21689477,21689477,21693383,0,0,0,3906
19091,21664383,21664383,21694319,0,0,0,29936
19103,21670492,21670492,21694530,0,0,0,24038
19145,21692221,21692221,21696790,0,0,0,4569
19125,21676619,21676619,21697229,0,0,0,20610
19146,21693320,21693320,21697260,0,0,0,3940
19104,21671556,21671556,21697364,0,0,0,25808
19115,21672880,21672880,21698720,0,0,0,25840
19129,21679375,21679375,21699722,0,0,0,20347
19122,21674432,21674432,21700840,0,0,0,26408
19151,21697198,21697198,21701167,0,0,0,3969
19149,21696750,21696750,21701341,0,0,0,4591
19124,21675284,21675284,21701373,0,0,0,26089
18834,21567557,21572295,21703316,0,0,4738,135759
19156,21701104,21701104,21705050,0,0,0,3946
18590,21404167,21404205,21705243,0,0,38,301076
19157,21701303,21701303,21705883,0,0,0,4580
18851,21574932,21574932,21706754,0,0,0,131822
19140,21686125,21686125,21707072,0,0,0,20947
19134,21684219,21684219,21708148,0,0,0,23929
19128,21679161,21679161,21708646,0,0,0,29485
19143,21688102,21688102,21708822,0,0,0,20720
19159,21704978,21704978,21708894,0,0,0,3916
19168,21709896,21709896,21709963,0,0,0,67
19160,21705820,21705820,21710378,0,0,0,4558
19170,21710726,21710726,21711142,0,0,0,416
19165,21708842,21708842,21712717,0,0,0,3875
19173,21713134,21713134,21713352,0,0,0,218
19169,21710333,21710333,21714902,0,0,0,4569
19176,21714710,21714710,21715460,0,0,0,750
19182,21715314,21715314,21715460,0,0,0,146
19177,21714725,21714725,21715464,0,0,0,739
19178,21714745,21714745,21715493,0,0,0,748
19183,21715366,21715366,21715495,0,0,0,129
19179,21714756,21714756,21715562,0,0,0,806
19180,21714768,21714768,21715574,0,0,0,806
19185,21715531,21715531,21715621,0,0,0,90
19184,21715498,21715498,21715644,0,0,0,146
19186,21715585,21715585,21715653,0,0,0,68
19187,21715684,21715684,21715751,0,0,0,67
19192,21715847,21715847,21715940,0,0,0,93
19172,21712653,21712653,21716540,0,0,0,3887
19199,21716665,21716665,21717259,0,0,0,594
19198,21716659,21716659,21717456,0,0,0,797
19193,21715854,21715854,21717490,0,0,0,1636
19150,21697142,21697142,21717522,0,0,0,20380
19148,21694467,21694467,21718398,0,0,0,23931
19181,21714861,21714861,21719360,0,0,0,4499
19194,21715995,21715995,21719560,0,0,0,3565
19166,21709036,21709036,21719836,0,0,0,10800
19205,21719876,21719876,21719978,0,0,0,102
19190,21715833,21715833,21719980,0,0,0,4147
19191,21715841,21715841,21719988,0,0,0,4147
19207,21719945,21719945,21720013,0,0,0,68
19208,21720035,21720035,21720101,0,0,0,66
19210,21720060,21720060,21720143,0,0,0,83
19211,21720109,21720109,21720187,0,0,0,78
19154,21699651,21699651,21720211,0,0,0,20560
19197,21716480,21716480,21720356,0,0,0,3876
19214,21720816,21720816,21720894,0,0,0,78
19189,21715827,21715827,21721325,0,0,0,5498
19216,21721473,21721473,21721554,0,0,0,81
19215,21721138,21721138,21721667,0,0,0,529
19217,21721492,21721492,21721859,0,0,0,367
19230,21722746,21722746,21722783,0,0,0,37
18973,21636515,21636515,21722915,0,0,0,86400
19232,21723012,21723012,21723059,0,0,0,47
18974,21636741,21636741,21723141,0,0,0,86400
19233,21723408,21723408,21723492,0,0,0,84
19152,21697295,21697295,21723515,0,0,0,26220
19235,21723554,21723554,21723680,0,0,0,126
19234,21723460,21723460,21723684,0,0,0,224
19147,21694257,21694257,21723686,0,0,0,29429
19236,21723637,21723637,21723809,0,0,0,172
19204,21719320,21719320,21723879,0,0,0,4559
19188,21715800,21715800,21724072,0,0,0,8272
19213,21720290,21720290,21724145,0,0,0,3855
19153,21698656,21698656,21724764,0,0,0,26108
19221,21722343,21722343,21725607,0,0,0,3264
19202,21718409,21718409,21725663,0,0,0,7254
19238,21723710,21723710,21726468,0,0,0,2758
19209,21720053,21720053,21726799,0,0,0,6746
19155,21700781,21700781,21727067,0,0,0,26286
19243,21726321,21726321,21727137,0,0,0,816
19228,21722711,21722711,21727556,0,0,0,4845
19229,21722720,21722720,21727565,0,0,0,4845
19158,21701308,21701308,21727571,0,0,0,26263
19227,21722704,21722704,21727580,0,0,0,4876
19240,21724078,21724078,21727828,0,0,0,3750
19161,21707026,21707026,21727970,0,0,0,20944
19239,21723827,21723827,21728418,0,0,0,4591
19244,21726588,21726588,21728756,0,0,0,2168
19164,21708766,21708766,21729682,0,0,0,20916
19220,21721991,21721991,21730761,0,0,0,8770
19167,21709271,21709271,21730871,0,0,0,21600
18806,21558430,21558430,21731230,0,0,0,172800
19252,21731182,21731182,21731306,0,0,0,124
19203,21719092,21719092,21731424,0,0,0,12332
19247,21727792,21727792,21731624,0,0,0,3832
19226,21722630,21722630,21731656,0,0,0,9026
19219,21721972,21721972,21731885,0,0,0,9913
19162,21708106,21708106,21731964,0,0,0,23858
19218,21721941,21721941,21732247,0,0,0,10306
19223,21722365,21722365,21732359,0,0,0,9994
19224,21722378,21722378,21732394,0,0,0,10016
19249,21728356,21728356,21732891,0,0,0,4535
19258,21733380,21733380,21734514,0,0,0,1134
19222,21722347,21722347,21734527,0,0,0,12180
19253,21731625,21731625,21735399,0,0,0,3774
19260,21735795,21735795,21736395,0,0,0,600
19261,21735795,21735795,21736395,0,0,0,600
19262,21735796,21735796,21736396,0,0,0,600
19263,21735796,21735796,21736396,0,0,0,600
19264,21735796,21735796,21736396,0,0,0,600
19265,21735797,21735797,21736397,0,0,0,600
19266,21735799,21735799,21736399,0,0,0,600
19267,21735799,21735799,21736399,0,0,0,600
19268,21735799,21735799,21736399,0,0,0,600
19269,21735800,21735800,21736400,0,0,0,600
19270,21735800,21735800,21736400,0,0,0,600
19271,21735800,21735800,21736400,0,0,0,600
19272,21735800,21735800,21736400,0,0,0,600
19273,21735800,21735800,21736400,0,0,0,600
19274,21735801,21735801,21736401,0,0,0,600
19275,21735801,21735801,21736401,0,0,0,600
19276,21735801,21735801,21736401,0,0,0,600
19277,21735801,21735801,21736401,0,0,0,600
19278,21735801,21735801,21736401,0,0,0,600
19279,21735802,21735802,21736402,0,0,0,600
19280,21735802,21735802,21736402,0,0,0,600
19281,21735802,21735802,21736402,0,0,0,600
19282,21735802,21735802,21736402,0,0,0,600
19283,21735803,21735803,21736403,0,0,0,600
19196,21716154,21716154,21736709,0,0,0,20555
19286,21736974,21736974,21737093,0,0,0,119
19195,21716044,21716044,21737143,0,0,0,21099
19257,21732891,21732891,21737427,0,0,0,4536
18996,21647802,21647802,21737961,0,0,0,90159
19200,21717462,21717462,21738030,0,0,0,20568
19206,21719890,21719890,21738658,0,0,0,18768
19163,21708593,21708593,21738686,0,0,0,30093
19259,21735338,21735338,21739119,0,0,0,3781
19284,21735988,21735988,21740677,0,0,0,4689
19212,21720156,21720156,21740732,0,0,0,20576
19291,21740271,21740271,21741432,0,0,0,1161
19256,21732154,21732154,21742126,0,0,0,9972
19287,21737427,21737427,21742202,0,0,0,4775
19201,21718351,21718351,21742266,0,0,0,23915
19086,21660742,21660742,21742724,0,0,0,81982
19290,21739108,21739108,21742840,0,0,0,3732
19297,21742763,21742763,21743363,0,0,0,600
19298,21742769,21742769,21743369,0,0,0,600
19299,21742769,21742769,21743369,0,0,0,600
19300,21742769,21742769,21743369,0,0,0,600
19301,21742770,21742770,21743370,0,0,0,600
19302,21742770,21742770,21743370,0,0,0,600
19303,21742770,21742770,21743370,0,0,0,600
19304,21742770,21742770,21743370,0,0,0,600
19305,21742771,21742771,21743371,0,0,0,600
19306,21742771,21742771,21743371,0,0,0,600
19307,21742771,21742771,21743371,0,0,0,600
19308,21742771,21742771,21743371,0,0,0,600
19309,21742772,21742772,21743372,0,0,0,600
19310,21742772,21742772,21743372,0,0,0,600
19311,21742772,21742772,21743372,0,0,0,600
19312,21742772,21742772,21743372,0,0,0,600
19313,21742773,21742773,21743373,0,0,0,600
19314,21742773,21742773,21743373,0,0,0,600
19315,21742773,21742773,21743373,0,0,0,600
19316,21742774,21742774,21743374,0,0,0,600
19317,21742774,21742774,21743374,0,0,0,600
19318,21742774,21742774,21743374,0,0,0,600
19319,21742774,21742774,21743374,0,0,0,600
19320,21742774,21742774,21743374,0,0,0,600
19321,21742775,21742775,21743375,0,0,0,600
19322,21742775,21742775,21743375,0,0,0,600
19323,21742775,21742775,21743375,0,0,0,600
19324,21742775,21742775,21743375,0,0,0,600
19325,21742775,21742775,21743375,0,0,0,600
19326,21742776,21742776,21743376,0,0,0,600
19327,21742776,21742776,21743376,0,0,0,600
19328,21742776,21742776,21743376,0,0,0,600
19330,21743643,21743643,21743768,0,0,0,125
19331,21743794,21743794,21743919,0,0,0,125
19332,21743803,21743803,21744217,0,0,0,414
19333,21743962,21743962,21744228,0,0,0,266
19295,21742567,21742567,21744643,0,0,0,2076
19334,21745517,21745517,21745584,0,0,0,67
19336,21745611,21745611,21745714,0,0,0,103
19338,21745677,21745677,21745776,0,0,0,99
19337,21745659,21745659,21745777,0,0,0,118
19339,21745720,21745720,21745803,0,0,0,83
19340,21745741,21745741,21745808,0,0,0,67
19341,21745819,21745819,21745918,0,0,0,99
19342,21745851,21745851,21745936,0,0,0,85
19343,21745897,21745897,21745976,0,0,0,79
19344,21745918,21745918,21745976,0,0,0,58
19345,21745940,21745940,21746007,0,0,0,67
19356,21746175,21746175,21746330,0,0,0,155
19329,21742871,21742871,21746553,0,0,0,3682
19285,21736031,21736031,21746864,0,0,0,10833
19296,21742751,21742751,21747367,0,0,0,4616
19364,21747551,21747551,21747644,0,0,0,93
19365,21747764,21747764,21747857,0,0,0,93
19352,21746147,21746147,21748474,0,0,0,2327
19248,21727911,21727911,21748602,0,0,0,20691
18580,21403157,21403157,21748757,0,0,0,345600
19237,21723659,21723659,21749413,0,0,0,25754
19370,21750012,21750012,21750207,0,0,0,195
19360,21746488,21746488,21750210,0,0,0,3722
19372,21750182,21750182,21750379,0,0,0,197
19374,21750375,21750375,21750543,0,0,0,168
19242,21724697,21724697,21750549,0,0,0,25852
19293,21741797,21741797,21750557,0,0,0,8760
19251,21729636,21729636,21750576,0,0,0,20940
19375,21750572,21750572,21750751,0,0,0,179
19377,21750776,21750776,21750900,0,0,0,124
19376,21750740,21750740,21750908,0,0,0,168
19367,21749057,21749057,21751812,0,0,0,2755
19383,21753069,21753069,21753277,0,0,0,208
19380,21752014,21752014,21753311,0,0,0,1297
19384,21753219,21753219,21753386,0,0,0,167
19385,21753324,21753324,21753500,0,0,0,176
19245,21726980,21726980,21753511,0,0,0,26531
19371,21750126,21750126,21753878,0,0,0,3752
19171,21710735,21710735,21753935,0,0,0,43200
19241,21724257,21724257,21753994,0,0,0,29737
19246,21727515,21727515,21754013,0,0,0,26498
19361,21747305,21747305,21754505,0,0,0,7200
19368,21749710,21749710,21755659,0,0,0,5949
19255,21731907,21731907,21755693,0,0,0,23786
19335,21745585,21745585,21755991,0,0,0,10406
19388,21753815,21753815,21757553,0,0,0,3738
19392,21755076,21755659,21757735,0,0,583,2659
19288,21738034,21738034,21758587,0,0,0,20553
18936,21629873,21629873,21759875,0,0,0,130002
19394,21755171,21759875,21760198,0,0,4704,5027
19395,21755176,21760198,21760417,0,0,5022,5241
19292,21740734,21740734,21761204,0,0,0,20470
19398,21757512,21757512,21761225,0,0,0,3713
19351,21746139,21746139,21761365,0,0,0,15226
19346,21746099,21746099,21761730,0,0,0,15631
19348,21746117,21746117,21761809,0,0,0,15692
19357,21746183,21746183,21761827,0,0,0,15644
19349,21746125,21746125,21761888,0,0,0,15763
19347,21746110,21746110,21762030,0,0,0,15920
19350,21746132,21746132,21762050,0,0,0,15918
19355,21746169,21746169,21762124,0,0,0,15955
19353,21746155,21746155,21762172,0,0,0,16017
19359,21746375,21746375,21762237,0,0,0,15862
19358,21746345,21746345,21762238,0,0,0,15893
19354,21746162,21746162,21762427,0,0,0,16265
19400,21759421,21761809,21763029,0,0,2388,3608
19412,21763087,21763087,21763191,0,0,0,104
19410,21762845,21762845,21764165,0,0,0,1320
19407,21761171,21761171,21764918,0,0,0,3747
19415,21763328,21763328,21765282,0,0,0,1954
19294,21742248,21742248,21766074,0,0,0,23826
19289,21738639,21738639,21768433,0,0,0,29794
19418,21764857,21764857,21768589,0,0,0,3732
19419,21765654,21765654,21769332,0,0,0,3678
19423,21770440,21770440,21770612,0,0,0,172
19424,21770549,21770549,21770717,0,0,0,168
19373,21750330,21750330,21771273,0,0,0,20943
19421,21768526,21768526,21772300,0,0,0,3774
19382,21752380,21752380,21773277,0,0,0,20897
19427,21772257,21772257,21776182,0,0,0,3925
19378,21750919,21750919,21777309,0,0,0,26390
19430,21777302,21777302,21777459,0,0,0,157
19431,21777412,21777412,21777569,0,0,0,157
19432,21777523,21777523,21777700,0,0,0,177
19399,21759191,21759191,21779520,0,0,0,20329
19429,21776119,21776119,21779907,0,0,0,3788
19386,21753432,21753432,21780022,0,0,0,26590
19436,21779959,21779959,21780132,0,0,0,173
19437,21780069,21780069,21780238,0,0,0,169
19438,21780176,21780176,21780343,0,0,0,167
19439,21780282,21780282,21780457,0,0,0,175
19440,21780394,21780394,21780563,0,0,0,169
19389,21754043,21754043,21780702,0,0,0,26659
19390,21754388,21754388,21781335,0,0,0,26947
19408,21761219,21761219,21781647,0,0,0,20428
19435,21779863,21779863,21783630,0,0,0,3767
19391,21754437,21754437,21783920,0,0,0,29483
19446,21783942,21783942,21784119,0,0,0,177
19445,21783571,21783571,21787355,0,0,0,3784
18966,21635517,21635517,21789431,0,0,0,153914
19401,21759483,21762237,21790146,0,0,2754,30663
19420,21766077,21766077,21790273,0,0,0,24196
19448,21787313,21787313,21791126,0,0,0,3813
19426,21771244,21771244,21792191,0,0,0,20947
19402,21759494,21763029,21792791,0,0,3535,33297
19404,21759811,21790146,21793505,0,0,30335,33694
19428,21773215,21773215,21794052,0,0,0,20837
19175,21713227,21713227,21794159,0,0,0,80932
19174,21713196,21713196,21794196,0,0,0,81000
19450,21791072,21791072,21794851,0,0,0,3779
19405,21759832,21792791,21796167,0,0,32959,36335
19409,21761783,21796167,21798288,0,0,34384,36505
19453,21794788,21794788,21798681,0,0,0,3893
19396,21755894,21755894,21799094,0,0,0,43200
19425,21770654,21770654,21799407,0,0,0,28753
19393,21755118,21757735,21799503,0,0,2617,44385
19455,21799345,21799345,21799532,0,0,0,187
19457,21799490,21799490,21799836,0,0,0,346
19434,21779458,21779458,21800006,0,0,0,20548
19458,21799953,21799953,21800011,0,0,0,58
19231,21722936,21722936,21800581,0,0,0,77645
19464,21800853,21800853,21800921,0,0,0,68
19465,21801182,21801182,21801260,0,0,0,78
19469,21801359,21801359,21801441,0,0,0,82
19470,21801410,21801410,21801503,0,0,0,93
19471,21801553,21801553,21801642,0,0,0,89
19472,21801590,21801590,21801674,0,0,0,84
19444,21781576,21781576,21802195,0,0,0,20619
19454,21798640,21798640,21802563,0,0,0,3923
19476,21802500,21802500,21802604,0,0,0,104
19479,21802627,21802627,21802700,0,0,0,73
19480,21802785,21802785,21802879,0,0,0,94
19481,21802977,21802977,21803064,0,0,0,87
19433,21777635,21777635,21803745,0,0,0,26110
19483,21803090,21803090,21804115,0,0,0,1025
19486,21804116,21804116,21804215,0,0,0,99
19487,21804236,21804236,21804296,0,0,0,60
19488,21804264,21804264,21804358,0,0,0,94
19489,21804360,21804360,21804520,0,0,0,160
19490,21804367,21804367,21804802,0,0,0,435
19492,21804708,21804708,21804803,0,0,0,95
19494,21804770,21804803,21804896,0,0,33,126
19495,21804895,21804896,21805011,0,0,1,116
19496,21804977,21805011,21805135,0,0,34,158
19397,21757142,21760417,21805372,0,0,3275,48230
19477,21802528,21802528,21806440,0,0,0,3912
19441,21780500,21780500,21806610,0,0,0,26110
19501,21807067,21807067,21807145,0,0,0,78
19442,21780705,21780705,21807292,0,0,0,26587
19504,21807325,21807325,21807392,0,0,0,67
19443,21781349,21781349,21808059,0,0,0,26710
19493,21804708,21805372,21808744,0,0,664,4036
19508,21808730,21808744,21808804,0,0,14,74
19369,21749734,21749734,21809042,0,0,0,59308
19509,21809236,21809236,21809296,0,0,0,60
19510,21809465,21809465,21809525,0,0,0,60
19511,21809611,21809611,21809671,0,0,0,60
19499,21806381,21806381,21810330,0,0,0,3949
19514,21810362,21810362,21810422,0,0,0,60
19482,21803002,21803002,21812038,0,0,0,9036
19451,21792139,21792139,21812979,0,0,0,20840
19478,21802605,21802605,21813380,0,0,0,10775
19497,21805193,21805193,21813803,0,0,0,8610
19513,21810265,21810265,21814193,0,0,0,3928
19447,21784052,21784052,21814221,0,0,0,30169
19449,21790201,21790201,21814601,0,0,0,24400
19507,21808477,21813803,21814849,0,0,5326,6372
19452,21794005,21794005,21814946,0,0,0,20941
19516,21813848,21814849,21815190,0,0,1001,1342
19524,21815156,21815156,21815223,0,0,0,67
19460,21799980,21799980,21815733,0,0,0,15753
19525,21815294,21815294,21815795,0,0,0,501
19463,21800084,21800084,21815827,0,0,0,15743
19461,21800009,21800009,21815959,0,0,0,15950
19462,21800041,21800041,21816101,0,0,0,16060
19526,21815832,21815832,21816362,0,0,0,530
19468,21801325,21801325,21816919,0,0,0,15594
19528,21816898,21816898,21816972,0,0,0,74
19467,21801317,21801317,21817090,0,0,0,15773
19498,21805471,21808744,21817246,0,0,3273,11775
19473,21801611,21801611,21817249,0,0,0,15638
19475,21802170,21802170,21817893,0,0,0,15723
19517,21814128,21814128,21818059,0,0,0,3931
19535,21818519,21818519,21818579,0,0,0,60
19530,21816990,21816990,21818907,0,0,0,1917
19536,21818829,21818829,21818995,0,0,0,166
19537,21819042,21819042,21819166,0,0,0,124
19539,21819170,21819170,21819274,0,0,0,104
19538,21819167,21819167,21819313,0,0,0,146
19541,21819281,21819281,21819416,0,0,0,135
19542,21819337,21819337,21819417,0,0,0,80
19543,21819380,21819380,21819458,0,0,0,78
19544,21819444,21819444,21819599,0,0,0,155
19545,21819602,21819602,21819662,0,0,0,60
19546,21819608,21819608,21819955,0,0,0,347
19547,21819929,21819929,21820054,0,0,0,125
19548,21820153,21820153,21820268,0,0,0,115
19549,21820165,21820165,21820290,0,0,0,125
19550,21820240,21820240,21820300,0,0,0,60
19459,21799959,21799959,21820487,0,0,0,20528
19553,21820460,21820460,21820553,0,0,0,93
19554,21820737,21820737,21820830,0,0,0,93
19555,21820913,21820913,21821069,0,0,0,156
19529,21816924,21816924,21821717,0,0,0,4793
19557,21821349,21821349,21821721,0,0,0,372
19532,21817990,21817990,21821929,0,0,0,3939
19533,21818069,21821717,21822262,0,0,3648,4193
19531,21817769,21817769,21822520,0,0,0,4751
19474,21802120,21802120,21822586,0,0,0,20466
19561,21822169,21822520,21822646,0,0,351,477
19560,21822062,21822520,21822691,0,0,458,629
19534,21818079,21822262,21822761,0,0,4183,4682
19564,21822802,21822802,21822849,0,0,0,47
19559,21821952,21821952,21822999,0,0,0,1047
19502,21807111,21807111,21823107,0,0,0,15996
19568,21823017,21823017,21823328,0,0,0,311
19569,21823371,21823371,21823467,0,0,0,96
19573,21823482,21823482,21823584,0,0,0,102
19574,21823546,21823546,21823619,0,0,0,73
19576,21823652,21823652,21823767,0,0,0,115
19577,21823759,21823759,21823894,0,0,0,135
19556,21821092,21822520,21824395,0,0,1428,3303
19583,21825591,21825591,21825776,0,0,0,185
19558,21821882,21821882,21825837,0,0,0,3955
19570,21823406,21823406,21826059,0,0,0,2653
19584,21825759,21825776,21826108,0,0,17,349
19586,21826103,21826108,21826248,0,0,5,145
19587,21826271,21826271,21826338,0,0,0,67
19588,21826365,21826365,21826459,0,0,0,94
19589,21826480,21826480,21826604,0,0,0,124
19581,21824408,21824408,21826666,0,0,0,2258
18833,21567551,21567551,21826751,0,0,0,259200
19590,21826714,21826714,21826807,0,0,0,93
19591,21826821,21826821,21826925,0,0,0,104
19592,21826892,21826892,21827001,0,0,0,109
19593,21826973,21826973,21827385,0,0,0,412
19596,21827331,21827331,21827424,0,0,0,93
19595,21827120,21827120,21827480,0,0,0,360
19540,21819246,21819274,21827656,0,0,28,8410
19580,21824190,21824190,21827790,0,0,0,3600
19456,21799453,21799453,21828131,0,0,0,28678
19600,21828552,21828552,21828807,0,0,0,255
19578,21824027,21824027,21829434,0,0,0,5407
19604,21829108,21829108,21829570,0,0,0,462
19582,21825236,21826059,21829659,0,0,823,4423
19585,21825776,21825837,21829787,0,0,61,4011
19485,21803691,21803691,21830066,0,0,0,26375
19606,21829887,21829887,21830501,0,0,0,614
19579,21824111,21824111,21830506,0,0,0,6395
19518,21814135,21815190,21830947,0,0,1055,16812
19611,21831763,21831763,21832400,0,0,0,637
19491,21804553,21804553,21832551,0,0,0,27998
19610,21831269,21831269,21832865,0,0,0,1596
19500,21806537,21806537,21832989,0,0,0,26452
19614,21833479,21833479,21833568,0,0,0,89
19605,21829660,21829660,21833573,0,0,0,3913
19515,21812934,21812934,21833796,0,0,0,20862
19503,21807229,21807292,21833910,0,0,63,26681
19618,21833801,21833801,21833930,0,0,0,129
19619,21833944,21833944,21834011,0,0,0,67
19594,21827048,21827048,21834338,0,0,0,7290
19505,21807983,21808059,21834784,0,0,76,26801
19622,21834990,21834990,21835130,0,0,0,140
19551,21820293,21820293,21835575,0,0,0,15282
19521,21814870,21814870,21835726,0,0,0,20856
19598,21828091,21828091,21836527,0,0,0,8436
19599,21828247,21828247,21836802,0,0,0,8555
19466,21801309,21801309,21836868,0,0,0,35559
19563,21822536,21822536,21836869,0,0,0,14333
19506,21808435,21809042,21836990,0,0,607,28555
19623,21835385,21835385,21836992,0,0,0,1607
19615,21833529,21833529,21837471,0,0,0,3942
19520,21814567,21814567,21838527,0,0,0,23960
19552,21820455,21820455,21840945,0,0,0,20490
18835,21567563,21581829,21841029,0,0,14266,273466
19625,21837411,21837411,21841328,0,0,0,3917
19562,21822534,21822534,21842677,0,0,0,20143
19519,21814165,21814165,21843886,0,0,0,29721
19630,21843823,21843823,21843997,0,0,0,174
19631,21843935,21843935,21844113,0,0,0,178
19632,21844042,21844042,21844211,0,0,0,169
19633,21844157,21844157,21844336,0,0,0,179
19575,21823609,21841029,21844705,0,0,17420,21096
19628,21841257,21841257,21845175,0,0,0,3918
19636,21845470,21845470,21847103,0,0,0,1633
19403,21759596,21789431,21848221,0,0,29835,88625
19572,21823427,21836990,21848856,0,0,13563,25429
19635,21845141,21845141,21849050,0,0,0,3909
19512,21810072,21810072,21851741,0,0,0,41669
19608,21831170,21831170,21852770,0,0,0,21600
19637,21848979,21848979,21852827,0,0,0,3848
19639,21854097,21854097,21854697,0,0,0,600
19616,21833710,21833796,21854720,0,0,86,21010
19641,21854148,21854148,21854748,0,0,0,600
19643,21854212,21854212,21854812,0,0,0,600
19644,21854560,21854560,21855316,0,0,0,756
19624,21835746,21835746,21856362,0,0,0,20616
19645,21854575,21855316,21856403,0,0,741,1828
19607,21830004,21830066,21856515,0,0,62,26511
19648,21856389,21856389,21856594,0,0,0,205
19638,21852794,21852794,21856686,0,0,0,3892
19597,21828068,21828068,21857042,0,0,0,28974
19609,21831217,21836802,21858402,0,0,5585,27185
19613,21832958,21832989,21859346,0,0,31,26388
19655,21858709,21858709,21860292,0,0,0,1583
19651,21856643,21856643,21860462,0,0,0,3819
19617,21833764,21833910,21860927,0,0,146,27163
19484,21803436,21803436,21861032,0,0,0,57596
19621,21834638,21834638,21861064,0,0,0,26426
19627,21840882,21840882,21861333,0,0,0,20451
19571,21823411,21832551,21862032,0,0,9140,38621
19626,21838508,21838508,21862306,0,0,0,23798
19629,21842638,21842638,21862966,0,0,0,20328
19657,21860401,21860401,21864218,0,0,0,3817
19660,21861650,21861650,21866593,0,0,0,4943
19664,21864172,21864172,21868009,0,0,0,3837
19665,21867973,21867973,21871790,0,0,0,3817
19634,21844273,21844273,21872939,0,0,0,28666
19667,21872896,21872896,21873073,0,0,0,177
19666,21871757,21871757,21875494,0,0,0,3737
19646,21854629,21854629,21875526,0,0,0,20897
19406,21759844,21793505,21876737,0,0,33661,116893
19642,21854154,21854154,21877803,0,0,0,23649
19654,21857223,21857223,21878021,0,0,0,20798
19653,21857049,21876737,21878627,0,0,19688,21578
19669,21875450,21875450,21879273,0,0,0,3823
19659,21861270,21861270,21881826,0,0,0,20556
19650,21856540,21856540,21882841,0,0,0,26301
19674,21882799,21882799,21882950,0,0,0,151
19672,21879214,21879214,21882992,0,0,0,3778
19663,21862906,21862906,21883542,0,0,0,20636
19652,21856990,21856990,21885549,0,0,0,28559
19656,21859292,21859292,21885656,0,0,0,26364
19679,21885597,21885597,21885767,0,0,0,170
19680,21885705,21885705,21885873,0,0,0,168
19662,21862237,21862237,21886186,0,0,0,23949
19676,21882924,21882924,21886636,0,0,0,3712
19612,21832358,21832400,21887019,0,0,42,54661
19620,21834050,21834338,21887106,0,0,288,53056
19658,21860717,21860717,21887207,0,0,0,26490
19565,21822849,21822849,21887451,0,0,0,64602
19685,21887593,21887593,21887661,0,0,0,68
19686,21887773,21887773,21887903,0,0,0,130
19687,21888560,21888560,21888689,0,0,0,129
19661,21862165,21862165,21889018,0,0,0,26853
19689,21888946,21888946,21889066,0,0,0,120
19691,21889084,21889084,21889214,0,0,0,130
19688,21888858,21888858,21889458,0,0,0,600
19692,21890032,21890032,21890343,0,0,0,311
19683,21886579,21886579,21890376,0,0,0,3797
19695,21890458,21890458,21890525,0,0,0,67
19601,21828724,21828724,21891110,0,0,0,62386
19566,21822883,21822883,21891223,0,0,0,68340
19698,21892320,21892320,21892398,0,0,0,78
19700,21892733,21892733,21892848,0,0,0,115
19647,21856370,21856403,21893057,0,0,33,36687
19697,21892222,21892222,21893097,0,0,0,875
19704,21892995,21892995,21893104,0,0,0,109
19699,21892667,21892667,21893267,0,0,0,600
19705,21893072,21893072,21893368,0,0,0,296
19702,21892935,21892935,21893535,0,0,0,600
19708,21893689,21893689,21893749,0,0,0,60
19706,21893263,21893263,21893863,0,0,0,600
19709,21893721,21893721,21893867,0,0,0,146
19707,21893447,21893447,21894047,0,0,0,600
19693,21890314,21890314,21894059,0,0,0,3745
19712,21894097,21894097,21894188,0,0,0,91
19713,21894275,21894275,21894342,0,0,0,67
19715,21894834,21894834,21895140,0,0,0,306
19717,21895098,21895098,21895238,0,0,0,140
19718,21895102,21895102,21895282,0,0,0,180
19719,21895257,21895257,21895373,0,0,0,116
19720,21895342,21895342,21895436,0,0,0,94
19721,21895435,21895435,21895557,0,0,0,122
19722,21895526,21895526,21895620,0,0,0,94
19710,21893867,21893867,21895667,0,0,0,1800
19723,21895669,21895669,21895949,0,0,0,280
19670,21875455,21875455,21895998,0,0,0,20543
19726,21895966,21895966,21896033,0,0,0,67
19714,21894393,21894393,21896193,0,0,0,1800
19727,21896172,21896172,21896266,0,0,0,94
19728,21896272,21896272,21896339,0,0,0,67
19724,21895737,21895737,21896471,0,0,0,734
19729,21896401,21896401,21896536,0,0,0,135
19716,21895075,21895075,21896875,0,0,0,1800
19730,21896786,21896786,21896891,0,0,0,105
19711,21893998,21893998,21897709,0,0,0,3711
19733,21898477,21898477,21898607,0,0,0,130
19671,21877955,21877955,21898902,0,0,0,20947
19737,21899162,21899162,21899447,0,0,0,285
19736,21898910,21898910,21899851,0,0,0,941
19649,21856422,21862032,21899958,0,0,5610,43536
19734,21898622,21898622,21900422,0,0,0,1800
19738,21900784,21900784,21900852,0,0,0,68
19739,21901012,21901012,21901110,0,0,0,98
19740,21901196,21901196,21901294,0,0,0,98
19731,21897638,21897638,21901363,0,0,0,3725
19668,21873006,21873006,21901396,0,0,0,28390
19741,21901340,21901340,21901512,0,0,0,172
19742,21901450,21901450,21901622,0,0,0,172
19743,21901560,21901560,21901729,0,0,0,169
19746,21901822,21901822,21901900,0,0,0,78
19673,21881764,21881764,21902304,0,0,0,20540
19747,21902229,21902229,21902398,0,0,0,169
19749,21902247,21902247,21902425,0,0,0,178
19750,21902261,21902261,21902427,0,0,0,166
19752,21902477,21902477,21902545,0,0,0,68
19753,21902657,21902657,21902725,0,0,0,68
19754,21903092,21903092,21903170,0,0,0,78
19694,21890374,21890374,21903327,0,0,0,12953
19703,21892942,21892942,21903742,0,0,0,10800
19757,21903789,21903789,21903871,0,0,0,82
19677,21883480,21883480,21904176,0,0,0,20696
19756,21903562,21903562,21904338,0,0,0,776
19759,21904401,21904401,21904468,0,0,0,67
19760,21904652,21904652,21904730,0,0,0,78
19761,21904662,21904662,21904767,0,0,0,105
19762,21904746,21904746,21904820,0,0,0,74
19763,21904779,21904779,21904858,0,0,0,79
19764,21904836,21904836,21904948,0,0,0,112
19765,21904916,21904916,21905010,0,0,0,94
19567,21822892,21826751,21905060,0,0,3859,82168
19766,21905100,21905100,21905189,0,0,0,89
19767,21905151,21905151,21905244,0,0,0,93
19768,21905200,21905200,21905282,0,0,0,82
19769,21905209,21905209,21905306,0,0,0,97
19770,21905253,21905253,21905315,0,0,0,62
19751,21902261,21902261,21905613,0,0,0,3352
19772,21905618,21905618,21905685,0,0,0,67
19773,21905838,21905838,21905906,0,0,0,68
19776,21906863,21906863,21906930,0,0,0,67
19701,21892749,21892749,21907149,0,0,0,14400
19603,21828752,21829659,21907416,0,0,907,78664
19778,21907359,21907359,21907426,0,0,0,67
19779,21907504,21907504,21907571,0,0,0,67
19774,21906063,21906063,21907656,0,0,0,1593
19777,21906998,21906998,21907969,0,0,0,971
19781,21908218,21908218,21908285,0,0,0,67
19780,21908197,21908197,21908350,0,0,0,153
19782,21908344,21908344,21908396,0,0,0,52
19783,21908354,21908354,21908421,0,0,0,67
19784,21908645,21908645,21908769,0,0,0,124
19799,21908779,21908779,21908873,0,0,0,94
19675,21882918,21882918,21909036,0,0,0,26118
19812,21908974,21908974,21909154,0,0,0,180
19846,21909358,21909358,21909490,0,0,0,132
19847,21909371,21909371,21909518,0,0,0,147
19848,21909435,21909435,21909569,0,0,0,134
19850,21909535,21909535,21909607,0,0,0,72
19696,21891973,21891973,21909611,0,0,0,17638
19851,21909544,21909544,21909616,0,0,0,72
19849,21909533,21909533,21909677,0,0,0,144
19813,21909285,21909285,21910029,0,0,0,744
19682,21886125,21886125,21910200,0,0,0,24075
19602,21828740,21829434,21910434,0,0,694,81694
19930,21910088,21910434,21910580,0,0,346,492
19932,21910439,21910439,21910594,0,0,0,155
19941,21910914,21910914,21911018,0,0,0,104
19362,21747367,21747367,21911198,0,0,0,163831
19942,21911253,21911253,21911357,0,0,0,104
19681,21885811,21885811,21911841,0,0,0,26030
19684,21887150,21887150,21914058,0,0,0,26908
19678,21885477,21885477,21914841,0,0,0,29364
19972,21912053,21914841,21915441,0,0,2788,3388
19690,21888978,21888978,21915470,0,0,0,26492
19975,21913908,21915441,21916117,0,0,1533,2209
19982,21916318,21916318,21916396,0,0,0,78
19725,21895950,21895950,21916745,0,0,0,20795
19985,21916716,21916716,21916858,0,0,0,142
19984,21916702,21916702,21916860,0,0,0,158
19986,21916808,21916808,21916861,0,0,0,53
19987,21916817,21916817,21916884,0,0,0,67
19755,21903555,21903555,21917242,0,0,0,13687
19893,21909765,21917242,21917533,0,0,7477,7768
19977,21914395,21916117,21917698,0,0,1722,3303
19979,21914941,21917698,21917791,0,0,2757,2850
19980,21915295,21917698,21918180,0,0,2403,2885
19991,21918433,21918433,21918527,0,0,0,94
19993,21918485,21918485,21918614,0,0,0,129
19892,21909754,21917242,21918859,0,0,7488,9105
19996,21919163,21919163,21919230,0,0,0,67
19775,21906733,21906733,21919697,0,0,0,12964
19997,21919308,21919308,21919697,0,0,0,389
19732,21898179,21898179,21919779,0,0,0,21600
19998,21919739,21919739,21919922,0,0,0,183
19735,21898868,21898868,21919925,0,0,0,21057
19992,21918443,21918443,21920024,0,0,0,1581
20000,21919970,21920024,21920211,0,0,54,241
20001,21920441,21920441,21921599,0,0,0,1158
19748,21902229,21902229,21922423,0,0,0,20194
20004,21922961,21922961,21923090,0,0,0,129
20005,21922981,21922981,21923129,0,0,0,148
20007,21923123,21923123,21923190,0,0,0,67
20006,21923112,21923112,21923195,0,0,0,83
20002,21922419,21922419,21923898,0,0,0,1479
19758,21904113,21904113,21924532,0,0,0,20419
19099,21667066,21667066,21926266,0,0,0,259200
20011,21923915,21924532,21926332,0,0,617,2417
19387,21753763,21753763,21926563,0,0,0,172800
19771,21905585,21905585,21927185,0,0,0,21600
19745,21901666,21901666,21930695,0,0,0,29029
20016,21925069,21930695,21931441,0,0,5626,6372
19107,21672688,21672688,21931888,0,0,0,259200
19108,21672688,21672688,21931888,0,0,0,259200
19109,21672689,21672689,21931889,0,0,0,259200
19110,21672689,21672689,21931889,0,0,0,259200
19111,21672689,21672689,21931889,0,0,0,259200
19112,21672690,21672690,21931890,0,0,0,259200
19113,21672690,21672690,21931890,0,0,0,259200
19744,21901621,21901621,21932097,0,0,0,30476
20017,21926004,21931441,21932165,0,0,5437,6161
19949,21911440,21932097,21932190,0,0,20657,20750
19363,21747395,21747395,21932280,0,0,0,184885
20014,21924589,21931888,21933482,0,0,7299,8893
19136,21684849,21684849,21944049,0,0,0,259200
20026,21938390,21944049,21944903,0,0,5659,6513
20027,21938391,21944903,21945777,0,0,6512,7386
19141,21686979,21686979,21946179,0,0,0,259200
20028,21938392,21945777,21946273,0,0,7385,7881
20029,21938392,21946179,21946675,0,0,7787,8283
20030,21938392,21946273,21946769,0,0,7881,8377
20031,21938392,21946675,21947171,0,0,8283,8779
20032,21938393,21946769,21947296,0,0,8376,8903
19931,21910136,21926563,21950270,0,0,16427,40134
19800,21908779,21908779,21956780,0,0,0,48001
19794,21908778,21908778,21957314,0,0,0,48536
19796,21908778,21908778,21957349,0,0,0,48571
19795,21908778,21908778,21957376,0,0,0,48598
19804,21908780,21908780,21957385,0,0,0,48605
19807,21908781,21908781,21957551,0,0,0,48770
19806,21908781,21908781,21957687,0,0,0,48906
19792,21908777,21908777,21957724,0,0,0,48947
19785,21908776,21908776,21957742,0,0,0,48966
19797,21908778,21908778,21957752,0,0,0,48974
19805,21908781,21908781,21957779,0,0,0,48998
19798,21908778,21908778,21957783,0,0,0,49005
20018,21930631,21957724,21957871,0,0,27093,27240
20019,21932147,21957752,21957899,0,0,25605,25752
19801,21908779,21908779,21957938,0,0,0,49159
20020,21932368,21957783,21957971,0,0,25415,25603
19810,21908782,21908782,21958011,0,0,0,49229
19788,21908777,21908777,21958013,0,0,0,49236
20021,21932369,21957871,21958048,0,0,25502,25679
19811,21908782,21908782,21958073,0,0,0,49291
19808,21908781,21908781,21958189,0,0,0,49408
19809,21908782,21908782,21958276,0,0,0,49494
19802,21908779,21908779,21958280,0,0,0,49501
19789,21908777,21908777,21958429,0,0,0,49652
19829,21909342,21909342,21958500,0,0,0,49158
19838,21909343,21909343,21958504,0,0,0,49161
19790,21908777,21908777,21958527,0,0,0,49750
19971,21911778,21932280,21958671,0,0,20502,46893
19818,21909340,21909340,21958712,0,0,0,49372
19853,21909570,21909570,21958791,0,0,0,49221
19989,21917090,21958504,21958793,0,0,41414,41703
19814,21909339,21909339,21958804,0,0,0,49465
19835,21909343,21909343,21958831,0,0,0,49488
20008,21923250,21958671,21958972,0,0,35421,35722
19988,21917041,21958429,21959059,0,0,41388,42018
20009,21923260,21958793,21959069,0,0,35533,35809
19793,21908777,21908777,21959075,0,0,0,50298
19815,21909339,21909339,21959094,0,0,0,49755
19862,21909731,21909731,21959361,0,0,0,49630
20023,21932520,21957938,21959407,0,0,25418,26887
19863,21909731,21909731,21959640,0,0,0,49909
19852,21909569,21909569,21959670,0,0,0,50101
19819,21909340,21909340,21959972,0,0,0,50632
19823,21909341,21909341,21959973,0,0,0,50632
19834,21909342,21909342,21960062,0,0,0,50720
19856,21909728,21909728,21960067,0,0,0,50339
19840,21909344,21909344,21960198,0,0,0,50854
19816,21909339,21909339,21960219,0,0,0,50880
19803,21908779,21908779,21960220,0,0,0,51441
19855,21909571,21909571,21960313,0,0,0,50742
19820,21909340,21909340,21960344,0,0,0,51004
19976,21914013,21933482,21960354,0,0,19469,46341
19830,21909342,21909342,21960532,0,0,0,51190
19842,21909345,21909345,21960787,0,0,0,51442
19832,21909342,21909342,21960859,0,0,0,51517
19833,21909342,21909342,21961011,0,0,0,51669
19973,21912321,21960344,21961244,0,0,48023,48923
19843,21909345,21909345,21961451,0,0,0,52106
19824,21909341,21909341,21961487,0,0,0,52146
20052,21961325,21961325,21961497,0,0,0,172
19825,21909341,21909341,21961957,0,0,0,52616
19839,21909343,21909343,21961962,0,0,0,52619
19791,21908777,21908777,21961965,0,0,0,53188
19836,21909343,21909343,21962079,0,0,0,52736
19821,21909340,21909340,21962416,0,0,0,53076
20056,21962629,21962629,21962800,0,0,0,171
19874,21909734,21911198,21962873,0,0,1464,53139
20040,21943611,21958013,21962877,0,0,14402,19266
19870,21909733,21911198,21962961,0,0,1465,53228
20057,21962737,21962800,21962978,0,0,63,241
20058,21962848,21962873,21963043,0,0,25,195
19866,21909732,21910434,21963070,0,0,702,53338
19854,21909570,21909570,21963119,0,0,0,53549
19822,21909340,21909340,21963247,0,0,0,53907
19826,21909341,21909341,21963279,0,0,0,53938
19841,21909344,21909344,21963621,0,0,0,54277
19831,21909342,21909342,21964262,0,0,0,54920
19894,21909791,21917242,21964599,0,0,7451,54808
19896,21909792,21917533,21965048,0,0,7741,55256
19844,21909345,21909345,21965632,0,0,0,56287
19875,21909734,21911198,21965873,0,0,1464,56139
19878,21909735,21911841,21965952,0,0,2106,56217
19858,21909730,21909730,21966173,0,0,0,56443
19895,21909791,21917533,21966285,0,0,7742,56494
19827,21909341,21909341,21966561,0,0,0,57220
19974,21912335,21965873,21966773,0,0,53538,54438
19871,21909733,21911198,21966896,0,0,1465,57163
19897,21909792,21918859,21967007,0,0,9067,57215
20024,21932868,21966773,21967606,0,0,33905,34738
19898,21909792,21918859,21967635,0,0,9067,57843
19904,21909794,21919779,21967642,0,0,9985,57848
19903,21909794,21919779,21967766,0,0,9985,57972
19859,21909730,21909730,21967907,0,0,0,58177
19905,21909794,21919922,21967940,0,0,10128,58146
19864,21909731,21910200,21967942,0,0,469,58211
19872,21909733,21911198,21968150,0,0,1465,58417
19901,21909793,21919779,21968275,0,0,9986,58482
19867,21909732,21910434,21968285,0,0,702,58553
20012,21924458,21959972,21968345,0,0,35514,43887
19860,21909730,21909730,21968458,0,0,0,58728
19900,21909793,21919779,21968481,0,0,9986,58688
20015,21924599,21960067,21968528,0,0,35468,43929
19786,21908776,21908776,21968686,0,0,0,59910
19899,21909792,21919697,21968917,0,0,9905,59125
19902,21909793,21919779,21968965,0,0,9986,59172
19906,21909794,21919925,21969342,0,0,10131,59548
19861,21909730,21909730,21969451,0,0,0,59721
19879,21909735,21911841,21969757,0,0,2106,60022
20054,21962156,21962156,21970650,0,0,0,8494
19873,21909733,21911198,21970731,0,0,1465,60998
19907,21909795,21922423,21970972,0,0,12628,61177
19884,21909736,21917242,21971381,0,0,7506,61645
20055,21962314,21963043,21971422,0,0,729,9108
19876,21909734,21911198,21971707,0,0,1464,61973
19877,21909734,21911198,21971738,0,0,1464,62004
19908,21909795,21923898,21972339,0,0,14103,62544
19868,21909732,21911198,21972837,0,0,1466,63105
19880,21909735,21914058,21972929,0,0,4323,63194
19909,21909795,21924532,21973521,0,0,14737,63726
19934,21910491,21926563,21974194,0,0,16072,63703
19913,21909796,21926266,21974228,0,0,16470,64432
19922,21909798,21926266,21974252,0,0,16468,64454
19912,21909796,21926266,21974285,0,0,16470,64489
19921,21909798,21926266,21974314,0,0,16468,64516
19915,21909796,21926266,21974401,0,0,16470,64605
19886,21909736,21917242,21974443,0,0,7506,64707
19914,21909796,21926266,21974460,0,0,16470,64664
19926,21909799,21926266,21974566,0,0,16467,64767
19933,21910490,21926563,21974701,0,0,16073,64211
19919,21909797,21926266,21974717,0,0,16469,64920
19918,21909797,21926266,21974835,0,0,16469,65038
19927,21909799,21926266,21975000,0,0,16467,65201
19935,21910492,21926563,21975058,0,0,16071,64566
19917,21909797,21926266,21975105,0,0,16469,65308
19881,21909735,21914841,21975189,0,0,5106,65454
19911,21909796,21926266,21975299,0,0,16470,65503
19885,21909736,21917242,21975321,0,0,7506,65585
19943,21911304,21927185,21975342,0,0,15881,64038
19923,21909798,21926266,21975440,0,0,16468,65642
19924,21909798,21926266,21975533,0,0,16468,65735
20067,21975515,21975515,21975645,0,0,0,130
19920,21909797,21926266,21975703,0,0,16469,65906
19887,21909736,21917242,21975737,0,0,7506,66001
19937,21910492,21927185,21975752,0,0,16693,65260
19928,21909799,21926266,21975755,0,0,16467,65956
19916,21909797,21926266,21975880,0,0,16469,66083
20068,21975771,21975771,21975922,0,0,0,151
20071,21975952,21975952,21976031,0,0,0,79
19929,21909799,21926266,21976091,0,0,16467,66292
19890,21909737,21917242,21976195,0,0,7505,66458
19910,21909795,21926266,21976432,0,0,16471,66637
20065,21974921,21974921,21976721,0,0,0,1800
19940,21910493,21927185,21976724,0,0,16692,66231
19225,21722411,21722411,21976765,0,0,0,254354
19939,21910493,21927185,21976930,0,0,16692,66437
19938,21910492,21927185,21977015,0,0,16693,66523
19882,21909735,21915470,21977110,0,0,5735,67375
19936,21910492,21926563,21977180,0,0,16071,66688
19837,21909343,21909343,21977451,0,0,0,68108
20072,21975984,21975984,21977465,0,0,0,1481
20078,21977617,21977617,21977699,0,0,0,82
20003,21922437,21957385,21977740,0,0,34948,55303
20080,21977709,21977709,21977762,0,0,0,53
20073,21976195,21976195,21977800,0,0,0,1605
20082,21977815,21977815,21977909,0,0,0,94
19889,21909737,21917242,21977954,0,0,7505,68217
20083,21977992,21977992,21978060,0,0,0,68
20074,21976301,21976301,21978101,0,0,0,1800
19999,21919875,21957376,21978156,0,0,37501,58281
19888,21909736,21917242,21978259,0,0,7506,68523
20081,21977734,21977734,21978262,0,0,0,528
19983,21916682,21957314,21978303,0,0,40632,61621
20013,21924489,21957687,21978332,0,0,33198,53843
20077,21976498,21977800,21978370,0,0,1302,1872
20079,21977675,21977675,21978372,0,0,0,697
20084,21978155,21978155,21978504,0,0,0,349
20085,21978427,21978427,21978505,0,0,0,78
20086,21978466,21978466,21978568,0,0,0,102
19955,21911537,21932097,21978649,0,0,20560,67112
19944,21911439,21930695,21978677,0,0,19256,67238
20043,21952559,21958073,21978716,0,0,5514,26157
20087,21978808,21978808,21978912,0,0,0,104
20044,21952846,21958189,21978929,0,0,5343,26083
20088,21978874,21978874,21979066,0,0,0,192
20089,21979132,21979132,21979256,0,0,0,124
20045,21953002,21958276,21979355,0,0,5274,26353
19978,21914780,21950270,21979391,0,0,35490,64611
20092,21979491,21979491,21979564,0,0,0,73
20090,21979445,21979445,21979627,0,0,0,182
20046,21953193,21958712,21979800,0,0,5519,26607
20093,21979524,21979524,21980124,0,0,0,600
19945,21911439,21931889,21980248,0,0,20450,68809
19946,21911439,21931889,21980397,0,0,20450,68958
19950,21911440,21932097,21980420,0,0,20657,68980
20099,21980381,21980381,21980521,0,0,0,140
20069,21975822,21975822,21980598,0,0,0,4776
20102,21980620,21980620,21980687,0,0,0,67
20103,21980742,21980742,21981094,0,0,0,352
19951,21911440,21932097,21981195,0,0,20657,69755
19963,21911644,21932280,21981273,0,0,20636,69629
19962,21911644,21932190,21981380,0,0,20546,69736
19948,21911439,21932097,21981745,0,0,20658,70306
19947,21911439,21931890,21981759,0,0,20451,70320
20104,21981598,21981598,21981815,0,0,0,217
19964,21911645,21932280,21981877,0,0,20635,70232
20105,21981876,21981876,21982000,0,0,0,124
20106,21981891,21981891,21982046,0,0,0,155
20112,21982095,21982095,21982188,0,0,0,93
19952,21911440,21932097,21982291,0,0,20657,70851
19990,21918033,21961011,21982611,0,0,42978,64578
19965,21911645,21932280,21982675,0,0,20635,71030
19966,21911645,21932280,21982940,0,0,20635,71295
20070,21975892,21975892,21982949,0,0,0,7057
20047,21955854,21958804,21982995,0,0,2950,27141
19981,21915412,21956780,21983517,0,0,41368,68105
20115,21982672,21982672,21983572,0,0,0,900
19969,21911646,21932280,21984052,0,0,20634,72406
19967,21911645,21932280,21984096,0,0,20635,72451
20022,21932479,21957899,21984143,0,0,25420,51664
19970,21911646,21932280,21984652,0,0,20634,73006
20116,21984734,21984734,21984893,0,0,0,159
20118,21984862,21984862,21985041,0,0,0,179
20048,21958595,21958831,21985059,0,0,236,26464
20049,21958688,21958972,21985208,0,0,284,26520
20051,21959096,21959096,21985339,0,0,0,26243
20050,21958941,21958972,21985607,0,0,31,26666
20142,21985804,21985804,21985834,0,0,0,30
20143,21985986,21985986,21986148,0,0,0,162
20108,21981938,21981938,21986549,0,0,0,4611
20025,21933967,21957971,21986696,0,0,24004,52729
19959,21911538,21932097,21986760,0,0,20559,75222
19956,21911537,21932097,21986776,0,0,20560,75239
20146,21986732,21986732,21986888,0,0,0,156
19957,21911537,21932097,21986901,0,0,20560,75364
20010,21923796,21961957,21986973,0,0,38161,63177
19960,21911538,21932097,21987508,0,0,20559,75970
19954,21911536,21932097,21987640,0,0,20561,76104
20111,21982081,21982081,21987950,0,0,0,5869
19250,21728915,21728915,21988115,0,0,0,259200
20148,21988807,21988807,21989096,0,0,0,289
20147,21987577,21987577,21989099,0,0,0,1522
20150,21989064,21989064,21989274,0,0,0,210
20151,21989248,21989248,21989454,0,0,0,206
20152,21989454,21989454,21990055,0,0,0,601
20053,21961435,21961435,21991149,0,0,0,29714
20145,21986510,21986510,21991176,0,0,0,4666
19961,21911538,21932165,21991503,0,0,20627,79965
20059,21962960,21962961,21992311,0,0,1,29351
20156,21992239,21992239,21992411,0,0,0,172
20157,21992357,21992357,21992530,0,0,0,173
20158,21992468,21992468,21992922,0,0,0,454
20161,21993236,21993236,21993329,0,0,0,93
20162,21993434,21993434,21993538,0,0,0,104
20060,21973128,21973128,21993835,0,0,0,20707
20164,21993996,21993996,21994083,0,0,0,87
20062,21973526,21973526,21994120,0,0,0,20594
20064,21974217,21974217,21995120,0,0,0,20903
19787,21908776,21908776,21995176,0,0,0,86400
20063,21974021,21974021,21995235,0,0,0,21214
19817,21909339,21909339,21995739,0,0,0,86400
19828,21909341,21909341,21995741,0,0,0,86400
19845,21909345,21909345,21995745,0,0,0,86400
20154,21991118,21991118,21995859,0,0,0,4741
19857,21909729,21909729,21996129,0,0,0,86400
20114,21982424,21982424,21996413,0,0,0,13989
20170,21996459,21996459,21996548,0,0,0,89
19865,21909731,21910434,21996834,0,0,703,87103
19869,21909732,21911198,21997598,0,0,1466,87866
20149,21988835,21988835,21997660,0,0,0,8825
20171,21996522,21996522,21998244,0,0,0,1722
20172,21996914,21996914,21998714,0,0,0,1800
20061,21973166,21973166,21999485,0,0,0,26319
20176,21998106,21998106,21999627,0,0,0,1521
20180,21999705,21999705,21999891,0,0,0,186
20169,21995788,21995788,22000490,0,0,0,4702
20183,22000722,22000722,22000939,0,0,0,217
20182,22000497,22000497,22001534,0,0,0,1037
20185,22001538,22001538,22001703,0,0,0,165
20186,22001790,22001790,22001953,0,0,0,163
20184,22000726,22000939,22002739,0,0,213,2013
19883,21909735,21916745,22003145,0,0,7010,93410
20190,22002527,22002527,22003399,0,0,0,872
19891,21909737,21917242,22003642,0,0,7505,93905
20098,21979974,21979974,22003658,0,0,0,23684
20191,22003088,22003088,22003896,0,0,0,808
20193,22003865,22003865,22004709,0,0,0,844
20181,22000437,22000437,22005110,0,0,0,4673
20194,22003892,22003892,22005185,0,0,0,1293
20197,22005191,22005191,22005295,0,0,0,104
20179,21999636,21999636,22005409,0,0,0,5773
20199,22005340,22005340,22005546,0,0,0,206
20198,22005199,22005199,22005551,0,0,0,352
20202,22005814,22005814,22006031,0,0,0,217
20175,21997824,21997824,22006159,0,0,0,8335
20203,22005861,22006031,22006211,0,0,170,350
20113,21982271,21982271,22006463,0,0,0,24192
20200,22005539,22005539,22006523,0,0,0,984
20196,22005158,22005158,22006722,0,0,0,1564
20205,22006625,22006625,22006765,0,0,0,140
20207,22006917,22006917,22007114,0,0,0,197
20075,21976311,21976311,22007442,0,0,0,31131
19366,21748357,21748357,22007557,0,0,0,259200
20208,22007755,22007755,22007973,0,0,0,218
20209,22007948,22007948,22008196,0,0,0,248
20206,22006868,22006868,22008440,0,0,0,1572
20210,22008666,22008666,22008775,0,0,0,109
20211,22009238,22009238,22009316,0,0,0,78
20212,22009318,22009318,22009407,0,0,0,89
20213,22009367,22009367,22009440,0,0,0,73
20214,22009367,22009367,22009563,0,0,0,196
20195,22005048,22005048,22009926,0,0,0,4878
20217,22010295,22010295,22010388,0,0,0,93
20218,22010559,22010559,22010653,0,0,0,94
20219,22010764,22010764,22010861,0,0,0,97
20117,21984844,21984844,22010891,0,0,0,26047
20221,22010829,22010829,22011001,0,0,0,172
20222,22010939,22010939,22011090,0,0,0,151
20119,21984971,21984971,22011121,0,0,0,26150
19381,21752200,21752200,22011400,0,0,0,259200
20141,21985513,21985513,22011938,0,0,0,26425
20140,21985295,21985295,22012008,0,0,0,26713
20097,21979711,21979711,22012168,0,0,0,32457
20220,22010787,22010787,22012587,0,0,0,1800
19925,21909798,21926266,22012666,0,0,16468,102868
20225,22011506,22011506,22013080,0,0,0,1574
20187,22001794,22012587,22013187,0,0,10793,11393
20188,22001818,22013187,22013787,0,0,11369,11969
20163,21993788,21993788,22014271,0,0,0,20483
20189,22001825,22013787,22014387,0,0,11962,12562
20201,22005544,22005544,22014544,0,0,0,9000
20215,22009856,22009856,22014579,0,0,0,4723
20165,21994057,21994057,22014775,0,0,0,20718
20167,21995059,21995059,22016143,0,0,0,21084
20168,21995167,21995167,22016173,0,0,0,21006
20076,21976317,21976721,22017680,0,0,404,41363
20233,22016979,22016979,22017879,0,0,0,900
20155,21991979,22017680,22017898,0,0,25701,25919
19254,21731684,21731684,22018246,0,0,0,286562
20234,22017511,22017511,22018411,0,0,0,900
19953,21911535,21932097,22018497,0,0,20562,106962
19958,21911537,21932097,22018497,0,0,20560,106960
19968,21911645,21932280,22018680,0,0,20635,107035
20235,22017816,22017816,22018716,0,0,0,900
20229,22014513,22014513,22019290,0,0,0,4777
20177,21999005,21999005,22020176,0,0,0,21171
20153,21991102,21991102,22020974,0,0,0,29872
20241,22020903,22020903,22021083,0,0,0,180
20242,22021030,22021030,22021202,0,0,0,172
20236,22019172,22019172,22021872,0,0,0,2700
20244,22021851,22021851,22021955,0,0,0,104
20094,21979627,21979627,22022112,0,0,0,42485
19411,21762939,21762939,22022139,0,0,0,259200
20245,22022085,22022085,22022176,0,0,0,91
20159,21992859,21992859,22022278,0,0,0,29419
19413,21763156,21763156,22022356,0,0,0,259200
19414,21763251,21763251,22022451,0,0,0,259200
19416,21763413,21763413,22022613,0,0,0,259200
19417,21763506,21763506,22022706,0,0,0,259200
20160,21993059,21993059,22022892,0,0,0,29833
20237,22019233,22019233,22023993,0,0,0,4760
20249,22025756,22025756,22026239,0,0,0,483
20192,22003619,22003619,22027328,0,0,0,23709
20095,21979701,21979701,22027462,0,0,0,47761
20252,22027419,22027419,22027685,0,0,0,266
20253,22027654,22027654,22027840,0,0,0,186
20248,22023931,22023931,22028738,0,0,0,4807
19422,21769641,21769641,22028841,0,0,0,259200
19132,21683327,21683327,22028927,0,0,0,345600
20204,22006401,22006401,22030548,0,0,0,24147
20255,22028694,22028694,22033487,0,0,0,4793
19994,21918993,21959069,22034970,0,0,40076,115977
20228,22014208,22014208,22035290,0,0,0,21082
20230,22014712,22014712,22035455,0,0,0,20743
19995,21919010,21959407,22035711,0,0,40397,116701
20133,21985277,21985277,22036274,0,0,0,50997
20134,21985277,21985277,22036449,0,0,0,51172
20122,21985169,21985169,22036541,0,0,0,51372
20091,21979485,22036541,22036759,0,0,57056,57274
20130,21985276,21985276,22036855,0,0,0,51579
20120,21985168,21985168,22036943,0,0,0,51775
20132,21985277,21985277,22037215,0,0,0,51938
20232,22016110,22016110,22037233,0,0,0,21123
20231,22016089,22016089,22037265,0,0,0,21176
20223,22011047,22011047,22037344,0,0,0,26297
20224,22011059,22011059,22037385,0,0,0,26326
20121,21985168,21985168,22037501,0,0,0,52333
20271,22037338,22037338,22037516,0,0,0,178
20131,21985276,21985276,22037557,0,0,0,52281
20272,22037451,22037451,22037620,0,0,0,169
20123,21985169,21985169,22037865,0,0,0,52696
20265,22033445,22033445,22038198,0,0,0,4753
20124,21985169,21985169,22038361,0,0,0,53192
20226,22011875,22011875,22038601,0,0,0,26726
20227,22011947,22011947,22038767,0,0,0,26820
20126,21985216,21985216,22039954,0,0,0,54738
20128,21985216,21985216,22040488,0,0,0,55272
20127,21985216,21985216,22040601,0,0,0,55385
20125,21985216,21985216,22040830,0,0,0,55614
20129,21985216,21985216,22041511,0,0,0,56295
20136,21985293,21985293,22042262,0,0,0,56969
20137,21985293,21985293,22042744,0,0,0,57451
20274,22038138,22038138,22042895,0,0,0,4757
20247,22023111,22023111,22042911,0,0,0,19800
20135,21985293,21985293,22043330,0,0,0,58037
20138,21985293,21985293,22045149,0,0,0,59856
20277,22042832,22042832,22047641,0,0,0,4809
20254,22028262,22028262,22048062,0,0,0,19800
20139,21985293,21985293,22050144,0,0,0,64851
20239,22020104,22020104,22050982,0,0,0,30878
20243,22021139,22021139,22051140,0,0,0,30001
20279,22051073,22051073,22051244,0,0,0,171
20251,22027271,22027271,22051365,0,0,0,24094
20280,22051186,22051186,22051365,0,0,0,179
20281,22051291,22051291,22051485,0,0,0,194
20066,21975387,22050982,22051945,0,0,75595,76558
20107,21981920,22051945,22052148,0,0,70025,70228
20246,22022235,22022235,22052154,0,0,0,29919
20278,22047572,22047572,22052313,0,0,0,4741
20263,22030485,22030485,22054463,0,0,0,23978
20266,22035227,22035227,22055960,0,0,0,20733
20267,22035409,22035409,22056060,0,0,0,20651
20285,22052258,22052258,22056987,0,0,0,4729
20269,22037202,22037202,22058266,0,0,0,21064
20268,22037175,22037175,22058363,0,0,0,21188
20238,22019645,22019645,22060253,0,0,0,40608
20110,21981968,22060253,22061029,0,0,78285,79061
20289,22056925,22056925,22061617,0,0,0,4692
20270,22037281,22037281,22063719,0,0,0,26438
20273,22037566,22037566,22063798,0,0,0,26232
20293,22063657,22063657,22063828,0,0,0,171
20295,22063751,22063751,22063902,0,0,0,151
20294,22063727,22063727,22064156,0,0,0,429
20298,22064064,22064064,22064156,0,0,0,92
20299,22064128,22064128,22064300,0,0,0,172
20300,22064256,22064256,22064335,0,0,0,79
20275,22038533,22038533,22065248,0,0,0,26715
20276,22038706,22038706,22065327,0,0,0,26621
20292,22061554,22061554,22066221,0,0,0,4667
20301,22064311,22064311,22067027,0,0,0,2716
20305,22067321,22067321,22067451,0,0,0,130
19522,21814915,21814915,22067515,0,0,0,252600
19523,21815104,21815104,22067704,0,0,0,252600
20240,22020110,22020110,22068236,0,0,0,48126
20306,22068305,22068305,22068373,0,0,0,68
20307,22068395,22068395,22068462,0,0,0,67
20308,22068480,22068480,22068548,0,0,0,68
19527,21815962,21815962,22068562,0,0,0,252600
20309,22068653,22068653,22068735,0,0,0,82
20310,22068749,22068749,22068816,0,0,0,67
20311,22068857,22068857,22068924,0,0,0,67
20312,22069166,22069166,22069255,0,0,0,89
20109,21981944,22068236,22070036,0,0,86292,88092
20304,22066177,22066177,22070832,0,0,0,4655
20318,22071058,22071058,22071151,0,0,0,93
20319,22071501,22071501,22071599,0,0,0,98
20320,22071706,22071706,22071774,0,0,0,68
20321,22071793,22071793,22071890,0,0,0,97
20322,22071811,22071811,22071946,0,0,0,135
20324,22071909,22071909,22071977,0,0,0,68
20323,22071846,22071846,22072230,0,0,0,384
20326,22073012,22073012,22073291,0,0,0,279
20317,22070769,22070769,22075447,0,0,0,4678
20282,22051317,22051317,22075521,0,0,0,24204
20287,22055898,22055898,22076526,0,0,0,20628
20288,22056000,22056000,22076627,0,0,0,20627
20332,22077007,22077007,22077269,0,0,0,262
20333,22077253,22077253,22077369,0,0,0,116
20335,22077409,22077409,22077545,0,0,0,136
20337,22077493,22077493,22077602,0,0,0,109
20339,22078006,22078006,22078132,0,0,0,126
20286,22054401,22054401,22078501,0,0,0,24100
19640,21854130,21854130,22078593,0,0,0,224463
20291,22058308,22058308,22079369,0,0,0,21061
20290,22058213,22058213,22079401,0,0,0,21188
20328,22075388,22075388,22079939,0,0,0,4551
20283,22051398,22051398,22081313,0,0,0,29915
20284,22052092,22052092,22081743,0,0,0,29651
20349,22081680,22081680,22081846,0,0,0,166
20343,22078200,22078200,22083037,0,0,0,4837
20347,22079867,22079867,22084468,0,0,0,4601
20100,21980539,21980539,22088539,0,0,0,108000
20101,21980571,21980598,22088598,0,0,27,108027
20351,22084416,22084416,22088971,0,0,0,4555
20297,22063855,22063855,22090074,0,0,0,26219
20296,22063766,22063766,22090110,0,0,0,26344
20353,22090002,22090002,22090190,0,0,0,188
20354,22090038,22090038,22090215,0,0,0,177
20356,22090157,22090157,22090323,0,0,0,166
20357,22090264,22090264,22090434,0,0,0,170
20358,22090374,22090374,22090544,0,0,0,170
20359,22090481,22090481,22090666,0,0,0,185
20302,22065193,22065193,22091732,0,0,0,26539
20303,22065282,22065282,22092082,0,0,0,26800
20352,22088929,22088929,22093492,0,0,0,4563
20330,22076457,22076457,22097196,0,0,0,20739
19379,21751644,21751644,22097244,0,0,0,345600
20331,22076562,22076562,22097369,0,0,0,20807
20365,22093437,22093437,22098042,0,0,0,4605
20329,22075464,22075464,22099742,0,0,0,24278
20345,22079328,22079328,22100362,0,0,0,21034
20346,22079333,22079333,22100563,0,0,0,21230
20341,22078043,22078043,22100775,0,0,0,22732
20369,22097983,22097983,22102421,0,0,0,4438
20344,22078438,22078438,22102512,0,0,0,24074
20372,22102359,22102359,22106816,0,0,0,4457
20348,22081271,22081271,22111298,0,0,0,30027
20375,22106753,22106753,22111321,0,0,0,4568
20377,22111707,22111707,22111879,0,0,0,172
20350,22082745,22082745,22112717,0,0,0,29972
20325,22072242,22072242,22115442,0,0,0,43200
20376,22111258,22111258,22115771,0,0,0,4513
20174,21997782,22011400,22116193,0,0,13618,118411
20355,22090114,22090114,22116375,0,0,0,26261
20360,22090589,22090589,22116927,0,0,0,26338
20367,22097282,22097282,22117819,0,0,0,20537
20366,22097131,22097131,22117848,0,0,0,20717
20361,22091661,22091661,22118303,0,0,0,26642
20364,22092043,22092043,22118701,0,0,0,26658
20380,22115725,22115725,22120221,0,0,0,4496
20371,22100393,22100393,22121515,0,0,0,21122
20397,22121642,22121642,22121768,0,0,0,126
20370,22099676,22099676,22123105,0,0,0,23429
20373,22102467,22102467,22123522,0,0,0,21055
20388,22120162,22120162,22124711,0,0,0,4549
20374,22102512,22102512,22126552,0,0,0,24040
20400,22124648,22124648,22129167,0,0,0,4519
20402,22129122,22129122,22133725,0,0,0,4603
20384,22117752,22117752,22138366,0,0,0,20614
20403,22133662,22133662,22138406,0,0,0,4744
20385,22117790,22117790,22138438,0,0,0,20648
20378,22111816,22111816,22141582,0,0,0,29766
20407,22141540,22141540,22141717,0,0,0,177
20389,22121463,22121463,22142410,0,0,0,20947
20379,22112641,22112641,22142513,0,0,0,29872
20381,22116336,22116336,22142863,0,0,0,26527
20405,22138334,22138334,22142952,0,0,0,4618
20411,22142812,22142812,22142985,0,0,0,173
20399,22123478,22123478,22144493,0,0,0,21015
20386,22118247,22118247,22144988,0,0,0,26741
20387,22118640,22118640,22145185,0,0,0,26545
20398,22123042,22123042,22146791,0,0,0,23749
20412,22142876,22142876,22147469,0,0,0,4593
20401,22126486,22126486,22150198,0,0,0,23712
20418,22147408,22147408,22152032,0,0,0,4624
20313,22069228,22069228,22155628,0,0,0,86400
20420,22151963,22151963,22156582,0,0,0,4619
20406,22138380,22138380,22159012,0,0,0,20632
20404,22138293,22138293,22159109,0,0,0,20816
20327,22073083,22073083,22159483,0,0,0,86400
20383,22116864,22116864,22160064,0,0,0,43200
20421,22156527,22156527,22161128,0,0,0,4601
20409,22142339,22142339,22163381,0,0,0,21042
20414,22144433,22144433,22165531,0,0,0,21098
20424,22161082,22161082,22165880,0,0,0,4798
20396,22121636,22121636,22166001,0,0,0,44365
20362,22091894,22091894,22167162,0,0,0,75268
20166,21994385,21994385,22168770,0,0,0,174385
20413,22142922,22142922,22169158,0,0,0,26236
20429,22169096,22169096,22169267,0,0,0,171
20427,22165817,22165817,22170593,0,0,0,4776
20417,22146733,22146733,22171012,0,0,0,24279
20416,22145114,22145114,22171330,0,0,0,26216
20415,22144942,22144942,22171625,0,0,0,26683
20408,22141649,22141649,22171720,0,0,0,30071
20435,22171664,22171664,22171836,0,0,0,172
20436,22171773,22171773,22171944,0,0,0,171
20410,22142444,22142444,22172318,0,0,0,29874
20363,22091919,22091919,22172919,0,0,0,81000
20382,22116560,22116560,22173057,0,0,0,56497
20419,22150134,22150134,22174310,0,0,0,24176
20431,22170535,22170535,22175267,0,0,0,4732
20443,22179033,22179033,22179204,0,0,0,171
20444,22179141,22179141,22179311,0,0,0,170
20445,22179249,22179249,22179431,0,0,0,182
20423,22159042,22159042,22179458,0,0,0,20416
20446,22179358,22179358,22179535,0,0,0,177
20422,22158949,22158949,22179619,0,0,0,20670
20448,22179466,22179466,22179643,0,0,0,177
20442,22175202,22175202,22180103,0,0,0,4901
20216,22010013,22010013,22182813,0,0,0,172800
20425,22163326,22163326,22184531,0,0,0,21205
20451,22180044,22180044,22184741,0,0,0,4697
20426,22165469,22165469,22186418,0,0,0,20949
20454,22184700,22184700,22189448,0,0,0,4748
20456,22189396,22189396,22194145,0,0,0,4749
20432,22170970,22170970,22194983,0,0,0,24013
20430,22169204,22169204,22195263,0,0,0,26059
20459,22195221,22195221,22195367,0,0,0,146
20460,22195323,22195323,22195500,0,0,0,177
20434,22171562,22171562,22197859,0,0,0,26297
20433,22171276,22171276,22197895,0,0,0,26619
20439,22174268,22174268,22198061,0,0,0,23793
20457,22194104,22194104,22198897,0,0,0,4793
20447,22179398,22179398,22199821,0,0,0,20423
20449,22179575,22179575,22200153,0,0,0,20578
20338,22077505,22077505,22201766,0,0,0,124261
20438,22172257,22172257,22202039,0,0,0,29782
20437,22171882,22171882,22202047,0,0,0,30165
20096,21979705,21979705,22202942,0,0,0,223237
20465,22198845,22198845,22203620,0,0,0,4775
20336,22077472,22077472,22203707,0,0,0,126235
20334,22077275,22077275,22204388,0,0,0,127113
20471,22204342,22204342,22204539,0,0,0,197
20452,22184471,22184471,22205326,0,0,0,20855
20450,22179582,22179582,22206019,0,0,0,26437
20033,21940210,21947171,22206371,0,0,6961,266161
20034,21940211,21947296,22206496,0,0,7085,266285
20455,22186350,22186350,22207304,0,0,0,20954
20469,22203557,22203557,22208338,0,0,0,4781
20483,22208276,22208276,22213067,0,0,0,4791
20035,21940211,21957349,22216549,0,0,17138,276338
20036,21940211,21957551,22216751,0,0,17340,276540
20037,21940212,21957742,22216942,0,0,17530,276730
20038,21940212,21957779,22216979,0,0,17567,276767
20039,21940212,21958011,22217211,0,0,17799,276999
20041,21944269,21958013,22217213,0,0,13744,272944
20042,21946422,21958048,22217248,0,0,11626,270826
20484,22213010,22213010,22217730,0,0,0,4720
20458,22194922,22194922,22219119,0,0,0,24197
20466,22200093,22200093,22220680,0,0,0,20587
20461,22195432,22195432,22221520,0,0,0,26088
20464,22197993,22197993,22221627,0,0,0,23634
20485,22217690,22217690,22222449,0,0,0,4759
20462,22197806,22197806,22224261,0,0,0,26455
20463,22197832,22197832,22224379,0,0,0,26547
20479,22205263,22205263,22226131,0,0,0,20868
20490,22222397,22222397,22227047,0,0,0,4650
20482,22207248,22207248,22228473,0,0,0,21225
20497,22228880,22228880,22229195,0,0,0,315
20495,22228500,22228500,22229340,0,0,0,840
20178,21999272,21999272,22229367,0,0,0,230095
20496,22228655,22228655,22229468,0,0,0,813
20493,22226984,22226984,22231636,0,0,0,4652
20468,22202000,22202000,22232013,0,0,0,30013
20467,22201966,22201966,22232041,0,0,0,30075
20481,22205963,22205963,22232079,0,0,0,26116
20501,22231984,22231984,22232165,0,0,0,181
20502,22232017,22232017,22232168,0,0,0,151
20504,22232126,22232126,22232303,0,0,0,177
20503,22232096,22232096,22232408,0,0,0,312
20508,22236037,22236037,22236130,0,0,0,93
20499,22231572,22231572,22236295,0,0,0,4723
20510,22236315,22236315,22236408,0,0,0,93
20511,22237145,22237145,22237218,0,0,0,73
20512,22237443,22237443,22237536,0,0,0,93
20513,22237714,22237714,22237807,0,0,0,93
20515,22239262,22239262,22239391,0,0,0,129
20516,22239813,22239813,22239908,0,0,0,95
20509,22236228,22236228,22240848,0,0,0,4620
20518,22240429,22240429,22241003,0,0,0,574
20521,22241310,22241310,22241427,0,0,0,117
20487,22220635,22220635,22241429,0,0,0,20794
20520,22241015,22241015,22241737,0,0,0,722
20507,22235426,22235426,22242017,0,0,0,6591
20514,22238543,22238543,22242602,0,0,0,4059
20486,22219087,22219087,22243393,0,0,0,24306
20527,22243593,22243593,22244341,0,0,0,748
20528,22244572,22244572,22244918,0,0,0,346
20144,21986002,21986002,22245142,0,0,0,259140
20519,22240812,22240812,22245466,0,0,0,4654
20489,22221586,22221586,22245763,0,0,0,24177
20529,22245114,22245114,22247453,0,0,0,2339
20532,22247456,22247456,22247799,0,0,0,343
20488,22221465,22221465,22247878,0,0,0,26413
20534,22247812,22247812,22248164,0,0,0,352
20535,22248107,22248107,22248460,0,0,0,353
20536,22248399,22248399,22248731,0,0,0,332
20533,22247491,22247491,22248866,0,0,0,1375
20538,22248688,22248688,22249051,0,0,0,363
20494,22228411,22228411,22249251,0,0,0,20840
20540,22248979,22248979,22249332,0,0,0,353
20537,22248682,22248682,22249582,0,0,0,900
20543,22249269,22249269,22249623,0,0,0,354
20544,22249552,22249552,22249908,0,0,0,356
20530,22245385,22245385,22250059,0,0,0,4674
20547,22250401,22250401,22250494,0,0,0,93
20548,22250497,22250497,22250600,0,0,0,103
20549,22250540,22250540,22250648,0,0,0,108
20550,22250575,22250575,22250668,0,0,0,93
20551,22250603,22250603,22250761,0,0,0,158
20491,22224200,22224200,22250792,0,0,0,26592
20492,22224317,22224317,22251130,0,0,0,26813
20553,22251048,22251048,22251203,0,0,0,155
20440,22174284,22174284,22251285,0,0,0,77001
20555,22252193,22252193,22252318,0,0,0,125
20524,22242469,22242469,22253280,0,0,0,10811
20560,22253186,22253186,22253341,0,0,0,155
20561,22254032,22254032,22254136,0,0,0,104
20525,22242472,22242472,22254180,0,0,0,11708
20562,22254092,22254092,22254218,0,0,0,126
20563,22254188,22254188,22254334,0,0,0,146
20556,22252345,22252345,22254697,0,0,0,2352
20546,22249996,22249996,22254732,0,0,0,4736
20557,22252785,22252785,22255239,0,0,0,2454
20559,22252802,22252802,22255287,0,0,0,2485
20558,22252793,22252793,22255309,0,0,0,2516
20565,22254733,22254733,22255333,0,0,0,600
20441,22174374,22174374,22255374,0,0,0,81000
20566,22255120,22255120,22256117,0,0,0,997
20572,22256234,22256234,22256318,0,0,0,84
20574,22256604,22256604,22256799,0,0,0,195
20571,22256224,22256224,22256824,0,0,0,600
20573,22256282,22256282,22256928,0,0,0,646
20539,22248726,22248726,22256992,0,0,0,8266
20575,22256869,22256869,22257037,0,0,0,168
20541,22249033,22249033,22257543,0,0,0,8510
20576,22256993,22256993,22257593,0,0,0,600
20578,22257736,22257736,22257814,0,0,0,78
20567,22255437,22255437,22258065,0,0,0,2628
20505,22232235,22232235,22258100,0,0,0,25865
20580,22258034,22258034,22258200,0,0,0,166
20568,22255547,22255547,22258241,0,0,0,2694
20569,22256042,22256042,22258601,0,0,0,2559
20570,22256138,22256138,22258743,0,0,0,2605
20564,22254660,22254660,22259213,0,0,0,4553
20584,22259107,22259107,22259357,0,0,0,250
20587,22259679,22259679,22259746,0,0,0,67
20586,22259357,22259357,22260161,0,0,0,804
20589,22260283,22260283,22260846,0,0,0,563
20579,22257750,22257750,22261276,0,0,0,3526
20577,22257408,22257408,22261495,0,0,0,4087
20588,22260166,22260166,22261702,0,0,0,1536
20522,22241379,22241379,22261757,0,0,0,20378
20500,22231949,22231949,22261790,0,0,0,29841
20593,22261836,22261836,22261846,0,0,0,10
20595,22261891,22261891,22261901,0,0,0,10
20592,22261730,22261730,22261910,0,0,0,180
20594,22261845,22261845,22262000,0,0,0,155
20596,22261964,22261964,22262115,0,0,0,151
20597,22262072,22262072,22262145,0,0,0,73
20506,22232361,22232361,22262315,0,0,0,29954
20590,22261670,22261670,22262422,0,0,0,752
20599,22262257,22262257,22262429,0,0,0,172
20601,22262468,22262468,22262933,0,0,0,465
20585,22259160,22259160,22263785,0,0,0,4625
20173,21997707,22007442,22266642,0,0,9735,268935
20526,22243341,22243341,22267605,0,0,0,24264
20602,22263722,22263722,22268327,0,0,0,4605
20606,22268621,22268621,22268731,0,0,0,110
20607,22268659,22268659,22268758,0,0,0,99
20608,22268687,22268687,22268767,0,0,0,80
20609,22268704,22268704,22268797,0,0,0,93
20610,22269321,22269321,22269755,0,0,0,434
20531,22245706,22245706,22269953,0,0,0,24247
20612,22269628,22269628,22270015,0,0,0,387
20542,22249188,22249188,22270046,0,0,0,20858
20613,22269670,22269670,22272122,0,0,0,2452
20614,22269692,22269692,22272153,0,0,0,2461
20605,22268273,22268273,22272766,0,0,0,4493
20582,22258323,22258323,22275630,0,0,0,17307
20545,22249852,22249852,22276400,0,0,0,26548
20616,22272703,22272703,22277279,0,0,0,4576
20552,22250729,22250729,22277393,0,0,0,26664
20554,22251066,22251066,22277744,0,0,0,26678
20603,22263862,22263862,22281528,0,0,0,17666
20618,22277214,22277214,22281753,0,0,0,4539
20591,22261724,22261724,22282252,0,0,0,20528
20581,22258163,22258163,22284429,0,0,0,26266
20621,22281713,22281713,22286223,0,0,0,4510
20611,22269324,22269324,22287138,0,0,0,17814
20624,22287864,22287864,22287957,0,0,0,93
20257,22029585,22029585,22288785,0,0,0,259200
20258,22029586,22029586,22288786,0,0,0,259200
20259,22029586,22029586,22288786,0,0,0,259200
20260,22029587,22029587,22288787,0,0,0,259200
20261,22029619,22029619,22288819,0,0,0,259200
20262,22029620,22029620,22288820,0,0,0,259200
20264,22030987,22030987,22290187,0,0,0,259200
20250,22026728,22026728,22290363,0,0,0,263635
20623,22286154,22286154,22290645,0,0,0,4491
20604,22267562,22267562,22291723,0,0,0,24161
20598,22262072,22262072,22291934,0,0,0,29862
20600,22262367,22262367,22292194,0,0,0,29827
20638,22292122,22292122,22292299,0,0,0,177
20639,22292242,22292242,22292414,0,0,0,172
20640,22292356,22292356,22292529,0,0,0,173
20641,22292467,22292467,22292636,0,0,0,169
20615,22269890,22269890,22294084,0,0,0,24194
20617,22276338,22276338,22302651,0,0,0,26313
20619,22277362,22277362,22303852,0,0,0,26490
20620,22277702,22277702,22304460,0,0,0,26758
20390,22121530,22121530,22306775,0,0,0,185245
20626,22289197,22289197,22308940,0,0,0,19743
20622,22284372,22284372,22310619,0,0,0,26247
20636,22291678,22291678,22315829,0,0,0,24151
20498,22229313,22229313,22317041,0,0,0,87728
20643,22294038,22294038,22317462,0,0,0,23424
20637,22291872,22291872,22322069,0,0,0,30197
20642,22292574,22292574,22322298,0,0,0,29724
20654,22323382,22323382,22323661,0,0,0,279
20655,22323667,22323667,22324092,0,0,0,425
20658,22323739,22323739,22324405,0,0,0,666
20656,22323701,22323701,22326075,0,0,0,2374
20659,22323756,22323756,22326294,0,0,0,2538
20661,22327363,22327363,22327591,0,0,0,228
20662,22327554,22327554,22328027,0,0,0,473
20634,22290832,22290832,22328265,0,0,0,37433
20650,22319195,22319195,22328328,0,0,0,9133
20314,22069715,22069715,22328915,0,0,0,259200
20660,22327150,22327150,22328950,0,0,0,1800
20315,22069771,22069771,22328971,0,0,0,259200
20644,22302584,22302584,22328976,0,0,0,26392
20316,22069909,22069909,22329109,0,0,0,259200
20665,22329000,22329000,22329144,0,0,0,144
20669,22329297,22329297,22329390,0,0,0,93
20668,22329255,22329255,22329555,0,0,0,300
20651,22319711,22319711,22329611,0,0,0,9900
20666,22329071,22329071,22329741,0,0,0,670
20670,22329710,22329710,22329803,0,0,0,93
20671,22329998,22329998,22330076,0,0,0,78
20625,22288032,22288032,22330548,0,0,0,42516
20340,22078027,22078027,22330627,0,0,0,252600
20342,22078068,22078068,22330668,0,0,0,252600
20667,22329126,22329126,22330724,0,0,0,1598
20646,22304399,22304399,22331228,0,0,0,26829
20645,22303806,22303806,22331254,0,0,0,27448
20676,22332003,22332003,22332077,0,0,0,74
20672,22330271,22330271,22332787,0,0,0,2516
20678,22333149,22333149,22333366,0,0,0,217
20684,22335334,22335334,22335412,0,0,0,78
20683,22335326,22335326,22335467,0,0,0,141
20583,22258989,22258989,22336340,0,0,0,77351
20686,22336350,22336350,22336536,0,0,0,186
20687,22336372,22336372,22336569,0,0,0,197
20688,22336394,22336394,22336592,0,0,0,198
20690,22336695,22336695,22336850,0,0,0,155
20689,22336414,22336592,22336903,0,0,178,489
20647,22310552,22310552,22337062,0,0,0,26510
20682,22334928,22334928,22337442,0,0,0,2514
20648,22315789,22315789,22339821,0,0,0,24032
20673,22330632,22330632,22340828,0,0,0,10196
20649,22317389,22317389,22341120,0,0,0,23731
20657,22323730,22323730,22343076,0,0,0,19346
20692,22337350,22337350,22343394,0,0,0,6044
20696,22341787,22341787,22343693,0,0,0,1906
20698,22343664,22343664,22343762,0,0,0,98
20685,22335724,22335724,22343792,0,0,0,8068
20699,22343976,22343976,22344117,0,0,0,141
20701,22344195,22344195,22344582,0,0,0,387
20677,22332040,22332040,22345012,0,0,0,12972
20700,22344116,22344116,22345916,0,0,0,1800
20695,22341738,22341738,22346294,0,0,0,4556
20705,22346262,22346262,22347662,0,0,0,1400
20709,22348889,22348889,22348961,0,0,0,72
20710,22348962,22348962,22349038,0,0,0,76
20711,22349078,22349078,22349156,0,0,0,78
20712,22349289,22349289,22349356,0,0,0,67
20713,22349382,22349382,22349449,0,0,0,67
20715,22349660,22349660,22349742,0,0,0,82
20716,22349894,22349894,22350003,0,0,0,109
20704,22346236,22346236,22350706,0,0,0,4470
20718,22351214,22351214,22351328,0,0,0,114
20719,22351318,22351318,22351416,0,0,0,98
20720,22351420,22351420,22351519,0,0,0,99
20721,22351520,22351520,22351603,0,0,0,83
20722,22351567,22351567,22351657,0,0,0,90
20652,22322022,22322022,22351946,0,0,0,29924
20724,22351911,22351911,22351994,0,0,0,83
20723,22351873,22351873,22352040,0,0,0,167
20725,22351947,22351947,22352067,0,0,0,120
20729,22352107,22352107,22352148,0,0,0,41
20726,22351994,22351994,22352150,0,0,0,156
20728,22352106,22352106,22352209,0,0,0,103
20653,22322236,22322236,22352430,0,0,0,30194
20732,22352473,22352473,22352571,0,0,0,98
20730,22352247,22352247,22352847,0,0,0,600
20733,22352833,22352833,22352937,0,0,0,104
20734,22353301,22353301,22353355,0,0,0,54
20735,22353359,22353359,22353415,0,0,0,56
20736,22353379,22353379,22353498,0,0,0,119
20737,22353608,22353608,22353676,0,0,0,68
20738,22354266,22354266,22354302,0,0,0,36
20739,22354547,22354547,22354646,0,0,0,99
20740,22354891,22354891,22355000,0,0,0,109
20717,22350670,22350670,22355102,0,0,0,4432
20742,22355106,22355106,22355173,0,0,0,67
20743,22355137,22355137,22355236,0,0,0,99
20664,22328908,22328908,22355261,0,0,0,26353
20745,22355318,22355318,22355417,0,0,0,99
20746,22355463,22355463,22355593,0,0,0,130
20747,22355814,22355814,22355892,0,0,0,78
20748,22355894,22355894,22355961,0,0,0,67
20749,22356115,22356115,22356162,0,0,0,47
20750,22356301,22356301,22356430,0,0,0,129
20751,22356745,22356745,22356843,0,0,0,98
20752,22357032,22357032,22357079,0,0,0,47
20753,22357206,22357206,22357284,0,0,0,78
20453,22184652,22184652,22357452,0,0,0,172800
20754,22357363,22357363,22357459,0,0,0,96
20755,22357689,22357689,22357769,0,0,0,80
20756,22357768,22357768,22357835,0,0,0,67
20675,22331196,22331196,22358126,0,0,0,26930
20674,22331154,22331154,22358213,0,0,0,27059
20741,22355035,22355035,22359527,0,0,0,4492
20691,22337004,22337004,22363594,0,0,0,26590
20759,22359490,22359490,22363952,0,0,0,4462
20693,22339760,22339760,22363988,0,0,0,24228
20694,22341062,22341062,22365393,0,0,0,24331
20761,22363908,22363908,22368415,0,0,0,4507
20764,22368359,22368359,22372940,0,0,0,4581
20256,22029496,22029496,22375096,0,0,0,345600
20765,22372877,22372877,22377475,0,0,0,4598
20391,22121543,22121543,22380743,0,0,0,259200
20392,22121552,22121552,22380752,0,0,0,259200
20393,22121571,22121571,22380771,0,0,0,259200
20394,22121576,22121576,22380776,0,0,0,259200
20395,22121581,22121581,22380781,0,0,0,259200
20744,22355202,22355202,22381636,0,0,0,26434
20766,22377413,22377413,22381993,0,0,0,4580
20727,22352105,22352105,22382300,0,0,0,30195
20731,22352364,22352364,22382388,0,0,0,30024
20702,22344835,22344835,22384097,0,0,0,39262
20757,22358060,22358060,22384786,0,0,0,26726
20758,22358150,22358150,22384964,0,0,0,26814
20769,22381931,22381931,22386536,0,0,0,4605
20762,22363921,22363921,22388417,0,0,0,24496
20703,22344905,22344905,22388790,0,0,0,43885
20763,22365322,22365322,22389229,0,0,0,23907
20760,22363524,22363524,22390041,0,0,0,26517
20774,22386467,22386467,22391107,0,0,0,4640
20714,22349448,22349448,22392648,0,0,0,43200
20778,22391044,22391044,22395714,0,0,0,4670
20779,22395659,22395659,22400222,0,0,0,4563
20780,22400176,22400176,22404813,0,0,0,4637
20782,22405821,22405821,22405993,0,0,0,172
20784,22405900,22405900,22406087,0,0,0,187
20783,22405844,22405844,22406118,0,0,0,274
20786,22407505,22407505,22407634,0,0,0,129
20517,22240165,22240165,22407668,0,0,0,167503
20768,22381576,22381576,22408198,0,0,0,26622
20787,22408133,22408133,22408295,0,0,0,162
20788,22408161,22408161,22408297,0,0,0,136
20790,22408265,22408265,22408375,0,0,0,110
20789,22408241,22408241,22408425,0,0,0,184
20796,22408702,22408702,22408800,0,0,0,98
20798,22408993,22408993,22409113,0,0,0,120
20799,22409019,22409019,22409262,0,0,0,243
20781,22404755,22404755,22409380,0,0,0,4625
20797,22408803,22408803,22409703,0,0,0,900
20801,22409470,22409470,22409742,0,0,0,272
20804,22410298,22410298,22410391,0,0,0,93
20803,22410278,22410278,22410961,0,0,0,683
20805,22411068,22411068,22411172,0,0,0,104
20806,22411139,22411139,22411243,0,0,0,104
20772,22384718,22384718,22411495,0,0,0,26777
20808,22411548,22411548,22411658,0,0,0,110
20809,22411626,22411626,22411702,0,0,0,76
20771,22382329,22382329,22411733,0,0,0,29404
20810,22411670,22411670,22411842,0,0,0,172
20773,22384901,22384901,22411902,0,0,0,27001
20770,22382240,22382240,22411926,0,0,0,29686
20775,22388377,22388377,22412363,0,0,0,23986
20815,22412646,22412646,22412744,0,0,0,98
20816,22412854,22412854,22412952,0,0,0,98
20817,22412952,22412952,22412999,0,0,0,47
20818,22413003,22413003,22413087,0,0,0,84
20819,22413157,22413157,22413215,0,0,0,58
20820,22413290,22413290,22413358,0,0,0,68
20776,22389192,22389192,22413392,0,0,0,24200
20821,22413320,22413320,22413397,0,0,0,77
20823,22413360,22413360,22413397,0,0,0,37
20825,22413511,22413511,22413603,0,0,0,92
20829,22413705,22413705,22413765,0,0,0,60
20831,22413730,22413730,22413793,0,0,0,63
20834,22413797,22413797,22413895,0,0,0,98
20800,22409317,22409317,22414083,0,0,0,4766
20830,22413711,22413711,22414190,0,0,0,479
20832,22413738,22413738,22414240,0,0,0,502
20828,22413681,22413681,22414295,0,0,0,614
20837,22414259,22414259,22414326,0,0,0,67
20827,22413661,22413661,22414760,0,0,0,1099
20663,22328642,22328642,22415042,0,0,0,86400
20838,22415235,22415235,22415302,0,0,0,67
20839,22415502,22415502,22415626,0,0,0,124
20826,22413578,22413578,22415694,0,0,0,2116
20840,22415637,22415637,22415694,0,0,0,57
20841,22415658,22415658,22415756,0,0,0,98
20842,22415802,22415802,22415869,0,0,0,67
20824,22413413,22413413,22415870,0,0,0,2457
20843,22415875,22415875,22415957,0,0,0,82
20844,22415957,22415957,22416042,0,0,0,85
20845,22415982,22415982,22416071,0,0,0,89
20846,22416086,22416086,22416153,0,0,0,67
20847,22416189,22416189,22416277,0,0,0,88
20777,22389986,22389986,22416494,0,0,0,26508
20848,22416402,22416402,22416574,0,0,0,172
20849,22416511,22416511,22416682,0,0,0,171
20850,22416619,22416619,22416788,0,0,0,169
20836,22414020,22414020,22418743,0,0,0,4723
20785,22406631,22406631,22419207,0,0,0,12576
20428,22167672,22167672,22420272,0,0,0,252600
20853,22422433,22422433,22422551,0,0,0,118
20854,22422498,22422498,22422592,0,0,0,94
20855,22422529,22422529,22422654,0,0,0,125
20856,22422648,22422648,22422784,0,0,0,136
20857,22422731,22422731,22422814,0,0,0,83
20858,22422748,22422748,22422889,0,0,0,141
20859,22422837,22422837,22422973,0,0,0,136
20861,22423004,22423004,22423082,0,0,0,78
20860,22422937,22422937,22423088,0,0,0,151
20863,22423182,22423182,22423273,0,0,0,91
20852,22418676,22418676,22423331,0,0,0,4655
20697,22343301,22343301,22424301,0,0,0,81000
20865,22424720,22424720,22424844,0,0,0,124
20866,22424845,22424845,22424969,0,0,0,124
20867,22425064,22425064,22425188,0,0,0,124
20868,22425448,22425448,22425509,0,0,0,61
20707,22348124,22348124,22425535,0,0,0,77411
20870,22425635,22425635,22425702,0,0,0,67
20871,22425978,22425978,22426144,0,0,0,166
20873,22426183,22426183,22426783,0,0,0,600
20872,22426118,22426118,22426924,0,0,0,806
20875,22426950,22426950,22427001,0,0,0,51
20862,22423047,22423047,22427266,0,0,0,4219
20874,22426877,22426877,22427270,0,0,0,393
20877,22427227,22427227,22427363,0,0,0,136
20878,22427300,22427300,22427394,0,0,0,94
20869,22425477,22425477,22427582,0,0,0,2105
20879,22427535,22427535,22427602,0,0,0,67
20880,22427634,22427634,22427719,0,0,0,85
20882,22427726,22427726,22427820,0,0,0,94
20883,22427881,22427881,22427928,0,0,0,47
20864,22423273,22423273,22427991,0,0,0,4718
20885,22427940,22427940,22428142,0,0,0,202
20889,22428284,22428284,22428359,0,0,0,75
20891,22428324,22428324,22428423,0,0,0,99
20887,22428238,22428238,22428492,0,0,0,254
20892,22428440,22428440,22428585,0,0,0,145
20893,22428935,22428935,22429112,0,0,0,177
20895,22429218,22429218,22429313,0,0,0,95
20876,22426969,22426969,22429698,0,0,0,2729
20896,22429577,22429577,22429698,0,0,0,121
20894,22429107,22429107,22429707,0,0,0,600
20899,22429655,22429655,22429733,0,0,0,78
20898,22429650,22429650,22429761,0,0,0,111
20900,22429704,22429704,22429773,0,0,0,69
20897,22429628,22429628,22429801,0,0,0,173
20901,22429758,22429758,22430467,0,0,0,709
20903,22430380,22430380,22430511,0,0,0,131
20906,22430480,22430480,22430573,0,0,0,93
20905,22430474,22430474,22430598,0,0,0,124
20904,22430456,22430456,22430798,0,0,0,342
20908,22430703,22430703,22430875,0,0,0,172
20907,22430652,22430652,22431111,0,0,0,459
20912,22431110,22431110,22431194,0,0,0,84
20911,22431050,22431050,22431237,0,0,0,187
20913,22431155,22431155,22431279,0,0,0,124
20914,22431428,22431428,22431537,0,0,0,109
20909,22430995,22430995,22431595,0,0,0,600
20915,22431428,22431428,22431596,0,0,0,168
20916,22431607,22431607,22431772,0,0,0,165
20910,22431021,22431021,22431782,0,0,0,761
20918,22431788,22431788,22431898,0,0,0,110
20833,22413744,22413744,22432013,0,0,0,18269
20921,22431984,22431984,22432149,0,0,0,165
20922,22432046,22432046,22432200,0,0,0,154
20923,22432105,22432105,22432291,0,0,0,186
20924,22432247,22432247,22432369,0,0,0,122
20884,22427927,22427927,22432661,0,0,0,4734
20919,22431911,22431911,22432721,0,0,0,810
20926,22432430,22432430,22433030,0,0,0,600
20917,22431747,22431747,22433332,0,0,0,1585
20929,22433329,22433329,22433461,0,0,0,132
20925,22432336,22432336,22434136,0,0,0,1800
20932,22434241,22434241,22434365,0,0,0,124
20931,22434189,22434189,22434425,0,0,0,236
20933,22434391,22434391,22434469,0,0,0,78
20934,22434615,22434615,22434683,0,0,0,68
20935,22434784,22434784,22434866,0,0,0,82
20936,22434893,22434893,22434992,0,0,0,99
20791,22408344,22408344,22435033,0,0,0,26689
20938,22435356,22435356,22435527,0,0,0,171
20814,22412303,22412303,22436179,0,0,0,23876
20939,22435646,22435646,22436246,0,0,0,600
20928,22432577,22432577,22437248,0,0,0,4671
20822,22413341,22413341,22437670,0,0,0,24329
20945,22438059,22438059,22438133,0,0,0,74
20948,22438060,22438060,22438133,0,0,0,73
20946,22438060,22438060,22438153,0,0,0,93
20949,22438060,22438060,22438153,0,0,0,93
20950,22438061,22438061,22438154,0,0,0,93
20951,22438061,22438061,22438154,0,0,0,93
20952,22438061,22438061,22438154,0,0,0,93
20953,22438061,22438061,22438154,0,0,0,93
20954,22438062,22438062,22438155,0,0,0,93
20947,22438060,22438060,22438164,0,0,0,104
20955,22438062,22438062,22438169,0,0,0,107
20956,22438062,22438062,22438169,0,0,0,107
20957,22438063,22438063,22438173,0,0,0,110
20964,22438064,22438154,22438209,0,0,90,145
20963,22438064,22438154,22438231,0,0,90,167
20807,22411442,22411442,22438236,0,0,0,26794
20959,22438063,22438133,22438237,0,0,70,174
20962,22438064,22438154,22438242,0,0,90,178
20958,22438063,22438133,22438243,0,0,70,180
20960,22438063,22438153,22438246,0,0,90,183
20961,22438064,22438153,22438252,0,0,89,188
20944,22437923,22437923,22438523,0,0,0,600
20812,22411838,22411838,22438783,0,0,0,26945
20969,22439033,22439033,22439143,0,0,0,110
20968,22438790,22438790,22439390,0,0,0,600
20991,22439804,22439804,22440094,0,0,0,290
20990,22439748,22439748,22440248,0,0,0,500
20966,22438589,22438589,22440338,0,0,0,1749
20992,22440415,22440415,22440940,0,0,0,525
21093,22440999,22440999,22441077,0,0,0,78
21094,22441258,22441258,22441387,0,0,0,129
20813,22411870,22411870,22441522,0,0,0,29652
21096,22441695,22441695,22441765,0,0,0,70
21097,22441731,22441731,22441767,0,0,0,36
20940,22437197,22437197,22441845,0,0,0,4648
20811,22411780,22411780,22441937,0,0,0,30157
21099,22441874,22441874,22442046,0,0,0,172
21102,22442187,22442187,22442223,0,0,0,36
21101,22442157,22442157,22442224,0,0,0,67
21103,22442349,22442349,22442407,0,0,0,58
21104,22442394,22442394,22442560,0,0,0,166
20851,22416726,22416726,22443165,0,0,0,26439
20368,22097698,22097698,22443298,0,0,0,345600
21106,22443211,22443211,22443332,0,0,0,121
21109,22443898,22443898,22444022,0,0,0,124
20941,22437528,22437528,22444128,0,0,0,6600
20943,22437734,22437734,22444334,0,0,0,6600
21107,22443798,22443798,22444384,0,0,0,586
21108,22443896,22444128,22444854,0,0,232,958
20976,22439604,22439604,22445040,0,0,0,5436
20970,22439604,22439604,22445044,0,0,0,5440
20973,22439604,22439604,22445061,0,0,0,5457
20980,22439605,22439605,22445066,0,0,0,5461
20979,22439605,22439605,22445072,0,0,0,5467
20981,22439605,22439605,22445072,0,0,0,5467
20982,22439605,22439605,22445125,0,0,0,5520
20974,22439604,22439604,22445357,0,0,0,5753
20975,22439604,22439604,22445373,0,0,0,5769
20978,22439605,22439605,22445384,0,0,0,5779
20971,22439604,22439604,22445643,0,0,0,6039
20977,22439605,22439605,22445665,0,0,0,6060
20972,22439604,22439604,22445682,0,0,0,6078
21098,22441789,22441789,22446454,0,0,0,4665
21110,22445828,22445828,22446603,0,0,0,775
20983,22439605,22443298,22449067,0,0,3693,9462
20984,22439606,22445040,22450507,0,0,5434,10901
20985,22439606,22445044,22450511,0,0,5438,10905
20986,22439606,22445061,22450528,0,0,5455,10922
20993,22440522,22445125,22450592,0,0,4603,10070
20987,22439606,22445066,22450804,0,0,5460,11198
20988,22439606,22445072,22450841,0,0,5466,11235
20994,22440523,22445357,22450866,0,0,4834,10343
20989,22439606,22445072,22451102,0,0,5466,11496
20995,22440523,22445373,22451111,0,0,4850,10588
20997,22440524,22445643,22451152,0,0,5119,10628
21111,22446398,22446454,22451173,0,0,56,4775
20996,22440523,22445384,22451402,0,0,4861,10879
20998,22440524,22445665,22451434,0,0,5141,10910
20999,22440524,22445682,22451774,0,0,5158,11250
20792,22408394,22408394,22452622,0,0,0,44228
21112,22451059,22451059,22455756,0,0,0,4697
21001,22440525,22450507,22456016,0,0,9982,15491
21002,22440525,22450511,22456063,0,0,9986,15538
21005,22440526,22450804,22456313,0,0,10278,15787
21003,22440525,22450528,22456340,0,0,10003,15815
21009,22440527,22451111,22456577,0,0,10584,16050
21006,22440526,22450841,22456610,0,0,10315,16084
21010,22440527,22451152,22456618,0,0,10625,16091
21007,22440526,22450866,22456635,0,0,10340,16109
21004,22440525,22450592,22456653,0,0,10067,16128
21011,22440527,22451402,22456868,0,0,10875,16341
21008,22440526,22451102,22456945,0,0,10576,16419
21012,22440528,22451434,22457203,0,0,10906,16675
21013,22440608,22451774,22457240,0,0,11166,16632
21015,22440608,22452622,22458080,0,0,12014,17472
21014,22440608,22452622,22458088,0,0,12014,17480
21017,22440609,22452622,22458387,0,0,12013,17778
21018,22440609,22452622,22458680,0,0,12013,18071
21016,22440609,22452622,22458686,0,0,12013,18077
21113,22455693,22455693,22460422,0,0,0,4729
21019,22440609,22456016,22461478,0,0,15407,20869
20937,22434991,22434991,22461535,0,0,0,26544
21022,22440610,22456340,22461824,0,0,15730,21214
21020,22440610,22456063,22461848,0,0,15453,21238
20942,22437607,22437607,22461856,0,0,0,24249
21023,22440610,22456577,22462048,0,0,15967,21438
21021,22440610,22456313,22462094,0,0,15703,21484
21026,22440611,22456635,22462119,0,0,16024,21508
21024,22440611,22456610,22462369,0,0,15999,21758
21030,22440612,22457203,22462671,0,0,16591,22059
21025,22440611,22456618,22462676,0,0,16007,22065
21027,22440611,22456653,22462695,0,0,16042,22084
21028,22440612,22456868,22462934,0,0,16256,22322
21029,22440612,22456945,22462980,0,0,16333,22368
21031,22440612,22457240,22463297,0,0,16628,22685
20470,22204341,22204341,22463541,0,0,0,259200
20472,22204342,22204342,22463542,0,0,0,259200
20473,22204342,22204342,22463542,0,0,0,259200
20474,22204342,22204342,22463542,0,0,0,259200
20475,22204342,22204342,22463542,0,0,0,259200
20476,22204342,22204342,22463542,0,0,0,259200
21032,22440612,22458080,22463848,0,0,17468,23236
20477,22204745,22204745,22463945,0,0,0,259200
21033,22440626,22458088,22464127,0,0,17462,23501
20478,22204973,22204973,22464173,0,0,0,259200
21034,22440626,22458387,22464214,0,0,17761,23588
21036,22440627,22458686,22464441,0,0,18059,23814
21035,22440626,22458680,22464728,0,0,18054,24102
21114,22460381,22460381,22465024,0,0,0,4643
20480,22205845,22205845,22465045,0,0,0,259200
20965,22438192,22438192,22465144,0,0,0,26952
20967,22438717,22438717,22465328,0,0,0,26611
21037,22440627,22461478,22466960,0,0,20851,26333
21038,22440627,22461824,22467286,0,0,21197,26659
21039,22440627,22461848,22467616,0,0,21221,26989
21040,22440627,22462048,22467847,0,0,21421,27220
21042,22440627,22462119,22467890,0,0,21492,27263
21043,22440628,22462369,22468131,0,0,21741,27503
21041,22440627,22462094,22468152,0,0,21467,27525
21044,22440628,22462671,22468434,0,0,22043,27806
21048,22440628,22462980,22468446,0,0,22352,27818
21045,22440628,22462676,22468470,0,0,22048,27842
21047,22440628,22462934,22468677,0,0,22306,28049
21046,22440628,22462695,22468730,0,0,22067,28102
21049,22440629,22463297,22469104,0,0,22668,28475
21050,22440629,22463542,22469307,0,0,22913,28678
21051,22440630,22463848,22469340,0,0,23218,28710
21053,22440658,22464127,22469586,0,0,23469,28928
20930,22433599,22433599,22469599,0,0,0,36000
21128,22464992,22464992,22469614,0,0,0,4622
21054,22440660,22464214,22469680,0,0,23554,29020
21105,22443121,22443121,22469689,0,0,0,26568
21052,22440630,22463945,22469998,0,0,23315,29368
21055,22440660,22464441,22470169,0,0,23781,29509
21056,22440660,22464728,22470241,0,0,24068,29581
21095,22441480,22441480,22471438,0,0,0,29958
21100,22441985,22441985,22471590,0,0,0,29605
21058,22440661,22467286,22472748,0,0,26625,32087
21057,22440660,22466960,22472998,0,0,26300,32338
21000,22440524,22449067,22473065,0,0,8543,32541
21060,22440661,22467847,22473326,0,0,27186,32665
21059,22440661,22467616,22473385,0,0,26955,32724
21062,22440662,22468131,22473592,0,0,27469,32930
21063,22440662,22468152,22473593,0,0,27490,32931
21061,22440661,22467890,22473656,0,0,27229,32995
21066,22440663,22468470,22473974,0,0,27807,33311
21067,22440663,22468677,22474150,0,0,28014,33487
21064,22440662,22468434,22474186,0,0,27772,33524
21065,22440662,22468446,22474500,0,0,27784,33838
21070,22440664,22469307,22474775,0,0,28643,34111
21068,22440663,22468730,22474808,0,0,28067,34145
21071,22440664,22469340,22474839,0,0,28676,34175
21069,22440663,22469104,22474886,0,0,28441,34223
21073,22440683,22469599,22475074,0,0,28916,34391
21135,22471367,22475074,22475256,0,0,3707,3889
21136,22471485,22475256,22475402,0,0,3771,3917
21075,22440684,22469998,22475471,0,0,29314,34787
21072,22440664,22469586,22475660,0,0,28922,34996
21074,22440684,22469680,22475739,0,0,28996,35055
21076,22440684,22470169,22475897,0,0,29485,35213
21077,22440684,22470241,22475995,0,0,29557,35311
21078,22440685,22472748,22478196,0,0,32063,37511
21079,22440685,22472998,22478798,0,0,32313,38113
21081,22440685,22473326,22478804,0,0,32641,38119
21080,22440685,22473065,22478831,0,0,32380,38146
21082,22440686,22473385,22478863,0,0,32699,38177
21083,22440686,22473592,22479066,0,0,32906,38380
21085,22440686,22473656,22479141,0,0,32970,38455
21139,22474048,22474886,22479416,0,0,838,5368
21086,22440687,22473974,22479443,0,0,33287,38756
21133,22469547,22474886,22479457,0,0,5339,9910
21087,22440687,22474150,22479612,0,0,33463,38925
21084,22440686,22473593,22479619,0,0,32907,38933
21088,22440687,22474186,22479663,0,0,33499,38976
21089,22440687,22474500,22480531,0,0,33813,39844
21090,22440687,22474775,22480858,0,0,34088,40171
21091,22440688,22474808,22480891,0,0,34120,40203
21092,22440688,22474839,22480953,0,0,34151,40265
21140,22478543,22478543,22483175,0,0,0,4632
21119,22461791,22461856,22485993,0,0,65,24202
21141,22483113,22483175,22487762,0,0,62,4649
21117,22461493,22461535,22488033,0,0,42,26540
20886,22428223,22428223,22490989,0,0,0,62766
20888,22428250,22428250,22491223,0,0,0,62973
20902,22430297,22430297,22491319,0,0,0,61022
21143,22487637,22487762,22492357,0,0,125,4720
21150,22495838,22495838,22496148,0,0,0,310
21129,22465081,22469689,22496351,0,0,4608,31270
21153,22496510,22496510,22496616,0,0,0,106
21146,22492170,22492170,22496690,0,0,0,4520
21155,22496583,22496583,22496754,0,0,0,171
21158,22496918,22496918,22497427,0,0,0,509
21130,22465300,22471438,22498488,0,0,6138,33188
21160,22497098,22498488,22498561,0,0,1390,1463
21157,22496828,22496828,22498628,0,0,0,1800
21168,22498208,22498208,22498633,0,0,0,425
21161,22497182,22498561,22498654,0,0,1379,1472
21162,22497372,22498628,22498721,0,0,1256,1349
21163,22497399,22498654,22498800,0,0,1255,1401
21166,22497844,22498721,22498814,0,0,877,970
21170,22498960,22498960,22499040,0,0,0,80
21172,22499031,22499031,22499129,0,0,0,98
21159,22496933,22497427,22499227,0,0,494,2294
21173,22499543,22499543,22499678,0,0,0,135
21175,22499780,22499780,22499847,0,0,0,67
21174,22499645,22499678,22499849,0,0,33,204
21176,22499849,22499849,22500020,0,0,0,171
21178,22500168,22500168,22500328,0,0,0,160
20523,22241401,22241401,22500601,0,0,0,259200
21171,22498978,22498978,22500740,0,0,0,1762
21179,22500687,22500687,22500812,0,0,0,125
21180,22500807,22500807,22500958,0,0,0,151
21156,22496644,22496644,22501165,0,0,0,4521
21177,22499892,22499892,22501692,0,0,0,1800
21134,22469622,22474886,22501826,0,0,5264,32204
21183,22501216,22501692,22501856,0,0,476,640
21185,22501580,22501580,22501942,0,0,0,362
21184,22501413,22501826,22502324,0,0,413,911
21188,22502234,22502234,22502927,0,0,0,693
21189,22503550,22503550,22504243,0,0,0,693
21190,22504513,22504513,22504884,0,0,0,371
21137,22471521,22475402,22505153,0,0,3881,33632
21138,22471587,22475471,22505357,0,0,3884,33770
21182,22501124,22501124,22505647,0,0,0,4523
21181,22500829,22500829,22506387,0,0,0,5558
20890,22428303,22428303,22506439,0,0,0,78136
21164,22497541,22506439,22506532,0,0,8898,8991
21167,22498134,22506532,22506641,0,0,8398,8507
21191,22505351,22506641,22506734,0,0,1290,1383
21194,22507029,22507029,22507238,0,0,0,209
21196,22507340,22507340,22507527,0,0,0,187
21193,22505768,22505768,22507568,0,0,0,1800
21197,22507387,22507387,22507611,0,0,0,224
21198,22507579,22507579,22507723,0,0,0,144
21199,22507726,22507726,22507877,0,0,0,151
21201,22507927,22507927,22508045,0,0,0,118
20706,22347472,22347472,22508065,0,0,0,160593
21203,22508301,22508301,22508912,0,0,0,611
21195,22507093,22507093,22508915,0,0,0,1822
21204,22508819,22508819,22509408,0,0,0,589
21200,22507846,22507846,22509646,0,0,0,1800
21142,22485951,22485993,22510101,0,0,42,24150
21192,22505583,22505583,22510133,0,0,0,4550
21208,22510140,22510140,22510207,0,0,0,67
21205,22509990,22509990,22511492,0,0,0,1502
21210,22511079,22511079,22511918,0,0,0,839
21214,22512559,22512559,22512626,0,0,0,67
21215,22512629,22512629,22512696,0,0,0,67
21213,22512394,22512394,22512965,0,0,0,571
21211,22511612,22511612,22513090,0,0,0,1478
21216,22512733,22512733,22513117,0,0,0,384
21217,22512868,22513090,22513214,0,0,222,346
21218,22513606,22513606,22513688,0,0,0,82
21219,22513651,22513651,22513718,0,0,0,67
21220,22513714,22513714,22513761,0,0,0,47
21212,22511842,22511842,22513788,0,0,0,1946
21221,22513807,22513807,22513885,0,0,0,78
21207,22510070,22510070,22513917,0,0,0,3847
21222,22513807,22513807,22514195,0,0,0,388
21223,22514388,22514388,22514484,0,0,0,96
21224,22514452,22514452,22514541,0,0,0,89
21144,22487971,22488033,22514649,0,0,62,26678
21226,22514567,22514567,22514867,0,0,0,300
21225,22514505,22514505,22514872,0,0,0,367
21228,22515297,22515297,22515609,0,0,0,312
21230,22515832,22515832,22515879,0,0,0,47
21231,22515975,22515975,22516230,0,0,0,255
21233,22516199,22516199,22516458,0,0,0,259
21232,22516190,22516190,22516539,0,0,0,349
21234,22516417,22516417,22516829,0,0,0,412
21238,22516978,22516978,22517045,0,0,0,67
21237,22516922,22516922,22517301,0,0,0,379
21235,22516539,22516539,22517408,0,0,0,869
21229,22515620,22515620,22517420,0,0,0,1800
21243,22517855,22517855,22517933,0,0,0,78
21145,22491746,22491746,22518440,0,0,0,26694
21245,22518387,22518387,22518472,0,0,0,85
21147,22492289,22492289,22518792,0,0,0,26503
21239,22517394,22517394,22519172,0,0,0,1778
21227,22514577,22514577,22519587,0,0,0,5010
21248,22519205,22519205,22519615,0,0,0,410
21251,22520142,22520142,22520323,0,0,0,181
21244,22518033,22518033,22520392,0,0,0,2359
21253,22520286,22520286,22520396,0,0,0,110
21256,22520759,22520759,22520839,0,0,0,80
21257,22520894,22520894,22520962,0,0,0,68
21259,22521122,22521122,22521189,0,0,0,67
21249,22519580,22519580,22521380,0,0,0,1800
21262,22521466,22521466,22521601,0,0,0,135
21263,22521564,22521564,22522820,0,0,0,1256
21152,22496509,22496509,22523436,0,0,0,26927
21265,22522916,22522916,22523567,0,0,0,651
21268,22524346,22524346,22524560,0,0,0,214
21250,22519596,22519596,22524580,0,0,0,4984
21270,22524908,22524908,22525327,0,0,0,419
21273,22526058,22526058,22526483,0,0,0,425
21274,22526603,22526603,22526815,0,0,0,212
21202,22507982,22507982,22529582,0,0,0,21600
21240,22517609,22529582,22529675,0,0,11973,12066
21241,22517625,22529675,22529768,0,0,12050,12143
21255,22520696,22529768,22529861,0,0,9072,9165
21258,22521042,22529861,22529985,0,0,8819,8943
21260,22521194,22529985,22530109,0,0,8791,8915
21266,22523600,22530109,22530561,0,0,6509,6961
21269,22524376,22530561,22531023,0,0,6185,6647
21242,22517668,22523567,22531047,0,0,5899,13379
21271,22524957,22531023,22531426,0,0,6066,6469
21276,22527758,22531047,22531590,0,0,3289,3832
21186,22501585,22501856,22532006,0,0,271,30421
21277,22529347,22531426,22532421,0,0,2079,3074
21187,22502072,22502324,22532486,0,0,252,30414
21280,22532091,22532421,22532598,0,0,330,507
21282,22532202,22532486,22532658,0,0,284,456
21279,22530741,22532006,22532740,0,0,1265,1999
21283,22532316,22532598,22532796,0,0,282,480
21206,22510038,22510038,22534071,0,0,0,24033
21247,22518782,22518792,22545428,0,0,10,26646
21246,22518440,22518440,22545546,0,0,0,27106
20627,22289318,22289318,22548518,0,0,0,259200
20628,22289318,22289318,22548518,0,0,0,259200
20629,22289319,22289319,22548519,0,0,0,259200
20630,22289319,22289319,22548519,0,0,0,259200
20631,22289348,22289348,22548548,0,0,0,259200
20632,22289349,22289349,22548549,0,0,0,259200
21289,22542308,22548518,22548591,0,0,6210,6283
20795,22408533,22408533,22549352,0,0,0,140819
21151,22496501,22549352,22549869,0,0,52851,53368
21165,22497716,22549869,22549963,0,0,52153,52247
21288,22537536,22545546,22549988,0,0,8010,12452
20633,22290791,22290791,22549991,0,0,0,259200
21169,22498282,22549963,22550056,0,0,51681,51774
21254,22520327,22550056,22550153,0,0,29729,29826
21290,22542339,22548519,22550186,0,0,6180,7847
21264,22522034,22550153,22550270,0,0,28119,28236
21267,22523680,22524580,22551075,0,0,900,27395
21272,22525850,22531047,22557237,0,0,5197,31387
21281,22532154,22532421,22561990,0,0,267,29836
20635,22290968,22290968,22562105,0,0,0,271137
21284,22532469,22532658,22562531,0,0,189,30062
21285,22534073,22545428,22569628,0,0,11355,35555
21292,22545916,22548591,22575166,0,0,2675,29250
21300,22550120,22550120,22576549,0,0,0,26429
21293,22546226,22549869,22576921,0,0,3643,30695
21302,22551980,22551980,22578218,0,0,0,26238
21312,22576510,22576510,22581548,0,0,0,5038
21303,22558229,22558229,22582639,0,0,0,24410
21318,22581854,22581854,22583654,0,0,0,1800
21321,22584065,22584065,22584159,0,0,0,94
21320,22584027,22584027,22584259,0,0,0,232
21322,22584155,22584155,22584259,0,0,0,104
21324,22584958,22584958,22585211,0,0,0,253
21326,22586433,22586433,22586794,0,0,0,361
20835,22413997,22413997,22586797,0,0,0,172800
21329,22586434,22586434,22586981,0,0,0,547
21338,22586497,22586497,22587003,0,0,0,506
21327,22586433,22586433,22587033,0,0,0,600
21328,22586433,22586433,22587033,0,0,0,600
21330,22586434,22586434,22587034,0,0,0,600
21331,22586434,22586434,22587034,0,0,0,600
21332,22586434,22586434,22587034,0,0,0,600
21333,22586434,22586434,22587034,0,0,0,600
21334,22586435,22586435,22587035,0,0,0,600
21335,22586435,22586435,22587035,0,0,0,600
21336,22586435,22586435,22587035,0,0,0,600
21337,22586435,22586435,22587035,0,0,0,600
21339,22586497,22586497,22587097,0,0,0,600
21340,22586497,22586497,22587097,0,0,0,600
21341,22586498,22586498,22587098,0,0,0,600
21342,22586498,22586498,22587098,0,0,0,600
21343,22586498,22586498,22587098,0,0,0,600
21344,22586498,22586498,22587098,0,0,0,600
21345,22586499,22586499,22587099,0,0,0,600
20794,22408487,22408487,22587279,0,0,0,178792
21349,22587713,22587713,22588313,0,0,0,600
21350,22587713,22587713,22588313,0,0,0,600
21351,22587714,22587714,22588314,0,0,0,600
21352,22587714,22587714,22588314,0,0,0,600
21353,22587714,22587714,22588314,0,0,0,600
21354,22587714,22587714,22588314,0,0,0,600
21355,22587715,22587715,22588315,0,0,0,600
21356,22587715,22587715,22588315,0,0,0,600
21357,22587715,22587715,22588315,0,0,0,600
21358,22587715,22587715,22588315,0,0,0,600
21359,22587716,22587716,22588316,0,0,0,600
21360,22587716,22587716,22588316,0,0,0,600
21361,22587716,22587716,22588316,0,0,0,600
21362,22587717,22587717,22588317,0,0,0,600
21363,22587717,22587717,22588317,0,0,0,600
21364,22587717,22587717,22588317,0,0,0,600
21365,22587717,22587717,22588317,0,0,0,600
21366,22587718,22587718,22588318,0,0,0,600
21367,22587718,22587718,22588318,0,0,0,600
21368,22587718,22587718,22588318,0,0,0,600
21370,22588900,22588900,22589140,0,0,0,240
21381,22589168,22589168,22589266,0,0,0,98
21376,22588902,22588902,22589291,0,0,0,389
21377,22588902,22588902,22589333,0,0,0,431
21371,22588900,22588900,22589500,0,0,0,600
21372,22588900,22588900,22589500,0,0,0,600
21373,22588901,22588901,22589501,0,0,0,600
21374,22588901,22588901,22589501,0,0,0,600
21375,22588901,22588901,22589501,0,0,0,600
21378,22588902,22588902,22589502,0,0,0,600
21379,22588902,22588902,22589502,0,0,0,600
21387,22590119,22590119,22590367,0,0,0,248
21395,22590121,22590121,22590369,0,0,0,248
21388,22590119,22590119,22590719,0,0,0,600
21389,22590119,22590119,22590719,0,0,0,600
21390,22590120,22590120,22590720,0,0,0,600
21391,22590120,22590120,22590720,0,0,0,600
21392,22590120,22590120,22590720,0,0,0,600
21393,22590120,22590120,22590720,0,0,0,600
21394,22590120,22590120,22590720,0,0,0,600
21396,22590121,22590121,22590721,0,0,0,600
21397,22591252,22591252,22591424,0,0,0,172
21398,22591360,22591424,22591596,0,0,64,236
21304,22561672,22561990,22591638,0,0,318,29966
21399,22591473,22591596,22591794,0,0,123,321
21400,22591623,22591638,22591815,0,0,15,192
21401,22591737,22591794,22591964,0,0,57,227
21402,22591851,22591851,22592022,0,0,0,171
21305,22562278,22562278,22592647,0,0,0,30369
21385,22589296,22589296,22592896,0,0,0,3600
21404,22592522,22592522,22593122,0,0,0,600
21405,22592522,22592522,22593122,0,0,0,600
21406,22592522,22592522,22593122,0,0,0,600
21407,22592523,22592523,22593123,0,0,0,600
21408,22592523,22592523,22593123,0,0,0,600
21409,22592523,22592523,22593123,0,0,0,600
21410,22592523,22592523,22593123,0,0,0,600
21411,22592523,22592523,22593123,0,0,0,600
21412,22592524,22592524,22593124,0,0,0,600
21413,22592524,22592524,22593124,0,0,0,600
20679,22334197,22334197,22593397,0,0,0,259200
21261,22521326,22530109,22593428,0,0,8783,72102
21236,22516777,22517420,22593504,0,0,643,76727
20680,22334349,22334349,22593549,0,0,0,259200
21306,22571450,22593504,22593608,0,0,22054,22158
21307,22572224,22593608,22593701,0,0,21384,21477
20681,22334502,22334502,22593702,0,0,0,259200
21309,22572745,22593701,22593794,0,0,20956,21049
21310,22573168,22593794,22593902,0,0,20626,20734
21291,22544848,22593397,22593972,0,0,48549,49124
21311,22573343,22593902,22594006,0,0,20559,20663
21415,22593683,22593702,22594114,0,0,19,431
21417,22594488,22594488,22594581,0,0,0,93
21418,22594704,22594704,22594782,0,0,0,78
21419,22594755,22594782,22594924,0,0,27,169
21416,22593854,22593972,22594954,0,0,118,1100
21424,22594926,22594926,22595315,0,0,0,389
21420,22594925,22594925,22595525,0,0,0,600
21421,22594925,22594925,22595525,0,0,0,600
21422,22594925,22594925,22595525,0,0,0,600
21423,22594925,22594925,22595525,0,0,0,600
21425,22594926,22594926,22595526,0,0,0,600
21426,22594926,22594926,22595526,0,0,0,600
21427,22594926,22594926,22595526,0,0,0,600
21428,22594926,22594926,22595526,0,0,0,600
21429,22594927,22594927,22595527,0,0,0,600
21437,22595724,22595724,22595971,0,0,0,247
21441,22596775,22596775,22596891,0,0,0,116
21442,22596855,22596855,22597000,0,0,0,145
21286,22535103,22587279,22597355,0,0,52176,62252
21316,22578560,22597355,22597448,0,0,18795,18888
21447,22597334,22597334,22597576,0,0,0,242
21445,22597148,22597148,22597587,0,0,0,439
21451,22597335,22597335,22597658,0,0,0,323
21457,22597520,22597520,22597756,0,0,0,236
21456,22597519,22597519,22597910,0,0,0,391
21446,22597328,22597328,22597928,0,0,0,600
21448,22597334,22597334,22597934,0,0,0,600
21449,22597334,22597334,22597934,0,0,0,600
21450,22597334,22597334,22597934,0,0,0,600
21452,22597335,22597335,22597935,0,0,0,600
21453,22597335,22597335,22597935,0,0,0,600
21454,22597335,22597335,22597935,0,0,0,600
21455,22597336,22597336,22597936,0,0,0,600
21461,22597521,22597521,22598046,0,0,0,525
21458,22597520,22597520,22598120,0,0,0,600
21459,22597520,22597520,22598120,0,0,0,600
21460,22597520,22597520,22598120,0,0,0,600
21462,22597521,22597521,22598121,0,0,0,600
21463,22597521,22597521,22598121,0,0,0,600
21464,22597521,22597521,22598121,0,0,0,600
21465,22597521,22597576,22598176,0,0,55,655
21467,22598161,22598161,22598199,0,0,0,38
21475,22598724,22598724,22598940,0,0,0,216
21468,22598342,22598342,22599031,0,0,0,689
21472,22598723,22598723,22599125,0,0,0,402
21476,22598724,22598724,22599199,0,0,0,475
21470,22598722,22598722,22599322,0,0,0,600
21471,22598722,22598722,22599322,0,0,0,600
21473,22598723,22598723,22599323,0,0,0,600
21474,22598723,22598723,22599323,0,0,0,600
21477,22598724,22598724,22599324,0,0,0,600
21478,22598724,22598724,22599324,0,0,0,600
21308,22572432,22572432,22599388,0,0,0,26956
21482,22599423,22599423,22599488,0,0,0,65
21495,22599811,22599811,22600021,0,0,0,210
21483,22599471,22599471,22600150,0,0,0,679
21485,22599736,22599736,22600336,0,0,0,600
21486,22599736,22599736,22600336,0,0,0,600
21487,22599737,22599737,22600337,0,0,0,600
21488,22599737,22599737,22600337,0,0,0,600
21489,22599737,22599737,22600337,0,0,0,600
21490,22599737,22599737,22600337,0,0,0,600
21491,22599738,22599738,22600338,0,0,0,600
21492,22599738,22599738,22600338,0,0,0,600
21493,22599738,22599738,22600338,0,0,0,600
21494,22599738,22599738,22600338,0,0,0,600
21496,22600446,22600446,22600786,0,0,0,340
21498,22600749,22600749,22600820,0,0,0,71
21430,22594979,22599388,22601120,0,0,4409,6141
21505,22601127,22601127,22601343,0,0,0,216
21501,22601126,22601126,22601373,0,0,0,247
21502,22601126,22601126,22601466,0,0,0,340
21500,22601125,22601125,22601682,0,0,0,557
21503,22601126,22601126,22601726,0,0,0,600
21504,22601126,22601126,22601726,0,0,0,600
21506,22601127,22601127,22601727,0,0,0,600
21507,22601127,22601127,22601727,0,0,0,600
21508,22601127,22601127,22601727,0,0,0,600
21287,22536892,22587279,22601853,0,0,50387,64961
21438,22595971,22601853,22601985,0,0,5882,6014
21432,22595321,22601853,22602019,0,0,6532,6698
21440,22596659,22601985,22602137,0,0,5326,5478
21443,22596906,22602019,22602174,0,0,5113,5268
21469,22598519,22602137,22602274,0,0,3618,3755
21479,22598782,22602174,22602329,0,0,3392,3547
21509,22602139,22602139,22602348,0,0,0,209
21480,22599136,22602274,22602429,0,0,3138,3293
21519,22602297,22602297,22602559,0,0,0,262
21510,22602139,22602139,22602739,0,0,0,600
21511,22602139,22602139,22602739,0,0,0,600
21512,22602139,22602139,22602739,0,0,0,600
21513,22602160,22602160,22602760,0,0,0,600
21514,22602161,22602161,22602761,0,0,0,600
21515,22602161,22602161,22602761,0,0,0,600
21516,22602161,22602161,22602761,0,0,0,600
21517,22602161,22602161,22602761,0,0,0,600
21518,22602162,22602162,22602762,0,0,0,600
21522,22603529,22603529,22603787,0,0,0,258
21526,22603530,22603530,22603788,0,0,0,258
21275,22526788,22550270,22603942,0,0,23482,77154
21527,22603530,22603530,22604047,0,0,0,517
21528,22603530,22603530,22604078,0,0,0,548
21520,22603528,22603528,22604107,0,0,0,579
21521,22603528,22603528,22604107,0,0,0,579
21523,22603529,22603529,22604129,0,0,0,600
21524,22603529,22603529,22604129,0,0,0,600
21525,22603529,22603529,22604129,0,0,0,600
21529,22603530,22603530,22604130,0,0,0,600
21530,22604252,22604252,22604351,0,0,0,99
21314,22578156,22578156,22604708,0,0,0,26552
21497,22600497,22604708,22604884,0,0,4211,4387
21499,22600779,22604884,22605016,0,0,4105,4237
21533,22604563,22604563,22605142,0,0,0,579
21531,22604562,22604562,22605162,0,0,0,600
21532,22604562,22604562,22605162,0,0,0,600
21534,22604563,22604563,22605163,0,0,0,600
21535,22604563,22604563,22605163,0,0,0,600
21536,22604563,22604563,22605163,0,0,0,600
21537,22604564,22604564,22605164,0,0,0,600
21538,22604564,22604564,22605164,0,0,0,600
21539,22604564,22604564,22605164,0,0,0,600
21540,22604564,22604564,22605164,0,0,0,600
21542,22605360,22605360,22605459,0,0,0,99
21543,22605638,22605638,22605823,0,0,0,185
21323,22584448,22603942,22606073,0,0,19494,21625
21544,22605931,22605931,22606086,0,0,0,155
21431,22595162,22606073,22606135,0,0,10911,10973
21439,22595997,22606135,22606238,0,0,10138,10241
21545,22605931,22605931,22606531,0,0,0,600
21546,22605931,22605931,22606531,0,0,0,600
21547,22605932,22605932,22606532,0,0,0,600
21548,22605932,22605932,22606532,0,0,0,600
21549,22605932,22605932,22606532,0,0,0,600
21550,22605932,22605932,22606532,0,0,0,600
21551,22605932,22605932,22606532,0,0,0,600
21552,22605933,22605933,22606533,0,0,0,600
21553,22605933,22605933,22606533,0,0,0,600
21319,22582578,22582578,22606596,0,0,0,24018
21466,22597605,22606073,22606761,0,0,8468,9156
21555,22606965,22606965,22607189,0,0,0,224
21558,22606966,22606966,22607266,0,0,0,300
21565,22607353,22607353,22607390,0,0,0,37
21563,22607008,22607008,22607422,0,0,0,414
21556,22606965,22606965,22607565,0,0,0,600
21557,22606965,22606965,22607565,0,0,0,600
21559,22606966,22606966,22607566,0,0,0,600
21560,22606966,22606966,22607566,0,0,0,600
21561,22606966,22606966,22607566,0,0,0,600
21562,22606966,22606966,22607566,0,0,0,600
21564,22607008,22607008,22607608,0,0,0,600
20708,22348559,22348559,22607759,0,0,0,259200
21317,22581487,22581487,22607809,0,0,0,26322
21576,22608336,22608336,22608502,0,0,0,166
21572,22608335,22608335,22608687,0,0,0,352
21579,22608461,22608461,22608762,0,0,0,301
21573,22608335,22608335,22608895,0,0,0,560
21574,22608335,22608335,22608926,0,0,0,591
21577,22608336,22608336,22608927,0,0,0,591
21569,22608334,22608334,22608934,0,0,0,600
21570,22608334,22608334,22608934,0,0,0,600
21571,22608334,22608334,22608934,0,0,0,600
21575,22608335,22608335,22608935,0,0,0,600
21578,22608336,22608336,22608936,0,0,0,600
21586,22609538,22609538,22609677,0,0,0,139
21582,22609537,22609537,22610101,0,0,0,564
21587,22609538,22609538,22610102,0,0,0,564
21583,22609537,22609537,22610137,0,0,0,600
21584,22609537,22609537,22610137,0,0,0,600
21585,22609537,22609537,22610137,0,0,0,600
21588,22609538,22609538,22610138,0,0,0,600
21325,22585536,22597448,22612942,0,0,11912,27406
21568,22608299,22612942,22613109,0,0,4643,4810
21581,22608773,22613109,22613264,0,0,4336,4491
21589,22609995,22613264,22613432,0,0,3269,3437
21591,22610511,22613432,22613556,0,0,2921,3045
21599,22614673,22614673,22614740,0,0,0,67
21315,22578389,22594954,22614762,0,0,16565,36373
21590,22610030,22614762,22615014,0,0,4732,4984
21600,22614984,22614984,22615073,0,0,0,89
21592,22610650,22615014,22615468,0,0,4364,4818
21313,22577876,22594006,22616374,0,0,16130,38498
21601,22615034,22616374,22616540,0,0,1340,1506
21598,22614367,22614367,22619064,0,0,0,4697
21566,22607394,22612942,22620313,0,0,5548,12919
21414,22592579,22592579,22622008,0,0,0,29429
21580,22608730,22608762,22622045,0,0,32,13315
21403,22591960,22591964,22622065,0,0,4,30105
21604,22622017,22622017,22622163,0,0,0,146
21603,22621973,22621973,22622327,0,0,0,354
21602,22620860,22620860,22623240,0,0,0,2380
21594,22610653,22616374,22624191,0,0,5721,13538
21608,22625505,22625505,22625573,0,0,0,68
21609,22625594,22625594,22625679,0,0,0,85
21611,22625742,22625742,22625809,0,0,0,67
21607,22624863,22624863,22625902,0,0,0,1039
21612,22625938,22625938,22626006,0,0,0,68
21613,22625954,22625954,22626006,0,0,0,52
21614,22625964,22625964,22626031,0,0,0,67
21615,22626037,22626037,22626084,0,0,0,47
21616,22626170,22626170,22626222,0,0,0,52
21617,22626181,22626181,22626248,0,0,0,67
21618,22626256,22626256,22626324,0,0,0,68
21619,22626278,22626278,22626330,0,0,0,52
21620,22626290,22626290,22626373,0,0,0,83
21621,22626338,22626338,22626421,0,0,0,83
21622,22626373,22626373,22626451,0,0,0,78
21624,22627004,22627004,22627067,0,0,0,63
21623,22626645,22626645,22627694,0,0,0,1049
21481,22599318,22602329,22628721,0,0,3011,29403
21625,22628059,22628059,22628928,0,0,0,869
21484,22599666,22602429,22629182,0,0,2763,29516
21626,22629088,22629088,22630080,0,0,0,992
21627,22630174,22630174,22630247,0,0,0,73
21554,22606595,22606595,22630460,0,0,0,23865
21541,22604641,22605016,22631114,0,0,375,26473
21596,22611766,22630460,22631360,0,0,18694,19594
21629,22630715,22631360,22632291,0,0,645,1576
21595,22611032,22624191,22632300,0,0,13159,21268
21630,22631716,22631716,22632596,0,0,0,880
21567,22607740,22607740,22633948,0,0,0,26208
21606,22622289,22622289,22651907,0,0,0,29618
21610,22625648,22625648,22652177,0,0,0,26529
21605,22622121,22622121,22652206,0,0,0,30085
21628,22630659,22631114,22657221,0,0,455,26562
21631,22633889,22633948,22660714,0,0,59,26825
20793,22408426,22408426,22667626,0,0,0,259200
20802,22409631,22409631,22668831,0,0,0,259200
21593,22610652,22615468,22671597,0,0,4816,60945
21380,22588905,22632596,22678794,0,0,43691,89889
21644,22678281,22678281,22678869,0,0,0,588
21640,22678280,22678280,22678880,0,0,0,600
21641,22678280,22678280,22678880,0,0,0,600
21642,22678280,22678280,22678880,0,0,0,600
21643,22678280,22678280,22678880,0,0,0,600
21645,22678281,22678281,22678881,0,0,0,600
21646,22678281,22678281,22678881,0,0,0,600
21647,22678281,22678281,22678881,0,0,0,600
21648,22678282,22678282,22678882,0,0,0,600
21649,22678282,22678282,22678882,0,0,0,600
21650,22678282,22678282,22678882,0,0,0,600
21651,22678282,22678282,22678882,0,0,0,600
21652,22678282,22678282,22678882,0,0,0,600
21653,22678283,22678283,22678883,0,0,0,600
21654,22678283,22678283,22678883,0,0,0,600
21655,22678283,22678283,22678883,0,0,0,600
21656,22678283,22678283,22678883,0,0,0,600
21657,22678370,22678370,22678970,0,0,0,600
21658,22678370,22678370,22678970,0,0,0,600
21659,22678371,22678371,22678971,0,0,0,600
21673,22678909,22678909,22679440,0,0,0,531
21661,22678895,22678895,22679495,0,0,0,600
21662,22678895,22678895,22679495,0,0,0,600
21663,22678906,22678906,22679506,0,0,0,600
21664,22678906,22678906,22679506,0,0,0,600
21665,22678907,22678907,22679507,0,0,0,600
21666,22678907,22678907,22679507,0,0,0,600
21667,22678907,22678907,22679507,0,0,0,600
21668,22678907,22678907,22679507,0,0,0,600
21669,22678908,22678908,22679508,0,0,0,600
21670,22678908,22678908,22679508,0,0,0,600
21671,22678908,22678908,22679508,0,0,0,600
21672,22678908,22678908,22679508,0,0,0,600
21674,22678909,22678909,22679509,0,0,0,600
21675,22678909,22678909,22679509,0,0,0,600
21676,22678910,22678910,22679510,0,0,0,600
21677,22678910,22678910,22679510,0,0,0,600
21678,22678910,22678910,22679510,0,0,0,600
21679,22678910,22678910,22679510,0,0,0,600
21680,22678911,22678911,22679511,0,0,0,600
21660,22678673,22678673,22679557,0,0,0,884
20881,22427687,22427687,22680287,0,0,0,252600
21681,22679729,22679729,22680619,0,0,0,890
21632,22651855,22651907,22682068,0,0,52,30213
21633,22652143,22652177,22682343,0,0,34,30200
21684,22682250,22682250,22682422,0,0,0,172
21685,22682359,22682359,22682531,0,0,0,172
21682,22680931,22680931,22682590,0,0,0,1659
21687,22682595,22682595,22683353,0,0,0,758
21688,22684536,22684536,22685592,0,0,0,1056
21634,22660609,22660609,22686830,0,0,0,26221
21689,22686119,22686119,22686861,0,0,0,742
21692,22686862,22686862,22686909,0,0,0,47
21691,22686782,22686782,22687032,0,0,0,250
21694,22686939,22686939,22687182,0,0,0,243
21693,22686933,22686933,22687192,0,0,0,259
21695,22686942,22686942,22687216,0,0,0,274
21696,22686946,22686946,22687220,0,0,0,274
21697,22686949,22686949,22687223,0,0,0,274
21698,22686970,22686970,22687244,0,0,0,274
21699,22686975,22686975,22687249,0,0,0,274
21700,22686978,22686978,22687252,0,0,0,274
21701,22687961,22687961,22688701,0,0,0,740
21702,22689600,22689600,22690955,0,0,0,1355
20920,22431966,22431966,22691166,0,0,0,259200
20927,22432450,22432450,22691650,0,0,0,259200
21154,22496530,22691166,22691849,0,0,194636,195319
21704,22692159,22692159,22692976,0,0,0,817
21597,22614235,22619064,22698653,0,0,4829,84418
21706,22693966,22698653,22699460,0,0,4687,5494
21707,22701360,22701360,22702105,0,0,0,745
21708,22702395,22702395,22703131,0,0,0,736
21636,22668032,22680287,22703525,0,0,12255,35493
21709,22703908,22703908,22704705,0,0,0,797
21710,22704911,22704911,22705562,0,0,0,651
21711,22706070,22706070,22706163,0,0,0,93
21639,22668618,22691166,22707107,0,0,22548,38489
21712,22706708,22706708,22707235,0,0,0,527
21713,22707354,22707354,22707820,0,0,0,466
21703,22691900,22691900,22710000,0,0,0,18100
21705,22692751,22692976,22710154,0,0,225,17403
21683,22681954,22681954,22711775,0,0,0,29821
21686,22682469,22682469,22712925,0,0,0,30456
21690,22686750,22686750,22713011,0,0,0,26261
21638,22668071,22691166,22719522,0,0,23095,51451
21121,22464122,22464173,22723373,0,0,51,259251
20767,22378346,22378346,22723946,0,0,0,345600
21122,22464123,22465045,22724245,0,0,922,260122
21123,22464123,22465144,22724344,0,0,1021,260221
21124,22464123,22465144,22724344,0,0,1021,260221
21125,22464123,22465328,22724528,0,0,1205,260405
21126,22464123,22465328,22724528,0,0,1205,260405
21637,22668058,22691166,22726443,0,0,23108,58385
21127,22464123,22469614,22728814,0,0,5491,264691
21635,22668020,22671597,22729400,0,0,3577,61380
21131,22466524,22471590,22730790,0,0,5066,264266
21132,22466575,22471590,22730790,0,0,5015,264215
21115,22461406,22479066,22738266,0,0,17660,276860
21116,22461462,22480953,22740153,0,0,19491,278691
21209,22510615,22740153,22740309,0,0,229538,229694
21348,22587425,22668831,22741726,0,0,81406,154301
21714,22711712,22711712,22742162,0,0,0,30450
21715,22712879,22712879,22743149,0,0,0,30270
21346,22587342,22607759,22746352,0,0,20417,159010
21148,22493355,22493355,22752555,0,0,0,259200
21149,22493370,22493370,22752570,0,0,0,259200
21118,22461500,22500601,22759801,0,0,39101,298301
21730,22762330,22762330,22762930,0,0,0,600
21731,22762336,22762336,22762936,0,0,0,600
21732,22762336,22762336,22762936,0,0,0,600
21733,22762337,22762337,22762937,0,0,0,600
21734,22762337,22762337,22762937,0,0,0,600
21735,22762337,22762337,22762937,0,0,0,600
21736,22762337,22762337,22762937,0,0,0,600
21737,22762338,22762338,22762938,0,0,0,600
21738,22762338,22762338,22762938,0,0,0,600
21739,22762338,22762338,22762938,0,0,0,600
21740,22762338,22762338,22762938,0,0,0,600
21741,22762339,22762339,22762939,0,0,0,600
21742,22762339,22762339,22762939,0,0,0,600
21743,22762339,22762339,22762939,0,0,0,600
21744,22762340,22762340,22762940,0,0,0,600
21745,22762340,22762340,22762940,0,0,0,600
21746,22762340,22762340,22762940,0,0,0,600
21747,22762340,22762340,22762940,0,0,0,600
21748,22762341,22762341,22762941,0,0,0,600
21749,22762341,22762341,22762941,0,0,0,600
21750,22762341,22762341,22762941,0,0,0,600
21751,22762341,22762341,22762941,0,0,0,600
21752,22762341,22762341,22762941,0,0,0,600
21753,22762342,22762342,22762942,0,0,0,600
21754,22762342,22762342,22762942,0,0,0,600
21755,22762342,22762342,22762942,0,0,0,600
21756,22762342,22762342,22762942,0,0,0,600
21757,22762342,22762342,22762942,0,0,0,600
21758,22762343,22762343,22762943,0,0,0,600
21759,22762343,22762343,22762943,0,0,0,600
21769,22763161,22763161,22763548,0,0,0,387
21760,22763159,22763159,22763759,0,0,0,600
21761,22763159,22763159,22763759,0,0,0,600
21762,22763159,22763159,22763759,0,0,0,600
21763,22763159,22763159,22763759,0,0,0,600
21764,22763159,22763159,22763759,0,0,0,600
21765,22763160,22763160,22763760,0,0,0,600
21766,22763160,22763160,22763760,0,0,0,600
21767,22763160,22763160,22763760,0,0,0,600
21768,22763160,22763160,22763760,0,0,0,600
21770,22763161,22763161,22763761,0,0,0,600
21771,22763161,22763161,22763761,0,0,0,600
21772,22763161,22763161,22763761,0,0,0,600
21773,22763161,22763161,22763761,0,0,0,600
21774,22763162,22763162,22763762,0,0,0,600
21775,22763162,22763162,22763762,0,0,0,600
21776,22763162,22763162,22763762,0,0,0,600
21777,22763162,22763162,22763762,0,0,0,600
21778,22763162,22763162,22763762,0,0,0,600
21779,22763259,22763259,22763859,0,0,0,600
21780,22764744,22764744,22765344,0,0,0,600
21781,22764744,22764744,22765344,0,0,0,600
21782,22764744,22764744,22765344,0,0,0,600
21783,22764744,22764744,22765344,0,0,0,600
21784,22764745,22764745,22765345,0,0,0,600
21785,22764745,22764745,22765345,0,0,0,600
21786,22764745,22764745,22765345,0,0,0,600
21787,22764745,22764745,22765345,0,0,0,600
21788,22764745,22764745,22765345,0,0,0,600
21789,22764791,22764791,22765391,0,0,0,600
21369,22587825,22691849,22765538,0,0,104024,177713
21793,22765661,22765661,22766061,0,0,0,400
21790,22765660,22765660,22766260,0,0,0,600
21791,22765660,22765660,22766260,0,0,0,600
21792,22765660,22765660,22766260,0,0,0,600
21794,22765661,22765661,22766261,0,0,0,600
21795,22765661,22765661,22766261,0,0,0,600
21796,22765661,22765661,22766261,0,0,0,600
21797,22765661,22765661,22766261,0,0,0,600
21798,22765662,22765662,22766262,0,0,0,600
21799,22765662,22765662,22766262,0,0,0,600
21800,22767192,22767192,22767792,0,0,0,600
21801,22767198,22767198,22767798,0,0,0,600
21802,22767198,22767198,22767798,0,0,0,600
21803,22767199,22767199,22767799,0,0,0,600
21804,22767199,22767199,22767799,0,0,0,600
21805,22767199,22767199,22767799,0,0,0,600
21806,22767199,22767199,22767799,0,0,0,600
21807,22767200,22767200,22767800,0,0,0,600
21808,22767200,22767200,22767800,0,0,0,600
21809,22767200,22767200,22767800,0,0,0,600
21815,22768064,22768064,22768444,0,0,0,380
21816,22768064,22768064,22768475,0,0,0,411
21810,22768063,22768063,22768663,0,0,0,600
21811,22768063,22768063,22768663,0,0,0,600
21812,22768063,22768063,22768663,0,0,0,600
21813,22768063,22768063,22768663,0,0,0,600
21814,22768063,22768063,22768663,0,0,0,600
21817,22768064,22768064,22768664,0,0,0,600
21818,22768064,22768064,22768664,0,0,0,600
21819,22768064,22768064,22768664,0,0,0,600
21820,22769601,22769601,22770201,0,0,0,600
21821,22769607,22769607,22770207,0,0,0,600
21822,22769607,22769607,22770207,0,0,0,600
21823,22769607,22769607,22770207,0,0,0,600
21824,22769608,22769608,22770208,0,0,0,600
21825,22769608,22769608,22770208,0,0,0,600
21826,22769608,22769608,22770208,0,0,0,600
21827,22769608,22769608,22770208,0,0,0,600
21828,22769609,22769609,22770209,0,0,0,600
21829,22769609,22769609,22770209,0,0,0,600
21834,22770482,22770482,22770867,0,0,0,385
21830,22770465,22770465,22771065,0,0,0,600
21831,22770465,22770465,22771065,0,0,0,600
21832,22770465,22770465,22771065,0,0,0,600
21833,22770481,22770481,22771081,0,0,0,600
21835,22770482,22770482,22771082,0,0,0,600
21836,22770482,22770482,22771082,0,0,0,600
21837,22770482,22770482,22771082,0,0,0,600
21838,22770483,22770483,22771083,0,0,0,600
21839,22770483,22770483,22771083,0,0,0,600
21726,22742099,22742099,22772539,0,0,0,30440
21727,22743090,22743090,22773405,0,0,0,30315
21444,22597072,22606761,22779561,0,0,9689,182489
21252,22520263,22534071,22786671,0,0,13808,266408
21728,22753221,22753221,22786831,0,0,0,33610
21841,22772476,22772476,22802894,0,0,0,30418
21842,22773334,22773334,22803533,0,0,0,30199
21120,22462690,22462690,22808290,0,0,0,345600
21294,22549627,22549627,22808827,0,0,0,259200
21295,22549627,22549627,22808827,0,0,0,259200
21845,22803479,22803479,22808959,0,0,0,5480
21296,22549815,22549815,22809015,0,0,0,259200
21297,22549816,22549869,22809069,0,0,53,259253
21298,22549817,22549988,22809188,0,0,171,259371
21299,22549817,22549991,22809191,0,0,174,259374
21301,22550253,22550253,22809453,0,0,0,259200
21843,22776346,22776346,22810514,0,0,0,34168
21729,22753281,22753281,22820913,0,0,0,67632
21844,22802831,22802831,22832875,0,0,0,30044
21856,22836269,22836269,22836368,0,0,0,99
21857,22836442,22836442,22836509,0,0,0,67
21858,22836506,22836506,22836600,0,0,0,94
21859,22836567,22836567,22836664,0,0,0,97
21860,22836629,22836629,22836696,0,0,0,67
21861,22836683,22836683,22836831,0,0,0,148
21863,22836702,22836702,22836857,0,0,0,155
21862,22836696,22836696,22836863,0,0,0,167
21864,22837263,22837263,22837416,0,0,0,153
21865,22837295,22837295,22837456,0,0,0,161
21866,22837439,22837439,22837491,0,0,0,52
21867,22837455,22837455,22837522,0,0,0,67
21846,22808876,22808876,22838798,0,0,0,29922
21278,22530213,22586797,22839397,0,0,56584,309184
21869,22839692,22839692,22840015,0,0,0,323
21871,22839810,22839810,22840410,0,0,0,600
21872,22839810,22839810,22840410,0,0,0,600
21873,22839810,22839810,22840410,0,0,0,600
21874,22839826,22839826,22840426,0,0,0,600
21875,22839826,22839826,22840426,0,0,0,600
21876,22839827,22839827,22840427,0,0,0,600
21877,22839827,22839827,22840427,0,0,0,600
21878,22839827,22839827,22840427,0,0,0,600
21879,22839828,22839828,22840428,0,0,0,600
21880,22839828,22839828,22840428,0,0,0,600
21882,22840338,22840338,22840693,0,0,0,355
21883,22840527,22840527,22840875,0,0,0,348
21895,22840954,22840954,22841042,0,0,0,88
21894,22840949,22840949,22841059,0,0,0,110
21893,22840665,22840665,22841123,0,0,0,458
21884,22840527,22840527,22841127,0,0,0,600
21885,22840527,22840527,22841127,0,0,0,600
21886,22840528,22840528,22841128,0,0,0,600
21887,22840528,22840528,22841128,0,0,0,600
21888,22840528,22840528,22841128,0,0,0,600
21889,22840528,22840528,22841128,0,0,0,600
21890,22840528,22840528,22841128,0,0,0,600
21891,22840529,22840529,22841129,0,0,0,600
21892,22840529,22840529,22841129,0,0,0,600
21870,22839728,22839728,22841253,0,0,0,1525
21881,22839894,22839894,22841570,0,0,0,1676
21899,22841520,22841520,22841663,0,0,0,143
21902,22841719,22841719,22841788,0,0,0,69
21901,22841706,22841706,22841791,0,0,0,85
21906,22841895,22841895,22842030,0,0,0,135
21907,22841908,22841908,22842074,0,0,0,166
21900,22841526,22841526,22842113,0,0,0,587
21909,22842117,22842117,22842195,0,0,0,78
21921,22842291,22842291,22842389,0,0,0,98
21922,22842406,22842406,22842473,0,0,0,67
21911,22842229,22842229,22842829,0,0,0,600
21912,22842229,22842229,22842829,0,0,0,600
21913,22842229,22842229,22842829,0,0,0,600
21914,22842229,22842229,22842829,0,0,0,600
21915,22842250,22842250,22842850,0,0,0,600
21916,22842251,22842251,22842851,0,0,0,600
21917,22842251,22842251,22842851,0,0,0,600
21918,22842251,22842251,22842851,0,0,0,600
21919,22842251,22842251,22842851,0,0,0,600
21920,22842252,22842252,22842852,0,0,0,600
21904,22841804,22841804,22843195,0,0,0,1391
21938,22843137,22843137,22843219,0,0,0,82
21896,22841181,22841181,22843223,0,0,0,2042
21897,22841226,22841226,22843224,0,0,0,1998
21942,22843360,22843360,22843459,0,0,0,99
21928,22842929,22842929,22843529,0,0,0,600
21929,22842935,22842935,22843535,0,0,0,600
21930,22842935,22842935,22843535,0,0,0,600
21931,22842936,22842936,22843536,0,0,0,600
21932,22842936,22842936,22843536,0,0,0,600
21933,22842936,22842936,22843536,0,0,0,600
21934,22842936,22842936,22843536,0,0,0,600
21935,22842937,22842937,22843537,0,0,0,600
21936,22842937,22842937,22843537,0,0,0,600
21937,22842937,22842937,22843537,0,0,0,600
21910,22842163,22842163,22843610,0,0,0,1447
21944,22843967,22843967,22844060,0,0,0,93
21946,22844100,22844100,22844202,0,0,0,102
21947,22844268,22844268,22844341,0,0,0,73
21948,22844391,22844391,22844460,0,0,0,69
21949,22844413,22844413,22844477,0,0,0,64
21951,22844437,22844437,22844505,0,0,0,68
21952,22844455,22844455,22844507,0,0,0,52
21950,22844426,22844426,22844510,0,0,0,84
21953,22844471,22844471,22844538,0,0,0,67
21941,22843225,22843225,22844634,0,0,0,1409
21961,22844660,22844660,22844732,0,0,0,72
21954,22844652,22844652,22844740,0,0,0,88
21966,22844668,22844668,22844740,0,0,0,72
21967,22844730,22844730,22844782,0,0,0,52
21968,22844749,22844749,22844816,0,0,0,67
21943,22843498,22843498,22844862,0,0,0,1364
21969,22844881,22844881,22845041,0,0,0,160
21926,22842656,22842656,22845106,0,0,0,2450
21940,22843180,22843180,22845155,0,0,0,1975
21939,22843172,22843172,22845158,0,0,0,1986
21905,22841832,22841832,22845159,0,0,0,3327
21955,22844658,22844658,22845258,0,0,0,600
21956,22844658,22844658,22845258,0,0,0,600
21957,22844659,22844659,22845259,0,0,0,600
21958,22844659,22844659,22845259,0,0,0,600
21959,22844659,22844659,22845259,0,0,0,600
21960,22844659,22844659,22845259,0,0,0,600
21962,22844660,22844660,22845260,0,0,0,600
21963,22844660,22844660,22845260,0,0,0,600
21964,22844660,22844660,22845260,0,0,0,600
21965,22844660,22844660,22845260,0,0,0,600
21974,22845337,22845337,22845403,0,0,0,66
21927,22842871,22842871,22845563,0,0,0,2692
21945,22844040,22844040,22845840,0,0,0,1800
21975,22845338,22845338,22845938,0,0,0,600
21976,22845338,22845338,22845938,0,0,0,600
21977,22845338,22845338,22845938,0,0,0,600
21978,22845339,22845339,22845939,0,0,0,600
21979,22845339,22845339,22845939,0,0,0,600
21980,22845339,22845339,22845939,0,0,0,600
21981,22845340,22845340,22845940,0,0,0,600
21982,22845340,22845340,22845940,0,0,0,600
21983,22845340,22845340,22845940,0,0,0,600
21984,22845340,22845340,22845940,0,0,0,600
21903,22841798,22841798,22846024,0,0,0,4226
21988,22846217,22846217,22846347,0,0,0,130
21989,22846228,22846228,22846358,0,0,0,130
21990,22846236,22846236,22846366,0,0,0,130
21991,22846336,22846336,22846422,0,0,0,86
21992,22846346,22846346,22846438,0,0,0,92
21993,22846365,22846365,22846452,0,0,0,87
21995,22846396,22846396,22846478,0,0,0,82
21998,22847061,22847061,22847661,0,0,0,600
21999,22847067,22847067,22847667,0,0,0,600
22000,22847067,22847067,22847667,0,0,0,600
22001,22847068,22847068,22847668,0,0,0,600
22002,22847068,22847068,22847668,0,0,0,600
22003,22847068,22847068,22847668,0,0,0,600
22004,22847068,22847068,22847668,0,0,0,600
22005,22847069,22847069,22847669,0,0,0,600
22006,22847069,22847069,22847669,0,0,0,600
22007,22847069,22847069,22847669,0,0,0,600
22009,22847576,22847576,22847677,0,0,0,101
21994,22846385,22846385,22847801,0,0,0,1416
21996,22846416,22846416,22847805,0,0,0,1389
21997,22846475,22846475,22847897,0,0,0,1422
22020,22848158,22848158,22848257,0,0,0,99
22010,22847741,22847741,22848341,0,0,0,600
22011,22847741,22847741,22848341,0,0,0,600
22012,22847742,22847742,22848342,0,0,0,600
22013,22847742,22847742,22848342,0,0,0,600
22014,22847742,22847742,22848342,0,0,0,600
22015,22847742,22847742,22848342,0,0,0,600
22016,22847743,22847743,22848343,0,0,0,600
22017,22847743,22847743,22848343,0,0,0,600
22018,22847743,22847743,22848343,0,0,0,600
22019,22847744,22847744,22848344,0,0,0,600
21987,22845876,22845876,22848727,0,0,0,2851
22021,22849733,22849733,22849843,0,0,0,110
22022,22849784,22849784,22849843,0,0,0,59
22023,22849807,22849807,22849893,0,0,0,86
22024,22849848,22849848,22849963,0,0,0,115
22027,22849915,22849915,22849985,0,0,0,70
22028,22849933,22849933,22850016,0,0,0,83
22030,22850144,22850144,22850744,0,0,0,600
22031,22850145,22850145,22850745,0,0,0,600
22032,22850145,22850145,22850745,0,0,0,600
22033,22850145,22850145,22850745,0,0,0,600
22034,22850145,22850145,22850745,0,0,0,600
22035,22850146,22850146,22850746,0,0,0,600
22036,22850146,22850146,22850746,0,0,0,600
22037,22850146,22850146,22850746,0,0,0,600
22038,22850146,22850146,22850746,0,0,0,600
22039,22850146,22850146,22850746,0,0,0,600
21840,22771666,22771666,22851591,0,0,0,79925
21383,22589206,22667626,22852034,0,0,78420,262828
22008,22847524,22847524,22853311,0,0,0,5787
21986,22845518,22845518,22854565,0,0,0,9047
21898,22841500,22841500,22855482,0,0,0,13982
21971,22845102,22845102,22855604,0,0,0,10502
21970,22845063,22845063,22856428,0,0,0,11365
22050,22855874,22855874,22856552,0,0,0,678
21985,22845509,22845509,22856580,0,0,0,11071
22055,22856672,22856672,22856838,0,0,0,166
21908,22842046,22842046,22857127,0,0,0,15081
22049,22855537,22855537,22857326,0,0,0,1789
22057,22857159,22857159,22857558,0,0,0,399
22058,22857666,22857666,22857759,0,0,0,93
22061,22857993,22857993,22858086,0,0,0,93
22060,22857885,22857885,22858272,0,0,0,387
22053,22856509,22856509,22858584,0,0,0,2075
22054,22856515,22856515,22858871,0,0,0,2356
22062,22858313,22858313,22858937,0,0,0,624
22067,22858999,22858999,22859076,0,0,0,77
22040,22853864,22853864,22859642,0,0,0,5778
22041,22853928,22853928,22859675,0,0,0,5747
22042,22854054,22854054,22859765,0,0,0,5711
22051,22855976,22855976,22859954,0,0,0,3978
22063,22858510,22858510,22859955,0,0,0,1445
22064,22858542,22858542,22859956,0,0,0,1414
22052,22856365,22856365,22859988,0,0,0,3623
22074,22860171,22860171,22860265,0,0,0,94
21434,22595579,22601120,22860320,0,0,5541,264741
22043,22854768,22854768,22860471,0,0,0,5703
22065,22858814,22858814,22860502,0,0,0,1688
22076,22860510,22860510,22860614,0,0,0,104
22077,22860582,22860582,22860675,0,0,0,93
22044,22854917,22854917,22860700,0,0,0,5783
21435,22595621,22601853,22861053,0,0,6232,265432
21436,22595660,22601853,22861053,0,0,6193,265393
21973,22845118,22845118,22861406,0,0,0,16288
21972,22845105,22845105,22861415,0,0,0,16310
21855,22832812,22832812,22862939,0,0,0,30127
22084,22862981,22862981,22863074,0,0,0,93
22082,22861760,22861760,22863578,0,0,0,1818
22086,22863649,22863649,22863742,0,0,0,93
22088,22864064,22864064,22864137,0,0,0,73
22087,22863992,22863992,22864138,0,0,0,146
22090,22864289,22864289,22864514,0,0,0,225
22091,22864366,22864366,22864565,0,0,0,199
22094,22864512,22864514,22864580,0,0,2,68
22089,22864286,22864286,22864584,0,0,0,298
22048,22855534,22855534,22865411,0,0,0,9877
22098,22866052,22866052,22866274,0,0,0,222
22093,22864481,22864481,22866886,0,0,0,2405
22096,22864584,22864584,22866907,0,0,0,2323
22095,22864538,22864565,22866909,0,0,27,2371
21347,22587355,22607759,22866959,0,0,20404,279604
22102,22867007,22867007,22867101,0,0,0,94
22099,22866874,22866874,22867272,0,0,0,398
22103,22867476,22867476,22867580,0,0,0,104
22075,22860440,22860440,22867799,0,0,0,7359
22097,22865529,22865529,22867825,0,0,0,2296
22071,22859913,22859913,22867882,0,0,0,7969
22085,22863536,22863536,22867911,0,0,0,4375
22072,22859919,22859919,22867950,0,0,0,8031
22110,22868129,22868129,22868549,0,0,0,420
22111,22868565,22868565,22868658,0,0,0,93
22092,22864425,22864425,22868721,0,0,0,4296
22112,22868832,22868832,22868931,0,0,0,99
21868,22838743,22838743,22869073,0,0,0,30330
22115,22869149,22869149,22869242,0,0,0,93
22114,22869133,22869133,22869353,0,0,0,220
22116,22869286,22869286,22869385,0,0,0,99
22117,22869414,22869414,22869503,0,0,0,89
22119,22869666,22869666,22869744,0,0,0,78
22120,22869681,22869681,22869810,0,0,0,129
22121,22870460,22870460,22870496,0,0,0,36
22122,22870558,22870558,22870605,0,0,0,47
22124,22870991,22870991,22871086,0,0,0,95
22125,22871056,22871056,22871151,0,0,0,95
22126,22871067,22871067,22871151,0,0,0,84
22127,22871090,22871090,22871183,0,0,0,93
22128,22871356,22871356,22871450,0,0,0,94
22130,22871583,22871583,22871656,0,0,0,73
22118,22869462,22869462,22871772,0,0,0,2310
22133,22871821,22871821,22871898,0,0,0,77
22134,22872038,22872038,22872132,0,0,0,94
22025,22849871,22849871,22872286,0,0,0,22415
22026,22849894,22849894,22872318,0,0,0,22424
22136,22873033,22873033,22873130,0,0,0,97
22137,22873103,22873103,22873202,0,0,0,99
22138,22873201,22873201,22873279,0,0,0,78
22135,22872659,22872659,22873280,0,0,0,621
22139,22873957,22873957,22874180,0,0,0,223
22140,22874175,22874175,22874366,0,0,0,191
22141,22874334,22874334,22874494,0,0,0,160
22142,22874490,22874490,22874661,0,0,0,171
22143,22874671,22874671,22874893,0,0,0,222
22129,22871451,22871451,22875354,0,0,0,3903
22081,22861739,22861739,22881044,0,0,0,19305
22131,22871689,22871689,22881569,0,0,0,9880
22132,22871738,22871738,22881855,0,0,0,10117
22108,22867845,22867845,22886290,0,0,0,18445
21433,22595420,22601120,22889085,0,0,5700,293665
22083,22862892,22862892,22892979,0,0,0,30087
22107,22867833,22867833,22898205,0,0,0,30372
22123,22870980,22870980,22898422,0,0,0,27442
22106,22867787,22867787,22898998,0,0,0,31211
22066,22858970,22898998,22899216,0,0,40028,40246
22113,22869010,22869010,22899444,0,0,0,30434
22109,22867918,22867918,22902592,0,0,0,34674
22070,22859905,22859905,22902901,0,0,0,42996
22104,22867541,22867541,22915833,0,0,0,48292
22069,22859889,22859889,22921247,0,0,0,61358
22147,22921667,22921667,22921761,0,0,0,94
22148,22922876,22922876,22922969,0,0,0,93
22145,22892922,22892922,22923086,0,0,0,30164
22153,22923168,22923168,22923251,0,0,0,83
22154,22923317,22923317,22923410,0,0,0,93
22152,22923159,22923159,22923656,0,0,0,497
22151,22923146,22923146,22923690,0,0,0,544
22150,22923137,22923137,22923697,0,0,0,560
22155,22923718,22923718,22923812,0,0,0,94
22156,22924149,22924149,22924242,0,0,0,93
22079,22861370,22861370,22926195,0,0,0,64825
22078,22861338,22861338,22926227,0,0,0,64889
22101,22866889,22866889,22927281,0,0,0,60392
22100,22866881,22866881,22927304,0,0,0,60423
22167,22927853,22927853,22927920,0,0,0,67
22163,22927222,22927222,22928147,0,0,0,925
22165,22927276,22927276,22928170,0,0,0,894
22164,22927246,22927246,22928203,0,0,0,957
22162,22927143,22927143,22928267,0,0,0,1124
22146,22899374,22899374,22929458,0,0,0,30084
22161,22927016,22927016,22929714,0,0,0,2698
22171,22928164,22928164,22929964,0,0,0,1800
22168,22928098,22928098,22930834,0,0,0,2736
22170,22928144,22928144,22930859,0,0,0,2715
22176,22929276,22929276,22930864,0,0,0,1588
22169,22928118,22928118,22930865,0,0,0,2747
22179,22929409,22929409,22930889,0,0,0,1480
22180,22930179,22930179,22930896,0,0,0,717
22175,22929152,22929152,22930952,0,0,0,1800
22181,22930788,22930788,22931674,0,0,0,886
22182,22930795,22930795,22931711,0,0,0,916
22185,22930829,22930829,22931711,0,0,0,882
22184,22930822,22930822,22931716,0,0,0,894
22183,22930803,22930803,22931730,0,0,0,927
22177,22929392,22929392,22931801,0,0,0,2409
22192,22931831,22931831,22931896,0,0,0,65
22193,22931865,22931865,22931950,0,0,0,85
22195,22931948,22931948,22931995,0,0,0,47
22194,22931914,22931914,22931997,0,0,0,83
22197,22932030,22932030,22932205,0,0,0,175
22202,22932400,22932400,22932431,0,0,0,31
22200,22932384,22932384,22932436,0,0,0,52
22201,22932387,22932387,22932439,0,0,0,52
22199,22932342,22932342,22932442,0,0,0,100
22203,22932478,22932478,22932716,0,0,0,238
22205,22932494,22932494,22932767,0,0,0,273
22206,22932496,22932496,22932769,0,0,0,273
22204,22932482,22932482,22932776,0,0,0,294
22207,22932499,22932499,22932803,0,0,0,304
22208,22932501,22932501,22932805,0,0,0,304
22210,22932530,22932530,22932851,0,0,0,321
22209,22932504,22932504,22932861,0,0,0,357
22214,22932741,22932741,22932862,0,0,0,121
22212,22932546,22932546,22932898,0,0,0,352
22213,22932548,22932548,22932900,0,0,0,352
22216,22932860,22932860,22932938,0,0,0,78
22190,22931678,22931678,22933123,0,0,0,1445
22189,22931669,22931669,22933125,0,0,0,1456
22217,22932966,22932966,22933125,0,0,0,159
22188,22931662,22931662,22933129,0,0,0,1467
22186,22931629,22931629,22933130,0,0,0,1501
22187,22931651,22931651,22933130,0,0,0,1479
22191,22931738,22931738,22933130,0,0,0,1392
22237,22933072,22933072,22933166,0,0,0,94
22215,22932825,22932825,22933239,0,0,0,414
22218,22932966,22932966,22933296,0,0,0,330
22224,22932968,22932968,22933546,0,0,0,578
22219,22932966,22932966,22933566,0,0,0,600
22220,22932967,22932967,22933567,0,0,0,600
22221,22932967,22932967,22933567,0,0,0,600
22222,22932967,22932967,22933567,0,0,0,600
22223,22932967,22932967,22933567,0,0,0,600
22225,22932968,22932968,22933568,0,0,0,600
22226,22932968,22932968,22933568,0,0,0,600
22227,22932968,22932968,22933568,0,0,0,600
22228,22932968,22932968,22933568,0,0,0,600
22229,22932969,22932969,22933569,0,0,0,600
22230,22932969,22932969,22933569,0,0,0,600
22231,22932969,22932969,22933569,0,0,0,600
22232,22932969,22932969,22933569,0,0,0,600
22233,22932970,22932970,22933570,0,0,0,600
22234,22932970,22932970,22933570,0,0,0,600
22235,22932970,22932970,22933570,0,0,0,600
22236,22932970,22932970,22933570,0,0,0,600
22198,22932174,22932174,22933974,0,0,0,1800
22245,22933741,22933741,22934057,0,0,0,316
22246,22933892,22933892,22934492,0,0,0,600
22247,22933892,22933892,22934492,0,0,0,600
22248,22933892,22933892,22934492,0,0,0,600
22249,22933892,22933892,22934492,0,0,0,600
22250,22933893,22933893,22934493,0,0,0,600
22251,22933893,22933893,22934493,0,0,0,600
22252,22933893,22933893,22934493,0,0,0,600
22253,22933893,22933893,22934493,0,0,0,600
22254,22933894,22933894,22934494,0,0,0,600
22255,22933894,22933894,22934494,0,0,0,600
22256,22933894,22933894,22934494,0,0,0,600
22257,22933894,22933894,22934494,0,0,0,600
22258,22933895,22933895,22934495,0,0,0,600
22259,22933895,22933895,22934495,0,0,0,600
22260,22933895,22933895,22934495,0,0,0,600
22261,22933895,22933895,22934495,0,0,0,600
22262,22933896,22933896,22934496,0,0,0,600
22263,22933896,22933896,22934496,0,0,0,600
22264,22933896,22933896,22934496,0,0,0,600
22265,22933896,22933896,22934496,0,0,0,600
22266,22933896,22933896,22934496,0,0,0,600
22267,22933897,22933897,22934497,0,0,0,600
22268,22933897,22933897,22934497,0,0,0,600
22269,22933897,22933897,22934497,0,0,0,600
22270,22933897,22933897,22934497,0,0,0,600
22271,22933897,22933897,22934497,0,0,0,600
22272,22933898,22933898,22934498,0,0,0,600
22273,22933898,22933898,22934498,0,0,0,600
22274,22933898,22933898,22934498,0,0,0,600
22275,22933898,22933898,22934498,0,0,0,600
22281,22935378,22935378,22935516,0,0,0,138
22073,22860117,22860117,22935774,0,0,0,75657
22279,22935377,22935377,22935794,0,0,0,417
22282,22935378,22935378,22935795,0,0,0,417
22280,22935377,22935377,22935825,0,0,0,448
22283,22935378,22935378,22935826,0,0,0,448
22285,22935379,22935379,22935889,0,0,0,510
22286,22935379,22935379,22935920,0,0,0,541
22278,22935371,22935371,22935928,0,0,0,557
22284,22935378,22935378,22935978,0,0,0,600
22287,22935379,22935379,22935979,0,0,0,600
22277,22934876,22934876,22936265,0,0,0,1389
22294,22936582,22936582,22936829,0,0,0,247
22288,22936580,22936580,22936920,0,0,0,340
22291,22936581,22936581,22936921,0,0,0,340
22289,22936580,22936580,22936982,0,0,0,402
22295,22936582,22936582,22937015,0,0,0,433
22296,22936582,22936582,22937132,0,0,0,550
22292,22936581,22936581,22937162,0,0,0,581
22059,22857754,22857754,22937163,0,0,0,79409
22290,22936580,22936580,22937180,0,0,0,600
22293,22936581,22936581,22937181,0,0,0,600
22297,22936582,22936582,22937182,0,0,0,600
22276,22934826,22934826,22937376,0,0,0,2550
22211,22932530,22932530,22937724,0,0,0,5194
22303,22937790,22937790,22937990,0,0,0,200
21386,22589303,22678794,22937994,0,0,89491,348691
22300,22937789,22937789,22938093,0,0,0,304
22307,22937791,22937791,22938095,0,0,0,304
22304,22937790,22937790,22938354,0,0,0,564
22299,22937783,22937783,22938383,0,0,0,600
22301,22937789,22937789,22938389,0,0,0,600
22302,22937789,22937789,22938389,0,0,0,600
22305,22937790,22937790,22938390,0,0,0,600
22306,22937790,22937790,22938390,0,0,0,600
22308,22937791,22937791,22938391,0,0,0,600
22080,22861517,22861517,22938711,0,0,0,77194
22311,22938333,22938333,22938758,0,0,0,425
22310,22938217,22938217,22940017,0,0,0,1800
22320,22940194,22940194,22940461,0,0,0,267
22323,22940404,22940404,22940497,0,0,0,93
22316,22940193,22940193,22940522,0,0,0,329
22321,22940194,22940194,22940616,0,0,0,422
22313,22940192,22940192,22940656,0,0,0,464
22317,22940193,22940193,22940657,0,0,0,464
22312,22939837,22939837,22940763,0,0,0,926
22314,22940192,22940192,22940792,0,0,0,600
22315,22940192,22940192,22940792,0,0,0,600
22318,22940193,22940193,22940793,0,0,0,600
22319,22940193,22940193,22940793,0,0,0,600
22322,22940194,22940194,22940794,0,0,0,600
22328,22940631,22940631,22940838,0,0,0,207
22325,22940622,22940622,22940840,0,0,0,218
22326,22940627,22940627,22940845,0,0,0,218
22327,22940629,22940629,22940847,0,0,0,218
22329,22940653,22940653,22940851,0,0,0,198
22330,22940691,22940691,22940884,0,0,0,193
22331,22940698,22940698,22940918,0,0,0,220
22332,22940702,22940702,22940922,0,0,0,220
22333,22940704,22940704,22940924,0,0,0,220
22105,22867757,22867757,22940982,0,0,0,73225
22324,22940620,22940620,22941014,0,0,0,394
22337,22941560,22941560,22941731,0,0,0,171
22338,22941563,22941563,22941734,0,0,0,171
22336,22941554,22941554,22941742,0,0,0,188
22339,22941567,22941567,22941769,0,0,0,202
22340,22941570,22941570,22941772,0,0,0,202
22341,22941591,22941591,22941793,0,0,0,202
22342,22941639,22941639,22941825,0,0,0,186
22343,22941642,22941642,22941828,0,0,0,186
22345,22941664,22941664,22941855,0,0,0,191
22344,22941645,22941645,22941862,0,0,0,217
22335,22941316,22941316,22942744,0,0,0,1428
22350,22942602,22942602,22942803,0,0,0,201
22172,22928210,22928210,22942841,0,0,0,14631
22173,22928345,22928345,22942872,0,0,0,14527
22349,22942596,22942596,22942876,0,0,0,280
22353,22942603,22942603,22943110,0,0,0,507
22357,22942604,22942604,22943111,0,0,0,507
22351,22942602,22942602,22943170,0,0,0,568
22352,22942602,22942602,22943170,0,0,0,568
22354,22942603,22942603,22943171,0,0,0,568
22355,22942603,22942603,22943203,0,0,0,600
22356,22942603,22942603,22943203,0,0,0,600
22358,22942604,22942604,22943204,0,0,0,600
22361,22943144,22943144,22943211,0,0,0,67
22364,22943470,22943470,22943541,0,0,0,71
22367,22943997,22943997,22944199,0,0,0,202
22369,22944366,22944366,22944440,0,0,0,74
22360,22943049,22943049,22944442,0,0,0,1393
22368,22944263,22944263,22944477,0,0,0,214
22371,22944414,22944414,22944488,0,0,0,74
22348,22942474,22942474,22944549,0,0,0,2075
22359,22943004,22943004,22944608,0,0,0,1604
22372,22944443,22944443,22944612,0,0,0,169
22375,22944619,22944619,22944712,0,0,0,93
22370,22944382,22944382,22944719,0,0,0,337
22373,22944601,22944601,22944720,0,0,0,119
22174,22929048,22929048,22944785,0,0,0,15737
22411,22944747,22944785,22944868,0,0,38,121
22410,22944747,22944785,22944884,0,0,38,137
22416,22944779,22944884,22944977,0,0,105,198
22414,22944748,22944868,22944983,0,0,120,235
22393,22944743,22944743,22945082,0,0,0,339
22419,22944919,22944983,22945098,0,0,64,179
22421,22945005,22945005,22945284,0,0,0,279
22434,22945135,22945135,22945338,0,0,0,203
22435,22945138,22945138,22945341,0,0,0,203
22436,22945141,22945141,22945344,0,0,0,203
22437,22945144,22945144,22945347,0,0,0,203
22379,22944739,22944739,22945352,0,0,0,613
22433,22945126,22945126,22945364,0,0,0,238
22365,22943578,22943578,22945378,0,0,0,1800
22438,22945150,22945150,22945384,0,0,0,234
22377,22944738,22944738,22945387,0,0,0,649
22407,22944746,22944746,22945401,0,0,0,655
22427,22945007,22945082,22945420,0,0,75,413
22380,22944739,22944739,22945424,0,0,0,685
22383,22944740,22944740,22945425,0,0,0,685
22384,22944740,22944740,22945425,0,0,0,685
22386,22944741,22944741,22945442,0,0,0,701
22387,22944741,22944741,22945442,0,0,0,701
22443,22945263,22945352,22945446,0,0,89,183
22431,22945008,22945082,22945451,0,0,74,443
22390,22944742,22944742,22945474,0,0,0,732
22394,22944743,22944743,22945475,0,0,0,732
22405,22944746,22944746,22945494,0,0,0,748
22406,22944746,22944746,22945494,0,0,0,748
22423,22945006,22945082,22945500,0,0,76,494
22417,22944889,22945424,22945518,0,0,535,629
22397,22944744,22944744,22945528,0,0,0,784
22398,22944744,22944744,22945528,0,0,0,784
22401,22944745,22944745,22945529,0,0,0,784
22402,22944745,22944745,22945529,0,0,0,784
22425,22945006,22945082,22945534,0,0,76,528
22439,22945154,22945338,22945567,0,0,184,413
22440,22945159,22945341,22945570,0,0,182,411
22441,22945162,22945344,22945573,0,0,182,411
22426,22945006,22945082,22945627,0,0,76,621
22428,22945007,22945082,22945674,0,0,75,667
22424,22945006,22945082,22945682,0,0,76,676
22429,22945007,22945082,22945682,0,0,75,675
22430,22945007,22945082,22945682,0,0,75,675
22442,22945183,22945518,22945772,0,0,335,589
22159,22926333,22926333,22945818,0,0,0,19485
22160,22926589,22926589,22945841,0,0,0,19252
22347,22942447,22942447,22945879,0,0,0,3432
22196,22932008,22932008,22946105,0,0,0,14097
22385,22944740,22944740,22946130,0,0,0,1390
22446,22946039,22946039,22946317,0,0,0,278
22449,22946308,22946308,22946386,0,0,0,78
22422,22945005,22945082,22946436,0,0,77,1431
22451,22946538,22946538,22946627,0,0,0,89
22455,22946572,22946572,22946758,0,0,0,186
22452,22946552,22946552,22946759,0,0,0,207
22456,22946576,22946576,22946762,0,0,0,186
22454,22946561,22946561,22946768,0,0,0,207
22459,22946601,22946601,22946792,0,0,0,191
22457,22946580,22946580,22946797,0,0,0,217
22458,22946598,22946598,22946820,0,0,0,222
22461,22946624,22946624,22946851,0,0,0,227
22463,22946628,22946628,22946855,0,0,0,227
22460,22946605,22946605,22946909,0,0,0,304
22412,22944747,22944785,22946989,0,0,38,2242
22413,22944747,22944785,22946989,0,0,38,2242
22453,22946555,22946555,22947021,0,0,0,466
22166,22927803,22927803,22947024,0,0,0,19221
22466,22946952,22946989,22947062,0,0,37,110
22467,22947108,22947108,22947201,0,0,0,93
22469,22947260,22947260,22947451,0,0,0,191
22470,22947264,22947264,22947455,0,0,0,191
22376,22944737,22944737,22947462,0,0,0,2725
22468,22947254,22947254,22947462,0,0,0,208
22378,22944738,22944738,22947502,0,0,0,2764
22473,22947291,22947291,22947502,0,0,0,211
22476,22947317,22947317,22947502,0,0,0,185
22381,22944739,22944739,22947503,0,0,0,2764
22474,22947295,22947295,22947506,0,0,0,211
22471,22947266,22947266,22947508,0,0,0,242
22472,22947269,22947269,22947511,0,0,0,242
22382,22944739,22944739,22947534,0,0,0,2795
22475,22947299,22947299,22947541,0,0,0,242
22388,22944741,22944741,22947567,0,0,0,2826
22389,22944741,22944741,22947567,0,0,0,2826
22408,22944746,22944746,22947567,0,0,0,2821
22391,22944742,22944742,22947568,0,0,0,2826
22392,22944742,22944742,22947568,0,0,0,2826
22395,22944743,22944743,22947600,0,0,0,2857
22396,22944743,22944743,22947600,0,0,0,2857
22399,22944744,22944744,22947601,0,0,0,2857
22400,22944744,22944744,22947601,0,0,0,2857
22403,22944745,22944745,22947602,0,0,0,2857
22404,22944745,22944745,22947602,0,0,0,2857
22409,22944746,22944785,22947606,0,0,39,2860
22448,22946210,22946210,22947632,0,0,0,1422
22479,22947415,22947415,22947658,0,0,0,243
22420,22944967,22947632,22947726,0,0,2665,2759
22486,22947417,22947417,22947768,0,0,0,351
22489,22947693,22947693,22947895,0,0,0,202
22490,22947697,22947697,22947899,0,0,0,202
22491,22947700,22947700,22947902,0,0,0,202
22488,22947687,22947687,22947905,0,0,0,218
22483,22947416,22947416,22947913,0,0,0,497
22487,22947417,22947417,22947945,0,0,0,528
22492,22947719,22947726,22947955,0,0,7,236
22493,22947724,22947726,22947955,0,0,2,231
22494,22947727,22947727,22947956,0,0,0,229
22495,22947745,22947745,22947979,0,0,0,234
22496,22947748,22947748,22947982,0,0,0,234
22497,22947752,22947752,22947986,0,0,0,234
22514,22947913,22947913,22948007,0,0,0,94
22478,22947409,22947409,22948009,0,0,0,600
22480,22947415,22947415,22948010,0,0,0,595
22481,22947415,22947415,22948015,0,0,0,600
22482,22947415,22947415,22948015,0,0,0,600
22484,22947416,22947416,22948016,0,0,0,600
22485,22947416,22947416,22948016,0,0,0,600
22518,22948102,22948102,22948389,0,0,0,287
22534,22948619,22948619,22948807,0,0,0,188
22520,22948328,22948328,22948928,0,0,0,600
22521,22948328,22948328,22948928,0,0,0,600
22522,22948328,22948328,22948928,0,0,0,600
22523,22948328,22948328,22948928,0,0,0,600
22524,22948329,22948329,22948929,0,0,0,600
22525,22948329,22948329,22948929,0,0,0,600
22526,22948329,22948329,22948929,0,0,0,600
22527,22948329,22948329,22948929,0,0,0,600
22528,22948330,22948330,22948930,0,0,0,600
22529,22948330,22948330,22948930,0,0,0,600
22538,22948620,22948620,22949073,0,0,0,453
22539,22948620,22948620,22949084,0,0,0,464
22536,22948619,22948619,22949130,0,0,0,511
22535,22948619,22948619,22949173,0,0,0,554
22533,22948618,22948618,22949218,0,0,0,600
22537,22948619,22948619,22949219,0,0,0,600
22540,22948620,22948620,22949220,0,0,0,600
22541,22948620,22948620,22949220,0,0,0,600
22542,22948621,22948621,22949221,0,0,0,600
22530,22948385,22948385,22949397,0,0,0,1012
22544,22949327,22949327,22949649,0,0,0,322
22546,22949336,22949336,22949770,0,0,0,434
22547,22949339,22949339,22949773,0,0,0,434
22545,22949333,22949333,22949780,0,0,0,447
22548,22949341,22949397,22949831,0,0,56,490
22549,22949347,22949649,22950134,0,0,302,787
22551,22949353,22949773,22950207,0,0,420,854
22553,22949657,22949831,22950247,0,0,174,590
22477,22947357,22947357,22950282,0,0,0,2925
22550,22949350,22949770,22950291,0,0,420,941
22554,22950359,22950359,22950458,0,0,0,99
22555,22950528,22950528,22950629,0,0,0,101
22556,22950531,22950531,22950855,0,0,0,324
22557,22950541,22950541,22950911,0,0,0,370
22559,22950547,22950629,22950937,0,0,82,390
22561,22950572,22950629,22950999,0,0,57,427
22563,22950577,22950629,22950999,0,0,52,422
22558,22950545,22950629,22951030,0,0,84,485
22560,22950551,22950629,22951030,0,0,78,479
22552,22949492,22949780,22951048,0,0,288,1556
21382,22589197,22691849,22951049,0,0,102652,361852
22565,22950801,22951049,22951142,0,0,248,341
22564,22950580,22950855,22951285,0,0,275,705
22569,22951288,22951288,22951370,0,0,0,82
22568,22951135,22951135,22951487,0,0,0,352
22532,22948385,22948385,22951731,0,0,0,3346
22567,22951115,22951115,22951772,0,0,0,657
22571,22951652,22951652,22951901,0,0,0,249
22572,22951653,22951653,22951933,0,0,0,280
22574,22951658,22951658,22951983,0,0,0,325
22580,22951911,22951911,22951993,0,0,0,82
22578,22951699,22951699,22951994,0,0,0,295
22573,22951655,22951655,22951997,0,0,0,342
22577,22951678,22951678,22952004,0,0,0,326
22576,22951661,22951661,22952018,0,0,0,357
22575,22951660,22951660,22952022,0,0,0,362
22579,22951704,22951704,22952030,0,0,0,326
22519,22948324,22951049,22952057,0,0,2725,3733
22570,22951646,22951646,22952098,0,0,0,452
22562,22950572,22950999,22952238,0,0,427,1666
22582,22952492,22952492,22952568,0,0,0,76
22584,22952569,22952569,22952631,0,0,0,62
22585,22952597,22952597,22952659,0,0,0,62
22581,22952101,22952101,22952711,0,0,0,610
22583,22952544,22952544,22952787,0,0,0,243
22531,22948385,22951049,22952849,0,0,2664,4464
22586,22952645,22952645,22952981,0,0,0,336
22588,22952922,22952922,22953051,0,0,0,129
22589,22953087,22953087,22953141,0,0,0,54
22149,22923025,22923025,22953300,0,0,0,30275
22693,22953524,22953524,22953648,0,0,0,124
22714,22953589,22953589,22953656,0,0,0,67
22029,22849985,22849985,22953694,0,0,0,103709
22715,22953708,22953708,22953962,0,0,0,254
22717,22954411,22954411,22954536,0,0,0,125
22591,22953160,22953160,22954769,0,0,0,1609
22718,22954499,22954769,22954836,0,0,270,337
22840,22955114,22955114,22955161,0,0,0,47
22543,22948750,22951049,22955689,0,0,2299,6939
22587,22952649,22952649,22955720,0,0,0,3071
22842,22955831,22955831,22955903,0,0,0,72
22843,22956466,22956466,22956544,0,0,0,78
22846,22956979,22956979,22957046,0,0,0,67
22848,22957164,22957164,22957231,0,0,0,67
22841,22955534,22955534,22957356,0,0,0,1822
22362,22943249,22943249,22957585,0,0,0,14336
22849,22957555,22957555,22957622,0,0,0,67
22716,22954043,22957585,22957709,0,0,3542,3666
22844,22956550,22957709,22957833,0,0,1159,1283
22845,22956592,22957833,22957943,0,0,1241,1351
22593,22953452,22953452,22958956,0,0,0,5504
22594,22953452,22953452,22958956,0,0,0,5504
22597,22953452,22953694,22959180,0,0,242,5728
22598,22953453,22953694,22959180,0,0,241,5727
22595,22953452,22953452,22959204,0,0,0,5752
22596,22953452,22953452,22959482,0,0,0,6030
22346,22941879,22941879,22959761,0,0,0,17882
22309,22938066,22938066,22959816,0,0,0,21750
22363,22943342,22943342,22960995,0,0,0,17653
22600,22953453,22955689,22961188,0,0,2236,7735
22599,22953453,22955689,22961190,0,0,2236,7737
22566,22951109,22951109,22961430,0,0,0,10321
22601,22953453,22955689,22961458,0,0,2236,8005
22602,22953453,22955689,22961489,0,0,2236,8036
22604,22953454,22957585,22963084,0,0,4131,9630
22590,22953116,22953116,22963125,0,0,0,10009
22603,22953453,22957585,22963664,0,0,4132,10211
22605,22953454,22958956,22964517,0,0,5502,11063
22606,22953454,22958956,22964723,0,0,5502,11269
22607,22953454,22959180,22964978,0,0,5726,11524
22608,22953454,22959180,22965226,0,0,5726,11772
22609,22953454,22959204,22965281,0,0,5750,11827
22614,22953465,22959816,22965295,0,0,6351,11830
22611,22953455,22959761,22965497,0,0,6306,12042
22612,22953455,22959761,22965528,0,0,6306,12073
22613,22953465,22959761,22965550,0,0,6296,12085
22610,22953454,22959482,22965559,0,0,6028,12105
22615,22953465,22959816,22965559,0,0,6351,12094
22617,22953465,22960995,22966448,0,0,7530,12983
22620,22953466,22961190,22966687,0,0,7724,13221
22616,22953465,22960995,22966738,0,0,7530,13273
22618,22953465,22960995,22966788,0,0,7530,13323
22622,22953467,22961458,22966941,0,0,7991,13474
22623,22953467,22961489,22966973,0,0,8022,13506
22621,22953466,22961430,22967802,0,0,7964,14336
22626,22953468,22963664,22969116,0,0,10196,15648
22624,22953467,22963084,22969177,0,0,9617,15710
22625,22953467,22963125,22969280,0,0,9658,15813
21384,22589285,22710154,22969354,0,0,120869,380069
22860,22969834,22969834,22969994,0,0,0,160
22627,22953468,22964517,22970280,0,0,11049,16812
22861,22970402,22970402,22970469,0,0,0,67
22630,22953469,22965226,22970679,0,0,11757,17210
22628,22953468,22964723,22970765,0,0,11255,17297
22631,22953469,22965281,22970765,0,0,11812,17296
22862,22970772,22970772,22970864,0,0,0,92
22634,22953486,22965528,22970974,0,0,12042,17488
22432,22945112,22945446,22970981,0,0,334,25869
22629,22953468,22964978,22971020,0,0,11510,17552
22636,22953486,22965559,22971020,0,0,12073,17534
22633,22953486,22965497,22971260,0,0,12011,17774
22635,22953486,22965550,22971306,0,0,12064,17820
22637,22953487,22965559,22971330,0,0,12072,17843
22632,22953469,22965295,22971379,0,0,11826,17910
22863,22971330,22971330,22971397,0,0,0,67
22864,22971851,22971851,22971949,0,0,0,98
22639,22953487,22966687,22972180,0,0,13200,18693
22638,22953487,22966448,22972188,0,0,12961,18701
22643,22953488,22966973,22972465,0,0,13485,18977
22640,22953487,22966738,22972485,0,0,13251,18998
22641,22953487,22966788,22972560,0,0,13301,19073
22178,22929400,22929400,22972600,0,0,0,43200
22642,22953487,22966941,22972713,0,0,13454,19226
22866,22972959,22972959,22973026,0,0,0,67
22644,22953488,22967802,22973263,0,0,14314,19775
22445,22946035,22946035,22974508,0,0,0,28473
22645,22953489,22969116,22974608,0,0,15627,21119
22649,22953490,22969354,22974815,0,0,15864,21325
22655,22953504,22969354,22974843,0,0,15850,21339
22650,22953490,22969354,22974846,0,0,15864,21356
22646,22953489,22969177,22974979,0,0,15688,21490
22647,22953489,22969280,22975082,0,0,15791,21593
22651,22953490,22969354,22975094,0,0,15864,21604
22657,22953504,22969354,22975105,0,0,15850,21601
22656,22953504,22969354,22975133,0,0,15850,21629
22652,22953490,22969354,22975136,0,0,15864,21646
22653,22953503,22969354,22975156,0,0,15851,21653
22648,22953489,22969354,22975229,0,0,15865,21740
22654,22953503,22969354,22975401,0,0,15851,21898
22660,22953504,22970765,22976237,0,0,17261,22733
22661,22953505,22970765,22976237,0,0,17260,22732
22658,22953504,22970280,22976310,0,0,16776,22806
22659,22953504,22970679,22976430,0,0,17175,22926
22662,22953505,22970974,22976446,0,0,17469,22941
22664,22953505,22970981,22976453,0,0,17476,22948
22663,22953505,22970981,22976484,0,0,17476,22979
22665,22953505,22971020,22976492,0,0,17515,22987
22667,22953506,22971260,22976732,0,0,17754,23226
22669,22953506,22971330,22976802,0,0,17824,23296
22670,22953506,22971379,22976882,0,0,17873,23376
22668,22953506,22971306,22977057,0,0,17800,23551
22666,22953505,22971020,22977081,0,0,17515,23576
22673,22953517,22972465,22977930,0,0,18948,24413
22671,22953506,22972180,22977955,0,0,18674,24449
22674,22953517,22972485,22977970,0,0,18968,24453
22676,22953517,22972600,22978085,0,0,19083,24568
22675,22953517,22972560,22978138,0,0,19043,24621
22677,22953517,22972713,22978198,0,0,19196,24681
22672,22953506,22972188,22978273,0,0,18682,24767
22678,22953517,22973263,22979058,0,0,19746,25541
22680,22953518,22974508,22979961,0,0,20990,26443
22681,22953518,22974608,22980094,0,0,21090,26576
22682,22953518,22974815,22980270,0,0,21297,26752
22679,22953518,22974508,22980272,0,0,20990,26754
22684,22953518,22974846,22980301,0,0,21328,26783
22683,22953518,22974843,22980329,0,0,21325,26811
22686,22953519,22975082,22980537,0,0,21563,27018
22687,22953519,22975094,22980580,0,0,21575,27061
22694,22953534,22975401,22980894,0,0,21867,27360
22689,22953519,22975133,22980905,0,0,21614,27386
22690,22953519,22975136,22980908,0,0,21617,27389
22685,22953518,22974979,22981023,0,0,21461,27505
22692,22953520,22975229,22981094,0,0,21709,27574
22688,22953519,22975105,22981149,0,0,21586,27630
22691,22953519,22975156,22981176,0,0,21637,27657
22695,22953535,22976237,22981699,0,0,22702,28164
22697,22953535,22976310,22981803,0,0,22775,28268
22698,22953535,22976430,22981923,0,0,22895,28388
22701,22953536,22976484,22981945,0,0,22948,28409
22696,22953535,22976237,22982040,0,0,22702,28505
22703,22953537,22976732,22982193,0,0,23195,28656
22700,22953536,22976453,22982194,0,0,22917,28658
22699,22953536,22976446,22982217,0,0,22910,28681
22704,22953537,22976802,22982263,0,0,23265,28726
22705,22953537,22976882,22982343,0,0,23345,28806
22706,22953537,22977057,22982550,0,0,23520,29013
22707,22953537,22977081,22982853,0,0,23544,29316
22592,22953238,22953238,22983135,0,0,0,29897
22709,22953538,22977955,22983416,0,0,24417,29878
22710,22953538,22977970,22983431,0,0,24432,29893
21717,22724540,22724540,22983740,0,0,0,259200
21718,22724541,22724541,22983741,0,0,0,259200
21719,22724541,22724541,22983741,0,0,0,259200
21720,22724541,22724541,22983741,0,0,0,259200
21721,22724541,22724541,22983741,0,0,0,259200
21722,22724542,22724542,22983742,0,0,0,259200
21723,22724542,22724542,22983742,0,0,0,259200
22711,22953538,22978085,22983857,0,0,24547,30319
22713,22953538,22978198,22983969,0,0,24660,30431
22708,22953537,22977930,22983981,0,0,24393,30444
22719,22954811,22978273,22984013,0,0,23462,29202
22712,22953538,22978138,22984188,0,0,24600,30650
22865,22972632,22983742,22984419,0,0,11110,11787
22720,22954812,22979058,22984550,0,0,24246,29738
22619,22953465,22961188,22984797,0,0,7723,31332
22867,22974331,22984419,22985112,0,0,10088,10781
21724,22725931,22725931,22985131,0,0,0,259200
21725,22725964,22725964,22985164,0,0,0,259200
22868,22976678,22985112,22985185,0,0,8434,8507
22721,22954813,22979961,22985453,0,0,25148,30640
22722,22954813,22980094,22985555,0,0,25281,30742
22723,22954813,22980270,22985762,0,0,25457,30949
22724,22954813,22980272,22985764,0,0,25459,30951
22726,22954814,22980329,22985790,0,0,25515,30976
22725,22954814,22980301,22985793,0,0,25487,30979
22869,22976895,22985185,22985930,0,0,8290,9035
22727,22954814,22980537,22986029,0,0,25723,31215
22728,22954814,22980580,22986072,0,0,25766,31258
22729,22954815,22980894,22986386,0,0,26079,31571
22730,22954815,22980905,22986397,0,0,26090,31582
22733,22954816,22981094,22986586,0,0,26278,31770
22734,22954816,22981149,22986610,0,0,26333,31794
22735,22954816,22981176,22986668,0,0,26360,31852
22870,22979563,22985930,22986710,0,0,6367,7147
22731,22954815,22980908,22986958,0,0,26093,32143
22732,22954815,22981023,22987197,0,0,26208,32382
22738,22954817,22981923,22987384,0,0,27106,32567
22736,22954816,22981699,22987501,0,0,26883,32685
22740,22954826,22982040,22987502,0,0,27214,32676
22737,22954817,22981803,22987554,0,0,26986,32737
22742,22954827,22982194,22987656,0,0,27367,32829
22743,22954827,22982217,22987679,0,0,27390,32852
22741,22954826,22982193,22987686,0,0,27367,32860
22444,22946018,22946018,22987717,0,0,0,41699
22744,22954827,22982263,22987756,0,0,27436,32929
22746,22954828,22982550,22988042,0,0,27722,33214
22739,22954826,22981945,22988051,0,0,27119,33225
22745,22954827,22982343,22988053,0,0,27516,33226
22747,22954828,22982853,22988625,0,0,28025,33797
22748,22954828,22983416,22988877,0,0,28588,34049
22749,22954828,22983431,22988917,0,0,28603,34089
22753,22954829,22983969,22989424,0,0,29140,34595
22754,22954829,22983981,22989467,0,0,29152,34638
22755,22954829,22984013,22989479,0,0,29184,34650
22751,22954828,22983741,22989517,0,0,28913,34689
22750,22954828,22983740,22989536,0,0,28912,34708
22756,22954829,22984188,22989685,0,0,29359,34856
22752,22954828,22983857,22989881,0,0,29029,35053
22757,22954829,22984550,22990357,0,0,29721,35528
22758,22954829,22984797,22990852,0,0,29968,36023
22759,22954840,22985453,22990919,0,0,30613,36079
22760,22954840,22985555,22991021,0,0,30715,36181
22762,22954840,22985764,22991230,0,0,30924,36390
22763,22954840,22985790,22991256,0,0,30950,36416
22764,22954841,22985793,22991290,0,0,30952,36449
22765,22954841,22986029,22991495,0,0,31188,36654
22761,22954840,22985762,22991538,0,0,30922,36698
22766,22954841,22986072,22991569,0,0,31231,36728
22768,22954841,22986397,22991956,0,0,31556,37115
22771,22954842,22986668,22992164,0,0,31826,37322
22767,22954841,22986386,22992472,0,0,31545,37631
22769,22954841,22986586,22992640,0,0,31745,37799
22770,22954841,22986610,22992664,0,0,31769,37823
22773,22954842,22987197,22992667,0,0,32355,37825
22772,22954842,22986958,22992722,0,0,32116,37880
22774,22954842,22987384,22992871,0,0,32542,38029
22777,22954843,22987554,22993047,0,0,32711,38204
22780,22954855,22987679,22993141,0,0,32824,38286
22782,22954855,22987717,22993148,0,0,32862,38293
22781,22954855,22987686,22993179,0,0,32831,38324
22783,22954855,22987717,22993179,0,0,32862,38324
22775,22954842,22987501,22993304,0,0,32659,38462
22778,22954843,22987656,22993397,0,0,32813,38554
22787,22954856,22988053,22993526,0,0,33197,38670
22784,22954855,22987756,22993533,0,0,32901,38678
22776,22954842,22987502,22993553,0,0,32660,38711
22785,22954855,22988042,22993788,0,0,33187,38933
22786,22954855,22988051,22994104,0,0,33196,39249
22789,22954857,22988877,22994336,0,0,34020,39479
22788,22954856,22988625,22994405,0,0,33769,39549
22790,22954857,22988917,22994666,0,0,34060,39809
22508,22947912,22947912,22994906,0,0,0,46994
22793,22954858,22989479,22994969,0,0,34621,40111
22794,22954858,22989517,22994976,0,0,34659,40118
22501,22947910,22947910,22995198,0,0,0,47288
22795,22954858,22989536,22995328,0,0,34678,40470
22797,22954859,22989881,22995332,0,0,35022,40473
22509,22947912,22947912,22995402,0,0,0,47490
22499,22947910,22947910,22995438,0,0,0,47528
22796,22954858,22989685,22995457,0,0,34827,40599
22791,22954857,22989424,22995475,0,0,34567,40618
22510,22947912,22947912,22995495,0,0,0,47583
22792,22954857,22989467,22995549,0,0,34610,40692
22500,22947910,22947910,22995562,0,0,0,47652
22798,22954859,22990357,22995839,0,0,35498,40980
22512,22947912,22947912,22995888,0,0,0,47976
22847,22957124,22995839,22995932,0,0,38715,38808
22511,22947912,22947912,22996078,0,0,0,48166
22799,22954859,22990852,22996345,0,0,35993,41486
22374,22944615,22944615,22996355,0,0,0,51740
22498,22947909,22947909,22996534,0,0,0,48625
22800,22954871,22990919,22996691,0,0,36048,41820
22803,22954872,22991256,22996780,0,0,36384,41908
22801,22954871,22991021,22996793,0,0,36150,41922
22804,22954872,22991290,22996814,0,0,36418,41942
22450,22946410,22946410,22996882,0,0,0,50472
22802,22954871,22991230,22996971,0,0,36359,42100
22505,22947911,22947911,22996976,0,0,0,49065
22805,22954872,22991495,22996988,0,0,36623,42116
22502,22947911,22947911,22996997,0,0,0,49086
22807,22954872,22991569,22997062,0,0,36697,42190
22504,22947911,22947911,22997216,0,0,0,49305
22503,22947911,22947911,22997235,0,0,0,49324
22806,22954872,22991538,22997310,0,0,36666,42438
22809,22954873,22992164,22997626,0,0,37291,42753
22808,22954872,22991956,22997820,0,0,37084,42948
22810,22954873,22992472,22997973,0,0,37599,43100
22811,22954873,22992640,22998148,0,0,37767,43275
22814,22954873,22992722,22998215,0,0,37849,43342
22812,22954873,22992664,22998458,0,0,37791,43585
22334,22940794,22940794,22998485,0,0,0,57691
22816,22954874,22993047,22998527,0,0,38173,43653
22850,22958780,22998485,22998579,0,0,39705,39799
22820,22954885,22993179,22998628,0,0,38294,43743
22815,22954873,22992871,22998642,0,0,37998,43769
22447,22946203,22946203,22998704,0,0,0,52501
22813,22954873,22992667,22998741,0,0,37794,43868
22821,22954885,22993304,22998769,0,0,38419,43884
22822,22954886,22993397,22998862,0,0,38511,43976
22817,22954874,22993141,22998916,0,0,38267,44042
22818,22954874,22993148,22998954,0,0,38274,44080
22819,22954874,22993179,22998985,0,0,38305,44111
22823,22954886,22993526,22998986,0,0,38640,44100
22826,22954886,22993788,22999261,0,0,38902,44375
22824,22954886,22993533,22999282,0,0,38647,44396
22506,22947911,22947911,22999395,0,0,0,51484
22825,22954886,22993553,22999581,0,0,38667,44695
22827,22954886,22994104,22999593,0,0,39218,44707
22829,22954887,22994405,22999863,0,0,39518,44976
22418,22944890,22944977,23000341,0,0,87,55451
22830,22954887,22994666,23000403,0,0,39779,45516
22828,22954886,22994336,23000414,0,0,39450,45528
22832,22954887,22994976,23000473,0,0,40089,45586
22831,22954887,22994969,23000737,0,0,40082,45850
22833,22954887,22995328,23000841,0,0,40441,45954
22835,22954888,22995438,23000920,0,0,40550,46032
22836,22954888,22995457,23000939,0,0,40569,46051
22837,22954888,22995475,23000957,0,0,40587,46069
22834,22954887,22995332,23001073,0,0,40445,46186
22871,22980638,22995932,23001414,0,0,15294,20776
22515,22947913,22947913,23001428,0,0,0,53515
22872,22980639,22996078,23001579,0,0,15439,20940
22838,22954888,22995549,23001608,0,0,40661,46720
22839,22954888,22995562,23001621,0,0,40674,46733
22873,22980639,22996345,23001838,0,0,15706,21199
22876,22980640,22996780,23002335,0,0,16140,21695
22465,22946947,22946947,23002398,0,0,0,55451
22879,22980640,22996971,23002427,0,0,16331,21787
22875,22980639,22996691,23002432,0,0,16052,21793
22880,22980641,22996976,23002485,0,0,16335,21844
22881,22980641,22996988,23002492,0,0,16347,21851
22874,22980639,22996534,23002553,0,0,15895,21914
22878,22980640,22996814,23002628,0,0,16174,21988
22884,22980642,22997310,23002779,0,0,16668,22137
22882,22980641,22997062,23002793,0,0,16421,22152
22877,22980640,22996793,23002848,0,0,16153,22208
22885,22980642,22997626,23003124,0,0,16984,22482
22883,22980641,22997216,23003251,0,0,16575,22610
22507,22947911,22947911,23003258,0,0,0,55347
22702,22953536,22976492,23003260,0,0,22956,49724
22886,22980642,22997820,23003566,0,0,17178,22924
22888,22980643,22998148,23003646,0,0,17505,23003
22889,22980643,22998215,23003666,0,0,17572,23023
22887,22980642,22997973,23004023,0,0,17331,23381
22893,22980665,22998579,23004077,0,0,17914,23412
22897,22980666,22998741,23004208,0,0,18075,23542
22898,22980666,22998769,23004236,0,0,18103,23570
22890,22980643,22998458,23004253,0,0,17815,23610
22892,22980664,22998527,23004269,0,0,17863,23605
22894,22980665,22998579,23004352,0,0,17914,23687
22901,22980667,22998954,23004446,0,0,18287,23779
22462,22946624,22946624,23004466,0,0,0,57842
22903,22980667,22998986,23004469,0,0,18319,23802
22902,22980667,22998985,23004494,0,0,18318,23827
22891,22980663,22998485,23004522,0,0,17822,23859
22899,22980666,22998862,23004652,0,0,18196,23986
22895,22980665,22998628,23004680,0,0,17963,24015
22896,22980665,22998642,23004725,0,0,17977,24060
22905,22980668,22999282,23004836,0,0,18614,24168
22464,22946881,22946881,23004942,0,0,0,58061
22900,22980666,22998916,23005007,0,0,18250,24341
22904,22980667,22999261,23005054,0,0,18594,24387
22909,22980669,22999863,23005343,0,0,19194,24674
22906,22980668,22999395,23005476,0,0,18727,24808
22907,22980668,22999581,23005600,0,0,18913,24932
22908,22980668,22999593,23005648,0,0,18925,24980
22911,22980692,23000414,23005863,0,0,19722,25171
22912,22980693,23000473,23005948,0,0,19780,25255
22910,22980669,23000403,23006460,0,0,19734,25791
22913,22980693,23000737,23006522,0,0,20044,25829
22918,22980694,23001073,23006529,0,0,20379,25835
22914,22980693,23000841,23006588,0,0,20148,25895
22915,22980693,23000920,23006683,0,0,20227,25990
22916,22980693,23000939,23006702,0,0,20246,26009
22516,22947913,22947955,23006714,0,0,42,58801
22920,22980694,23001428,23006856,0,0,20734,26162
22919,22980694,23001414,23006873,0,0,20720,26179
22921,22980694,23001579,23007038,0,0,20885,26344
22922,22980694,23001608,23007074,0,0,20914,26380
22923,22980694,23001621,23007087,0,0,20927,26393
22925,22980695,23002335,23007827,0,0,21640,27132
22924,22980694,23001838,23007846,0,0,21144,27152
22928,22980695,23002485,23007966,0,0,21790,27271
22513,22947912,22947912,23007967,0,0,0,60055
22931,22980706,23002628,23008134,0,0,21922,27428
22926,22980695,23002427,23008187,0,0,21732,27492
22929,22980695,23002492,23008259,0,0,21797,27564
22933,22980707,23002793,23008274,0,0,22086,27567
22927,22980695,23002432,23008440,0,0,21737,27745
22935,22980708,23003124,23008585,0,0,22416,27877
22930,22980695,23002553,23008599,0,0,21858,27904
22934,22980707,23002848,23008623,0,0,22141,27916
22937,22980709,23003258,23008732,0,0,22549,28023
22936,22980708,23003251,23008765,0,0,22543,28057
22517,22947913,22947986,23008872,0,0,73,60959
22938,22980709,23003260,23009054,0,0,22551,28345
22932,22980706,23002779,23009104,0,0,22073,28398
22939,22980709,23003566,23009130,0,0,22857,28421
22941,22980710,23003666,23009137,0,0,22956,28427
22940,22980709,23003646,23009407,0,0,22937,28698
22944,22980711,23004208,23009710,0,0,23497,28999
22946,22980711,23004253,23009755,0,0,23542,29044
22947,22980711,23004269,23009759,0,0,23558,29048
22942,22980710,23004023,23009798,0,0,23313,29088
22948,22980712,23004352,23009840,0,0,23640,29128
22943,22980710,23004077,23009845,0,0,23367,29135
22851,22959016,23009759,23009852,0,0,50743,50836
22949,22980712,23004446,23009930,0,0,23734,29218
22951,22980723,23004494,23009947,0,0,23771,29224
22952,22980723,23004522,23009999,0,0,23799,29276
22955,22980724,23004725,23010184,0,0,24001,29460
22945,22980711,23004236,23010274,0,0,23525,29563
22956,22980724,23004836,23010326,0,0,24112,29602
22957,22980724,23004942,23010386,0,0,24218,29662
22953,22980723,23004652,23010392,0,0,23929,29669
22954,22980723,23004680,23010420,0,0,23957,29697
22950,22980712,23004469,23010485,0,0,23757,29773
22959,22980724,23005054,23010529,0,0,24330,29805
22958,22980724,23005007,23010781,0,0,24283,30057
22960,22980724,23005343,23010849,0,0,24619,30125
22962,22980725,23005600,23011099,0,0,24875,30374
22963,22980725,23005648,23011147,0,0,24923,30422
22961,22980724,23005476,23011261,0,0,24752,30537
22964,22980725,23005863,23011652,0,0,25138,30927
22965,22980725,23005948,23011985,0,0,25223,31260
22968,22980726,23006529,23011985,0,0,25803,31259
22971,22980739,23006702,23012191,0,0,25963,31452
22972,22980740,23006856,23012314,0,0,26116,31574
22969,22980726,23006588,23012338,0,0,25862,31612
22973,22980740,23006873,23012353,0,0,26133,31613
22970,22980728,23006683,23012442,0,0,25955,31714
22966,22980725,23006460,23012497,0,0,25735,31772
22976,22980740,23007087,23012569,0,0,26347,31829
22967,22980725,23006522,23012591,0,0,25797,31866
22975,22980740,23007074,23012629,0,0,26334,31889
22974,22980740,23007038,23012797,0,0,26298,32057
22991,22983131,22983131,23012852,0,0,0,29721
22979,22980741,23007966,23013434,0,0,27225,32693
22982,22980742,23008187,23013683,0,0,27445,32941
22984,22980743,23008274,23013740,0,0,27531,32997
22983,22980742,23008259,23013741,0,0,27517,32999
22980,22980741,23007967,23013760,0,0,27226,33019
22977,22980740,23007827,23013847,0,0,27087,33107
22981,22980742,23008134,23013874,0,0,27392,33132
22978,22980740,23007846,23013896,0,0,27106,33156
22985,22980743,23008440,23014219,0,0,27697,33476
22986,22980743,23008585,23014334,0,0,27842,33591
22987,22980743,23008599,23014379,0,0,27856,33636
22988,22980744,23008623,23014397,0,0,27879,33653
22989,22980744,23008732,23014463,0,0,27988,33719
22990,22980744,23008765,23014527,0,0,28021,33783
22298,22937106,22937106,23016417,0,0,0,79311
23008,23018080,23018080,23018159,0,0,0,79
23011,23018201,23018201,23018363,0,0,0,162
23015,23018327,23018327,23018364,0,0,0,37
23014,23018299,23018299,23018509,0,0,0,210
23018,23018470,23018470,23018537,0,0,0,67
23020,23018769,23018769,23018847,0,0,0,78
23021,23019369,23019369,23019461,0,0,0,92
22366,22943603,22943603,23019984,0,0,0,76381
23023,23019882,23019882,23020200,0,0,0,318
23022,23019839,23019839,23020439,0,0,0,600
23024,23020173,23020173,23020594,0,0,0,421
23025,23020567,23020567,23020603,0,0,0,36
23026,23020626,23020626,23020725,0,0,0,99
23027,23020727,23020727,23020825,0,0,0,98
23029,23021505,23021505,23021572,0,0,0,67
23031,23022084,23022084,23022182,0,0,0,98
23034,23024410,23024410,23024470,0,0,0,60
22917,22980693,23000957,23024908,0,0,20264,44215
23035,23025020,23025020,23025129,0,0,0,109
23036,23025553,23025553,23025651,0,0,0,98
22244,22933145,22933145,23025682,0,0,0,92537
23009,23018128,23025682,23025775,0,0,7554,7647
23012,23018233,23025775,23025868,0,0,7542,7635
23016,23018361,23018361,23026664,0,0,0,8303
23037,23026326,23026326,23026908,0,0,0,582
23017,23018464,23018464,23027171,0,0,0,8707
23039,23027015,23027015,23027532,0,0,0,517
23040,23027333,23027333,23027679,0,0,0,346
23003,23013139,23013139,23028164,0,0,0,15025
23010,23018176,23028164,23028257,0,0,9988,10081
23013,23018262,23028257,23028350,0,0,9995,10088
23043,23028297,23028350,23028422,0,0,53,125
23042,23028097,23028097,23028465,0,0,0,368
23019,23018574,23019984,23028489,0,0,1410,9915
23041,23028079,23028079,23028558,0,0,0,479
23044,23029748,23029748,23029815,0,0,0,67
23001,23010143,23010143,23030098,0,0,0,19955
23045,23030241,23030241,23030339,0,0,0,98
23046,23030551,23030551,23030820,0,0,0,269
23048,23030877,23030877,23031152,0,0,0,275
23051,23031983,23031983,23032067,0,0,0,84
23054,23033167,23033167,23033260,0,0,0,93
23053,23033105,23033105,23033409,0,0,0,304
23055,23033507,23033507,23033580,0,0,0,73
22239,22933073,22933073,23033661,0,0,0,100588
23057,23033628,23033628,23033701,0,0,0,73
23038,23026876,23033661,23033755,0,0,6785,6879
23052,23032120,23032120,23033876,0,0,0,1756
23060,23033823,23033823,23033896,0,0,0,73
23061,23033918,23033918,23034033,0,0,0,115
23059,23033817,23033817,23034090,0,0,0,273
23066,23034172,23034172,23034291,0,0,0,119
23067,23034254,23034254,23034508,0,0,0,254
23068,23034806,23034806,23034899,0,0,0,93
23070,23035081,23035081,23035174,0,0,0,93
23071,23035319,23035319,23035412,0,0,0,93
23072,23035408,23035408,23035481,0,0,0,73
23073,23035485,23035485,23035563,0,0,0,78
23074,23035568,23035568,23035674,0,0,0,106
23075,23035681,23035681,23035774,0,0,0,93
23076,23035769,23035769,23035842,0,0,0,73
23077,23035934,23035934,23036007,0,0,0,73
23078,23036042,23036042,23036115,0,0,0,73
23079,23036141,23036141,23036234,0,0,0,93
23080,23036259,23036259,23036353,0,0,0,94
23081,23036431,23036431,23036524,0,0,0,93
23082,23036527,23036527,23036620,0,0,0,93
23083,23036864,23036864,23036988,0,0,0,124
23084,23037233,23037233,23037337,0,0,0,104
23069,23035068,23035068,23042495,0,0,0,7427
23093,23037741,23042495,23042587,0,0,4754,4846
23087,23037538,23042495,23042592,0,0,4957,5054
23096,23037917,23042587,23042660,0,0,4670,4743
23102,23038253,23042592,23042685,0,0,4339,4432
23004,23013147,23013434,23044202,0,0,287,31055
23085,23037477,23037477,23046457,0,0,0,8980
23005,23016312,23016312,23049628,0,0,0,33316
23007,23016483,23016483,23049850,0,0,0,33367
23090,23037609,23049850,23049944,0,0,12241,12335
23092,23037720,23042495,23050841,0,0,4775,13121
23088,23037575,23042495,23051022,0,0,4920,13447
23089,23037578,23037578,23051099,0,0,0,13521
23104,23042172,23051022,23051146,0,0,8850,8974
23105,23042439,23051146,23051239,0,0,8707,8800
23107,23043689,23051239,23051487,0,0,7550,7798
23108,23044070,23051487,23051580,0,0,7417,7510
23109,23044161,23051580,23051653,0,0,7419,7492
23110,23044340,23051653,23051808,0,0,7313,7468
23111,23044541,23051808,23051902,0,0,7267,7361
23112,23045170,23051902,23051996,0,0,6732,6826
23086,23037507,23037507,23052091,0,0,0,14584
22855,22961527,23010392,23054513,0,0,48865,92986
23095,23037801,23046457,23054540,0,0,8656,16739
23002,23012978,23012978,23054564,0,0,0,41586
23056,23033597,23054513,23054660,0,0,20916,21063
23058,23033701,23054564,23054727,0,0,20863,21026
23047,23030602,23033755,23055047,0,0,3153,24445
23030,23022068,23022068,23055262,0,0,0,33194
23094,23037758,23042495,23056160,0,0,4737,18402
22856,22961540,23010849,23057175,0,0,49309,95635
23062,23033959,23057175,23057330,0,0,23216,23371
23103,23038673,23049628,23058444,0,0,10955,19771
23097,23037918,23049628,23058973,0,0,11710,21055
23033,23024008,23028350,23060223,0,0,4342,36215
23106,23042840,23042840,23062047,0,0,0,19207
23091,23037699,23049944,23063701,0,0,12245,26002
22242,22933088,22933088,23066109,0,0,0,133021
21853,22809640,22809640,23067910,0,0,0,258270
22241,22933082,22933082,23068602,0,0,0,135520
21847,22809497,22809497,23068697,0,0,0,259200
21848,22809498,22809498,23068698,0,0,0,259200
21849,22809498,22809498,23068698,0,0,0,259200
21850,22809498,22809498,23068698,0,0,0,259200
21851,22809520,22809520,23068720,0,0,0,259200
21852,22809520,22809520,23068720,0,0,0,259200
21854,22809736,22809736,23068936,0,0,0,259200
21716,22724137,22724137,23069737,0,0,0,345600
23049,23031081,23044202,23086085,0,0,13121,55004
23113,23051076,23054540,23087833,0,0,3464,36757
22857,22961576,23014379,23087876,0,0,52803,126300
22415,22944773,23087876,23088032,0,0,143103,143259
23114,23051113,23054727,23088969,0,0,3614,37856
23050,23031088,23054513,23088973,0,0,23425,57885
23063,23033990,23088973,23089190,0,0,54983,55200
23098,23038130,23054660,23090609,0,0,16530,52479
23099,23038201,23054727,23091836,0,0,16526,53635
22238,22933072,22933072,23094019,0,0,0,160947
23101,23038252,23057175,23094325,0,0,18923,56073
21923,22842547,22842547,23095147,0,0,0,252600
21924,22842561,22842561,23095161,0,0,0,252600
21925,22842578,22842578,23095178,0,0,0,252600
23006,23016348,23016348,23095183,0,0,0,78835
23100,23038227,23055047,23095725,0,0,16820,57498
23126,23097076,23097076,23097170,0,0,0,94
23127,23097607,23097607,23097700,0,0,0,93
23128,23098226,23098226,23098319,0,0,0,93
23129,23098758,23098758,23098851,0,0,0,93
23130,23099301,23099301,23099405,0,0,0,104
23131,23099757,23099757,23099863,0,0,0,106
23132,23100099,23100099,23100193,0,0,0,94
23133,23100412,23100412,23100514,0,0,0,102
23134,23100484,23100484,23100578,0,0,0,94
23136,23100617,23100617,23100701,0,0,0,84
23135,23100607,23100607,23100702,0,0,0,95
23137,23100662,23100662,23100749,0,0,0,87
23138,23100728,23100728,23100822,0,0,0,94
23139,23100824,23100824,23100917,0,0,0,93
23141,23100968,23100968,23101030,0,0,0,62
23142,23101074,23101074,23101167,0,0,0,93
23140,23100934,23100934,23101235,0,0,0,301
23143,23101260,23101260,23101354,0,0,0,94
23144,23101378,23101378,23101482,0,0,0,104
23145,23101439,23101439,23101512,0,0,0,73
23146,23101539,23101539,23101829,0,0,0,290
23147,23101850,23101850,23102172,0,0,0,322
23149,23102249,23102249,23102360,0,0,0,111
23150,23102335,23102335,23102429,0,0,0,94
23148,23102130,23102130,23102480,0,0,0,350
23151,23102526,23102526,23102855,0,0,0,329
23153,23102863,23102863,23102978,0,0,0,115
23154,23102935,23102935,23103008,0,0,0,73
23155,23102943,23102943,23103201,0,0,0,258
23157,23103172,23103172,23103265,0,0,0,93
23159,23103676,23103676,23103749,0,0,0,73
23158,23103571,23103571,23103852,0,0,0,281
23160,23103819,23103819,23103892,0,0,0,73
23164,23105095,23105095,23105331,0,0,0,236
23165,23105238,23105238,23105332,0,0,0,94
23166,23105386,23105386,23105479,0,0,0,93
23167,23105536,23105536,23105609,0,0,0,73
23168,23105737,23105737,23105810,0,0,0,73
23169,23106034,23106034,23106128,0,0,0,94
23170,23106278,23106278,23106537,0,0,0,259
23028,23021339,23025868,23106868,0,0,4529,85529
23171,23108199,23108199,23108835,0,0,0,636
23163,23104274,23104274,23109196,0,0,0,4922
23152,23102737,23102737,23111624,0,0,0,8887
23156,23103145,23103145,23111740,0,0,0,8595
23176,23111921,23111921,23112020,0,0,0,99
23161,23103855,23103855,23112468,0,0,0,8613
23177,23112181,23112181,23112868,0,0,0,687
23178,23113013,23113013,23113717,0,0,0,704
23162,23104012,23104012,23113779,0,0,0,9767
22045,22854961,22854961,23114161,0,0,0,259200
22046,22855004,22855004,23114204,0,0,0,259200
23180,23114217,23114217,23114288,0,0,0,71
22047,22855176,22855176,23114376,0,0,0,259200
23181,23114326,23114326,23114427,0,0,0,101
23185,23114851,23114851,23114949,0,0,0,98
23173,23109800,23109800,23114981,0,0,0,5181
23187,23115239,23115239,23115319,0,0,0,80
23188,23115256,23115256,23115350,0,0,0,94
23189,23115361,23115361,23115519,0,0,0,158
23193,23115803,23115803,23115896,0,0,0,93
23194,23115898,23115898,23115971,0,0,0,73
22056,22856853,22856853,23116053,0,0,0,259200
23195,23116109,23116109,23116202,0,0,0,93
23196,23116216,23116216,23116309,0,0,0,93
23197,23116305,23116305,23116378,0,0,0,73
23064,23034028,23116053,23116712,0,0,82025,82684
23199,23116527,23116527,23116858,0,0,0,331
23200,23116578,23116578,23116910,0,0,0,332
22243,22933088,22933088,23117044,0,0,0,183956
22240,22933079,22933079,23117051,0,0,0,183972
23198,23116411,23116411,23117115,0,0,0,704
23207,23117250,23117250,23117333,0,0,0,83
23065,23034059,23116712,23117510,0,0,82653,83451
23210,23117699,23117699,23117793,0,0,0,94
23175,23111314,23111314,23118010,0,0,0,6696
23209,23117608,23117608,23118474,0,0,0,866
23211,23118009,23118009,23118566,0,0,0,557
23206,23117152,23117152,23118867,0,0,0,1715
23214,23118788,23118788,23118873,0,0,0,85
23216,23119371,23119371,23119725,0,0,0,354
23218,23119594,23119594,23119956,0,0,0,362
23213,23118499,23118499,23120211,0,0,0,1712
23208,23117328,23117328,23120264,0,0,0,2936
23219,23120222,23120222,23120775,0,0,0,553
23179,23113933,23113933,23120805,0,0,0,6872
23186,23115057,23115057,23120836,0,0,0,5779
23191,23115410,23115410,23121072,0,0,0,5662
23222,23121045,23121045,23121124,0,0,0,79
23220,23120877,23120877,23121225,0,0,0,348
23224,23121154,23121154,23121289,0,0,0,135
23221,23121033,23121033,23121321,0,0,0,288
23225,23121321,23121321,23121388,0,0,0,67
23223,23121080,23121080,23121753,0,0,0,673
23228,23122063,23122063,23122154,0,0,0,91
23230,23122121,23122121,23122188,0,0,0,67
23226,23121648,23121648,23122237,0,0,0,589
23215,23118935,23118935,23122324,0,0,0,3389
23192,23115473,23115473,23122352,0,0,0,6879
23229,23122100,23122100,23122418,0,0,0,318
23233,23122482,23122482,23122761,0,0,0,279
23232,23122286,23122286,23122820,0,0,0,534
23236,23122974,23122974,23123054,0,0,0,80
23217,23119417,23119417,23123120,0,0,0,3703
23235,23122906,23122906,23123225,0,0,0,319
23237,23123028,23123028,23123298,0,0,0,270
23238,23123188,23123188,23123788,0,0,0,600
23239,23123236,23123236,23123871,0,0,0,635
23172,23108979,23108979,23124162,0,0,0,15183
23240,23123829,23123829,23124548,0,0,0,719
23248,23125019,23125019,23125098,0,0,0,79
23251,23125103,23125103,23125172,0,0,0,69
23254,23125203,23125203,23125266,0,0,0,63
23231,23122210,23122210,23125297,0,0,0,3087
23247,23124877,23124877,23125452,0,0,0,575
23227,23122008,23122008,23125482,0,0,0,3474
23255,23125573,23125573,23125664,0,0,0,91
23242,23124162,23124162,23125771,0,0,0,1609
23256,23125678,23125678,23125775,0,0,0,97
23258,23125744,23125744,23125819,0,0,0,75
23260,23125998,23125998,23126091,0,0,0,93
23190,23115369,23115369,23126150,0,0,0,10781
23234,23122786,23122786,23126454,0,0,0,3668
23264,23127072,23127072,23127166,0,0,0,94
23266,23127355,23127355,23127459,0,0,0,104
23267,23127485,23127485,23127595,0,0,0,110
23268,23127545,23127545,23127623,0,0,0,78
23269,23127563,23127563,23127656,0,0,0,93
23241,23124004,23124004,23127820,0,0,0,3816
23243,23124336,23124336,23127846,0,0,0,3510
23270,23127778,23127778,23127851,0,0,0,73
23265,23127349,23127349,23127960,0,0,0,611
23244,23124473,23124473,23128076,0,0,0,3603
23249,23125022,23125022,23128078,0,0,0,3056
23253,23125146,23125146,23128524,0,0,0,3378
23245,23124511,23124511,23128575,0,0,0,4064
23257,23125730,23125730,23128576,0,0,0,2846
23259,23125787,23125787,23128576,0,0,0,2789
23252,23125121,23125121,23128707,0,0,0,3586
23271,23128110,23128110,23128742,0,0,0,632
23246,23124559,23124559,23128773,0,0,0,4214
23250,23125096,23125096,23128864,0,0,0,3768
23275,23129012,23129012,23129666,0,0,0,654
23274,23128995,23128995,23129693,0,0,0,698
23276,23129025,23129025,23129775,0,0,0,750
23273,23128574,23128574,23129909,0,0,0,1335
23272,23128544,23128544,23129941,0,0,0,1397
23261,23126122,23126122,23130635,0,0,0,4513
23262,23126391,23126391,23130857,0,0,0,4466
23263,23126713,23126713,23131136,0,0,0,4423
23281,23131027,23131027,23131570,0,0,0,543
23282,23131902,23131902,23131970,0,0,0,68
23284,23132135,23132135,23132182,0,0,0,47
23283,23132011,23132011,23132519,0,0,0,508
23277,23129865,23129865,23132600,0,0,0,2735
23288,23132603,23132603,23132701,0,0,0,98
23290,23132755,23132755,23132900,0,0,0,145
23289,23132746,23132746,23132907,0,0,0,161
23294,23133003,23133003,23133163,0,0,0,160
23204,23116963,23116963,23133182,0,0,0,16219
22157,22926147,22926147,23133286,0,0,0,207139
22158,22926154,22926154,23133329,0,0,0,207175
23297,23133288,23133288,23133448,0,0,0,160
23298,23133461,23133461,23133621,0,0,0,160
23299,23133994,23133994,23134057,0,0,0,63
23300,23134010,23134010,23134057,0,0,0,47
23280,23130715,23130715,23134059,0,0,0,3344
23301,23134072,23134072,23134169,0,0,0,97
23302,23134137,23134137,23134198,0,0,0,61
23304,23134213,23134213,23134249,0,0,0,36
23287,23132586,23132586,23134253,0,0,0,1667
23303,23134170,23134170,23134254,0,0,0,84
23305,23134258,23134258,23134321,0,0,0,63
23279,23130650,23130650,23134327,0,0,0,3677
23307,23134283,23134283,23134366,0,0,0,83
23309,23134329,23134329,23134396,0,0,0,67
23312,23134896,23134896,23134998,0,0,0,102
23313,23134954,23134954,23135008,0,0,0,54
23314,23134971,23134971,23135040,0,0,0,69
23315,23135002,23135002,23135066,0,0,0,64
23317,23135029,23135029,23135097,0,0,0,68
23318,23135045,23135045,23135097,0,0,0,52
23319,23135061,23135061,23135097,0,0,0,36
23316,23135014,23135014,23135098,0,0,0,84
23320,23135116,23135116,23135240,0,0,0,124
23329,23135361,23135361,23135547,0,0,0,186
23115,23058003,23058003,23135591,0,0,0,77588
23323,23135157,23135591,23135833,0,0,434,676
23330,23135565,23135565,23135844,0,0,0,279
23212,23118210,23118210,23135867,0,0,0,17657
23203,23116961,23116961,23138868,0,0,0,21907
23326,23135198,23138868,23138961,0,0,3670,3763
23331,23135868,23138868,23139624,0,0,3000,3756
23306,23134275,23134275,23140256,0,0,0,5981
23332,23136756,23139624,23140326,0,0,2868,3570
22858,22961597,23066109,23140686,0,0,104512,179089
23336,23137017,23140326,23140946,0,0,3309,3929
23333,23136972,23140256,23141013,0,0,3284,4041
23334,23136979,23140256,23141013,0,0,3277,4034
23337,23137063,23140686,23141324,0,0,3623,4261
23338,23137089,23140686,23141364,0,0,3597,4275
23339,23137120,23140686,23141395,0,0,3566,4275
23340,23137153,23140686,23141395,0,0,3533,4242
23341,23137179,23140686,23141399,0,0,3507,4220
23342,23137201,23140686,23141430,0,0,3485,4229
23343,23137227,23140686,23141430,0,0,3459,4203
23292,23132875,23132875,23141440,0,0,0,8565
23293,23132926,23132926,23143893,0,0,0,10967
22853,22961368,23009999,23149637,0,0,48631,188269
23325,23135186,23135844,23149872,0,0,658,14686
23311,23134880,23135867,23149909,0,0,987,15029
23201,23116739,23116739,23150067,0,0,0,33328
23202,23116941,23116941,23150408,0,0,0,33467
23205,23116992,23116992,23150657,0,0,0,33665
23308,23134323,23134323,23155868,0,0,0,21545
23328,23135233,23138961,23158677,0,0,3728,23444
23327,23135221,23138868,23158987,0,0,3647,23766
23285,23132439,23132439,23160479,0,0,0,28040
23291,23132859,23132859,23161459,0,0,0,28600
23286,23132453,23132453,23162624,0,0,0,30171
23324,23135169,23135833,23163328,0,0,664,28159
23310,23134400,23134400,23168495,0,0,0,34095
22068,22859013,23168495,23168589,0,0,309482,309576
23032,23022641,23090609,23169659,0,0,67968,147018
23125,23095254,23095254,23174153,0,0,0,78899
22144,22884711,22884711,23181990,0,0,0,297279
23348,23183658,23183658,23183794,0,0,0,136
23349,23183685,23183685,23183872,0,0,0,187
23352,23184160,23184160,23184227,0,0,0,67
23353,23184298,23184298,23184365,0,0,0,67
23350,23184097,23184097,23184430,0,0,0,333
23354,23184425,23184425,23184503,0,0,0,78
23351,23184113,23184113,23184822,0,0,0,709
23347,23183604,23183604,23185586,0,0,0,1982
23356,23184600,23184600,23185587,0,0,0,987
23358,23185994,23185994,23186216,0,0,0,222
23359,23186431,23186431,23186686,0,0,0,255
23360,23186649,23186649,23186820,0,0,0,171
23361,23186811,23186811,23187411,0,0,0,600
23362,23187545,23187545,23187644,0,0,0,99
23363,23187596,23187596,23187869,0,0,0,273
23364,23187608,23187608,23188115,0,0,0,507
23174,23110866,23110866,23188259,0,0,0,77393
23369,23188219,23188219,23188317,0,0,0,98
23365,23187755,23187755,23188355,0,0,0,600
23373,23189098,23189098,23189208,0,0,0,110
23374,23189247,23189247,23189411,0,0,0,164
23375,23189310,23189310,23189496,0,0,0,186
23376,23189341,23189341,23189504,0,0,0,163
23377,23189370,23189370,23189533,0,0,0,163
23378,23189400,23189400,23189609,0,0,0,209
23380,23189427,23189427,23189645,0,0,0,218
23384,23189635,23189635,23189728,0,0,0,93
23382,23189453,23189453,23189890,0,0,0,437
23379,23189414,23189414,23189901,0,0,0,487
23390,23189965,23189965,23190132,0,0,0,167
23388,23189869,23189869,23190277,0,0,0,408
23371,23188625,23188625,23190346,0,0,0,1721
23389,23189941,23189941,23190355,0,0,0,414
23392,23190014,23190014,23190454,0,0,0,440
23393,23190101,23190101,23190546,0,0,0,445
23381,23189452,23189645,23190582,0,0,193,1130
23394,23190196,23190196,23190661,0,0,0,465
23395,23190276,23190276,23190741,0,0,0,465
23383,23189477,23189477,23190759,0,0,0,1282
23396,23190385,23190385,23190860,0,0,0,475
23397,23190547,23190547,23191689,0,0,0,1142
23398,23190629,23190629,23191771,0,0,0,1142
23370,23188320,23188320,23191920,0,0,0,3600
23399,23190787,23190787,23191958,0,0,0,1171
23372,23188672,23188672,23192272,0,0,0,3600
23400,23190881,23190881,23192498,0,0,0,1617
23408,23191467,23191467,23192521,0,0,0,1054
23407,23191441,23191441,23192548,0,0,0,1107
23409,23191483,23191483,23192618,0,0,0,1135
22852,22961351,23009852,23192747,0,0,48501,231396
23406,23191319,23191319,23193119,0,0,0,1800
23410,23191746,23191746,23193452,0,0,0,1706
23401,23191006,23191006,23194319,0,0,0,3313
23385,23189737,23189737,23194531,0,0,0,4794
23403,23191127,23191127,23194562,0,0,0,3435
23412,23194541,23194541,23195141,0,0,0,600
23413,23194572,23194572,23195172,0,0,0,600
23411,23192207,23192207,23195388,0,0,0,3181
23414,23195746,23195746,23195813,0,0,0,67
23402,23191115,23191115,23196226,0,0,0,5111
23415,23196451,23196451,23196498,0,0,0,47
23417,23196959,23196959,23197026,0,0,0,67
23420,23198021,23198021,23198120,0,0,0,99
23421,23198165,23198165,23198258,0,0,0,93
23278,23130254,23130254,23198373,0,0,0,68119
23422,23198399,23198399,23198508,0,0,0,109
23418,23197426,23197426,23198549,0,0,0,1123
23423,23198460,23198460,23198549,0,0,0,89
23424,23198506,23198506,23198610,0,0,0,104
23419,23197468,23197468,23198611,0,0,0,1143
23426,23198854,23198854,23198922,0,0,0,68
23425,23198771,23198771,23198977,0,0,0,206
23427,23199074,23199074,23199152,0,0,0,78
23429,23199924,23199924,23199992,0,0,0,68
23431,23200101,23200101,23200168,0,0,0,67
23430,23200005,23200005,23200207,0,0,0,202
23322,23135146,23135240,23200250,0,0,94,65104
23321,23135127,23135127,23200261,0,0,0,65134
23416,23196890,23196890,23200331,0,0,0,3441
23368,23188042,23188042,23201107,0,0,0,13065
23449,23201125,23201125,23201203,0,0,0,78
23450,23201261,23201261,23201447,0,0,0,186
23451,23201570,23201570,23201632,0,0,0,62
23452,23201900,23201900,23201967,0,0,0,67
23453,23202156,23202156,23202223,0,0,0,67
23405,23191195,23191195,23202284,0,0,0,11089
23428,23199228,23199228,23202574,0,0,0,3346
23455,23202527,23202527,23202594,0,0,0,67
23456,23202922,23202922,23202989,0,0,0,67
23346,23180739,23180739,23203065,0,0,0,22326
23457,23203600,23203600,23203678,0,0,0,78
23458,23203647,23203647,23203714,0,0,0,67
23459,23203746,23203746,23203835,0,0,0,89
23460,23203794,23203794,23203872,0,0,0,78
23461,23203835,23203835,23203923,0,0,0,88
23463,23203933,23203933,23204045,0,0,0,112
23462,23203892,23203892,23204131,0,0,0,239
23391,23189985,23189985,23204203,0,0,0,14218
23465,23204131,23204131,23204465,0,0,0,334
23466,23204453,23204453,23204789,0,0,0,336
23472,23204757,23204757,23205151,0,0,0,394
23474,23205176,23205176,23205373,0,0,0,197
23475,23205339,23205339,23205538,0,0,0,199
23481,23205633,23205633,23205757,0,0,0,124
23477,23205547,23205547,23206298,0,0,0,751
23479,23205631,23205631,23206375,0,0,0,744
23478,23205630,23205630,23206540,0,0,0,910
23484,23206355,23206355,23206997,0,0,0,642
23485,23206961,23206961,23207085,0,0,0,124
23489,23207582,23207582,23207675,0,0,0,93
23490,23207693,23207693,23207786,0,0,0,93
23491,23207813,23207813,23207886,0,0,0,73
23492,23207967,23207967,23208047,0,0,0,80
23467,23204456,23204456,23208056,0,0,0,3600
23468,23204461,23204461,23208061,0,0,0,3600
23469,23204466,23204466,23208066,0,0,0,3600
23470,23204469,23204469,23208069,0,0,0,3600
23493,23208015,23208015,23208112,0,0,0,97
23487,23207148,23207148,23208113,0,0,0,965
23494,23208048,23208048,23208114,0,0,0,66
23495,23208059,23208059,23208211,0,0,0,152
23486,23207099,23207099,23208250,0,0,0,1151
23497,23208145,23208145,23208251,0,0,0,106
23488,23207236,23207236,23208303,0,0,0,1067
23500,23208337,23208337,23208395,0,0,0,58
23480,23205632,23205632,23208534,0,0,0,2902
23496,23208132,23208132,23208541,0,0,0,409
23503,23208556,23208556,23208646,0,0,0,90
23504,23208615,23208615,23208708,0,0,0,93
23387,23189837,23189837,23208930,0,0,0,19093
23482,23205633,23205633,23209195,0,0,0,3562
23510,23209246,23209246,23209375,0,0,0,129
23502,23208448,23208448,23209617,0,0,0,1169
23513,23209569,23209569,23209647,0,0,0,78
23505,23208908,23208908,23209650,0,0,0,742
23514,23209809,23209809,23209876,0,0,0,67
23515,23209927,23209927,23210032,0,0,0,105
23367,23187983,23187983,23210110,0,0,0,22127
23518,23210056,23210056,23210150,0,0,0,94
23519,23210182,23210182,23210273,0,0,0,91
23520,23210233,23210233,23210311,0,0,0,78
23499,23208277,23208277,23210417,0,0,0,2140
23521,23210352,23210352,23210445,0,0,0,93
23501,23208426,23208426,23210581,0,0,0,2155
23522,23210510,23210510,23210583,0,0,0,73
23523,23210584,23210584,23210708,0,0,0,124
23524,23210733,23210733,23210830,0,0,0,97
23526,23210813,23210813,23210947,0,0,0,134
23525,23210757,23210757,23211357,0,0,0,600
23531,23211769,23211769,23211868,0,0,0,99
23530,23211646,23211646,23211880,0,0,0,234
23355,23184541,23184541,23211895,0,0,0,27354
23527,23210819,23211357,23211957,0,0,538,1138
23532,23211903,23211903,23211970,0,0,0,67
23533,23212313,23212313,23212381,0,0,0,68
23529,23211462,23211957,23212486,0,0,495,1024
23534,23213138,23213138,23213258,0,0,0,120
23535,23213221,23213221,23213258,0,0,0,37
22994,22984501,22986710,23213475,0,0,2209,228974
23546,23214279,23214279,23214700,0,0,0,421
23550,23214279,23214279,23214709,0,0,0,430
23547,23214279,23214279,23214731,0,0,0,452
23548,23214279,23214279,23214731,0,0,0,452
23549,23214279,23214279,23214731,0,0,0,452
23551,23214279,23214700,23215138,0,0,421,859
23553,23214280,23214731,23215152,0,0,451,872
23554,23214280,23214731,23215152,0,0,451,872
23555,23214280,23214731,23215152,0,0,451,872
23588,23215046,23215046,23215299,0,0,0,253
23589,23215303,23215303,23215432,0,0,0,129
23557,23214280,23215152,23215581,0,0,872,1301
23558,23214280,23215152,23215581,0,0,872,1301
23559,23214281,23215152,23215581,0,0,871,1300
23590,23215546,23215546,23215614,0,0,0,68
23556,23214280,23215138,23215620,0,0,858,1340
23560,23214281,23215581,23216010,0,0,1300,1729
23561,23214281,23215581,23216010,0,0,1300,1729
23562,23214281,23215581,23216010,0,0,1300,1729
23563,23214281,23215620,23216049,0,0,1339,1768
23592,23215926,23215926,23216085,0,0,0,159
23593,23216059,23216059,23216158,0,0,0,99
23386,23189835,23189835,23216419,0,0,0,26584
23564,23214281,23216010,23216439,0,0,1729,2158
23565,23214281,23216010,23216439,0,0,1729,2158
23566,23214282,23216010,23216439,0,0,1728,2157
23594,23216349,23216349,23216447,0,0,0,98
23567,23214282,23216049,23216478,0,0,1767,2196
23464,23203979,23203979,23216515,0,0,0,12536
23568,23214282,23216419,23216848,0,0,2137,2566
23573,23214284,23216439,23216859,0,0,2155,2575
23574,23214284,23216439,23216859,0,0,2155,2575
23575,23214284,23216439,23216859,0,0,2155,2575
23569,23214282,23216419,23216869,0,0,2137,2587
23570,23214282,23216419,23216869,0,0,2137,2587
23571,23214282,23216419,23216869,0,0,2137,2587
23572,23214283,23216419,23216870,0,0,2136,2587
23576,23214284,23216478,23216929,0,0,2194,2645
23596,23216843,23216843,23216983,0,0,0,140
23577,23214285,23216848,23217268,0,0,2563,2983
23578,23214285,23216859,23217279,0,0,2574,2994
23579,23214285,23216859,23217279,0,0,2574,2994
23581,23214286,23216869,23217289,0,0,2583,3003
23582,23214286,23216869,23217289,0,0,2583,3003
23583,23214286,23216869,23217289,0,0,2583,3003
23584,23214287,23216870,23217290,0,0,2583,3003
23580,23214285,23216859,23217311,0,0,2574,3026
23585,23214287,23216929,23217368,0,0,2642,3081
23597,23217349,23217349,23217385,0,0,0,36
23598,23217419,23217419,23217504,0,0,0,85
23599,23217439,23217439,23217508,0,0,0,69
23600,23217482,23217482,23217548,0,0,0,66
23601,23217512,23217512,23217606,0,0,0,94
23602,23217570,23217570,23217637,0,0,0,67
23586,23214287,23217268,23217707,0,0,2981,3420
23603,23217643,23217643,23217710,0,0,0,67
23604,23217751,23217751,23217787,0,0,0,36
23605,23217807,23217807,23217860,0,0,0,53
23606,23217823,23217823,23217891,0,0,0,68
23607,23217859,23217859,23217929,0,0,0,70
23608,23217873,23217873,23217943,0,0,0,70
23610,23217910,23217910,23217962,0,0,0,52
23609,23217892,23217892,23217971,0,0,0,79
23611,23217920,23217920,23217989,0,0,0,69
23612,23217929,23217929,23217999,0,0,0,70
23498,23208267,23208267,23218222,0,0,0,9955
23619,23218100,23218222,23218377,0,0,122,277
23614,23217992,23217992,23218385,0,0,0,393
23622,23218495,23218495,23218573,0,0,0,78
23613,23217978,23217978,23218606,0,0,0,628
23623,23218656,23218656,23218724,0,0,0,68
23624,23218773,23218773,23218861,0,0,0,88
23625,23218824,23218824,23218861,0,0,0,37
23366,23187957,23187957,23218887,0,0,0,30930
23621,23218122,23218887,23218980,0,0,765,858
23626,23218913,23218913,23218981,0,0,0,68
22995,22984501,22986710,23219089,0,0,2209,234588
23627,23218979,23218979,23219132,0,0,0,153
23628,23219031,23219031,23219157,0,0,0,126
23631,23219103,23219103,23219160,0,0,0,57
23528,23210915,23210915,23219618,0,0,0,8703
23404,23191169,23191169,23220561,0,0,0,29392
23506,23208933,23208933,23221159,0,0,0,12226
23508,23208942,23208942,23221529,0,0,0,12587
23344,23145036,23145036,23222985,0,0,0,77949
23536,23213351,23213351,23223910,0,0,0,10559
23509,23208947,23208947,23226341,0,0,0,17394
23507,23208938,23208938,23226460,0,0,0,17522
23633,23222667,23222667,23227055,0,0,0,4388
23629,23219037,23227055,23228140,0,0,8018,9103
23512,23209557,23209557,23228257,0,0,0,18700
23630,23219092,23228140,23228791,0,0,9048,9699
23632,23219133,23228791,23229320,0,0,9658,10187
23634,23228890,23228890,23231146,0,0,0,2256
23511,23209556,23209556,23234220,0,0,0,24664
23637,23234788,23234788,23235036,0,0,0,248
23616,23218071,23218071,23237706,0,0,0,19635
23615,23218062,23218062,23237914,0,0,0,19852
23516,23209930,23209930,23244238,0,0,0,34308
22992,22984500,22985131,23244331,0,0,631,259831
22993,22984500,22985164,23244364,0,0,664,259864
23640,23242808,23242808,23244955,0,0,0,2147
23517,23210043,23210043,23244987,0,0,0,34944
23617,23218080,23218080,23245669,0,0,0,27589
22996,22984501,22986710,23245910,0,0,2209,261409
23618,23218090,23218222,23246473,0,0,132,28383
23471,23204630,23204630,23246708,0,0,0,42078
23642,23242836,23244331,23246799,0,0,1495,3963
23641,23242823,23244238,23246904,0,0,1415,4081
22997,22984501,22987717,23246917,0,0,3216,262416
23438,23200747,23200747,23248052,0,0,0,47305
23432,23200745,23200745,23248407,0,0,0,47662
23433,23200745,23200745,23250309,0,0,0,49564
23439,23200747,23200747,23250432,0,0,0,49685
23595,23216628,23220561,23251278,0,0,3933,34650
23434,23200745,23200745,23251518,0,0,0,50773
23345,23174117,23174117,23253091,0,0,0,78974
23435,23200745,23200745,23253478,0,0,0,52733
22998,22984501,22994906,23254106,0,0,10405,269605
22999,22985275,22994906,23254106,0,0,9631,268831
23000,22985341,22995198,23254398,0,0,9857,269057
23445,23200749,23200749,23258070,0,0,0,57321
23441,23200748,23200748,23259092,0,0,0,58344
22779,22954845,23009137,23262124,0,0,54292,307279
23540,23214278,23214278,23263835,0,0,0,49557
23541,23214278,23214278,23264207,0,0,0,49929
23537,23214277,23214277,23264447,0,0,0,50170
23542,23214278,23214278,23264634,0,0,0,50356
23543,23214278,23214278,23264716,0,0,0,50438
23538,23214277,23214277,23265067,0,0,0,50790
23544,23214278,23214278,23265212,0,0,0,50934
23545,23214278,23214278,23265243,0,0,0,50965
23552,23214279,23214709,23265333,0,0,430,51054
23539,23214277,23214277,23265346,0,0,0,51069
23124,23093626,23093626,23266426,0,0,0,172800
23587,23214466,23217289,23270979,0,0,2823,56513
22854,22961468,23012353,23271553,0,0,50885,310085
23660,23279996,23279996,23282084,0,0,0,2088
23661,23282342,23282342,23282869,0,0,0,527
23662,23284314,23284314,23285131,0,0,0,817
23663,23285159,23285159,23285263,0,0,0,104
23665,23285793,23285793,23285928,0,0,0,135
23664,23285623,23285623,23287128,0,0,0,1505
23436,23200746,23200746,23287146,0,0,0,86400
23437,23200746,23200746,23287146,0,0,0,86400
23440,23200747,23200747,23287147,0,0,0,86400
23442,23200748,23200748,23287148,0,0,0,86400
23443,23200748,23200748,23287148,0,0,0,86400
23444,23200748,23200748,23287148,0,0,0,86400
23446,23200749,23200749,23287149,0,0,0,86400
23447,23200749,23200749,23287149,0,0,0,86400
23448,23200749,23200749,23287149,0,0,0,86400
23666,23285970,23285970,23287770,0,0,0,1800
23668,23288944,23288944,23290744,0,0,0,1800
23620,23218113,23218377,23290771,0,0,264,72658
23473,23204820,23204820,23291220,0,0,0,86400
23667,23287093,23287093,23295017,0,0,0,7924
23669,23299711,23299711,23299804,0,0,0,93
23670,23299820,23299820,23301620,0,0,0,1800
23652,23268498,23268498,23302149,0,0,0,33651
23655,23276040,23276040,23302191,0,0,0,26151
23651,23268425,23268425,23302273,0,0,0,33848
23653,23268643,23268643,23306157,0,0,0,37514
23657,23276076,23276076,23308439,0,0,0,32363
23674,23307624,23307624,23309019,0,0,0,1395
23658,23276095,23276095,23309579,0,0,0,33484
23678,23312014,23312014,23312087,0,0,0,73
23679,23312015,23312015,23312088,0,0,0,73
23680,23312015,23312015,23312088,0,0,0,73
23681,23312015,23312015,23312088,0,0,0,73
23682,23312015,23312015,23312088,0,0,0,73
23677,23311910,23311910,23313482,0,0,0,1572
23659,23276100,23276100,23320507,0,0,0,44407
23116,23069191,23069191,23328391,0,0,0,259200
23117,23069192,23069192,23328392,0,0,0,259200
23118,23069193,23069193,23328393,0,0,0,259200
23119,23069193,23069193,23328393,0,0,0,259200
23120,23069224,23069224,23328424,0,0,0,259200
23121,23069225,23069225,23328425,0,0,0,259200
23122,23069336,23069336,23328536,0,0,0,259200
23650,23253092,23253092,23332791,0,0,0,79699
23676,23309517,23309517,23336110,0,0,0,26593
23671,23305960,23305960,23339090,0,0,0,33130
23672,23306017,23306017,23339611,0,0,0,33594
23675,23309442,23309442,23342814,0,0,0,33372
23656,23276058,23276058,23346507,0,0,0,70449
22859,22961647,23088032,23347232,0,0,126385,385585
23476,23205479,23205479,23350992,0,0,0,145513
23697,23359632,23359632,23359767,0,0,0,135
23483,23205866,23205866,23360757,0,0,0,154891
23673,23306193,23306193,23366136,0,0,0,59943
23296,23133254,23133254,23372475,0,0,0,239221
23182,23114336,23114336,23373536,0,0,0,259200
23183,23114403,23114403,23373603,0,0,0,259200
23184,23114534,23114534,23373734,0,0,0,259200
23335,23136996,23140686,23381917,0,0,3690,244921
23700,23366251,23366251,23391786,0,0,0,25535
23295,23133240,23133240,23392440,0,0,0,259200
23698,23365904,23365904,23399256,0,0,0,33352
23699,23365987,23365987,23399762,0,0,0,33775
23713,23409031,23409031,23409315,0,0,0,284
23709,23408945,23408945,23409465,0,0,0,520
23708,23408934,23408934,23409471,0,0,0,537
23711,23408974,23408974,23409772,0,0,0,798
23710,23408962,23408962,23409776,0,0,0,814
23715,23411289,23411289,23411381,0,0,0,92
23714,23411243,23411243,23411382,0,0,0,139
23716,23411346,23411346,23411436,0,0,0,90
23717,23411399,23411399,23411467,0,0,0,68
23718,23411484,23411484,23411627,0,0,0,143
23719,23411513,23411513,23411627,0,0,0,114
23720,23411588,23411588,23411709,0,0,0,121
23722,23411675,23411675,23411738,0,0,0,63
23721,23411627,23411627,23411748,0,0,0,121
23723,23411712,23411712,23411779,0,0,0,67
23696,23332789,23332789,23412123,0,0,0,79334
23123,23069899,23069899,23415499,0,0,0,345600
23636,23234686,23234686,23420575,0,0,0,185889
23357,23185555,23185555,23426724,0,0,0,241169
23654,23275900,23275900,23430301,0,0,0,154401
23635,23234614,23234614,23435254,0,0,0,200640
23726,23440059,23440059,23440169,0,0,0,110
23729,23442052,23442052,23442181,0,0,0,129
23730,23442275,23442275,23442327,0,0,0,52
23731,23442291,23442291,23442358,0,0,0,67
23732,23442944,23442944,23443011,0,0,0,67
23591,23215767,23219618,23443172,0,0,3851,227405
23705,23391842,23391842,23443338,0,0,0,51496
23733,23443276,23443276,23443343,0,0,0,67
23734,23443675,23443675,23443742,0,0,0,67
23735,23443847,23443847,23443915,0,0,0,68
23736,23446800,23446800,23446855,0,0,0,55
23738,23447538,23447538,23447605,0,0,0,67
23741,23448005,23448005,23448052,0,0,0,47
23743,23448163,23448163,23448737,0,0,0,574
23745,23449182,23449182,23449264,0,0,0,82
23746,23449229,23449229,23449795,0,0,0,566
23748,23449956,23449956,23450029,0,0,0,73
23749,23449960,23449960,23450064,0,0,0,104
23751,23450286,23450286,23451778,0,0,0,1492
23750,23450283,23450283,23452282,0,0,0,1999
23752,23452877,23452877,23452955,0,0,0,78
23753,23453102,23453102,23453305,0,0,0,203
23643,23244912,23244912,23453356,0,0,0,208444
23754,23454905,23454905,23455032,0,0,0,127
23756,23454933,23454933,23455084,0,0,0,151
23755,23454919,23454919,23455092,0,0,0,173
23757,23454958,23454958,23455113,0,0,0,155
23758,23454975,23454975,23455576,0,0,0,601
23759,23455045,23455045,23455941,0,0,0,896
23760,23455061,23455113,23456029,0,0,52,968
23761,23457123,23457123,23457216,0,0,0,93
23764,23457300,23457300,23457404,0,0,0,104
23763,23457297,23457297,23458135,0,0,0,838
23762,23457270,23457270,23458251,0,0,0,981
23766,23459283,23459283,23459390,0,0,0,107
23767,23459299,23459299,23459483,0,0,0,184
23727,23440143,23440143,23459517,0,0,0,19374
23638,23235191,23235191,23460576,0,0,0,225385
23772,23461393,23461393,23461460,0,0,0,67
23773,23461748,23461748,23461908,0,0,0,160
23774,23462657,23462657,23462818,0,0,0,161
23639,23235206,23237706,23462956,0,0,2500,227750
23775,23463928,23463928,23463995,0,0,0,67
23776,23464126,23464126,23464204,0,0,0,78
23777,23464271,23464271,23464338,0,0,0,67
23765,23457611,23457611,23464652,0,0,0,7041
23779,23464968,23464968,23465028,0,0,0,60
23781,23465791,23465791,23465869,0,0,0,78
23768,23459362,23459362,23466165,0,0,0,6803
23782,23466016,23466016,23466176,0,0,0,160
23783,23466285,23466285,23466445,0,0,0,160
23785,23466611,23466611,23466678,0,0,0,67
23788,23467301,23467301,23467394,0,0,0,93
23789,23467424,23467424,23467523,0,0,0,99
23790,23467685,23467685,23467752,0,0,0,67
23792,23468081,23468081,23468148,0,0,0,67
23791,23468062,23468062,23470179,0,0,0,2117
23793,23470262,23470262,23470322,0,0,0,60
23794,23470921,23470921,23471071,0,0,0,150
23795,23470998,23470998,23471091,0,0,0,93
23802,23471478,23471478,23471544,0,0,0,66
23800,23471463,23471463,23471663,0,0,0,200
23807,23471812,23471812,23472004,0,0,0,192
23808,23472410,23472410,23472570,0,0,0,160
23809,23472639,23472639,23472717,0,0,0,78
23811,23473350,23473350,23473417,0,0,0,67
23812,23473637,23473637,23473706,0,0,0,69
23814,23474207,23474207,23474350,0,0,0,143
23816,23474384,23474384,23474498,0,0,0,114
23817,23474486,23474486,23474533,0,0,0,47
23818,23474543,23474543,23474637,0,0,0,94
23819,23475335,23475335,23475382,0,0,0,47
23820,23476757,23476757,23476804,0,0,0,47
23821,23476979,23476979,23477046,0,0,0,67
23707,23408910,23408910,23477070,0,0,0,68160
23822,23477234,23477234,23477301,0,0,0,67
23823,23477442,23477442,23477509,0,0,0,67
23824,23477600,23477600,23477668,0,0,0,68
23825,23477853,23477853,23477900,0,0,0,47
23769,23460565,23460565,23478329,0,0,0,17764
23780,23465040,23465040,23479017,0,0,0,13977
23826,23479251,23479251,23479311,0,0,0,60
23827,23479446,23479446,23479506,0,0,0,60
23828,23480108,23480108,23480168,0,0,0,60
23813,23473939,23473939,23481384,0,0,0,7445
23829,23481640,23481640,23481768,0,0,0,128
23810,23472656,23472656,23483341,0,0,0,10685
23712,23409007,23409007,23484115,0,0,0,75108
23683,23312495,23312495,23485295,0,0,0,172800
23685,23312496,23312496,23485296,0,0,0,172800
23830,23481735,23481735,23485335,0,0,0,3600
23833,23485127,23485127,23489585,0,0,0,4458
23724,23412059,23412059,23490399,0,0,0,78340
23454,23202278,23202278,23492583,0,0,0,290305
23644,23244923,23244955,23504155,0,0,32,259232
23645,23244935,23244955,23504155,0,0,20,259220
23646,23244944,23244955,23504155,0,0,11,259211
23647,23245020,23245020,23504220,0,0,0,259200
23648,23245075,23245075,23504275,0,0,0,259200
23649,23245105,23245105,23504305,0,0,0,259200
23739,23447977,23447977,23509163,0,0,0,61186
23747,23449349,23449349,23512675,0,0,0,63326
23798,23471448,23471448,23515148,0,0,0,43700
23799,23471459,23471459,23517233,0,0,0,45774
23737,23446824,23446824,23521116,0,0,0,74292
23838,23528024,23528024,23528184,0,0,0,160
23841,23528569,23528569,23528647,0,0,0,78
23839,23528255,23528255,23528670,0,0,0,415
23843,23528994,23528994,23529123,0,0,0,129
23842,23528808,23528808,23529371,0,0,0,563
23840,23528375,23528375,23529577,0,0,0,1202
23845,23529717,23529717,23529846,0,0,0,129
23846,23529941,23529941,23530070,0,0,0,129
23844,23529541,23529541,23531067,0,0,0,1526
23847,23530155,23530155,23532555,0,0,0,2400
23848,23531282,23531282,23532824,0,0,0,1542
23849,23533328,23533328,23533425,0,0,0,97
23850,23533345,23533345,23533431,0,0,0,86
23778,23464937,23464937,23533866,0,0,0,68929
23854,23534075,23534075,23534328,0,0,0,253
23853,23533442,23533442,23534450,0,0,0,1008
23852,23533433,23533433,23534483,0,0,0,1050
23851,23533421,23533421,23534608,0,0,0,1187
23856,23535120,23535120,23535281,0,0,0,161
23858,23535646,23535646,23535706,0,0,0,60
23859,23535669,23535669,23535736,0,0,0,67
23861,23535956,23535956,23536747,0,0,0,791
23876,23536927,23536927,23537020,0,0,0,93
23877,23536927,23536927,23537020,0,0,0,93
23878,23536928,23536928,23537021,0,0,0,93
23874,23536927,23536927,23537029,0,0,0,102
23875,23536927,23536927,23537029,0,0,0,102
23879,23536928,23537020,23537113,0,0,92,185
23880,23536928,23537020,23537113,0,0,92,185
23881,23536928,23537021,23537114,0,0,93,186
23882,23536929,23537029,23537122,0,0,100,193
23883,23536929,23537029,23537122,0,0,100,193
23884,23536929,23537113,23537206,0,0,184,277
23885,23536929,23537113,23537206,0,0,184,277
23886,23536929,23537114,23537207,0,0,185,278
23887,23536929,23537122,23537235,0,0,193,306
23888,23536930,23537122,23537235,0,0,192,305
23892,23536930,23537235,23537317,0,0,305,387
23893,23536930,23537235,23537317,0,0,305,387
23889,23536930,23537206,23537319,0,0,276,389
23890,23536930,23537206,23537319,0,0,276,389
23891,23536930,23537207,23537320,0,0,277,390
23860,23535821,23535821,23537360,0,0,0,1539
23894,23536931,23537317,23537399,0,0,386,468
23895,23536931,23537317,23537431,0,0,386,500
23896,23536931,23537319,23537433,0,0,388,502
23897,23536931,23537319,23537433,0,0,388,502
23898,23536931,23537320,23537434,0,0,389,503
23899,23536931,23537399,23537513,0,0,468,582
23903,23536932,23537434,23537540,0,0,502,608
23900,23536932,23537431,23537545,0,0,499,613
23901,23536932,23537433,23537547,0,0,501,615
23902,23536932,23537433,23537547,0,0,501,615
23904,23536932,23537513,23537619,0,0,581,687
23905,23536932,23537540,23537646,0,0,608,714
23907,23536933,23537547,23537653,0,0,614,720
23908,23536933,23537547,23537653,0,0,614,720
23906,23536932,23537545,23537683,0,0,613,751
23909,23536933,23537619,23537725,0,0,686,792
23910,23536933,23537646,23537740,0,0,713,807
23911,23536933,23537653,23537747,0,0,720,814
23912,23536933,23537653,23537747,0,0,720,814
23913,23536934,23537683,23537777,0,0,749,843
23914,23537629,23537747,23537849,0,0,118,220
23916,23537768,23537768,23538238,0,0,0,470
23915,23537683,23537683,23538455,0,0,0,772
23784,23466506,23466506,23538649,0,0,0,72143
23917,23538822,23538822,23539052,0,0,0,230
23919,23539015,23539015,23539082,0,0,0,67
23918,23539009,23539009,23539093,0,0,0,84
23920,23539137,23539137,23539327,0,0,0,190
23922,23539484,23539484,23539639,0,0,0,155
23834,23486078,23486078,23539697,0,0,0,53619
23921,23539260,23539260,23539967,0,0,0,707
23923,23539713,23539713,23540515,0,0,0,802
23924,23540166,23540166,23541196,0,0,0,1030
23925,23540177,23540177,23541317,0,0,0,1140
23926,23540186,23540186,23541419,0,0,0,1233
23701,23368919,23368919,23541719,0,0,0,172800
23927,23540438,23540438,23542568,0,0,0,2130
23929,23543433,23543433,23544326,0,0,0,893
23801,23471469,23471469,23545362,0,0,0,73893
23928,23543305,23543305,23545431,0,0,0,2126
23939,23545705,23545705,23545803,0,0,0,98
23857,23535568,23535568,23546181,0,0,0,10613
23938,23545569,23545569,23546469,0,0,0,900
23940,23546420,23546420,23546505,0,0,0,85
23931,23543873,23543873,23546536,0,0,0,2663
23941,23546437,23546437,23547213,0,0,0,776
23863,23536778,23536778,23547452,0,0,0,10674
23862,23536772,23536772,23547458,0,0,0,10686
23942,23547248,23547248,23547830,0,0,0,582
23944,23548234,23548234,23548519,0,0,0,285
23945,23549858,23549858,23549952,0,0,0,94
23855,23534161,23534161,23550068,0,0,0,15907
23947,23550442,23550442,23550535,0,0,0,93
23948,23550916,23550916,23551029,0,0,0,113
23949,23550998,23550998,23551102,0,0,0,104
23950,23551055,23551055,23551128,0,0,0,73
23951,23551136,23551136,23551320,0,0,0,184
23952,23551293,23551293,23551453,0,0,0,160
23953,23551460,23551460,23551567,0,0,0,107
23954,23551539,23551539,23551613,0,0,0,74
23955,23551581,23551581,23551675,0,0,0,94
23957,23551618,23551618,23551696,0,0,0,78
23956,23551608,23551608,23551702,0,0,0,94
23744,23448270,23448270,23551890,0,0,0,103620
23959,23552201,23552201,23552307,0,0,0,106
23958,23552171,23552171,23552315,0,0,0,144
23960,23552261,23552261,23552367,0,0,0,106
23930,23543675,23543675,23552901,0,0,0,9226
23963,23552918,23552918,23553011,0,0,0,93
23964,23553175,23553175,23553268,0,0,0,93
23965,23553185,23553185,23553278,0,0,0,93
23970,23553388,23553388,23553448,0,0,0,60
23969,23553381,23553381,23553581,0,0,0,200
23971,23553548,23553548,23553608,0,0,0,60
23973,23553727,23553727,23553787,0,0,0,60
23972,23553691,23553691,23553826,0,0,0,135
23974,23553894,23553894,23553930,0,0,0,36
23975,23554080,23554080,23554116,0,0,0,36
23976,23554244,23554244,23554311,0,0,0,67
23966,23553303,23553303,23554318,0,0,0,1015
23977,23554361,23554361,23554428,0,0,0,67
23967,23553313,23553313,23554458,0,0,0,1145
23968,23553322,23553322,23554504,0,0,0,1182
23979,23554525,23554525,23554585,0,0,0,60
23978,23554459,23554459,23554616,0,0,0,157
23981,23556090,23556090,23556168,0,0,0,78
23983,23556176,23556176,23556269,0,0,0,93
23984,23556302,23556302,23556375,0,0,0,73
23985,23556421,23556421,23556488,0,0,0,67
23832,23482171,23482171,23556648,0,0,0,74477
23742,23448012,23448012,23557613,0,0,0,109601
23740,23447995,23447995,23557624,0,0,0,109629
23986,23556605,23556605,23558058,0,0,0,1453
23987,23557321,23557321,23558311,0,0,0,990
23988,23557350,23557350,23558402,0,0,0,1052
23989,23557365,23557365,23558424,0,0,0,1059
23998,23561802,23561802,23561993,0,0,0,191
23999,23562436,23562436,23562690,0,0,0,254
24000,23562593,23562593,23562691,0,0,0,98
23831,23482152,23482152,23563152,0,0,0,81000
24001,23563007,23563007,23563293,0,0,0,286
23994,23559633,23563152,23563384,0,0,3519,3751
23982,23556110,23556110,23563530,0,0,0,7420
24004,23563567,23563567,23563727,0,0,0,160
24003,23563239,23563239,23564021,0,0,0,782
23943,23547299,23547299,23564608,0,0,0,17309
23835,23486086,23486086,23568120,0,0,0,82034
23803,23471478,23471478,23568228,0,0,0,96750
23686,23312496,23312496,23568362,0,0,0,255866
23836,23490341,23490341,23569376,0,0,0,79035
24007,23569728,23569728,23569832,0,0,0,104
24006,23569728,23569728,23569843,0,0,0,115
24008,23569729,23569729,23569864,0,0,0,135
23980,23555508,23555508,23569897,0,0,0,14389
24009,23569773,23569773,23569897,0,0,0,124
24010,23569773,23569773,23569897,0,0,0,124
24005,23563763,23563763,23569898,0,0,0,6135
24011,23569774,23569774,23569898,0,0,0,124
24012,23569774,23569774,23569898,0,0,0,124
24015,23570787,23570787,23570911,0,0,0,124
24016,23570787,23570787,23570911,0,0,0,124
24017,23570787,23570787,23570911,0,0,0,124
23687,23312496,23312496,23570972,0,0,0,258476
23996,23560229,23563384,23571160,0,0,3155,10931
24013,23570773,23570773,23574316,0,0,0,3543
24020,23574291,23574291,23574385,0,0,0,94
24021,23574336,23574385,23574478,0,0,49,142
23995,23560205,23563293,23581523,0,0,3088,21318
23871,23536926,23536926,23584556,0,0,0,47630
23865,23536924,23536924,23584782,0,0,0,47858
23867,23536925,23536925,23584814,0,0,0,47889
24023,23583871,23584556,23584835,0,0,685,964
23873,23536926,23536926,23584844,0,0,0,47918
23866,23536924,23536924,23585030,0,0,0,48106
23864,23536923,23536923,23585040,0,0,0,48117
24024,23583901,23584814,23585093,0,0,913,1192
23868,23536925,23536925,23585124,0,0,0,48199
23872,23536926,23536926,23585687,0,0,0,48761
23869,23536925,23536925,23585786,0,0,0,48861
23870,23536925,23536925,23586096,0,0,0,49171
23688,23329827,23329827,23589027,0,0,0,259200
23804,23471485,23515148,23589736,0,0,43663,118251
23689,23332621,23332621,23591821,0,0,0,259200
23690,23332622,23332622,23591822,0,0,0,259200
23691,23332639,23332639,23591839,0,0,0,259200
23692,23332639,23332639,23591839,0,0,0,259200
23693,23332639,23332639,23591839,0,0,0,259200
23694,23332640,23332640,23591840,0,0,0,259200
23695,23332698,23332698,23591898,0,0,0,259200
23786,23467279,23467279,23595611,0,0,0,128332
23787,23467284,23467284,23595616,0,0,0,128332
23991,23557565,23557624,23603132,0,0,59,45567
23684,23312495,23312495,23603400,0,0,0,290905
23992,23557578,23558424,23603996,0,0,846,46418
23990,23557558,23557613,23605114,0,0,55,47556
24002,23563026,23569376,23607366,0,0,6350,44340
23946,23550069,23550069,23609892,0,0,0,59823
23997,23560381,23563530,23613054,0,0,3149,52673
23771,23461003,23461003,23614314,0,0,0,153311
24026,23588337,23588337,23614657,0,0,0,26320
24029,23614878,23614878,23615168,0,0,0,290
24030,23615161,23615161,23615449,0,0,0,288
24031,23616775,23616775,23617567,0,0,0,792
24028,23612993,23612993,23618042,0,0,0,5049
24027,23612918,23612918,23618206,0,0,0,5288
23815,23474288,23478329,23618427,0,0,4041,144139
24032,23618012,23618012,23618929,0,0,0,917
24036,23619085,23619085,23619189,0,0,0,104
24037,23619124,23619124,23619228,0,0,0,104
24038,23619745,23619745,23619781,0,0,0,36
24040,23619898,23619898,23620368,0,0,0,470
24039,23619799,23619799,23620379,0,0,0,580
23962,23552869,23552869,23621168,0,0,0,68299
24042,23620689,23620689,23621316,0,0,0,627
24052,23622608,23622608,23622644,0,0,0,36
24047,23622054,23622054,23622750,0,0,0,696
24053,23622702,23622702,23622791,0,0,0,89
24054,23622759,23622759,23622852,0,0,0,93
24051,23622388,23622388,23623221,0,0,0,833
24056,23623728,23623728,23624581,0,0,0,853
24018,23572365,23572365,23625016,0,0,0,52651
24058,23625740,23625740,23625885,0,0,0,145
24055,23623086,23623086,23626043,0,0,0,2957
24059,23625771,23625771,23626062,0,0,0,291
24060,23625956,23625956,23626220,0,0,0,264
24061,23626310,23626310,23626414,0,0,0,104
24048,23622195,23622195,23626762,0,0,0,4567
24049,23622278,23622278,23626885,0,0,0,4607
24062,23627120,23627120,23627187,0,0,0,67
24064,23628009,23628009,23628076,0,0,0,67
24065,23628140,23628140,23628207,0,0,0,67
24066,23628424,23628424,23628472,0,0,0,48
24068,23628699,23628699,23628766,0,0,0,67
24069,23628792,23628792,23628839,0,0,0,47
24070,23628951,23628951,23629019,0,0,0,68
24071,23629066,23629066,23629133,0,0,0,67
24063,23627611,23627611,23629243,0,0,0,1632
24072,23629176,23629176,23629321,0,0,0,145
24073,23629281,23629281,23629348,0,0,0,67
24076,23629600,23629600,23629693,0,0,0,93
24074,23629528,23629528,23629695,0,0,0,167
24075,23629592,23629592,23629743,0,0,0,151
24080,23629714,23629714,23629781,0,0,0,67
24077,23629629,23629629,23629829,0,0,0,200
24081,23629790,23629790,23629976,0,0,0,186
24082,23630114,23630114,23630150,0,0,0,36
24078,23629664,23629664,23630299,0,0,0,635
24079,23629692,23629829,23630523,0,0,137,831
24083,23630452,23630452,23630677,0,0,0,225
23993,23557907,23558311,23630863,0,0,404,72956
24084,23630578,23630578,23630894,0,0,0,316
24086,23631601,23631601,23631648,0,0,0,47
24087,23631703,23631703,23631770,0,0,0,67
24088,23631935,23631935,23632090,0,0,0,155
24035,23618821,23618821,23632098,0,0,0,13277
24090,23632494,23632494,23632559,0,0,0,65
24091,23632522,23632522,23632590,0,0,0,68
24100,23633562,23633562,23633629,0,0,0,67
24101,23633654,23633654,23633721,0,0,0,67
24102,23633752,23633752,23633819,0,0,0,67
23702,23375260,23375260,23634460,0,0,0,259200
23703,23375289,23375289,23634489,0,0,0,259200
23704,23375315,23375315,23634515,0,0,0,259200
24103,23634595,23634595,23634642,0,0,0,47
24107,23634725,23634725,23634818,0,0,0,93
24109,23635999,23635999,23636067,0,0,0,68
24110,23636126,23636126,23636173,0,0,0,47
24111,23636245,23636245,23636312,0,0,0,67
24112,23636315,23636315,23636362,0,0,0,47
24113,23636570,23636570,23636637,0,0,0,67
24115,23636869,23636869,23636932,0,0,0,63
24114,23636780,23636780,23637583,0,0,0,803
24116,23637657,23637657,23637710,0,0,0,53
24117,23637663,23637663,23637730,0,0,0,67
24119,23637785,23637785,23637832,0,0,0,47
24120,23637959,23637959,23638026,0,0,0,67
24121,23638172,23638172,23638239,0,0,0,67
24122,23638353,23638353,23638420,0,0,0,67
24123,23638508,23638508,23638555,0,0,0,47
24124,23638646,23638646,23638713,0,0,0,67
24125,23638947,23638947,23639014,0,0,0,67
24126,23639018,23639018,23639065,0,0,0,47
24127,23639087,23639087,23639166,0,0,0,79
24129,23639213,23639213,23639281,0,0,0,68
24128,23639128,23639128,23639770,0,0,0,642
24130,23640106,23640106,23640173,0,0,0,67
24131,23640406,23640406,23640466,0,0,0,60
24132,23641131,23641131,23641198,0,0,0,67
23706,23408813,23408813,23642266,0,0,0,233453
24135,23642714,23642714,23642766,0,0,0,52
24136,23642717,23642717,23642801,0,0,0,84
24137,23642785,23642785,23642837,0,0,0,52
24138,23642795,23642795,23642862,0,0,0,67
24139,23642900,23642900,23642967,0,0,0,67
24140,23643094,23643094,23643162,0,0,0,68
24141,23643312,23643312,23643359,0,0,0,47
24142,23643501,23643501,23643569,0,0,0,68
24144,23644089,23644089,23644157,0,0,0,68
24145,23644211,23644211,23644295,0,0,0,84
24147,23644450,23644450,23644517,0,0,0,67
24050,23622292,23622292,23644973,0,0,0,22681
24146,23644248,23644248,23645005,0,0,0,757
24149,23644900,23644900,23645016,0,0,0,116
24067,23628440,23628440,23645108,0,0,0,16668
24045,23621150,23621150,23646366,0,0,0,25216
24151,23645985,23645985,23646698,0,0,0,713
24154,23646754,23646754,23646848,0,0,0,94
24046,23621519,23621519,23649546,0,0,0,28027
24156,23649448,23649448,23651515,0,0,0,2067
24158,23653421,23653421,23653514,0,0,0,93
24159,23653426,23653426,23653519,0,0,0,93
24160,23653431,23653431,23653524,0,0,0,93
24157,23653415,23653415,23653525,0,0,0,110
24161,23653437,23653437,23653530,0,0,0,93
23796,23471265,23471265,23656446,0,0,0,185181
24019,23573146,23573146,23659546,0,0,0,86400
24118,23637742,23637742,23660443,0,0,0,22701
24022,23579172,23581523,23661189,0,0,2351,82017
24133,23642021,23642021,23663347,0,0,0,21326
24152,23646182,23646182,23663525,0,0,0,17343
24155,23648690,23648690,23666157,0,0,0,17467
24163,23665209,23665209,23667364,0,0,0,2155
24034,23618316,23618316,23668989,0,0,0,50673
24043,23620949,23620949,23672308,0,0,0,51359
24044,23620991,23620991,23672649,0,0,0,51658
23728,23440172,23440172,23678264,0,0,0,238092
24153,23646548,23646548,23679667,0,0,0,33119
24150,23644984,23644984,23680984,0,0,0,36000
23935,23543940,23543940,23682385,0,0,0,138445
24041,23620668,23620668,23689106,0,0,0,68438
24033,23618088,23618088,23689817,0,0,0,71729
24164,23665226,23665226,23692849,0,0,0,27623
24014,23570776,23574316,23695602,0,0,3540,124826
24057,23625720,23625720,23697720,0,0,0,72000
24168,23702496,23702496,23702532,0,0,0,36
23770,23461002,23461002,23703863,0,0,0,242861
24085,23631530,23631530,23703973,0,0,0,72443
24173,23704789,23704789,23704893,0,0,0,104
24148,23644523,23644523,23705362,0,0,0,60839
24175,23705229,23705229,23705437,0,0,0,208
24178,23706038,23706038,23706105,0,0,0,67
24025,23585578,23585578,23706310,0,0,0,120732
24179,23706226,23706226,23706319,0,0,0,93
24180,23706532,23706532,23706636,0,0,0,104
24177,23705633,23705633,23706743,0,0,0,1110
24185,23707167,23707167,23707291,0,0,0,124
24186,23707490,23707490,23707738,0,0,0,248
24181,23706702,23706702,23708080,0,0,0,1378
24187,23708183,23708183,23708219,0,0,0,36
24188,23708341,23708341,23708414,0,0,0,73
24192,23709474,23709474,23709567,0,0,0,93
24193,23709597,23709597,23709681,0,0,0,84
24194,23709644,23709644,23709737,0,0,0,93
24195,23709970,23709970,23710063,0,0,0,93
24196,23710125,23710125,23710209,0,0,0,84
24197,23710177,23710177,23710270,0,0,0,93
24198,23710451,23710451,23710519,0,0,0,68
24199,23710689,23710689,23710757,0,0,0,68
24200,23710805,23710805,23710873,0,0,0,68
24201,23710902,23710902,23711197,0,0,0,295
24203,23711462,23711462,23711535,0,0,0,73
24202,23711332,23711332,23711591,0,0,0,259
24183,23706885,23706885,23712330,0,0,0,5445
24204,23712091,23712091,23712339,0,0,0,248
24182,23706884,23706884,23712476,0,0,0,5592
24184,23706886,23706886,23712509,0,0,0,5623
24205,23713351,23713351,23713951,0,0,0,600
24209,23716469,23716469,23716522,0,0,0,53
24208,23716379,23716379,23716525,0,0,0,146
24210,23716494,23716494,23717054,0,0,0,560
24211,23716538,23716538,23717138,0,0,0,600
24215,23717419,23717419,23717512,0,0,0,93
24216,23717536,23717536,23717584,0,0,0,48
24217,23717553,23717553,23717739,0,0,0,186
24218,23717668,23717668,23717814,0,0,0,146
24219,23717683,23717683,23717850,0,0,0,167
24221,23717756,23717756,23717974,0,0,0,218
24223,23717988,23717988,23718066,0,0,0,78
24222,23717782,23717974,23718192,0,0,192,410
24220,23717727,23717727,23718326,0,0,0,599
24224,23718397,23718397,23718464,0,0,0,67
24213,23717054,23717054,23718854,0,0,0,1800
24225,23718956,23718956,23719330,0,0,0,374
24226,23719367,23719367,23719575,0,0,0,208
24227,23719533,23719533,23719720,0,0,0,187
24228,23719722,23719722,23719909,0,0,0,187
24229,23720108,23720108,23720213,0,0,0,105
24230,23720173,23720173,23720403,0,0,0,230
24231,23720331,23720331,23720443,0,0,0,112
24233,23720568,23720568,23720776,0,0,0,208
24235,23720749,23720749,23720848,0,0,0,99
24236,23720791,23720791,23720879,0,0,0,88
24238,23720854,23720854,23721020,0,0,0,166
24239,23720883,23720883,23721050,0,0,0,167
24245,23721780,23721780,23721843,0,0,0,63
24246,23721830,23721830,23721893,0,0,0,63
24247,23721847,23721847,23721910,0,0,0,63
24248,23722288,23722288,23722930,0,0,0,642
24214,23717372,23717372,23723499,0,0,0,6127
24250,23724041,23724041,23724135,0,0,0,94
24251,23724576,23724576,23724680,0,0,0,104
24174,23705014,23705014,23724998,0,0,0,19984
24176,23705336,23705336,23725231,0,0,0,19895
24206,23714887,23714887,23725298,0,0,0,10411
24191,23709296,23709296,23725330,0,0,0,16034
24253,23725225,23725225,23725392,0,0,0,167
24212,23716699,23716699,23726501,0,0,0,9802
24249,23723813,23723813,23726890,0,0,0,3077
24260,23727996,23727996,23728064,0,0,0,68
24266,23728765,23728765,23728982,0,0,0,217
24263,23728721,23728721,23729233,0,0,0,512
24267,23729265,23729265,23729420,0,0,0,155
23797,23471275,23471275,23730475,0,0,0,259200
24165,23668391,23668391,23730731,0,0,0,62340
24268,23731467,23731467,23731602,0,0,0,135
24269,23731654,23731654,23731815,0,0,0,161
24271,23731991,23731991,23732120,0,0,0,129
24264,23728735,23728735,23732129,0,0,0,3394
24252,23724762,23724762,23732146,0,0,0,7384
24272,23732337,23732337,23732497,0,0,0,160
24273,23732588,23732588,23732759,0,0,0,171
24277,23734148,23734148,23734303,0,0,0,155
24278,23734297,23734297,23734375,0,0,0,78
24279,23734681,23734681,23734806,0,0,0,125
24265,23728742,23728742,23738869,0,0,0,10127
24283,23737742,23737742,23739081,0,0,0,1339
24280,23734904,23734904,23741478,0,0,0,6574
24282,23735094,23735094,23741484,0,0,0,6390
24189,23709162,23709162,23745162,0,0,0,36000
24166,23668456,23668456,23745420,0,0,0,76964
24289,23747486,23747486,23747610,0,0,0,124
24285,23738289,23738289,23748145,0,0,0,9856
24270,23731896,23731896,23750514,0,0,0,18618
24169,23703889,23703889,23754295,0,0,0,50406
24288,23747235,23747235,23754667,0,0,0,7432
23725,23416730,23416730,23762330,0,0,0,345600
24274,23733079,23733079,23769079,0,0,0,36000
24276,23733645,23733645,23773848,0,0,0,40203
24190,23709228,23709228,23774558,0,0,0,65330
24171,23703987,23703987,23775303,0,0,0,71316
24172,23704108,23704108,23775900,0,0,0,71792
24287,23740626,23740626,23779281,0,0,0,38655
24232,23720411,23720411,23779617,0,0,0,59206
24284,23737764,23737764,23785098,0,0,0,47334
23961,23552383,23552383,23789424,0,0,0,237041
24286,23739025,23739025,23791310,0,0,0,52285
24296,23794109,23794109,23794213,0,0,0,104
24298,23794416,23794416,23794851,0,0,0,435
24299,23794858,23794858,23795387,0,0,0,529
24305,23796464,23796464,23797240,0,0,0,776
24309,23796584,23797240,23797395,0,0,656,811
24306,23796518,23797240,23797967,0,0,722,1449
24317,23797946,23797967,23798061,0,0,21,115
24308,23796561,23797967,23798153,0,0,1406,1592
24316,23797945,23797967,23798211,0,0,22,266
24320,23798858,23798858,23799029,0,0,0,171
24318,23797951,23797967,23800130,0,0,16,2179
24207,23716259,23716259,23801158,0,0,0,84899
24134,23642492,23642492,23802726,0,0,0,160234
23932,23543916,23543916,23803116,0,0,0,259200
23933,23543917,23543917,23803117,0,0,0,259200
23934,23543917,23543917,23803117,0,0,0,259200
23936,23544062,23544062,23803262,0,0,0,259200
23937,23544062,23544062,23803262,0,0,0,259200
23805,23471629,23545362,23804562,0,0,73733,332933
24294,23792733,23792733,23804820,0,0,0,12087
24363,23804220,23804562,23804956,0,0,342,736
24364,23804590,23804590,23804962,0,0,0,372
24312,23797058,23797967,23805240,0,0,909,8182
24314,23797496,23797967,23805240,0,0,471,7744
24365,23804993,23805240,23805386,0,0,247,393
24366,23805104,23805386,23805769,0,0,282,665
24300,23795000,23795000,23806577,0,0,0,11577
24297,23794271,23794271,23806753,0,0,0,12482
24368,23805535,23806577,23806887,0,0,1042,1352
24304,23795808,23795808,23807361,0,0,0,11553
24370,23807115,23807115,23807454,0,0,0,339
24162,23665100,23665100,23807768,0,0,0,142668
24371,23807418,23807418,23808060,0,0,0,642
24374,23807563,23807563,23808215,0,0,0,652
24375,23807668,23807668,23808273,0,0,0,605
24311,23796686,23797395,23808378,0,0,709,11692
23837,23493904,23493904,23808396,0,0,0,314492
24313,23797431,23797967,23809057,0,0,536,11626
24377,23808582,23808582,23809218,0,0,0,636
24379,23808674,23808674,23809343,0,0,0,669
24383,23810205,23810205,23810330,0,0,0,125
24384,23810386,23810386,23810521,0,0,0,135
24385,23810673,23810673,23810815,0,0,0,142
24302,23795467,23795467,23811067,0,0,0,15600
24389,23811202,23811202,23811379,0,0,0,177
24393,23811441,23811441,23811621,0,0,0,180
24376,23808541,23808541,23811665,0,0,0,3124
24395,23811751,23811751,23811868,0,0,0,117
24367,23805426,23805769,23812415,0,0,343,6989
24398,23811947,23811947,23812547,0,0,0,600
24381,23808991,23812415,23812768,0,0,3424,3777
24400,23813017,23813017,23813090,0,0,0,73
24401,23813197,23813197,23813344,0,0,0,147
24402,23813280,23813280,23813466,0,0,0,186
24403,23813818,23813818,23813891,0,0,0,73
24404,23813856,23813856,23814104,0,0,0,248
24407,23814881,23814881,23814974,0,0,0,93
24319,23797971,23797971,23815864,0,0,0,17893
24386,23810753,23810815,23815904,0,0,62,5151
24405,23814227,23815904,23816091,0,0,1677,1864
24417,23816394,23816394,23816857,0,0,0,463
24428,23817013,23817013,23817437,0,0,0,424
24410,23816325,23816325,23821466,0,0,0,5141
24258,23727805,23727805,23825771,0,0,0,97966
23806,23471640,23568228,23827428,0,0,96588,355788
24315,23797931,23797931,23831238,0,0,0,33307
24303,23795692,23795692,23831692,0,0,0,36000
24301,23795422,23795422,23832513,0,0,0,37091
24399,23812136,23827428,23836448,0,0,15292,24312
24108,23635514,23635514,23837788,0,0,0,202274
24438,23818124,23837788,23838070,0,0,19664,19946
24448,23833215,23838070,23838349,0,0,4855,5134
24432,23817588,23836448,23841524,0,0,18860,23936
24411,23816336,23816336,23846254,0,0,0,29918
24089,23631997,23631997,23846615,0,0,0,214618
24447,23829208,23846615,23846711,0,0,17407,17503
24262,23728179,23728179,23847372,0,0,0,119193
24339,23799018,23799018,23848251,0,0,0,49233
24334,23799017,23799017,23848308,0,0,0,49291
24340,23799018,23799018,23848313,0,0,0,49295
24412,23816349,23821466,23848315,0,0,5117,31966
24336,23799017,23799017,23848510,0,0,0,49493
24452,23838362,23848251,23848530,0,0,9889,10168
24341,23799018,23799018,23848759,0,0,0,49741
24335,23799017,23799017,23848908,0,0,0,49891
24342,23799018,23799018,23848945,0,0,0,49927
24333,23799017,23799017,23849094,0,0,0,50077
24343,23799018,23799018,23849286,0,0,0,50268
24344,23799018,23799018,23849348,0,0,0,50330
24453,23843795,23848313,23849521,0,0,4518,5726
24346,23799019,23800130,23849530,0,0,1111,50511
24455,23843855,23848530,23849677,0,0,4675,5822
24454,23843830,23848510,23849701,0,0,4680,5871
24345,23799018,23800130,23850584,0,0,1112,51566
24348,23799020,23801158,23850651,0,0,2138,51631
24361,23799242,23804962,23851094,0,0,5720,51852
24347,23799019,23801158,23851116,0,0,2139,52097
24349,23799020,23801158,23851488,0,0,2138,52468
24350,23799020,23801158,23851519,0,0,2138,52499
24382,23809188,23812768,23851721,0,0,3580,42533
24359,23799023,23802726,23851863,0,0,3703,52840
24355,23799022,23802726,23851897,0,0,3704,52875
24240,23721090,23721090,23852468,0,0,0,131378
24352,23799021,23802726,23852653,0,0,3705,53632
24356,23799022,23802726,23852746,0,0,3704,53724
24357,23799022,23802726,23852808,0,0,3704,53786
24360,23799023,23802726,23852839,0,0,3703,53816
24358,23799022,23802726,23852963,0,0,3704,53941
24353,23799021,23802726,23853087,0,0,3705,54066
24422,23816459,23832513,23853197,0,0,16054,36738
24423,23816469,23832513,23853228,0,0,16044,36759
24351,23799020,23802726,23853366,0,0,3706,54346
24354,23799021,23802726,23853604,0,0,3705,54583
24420,23816441,23832513,23853622,0,0,16072,37181
24421,23816450,23832513,23853653,0,0,16063,37203
24414,23816369,23827428,23853655,0,0,11059,37286
24416,23816380,23827428,23854173,0,0,11048,37793
24413,23816359,23827428,23854443,0,0,11069,38084
24418,23816425,23831238,23855119,0,0,14813,38694
24419,23816433,23831692,23855531,0,0,15259,39098
24449,23836361,23846711,23859672,0,0,10350,23311
24257,23727597,23727597,23860654,0,0,0,133057
24237,23720827,23720827,23862418,0,0,0,141591
24450,23837146,23849094,23864967,0,0,11948,27821
24430,23817488,23831238,23867005,0,0,13750,49517
24255,23727195,23727195,23873544,0,0,0,146349
24456,23853223,23853223,23874030,0,0,0,20807
24457,23853241,23853241,23874164,0,0,0,20923
24458,23853655,23853655,23874756,0,0,0,21101
24459,23853659,23853659,23874791,0,0,0,21132
24256,23727432,23727432,23877848,0,0,0,150416
24254,23726914,23726914,23879252,0,0,0,152338
24295,23793740,23793740,23879998,0,0,0,86258
24170,23703984,23703984,23881269,0,0,0,177285
24292,23792254,23792254,23881337,0,0,0,89083
24293,23792326,23792326,23881367,0,0,0,89041
24451,23837698,23838349,23881549,0,0,651,43851
24234,23720673,23720673,23881689,0,0,0,161016
24099,23633244,23633244,23883389,0,0,0,250145
24460,23856384,23859672,23883482,0,0,3288,27098
24461,23856395,23859672,23883545,0,0,3277,27150
24321,23799015,23799015,23885415,0,0,0,86400
24322,23799015,23799015,23885415,0,0,0,86400
24323,23799015,23799015,23885415,0,0,0,86400
24324,23799015,23799015,23885415,0,0,0,86400
24325,23799015,23799015,23885415,0,0,0,86400
24326,23799016,23799016,23885416,0,0,0,86400
24327,23799016,23799016,23885416,0,0,0,86400
24328,23799016,23799016,23885416,0,0,0,86400
24329,23799016,23799016,23885416,0,0,0,86400
24330,23799016,23799016,23885416,0,0,0,86400
24331,23799016,23799016,23885416,0,0,0,86400
24332,23799016,23799016,23885416,0,0,0,86400
24337,23799017,23799017,23885417,0,0,0,86400
24338,23799017,23799017,23885417,0,0,0,86400
24275,23733127,23733127,23885658,0,0,0,152531
24310,23796623,23885658,23886341,0,0,89035,89718
24462,23858753,23859672,23886480,0,0,919,27727
24362,23801160,23803116,23886706,0,0,1956,85546
24463,23859271,23862418,23889307,0,0,3147,30036
24281,23735034,23735034,23891799,0,0,0,156765
24464,23859396,23864967,23891831,0,0,5571,32435
24092,23632888,23632888,23892088,0,0,0,259200
24093,23632889,23632889,23892089,0,0,0,259200
24094,23632889,23632889,23892089,0,0,0,259200
24095,23632889,23632889,23892089,0,0,0,259200
24096,23632912,23632912,23892112,0,0,0,259200
24097,23632913,23632913,23892113,0,0,0,259200
24098,23633000,23633000,23892200,0,0,0,259200
24465,23859538,23864967,23892213,0,0,5429,32675
24104,23634651,23634651,23893851,0,0,0,259200
24105,23634677,23634677,23893877,0,0,0,259200
24106,23634718,23634718,23893918,0,0,0,259200
24244,23721218,23721218,23894156,0,0,0,172938
24467,23873967,23874030,23894654,0,0,63,20687
24468,23874154,23874164,23894695,0,0,10,20541
24466,23862435,23864967,23894860,0,0,2532,32425
24469,23874711,23874756,23895725,0,0,45,21014
24470,23874759,23874791,23895738,0,0,32,20979
24387,23811037,23811067,23897467,0,0,30,86430
24495,23897778,23897778,23897902,0,0,0,124
24291,23790190,23790190,23900287,0,0,0,110097
24143,23644034,23644034,23903234,0,0,0,259200
24472,23880133,23881337,23904127,0,0,1204,23994
24473,23880238,23881337,23904201,0,0,1099,23963
24243,23721185,23721185,23908710,0,0,0,187525
24259,23727961,23727961,23911333,0,0,0,183372
24475,23885478,23885478,23912094,0,0,0,26616
24476,23886098,23886098,23912814,0,0,0,26716
24388,23811096,23827428,23912891,0,0,16332,101795
24477,23886208,23886208,23913414,0,0,0,27206
24478,23886726,23886726,23913933,0,0,0,27207
24482,23894544,23894544,23915034,0,0,0,20490
24483,23894648,23894648,23915180,0,0,0,20532
24485,23895652,23895652,23916543,0,0,0,20891
24484,23895637,23895637,23916575,0,0,0,20938
24509,23916511,23916511,23916606,0,0,0,95
24480,23892275,23892275,23921451,0,0,0,29176
24513,23921389,23921389,23921563,0,0,0,174
24514,23921501,23921501,23921672,0,0,0,171
24446,23829189,23841524,23921936,0,0,12335,92747
24241,23721128,23721128,23922704,0,0,0,201576
24512,23918664,23918664,23923464,0,0,0,4800
24500,23902944,23902944,23926665,0,0,0,23721
24501,23903102,23903102,23926811,0,0,0,23709
24474,23881201,23881367,23928923,0,0,166,47722
24242,23721154,23721154,23932264,0,0,0,211110
24435,23817829,23836448,23932579,0,0,18619,114750
24507,23915123,23915123,23935531,0,0,0,20408
24506,23914968,23914968,23935895,0,0,0,20927
24508,23916487,23916487,23937345,0,0,0,20858
24510,23916512,23916512,23937376,0,0,0,20864
24167,23702333,23702333,23937586,0,0,0,235253
24502,23912039,23912039,23938136,0,0,0,26097
24503,23912752,23912752,23938994,0,0,0,26242
24504,23913408,23913408,23940139,0,0,0,26731
24505,23913932,23913932,23940714,0,0,0,26782
24511,23916543,23916543,23945343,0,0,0,28800
24261,23728061,23728061,23946297,0,0,0,218236
24408,23815014,23815904,23948843,0,0,890,133829
24516,23926631,23926631,23950480,0,0,0,23849
24409,23816264,23816264,23950675,0,0,0,134411
24517,23926764,23926764,23950707,0,0,0,23943
24515,23921610,23921610,23951388,0,0,0,29778
24531,23951325,23951325,23954988,0,0,0,3663
24521,23935468,23935468,23955912,0,0,0,20444
24522,23935842,23935842,23956304,0,0,0,20462
24481,23892582,23892582,23957078,0,0,0,64496
24445,23826261,23837788,23957548,0,0,11527,131287
24523,23937276,23937276,23958121,0,0,0,20845
24524,23937324,23937324,23958156,0,0,0,20832
24390,23811256,23851094,23960900,0,0,39838,149644
24391,23811269,23851721,23963250,0,0,40452,151981
24525,23938074,23938074,23964615,0,0,0,26541
24526,23938931,23938931,23965526,0,0,0,26595
24527,23940104,23940104,23966677,0,0,0,26573
24528,23940648,23940648,23967165,0,0,0,26517
24440,23819828,23837788,23970786,0,0,17960,150958
24433,23817600,23836448,23971919,0,0,18848,154319
24518,23929523,23929523,23972266,0,0,0,42743
24479,23888561,23888561,23972289,0,0,0,83728
24392,23811280,23855531,23972914,0,0,44251,161634
24529,23950420,23950420,23973514,0,0,0,23094
24530,23950650,23950650,23973712,0,0,0,23062
24439,23819769,23837788,23974228,0,0,18019,154459
24533,23955843,23955843,23976422,0,0,0,20579
24534,23956242,23956242,23976789,0,0,0,20547
24535,23958080,23958080,23979089,0,0,0,21009
24536,23958093,23958093,23979122,0,0,0,21029
24415,23816374,23825771,23979373,0,0,9397,162999
24496,23897898,23897898,23979590,0,0,0,81692
24554,23981243,23981243,23981324,0,0,0,81
24555,23981294,23981294,23981387,0,0,0,93
24556,23981450,23981450,23981575,0,0,0,125
24557,23981594,23981594,23981729,0,0,0,135
24558,23981691,23981691,23981815,0,0,0,124
24431,23817547,23832513,23982383,0,0,14966,164836
24559,23982845,23982845,23982938,0,0,0,93
24560,23982992,23982992,23983148,0,0,0,156
24561,23983447,23983447,23983789,0,0,0,342
24541,23970038,23970038,23984219,0,0,0,14181
24532,23954919,23954919,23984890,0,0,0,29971
24538,23965458,23965458,23988443,0,0,0,22985
24519,23929836,23929836,23988480,0,0,0,58644
24537,23964553,23964553,23990869,0,0,0,26316
24564,23990818,23990818,23990985,0,0,0,167
24567,23990931,23990931,23991097,0,0,0,166
24568,23991035,23991035,23991203,0,0,0,168
24539,23966625,23966625,23993438,0,0,0,26813
24540,23967107,23967107,23993982,0,0,0,26875
24406,23814622,23827428,23994199,0,0,12806,179577
24574,23995427,23995427,23995507,0,0,0,80
24545,23973452,23973452,23995548,0,0,0,22096
24546,23973648,23973648,23995757,0,0,0,22109
24579,23996068,23996068,23996141,0,0,0,73
24548,23976367,23976367,23996941,0,0,0,20574
24549,23976726,23976726,23997323,0,0,0,20597
24441,23819882,23837788,23999789,0,0,17906,179907
24550,23979030,23979030,23999995,0,0,0,20965
24551,23979060,23979060,24000026,0,0,0,20966
24425,23816662,23827428,24000772,0,0,10766,184110
24494,23897620,23897620,24001119,0,0,0,103499
24562,23984832,23984832,24014113,0,0,0,29281
24586,24014054,24014054,24014468,0,0,0,414
24563,23988386,23988386,24014604,0,0,0,26218
24587,24014427,24014427,24014857,0,0,0,430
24443,23820135,23837788,24017441,0,0,17653,197306
24580,23996879,23996879,24017485,0,0,0,20606
24543,23971805,23971805,24017578,0,0,0,45773
24569,23991141,23991141,24017651,0,0,0,26510
24591,24017607,24017607,24017784,0,0,0,177
24581,23997276,23997276,24017946,0,0,0,20670
24585,24008838,24008838,24018076,0,0,0,9238
24577,23995506,23995506,24019291,0,0,0,23785
24578,23995696,23995696,24019427,0,0,0,23731
24570,23993359,23993359,24020361,0,0,0,27002
24582,23999949,23999949,24021002,0,0,0,21053
24572,23993920,23993920,24021044,0,0,0,27124
24583,23999964,23999964,24021075,0,0,0,21111
24434,23817669,23836448,24022938,0,0,18779,205269
24424,23816521,23827428,24025789,0,0,10907,209268
24547,23973890,23973890,24026234,0,0,0,52344
24552,23979404,23979404,24028512,0,0,0,49108
24426,23816885,23831238,24037176,0,0,14353,220291
24590,24017422,24017422,24037896,0,0,0,20474
24593,24017882,24017882,24038402,0,0,0,20520
24588,24014539,24014539,24041040,0,0,0,26501
24553,23979420,23979420,24041318,0,0,0,61898
24369,23806635,23806635,24041661,0,0,0,235026
24599,24021004,24021004,24041872,0,0,0,20868
24597,24020951,24020951,24041903,0,0,0,20952
24589,24014808,24014808,24042797,0,0,0,27989
24437,23817943,23836448,24043005,0,0,18505,225062
24594,24019229,24019229,24043459,0,0,0,24230
24595,24019382,24019382,24043560,0,0,0,24178
24499,23902008,23902008,24043785,0,0,0,141777
24575,23995476,23995476,24044163,0,0,0,48687
24592,24017714,24017714,24044544,0,0,0,26830
24444,23820138,23837788,24044641,0,0,17650,224503
24394,23811471,23815864,24046797,0,0,4393,235326
24596,24020298,24020298,24047410,0,0,0,27112
24610,24047503,24047503,24047689,0,0,0,186
24611,24047505,24047505,24047692,0,0,0,187
24598,24020964,24020964,24047860,0,0,0,26896
24576,23995501,23995501,24048130,0,0,0,52629
24615,24048738,24048738,24048967,0,0,0,229
24614,24048729,24048729,24048989,0,0,0,260
24616,24049835,24049835,24050053,0,0,0,218
24542,23970062,23970062,24050576,0,0,0,80514
24617,24050249,24050249,24050745,0,0,0,496
24619,24050683,24050683,24050776,0,0,0,93
24622,24050932,24050932,24051222,0,0,0,290
24621,24050870,24050870,24051405,0,0,0,535
24623,24051373,24051373,24051495,0,0,0,122
24630,24052605,24052605,24052691,0,0,0,86
24632,24053163,24053163,24053231,0,0,0,68
24635,24053619,24053619,24053686,0,0,0,67
24634,24053366,24053366,24054037,0,0,0,671
24520,23929869,23929869,24054829,0,0,0,124960
24627,24051575,24051575,24054973,0,0,0,3398
24638,24055376,24055376,24055485,0,0,0,109
24639,24055498,24055498,24055565,0,0,0,67
24640,24055731,24055731,24055798,0,0,0,67
24544,23972293,23972293,24055876,0,0,0,83583
24642,24055827,24055827,24055905,0,0,0,78
24643,24055927,24055927,24056051,0,0,0,124
24644,24056215,24056215,24056357,0,0,0,142
24307,23796545,23797240,24056440,0,0,695,259895
24625,24051464,24051464,24056546,0,0,0,5082
24626,24051513,24051513,24056546,0,0,0,5033
24647,24057014,24057014,24057073,0,0,0,59
24645,24056562,24056562,24057513,0,0,0,951
24649,24058213,24058213,24058318,0,0,0,105
24600,24037833,24037833,24058349,0,0,0,20516
24651,24058592,24058592,24058665,0,0,0,73
24601,24038347,24038347,24058889,0,0,0,20542
24378,23808663,23811665,24059709,0,0,3002,251046
24656,24060293,24060293,24060417,0,0,0,124
24658,24060700,24060700,24060835,0,0,0,135
24659,24060789,24060789,24060862,0,0,0,73
24657,24060675,24060675,24060893,0,0,0,218
24660,24061093,24061093,24061186,0,0,0,93
24661,24061208,24061208,24061301,0,0,0,93
24662,24061379,24061379,24061535,0,0,0,156
24648,24057078,24057078,24062162,0,0,0,5084
24663,24062057,24062057,24062186,0,0,0,129
24633,24053225,24053225,24062311,0,0,0,9086
24665,24062497,24062497,24062621,0,0,0,124
24604,24041851,24041851,24062775,0,0,0,20924
24603,24041827,24041827,24062821,0,0,0,20994
24668,24062791,24062791,24062946,0,0,0,155
24671,24063008,24063008,24063143,0,0,0,135
24672,24063511,24063511,24063636,0,0,0,125
24664,24062369,24062369,24064678,0,0,0,2309
24677,24064777,24064777,24064932,0,0,0,155
24678,24065165,24065165,24065301,0,0,0,136
24679,24065308,24065308,24065448,0,0,0,140
24372,23807506,23807506,24066706,0,0,0,259200
24373,23807521,23807768,24066968,0,0,247,259447
24641,24055825,24055825,24067156,0,0,0,11331
24602,24040980,24040980,24067327,0,0,0,26347
24606,24043392,24043392,24067672,0,0,0,24280
24607,24043520,24043520,24067707,0,0,0,24187
24687,24067738,24067738,24067816,0,0,0,78
24684,24067548,24067548,24067941,0,0,0,393
24688,24067936,24067936,24068040,0,0,0,104
24689,24068470,24068470,24068538,0,0,0,68
24690,24069151,24069151,24069435,0,0,0,284
24676,24064647,24064647,24069751,0,0,0,5104
24618,24050293,24050293,24069933,0,0,0,19640
24608,24044491,24044491,24070868,0,0,0,26377
24696,24071857,24071857,24072012,0,0,0,155
24605,24042734,24042734,24072350,0,0,0,29616
24699,24072404,24072404,24072470,0,0,0,66
24691,24069957,24069957,24072540,0,0,0,2583
24700,24072427,24072427,24073339,0,0,0,912
24704,24073306,24073306,24073461,0,0,0,155
24705,24073561,24073561,24073685,0,0,0,124
24706,24073782,24073782,24073886,0,0,0,104
24609,24047363,24047363,24074218,0,0,0,26855
24708,24074517,24074517,24074672,0,0,0,155
24709,24074921,24074921,24075025,0,0,0,104
24396,23811814,23815864,24075064,0,0,4050,263250
24397,23811906,23815864,24075064,0,0,3958,263158
24710,24075162,24075162,24075304,0,0,0,142
24711,24075218,24075218,24075343,0,0,0,125
24712,24075341,24075341,24077123,0,0,0,1782
24703,24072603,24072603,24077683,0,0,0,5080
24613,24047980,24047980,24078095,0,0,0,30115
24650,24058284,24058284,24078692,0,0,0,20408
24692,24070420,24070420,24078943,0,0,0,8523
24652,24058816,24058816,24079218,0,0,0,20402
24698,24072305,24072305,24079999,0,0,0,7694
24695,24071649,24071649,24080121,0,0,0,8472
24715,24077062,24077062,24080662,0,0,0,3600
24702,24072555,24072555,24081092,0,0,0,8537
24719,24081714,24081714,24081808,0,0,0,94
24666,24062728,24062728,24083490,0,0,0,20762
24667,24062736,24062736,24083529,0,0,0,20793
24427,23816935,23831238,24085210,0,0,14303,268275
24724,24084736,24084736,24085254,0,0,0,518
24725,24084770,24084770,24085277,0,0,0,507
24727,24085632,24085632,24086310,0,0,0,678
24654,24059354,24059354,24088288,0,0,0,28934
24734,24088391,24088391,24088511,0,0,0,120
24429,23817252,23831692,24090892,0,0,14440,273640
24612,24047805,24047805,24091005,0,0,0,43200
24685,24067603,24067603,24091497,0,0,0,23894
24686,24067644,24067644,24091538,0,0,0,23894
24739,24092554,24092554,24092991,0,0,0,437
24682,24067284,24067284,24093569,0,0,0,26285
24669,24062946,24062946,24095396,0,0,0,32450
24670,24062977,24062977,24095476,0,0,0,32499
24436,23817883,23836448,24095648,0,0,18565,277765
24442,23819938,23837788,24096988,0,0,17850,277050
24675,24064367,24064367,24096988,0,0,0,32621
24693,24070806,24070806,24097298,0,0,0,26492
24680,24065420,24065420,24097903,0,0,0,32483
24731,24087202,24087202,24098343,0,0,0,11141
24717,24078652,24078652,24098767,0,0,0,20115
24718,24079156,24079156,24099305,0,0,0,20149
24681,24066238,24066238,24099383,0,0,0,33145
24707,24074151,24074151,24100685,0,0,0,26534
24683,24067341,24067341,24102047,0,0,0,34706
24745,24098475,24098475,24102189,0,0,0,3714
24697,24072301,24072301,24102279,0,0,0,29978
24721,24083431,24083431,24104000,0,0,0,20569
24722,24083491,24083491,24104074,0,0,0,20583
24742,24096739,24096739,24107400,0,0,0,10661
24743,24096939,24096939,24107618,0,0,0,10679
24716,24078030,24078030,24107850,0,0,0,29820
24754,24107790,24107790,24107970,0,0,0,180
24290,23762889,23762889,24108489,0,0,0,345600
24646,24056955,24056955,24110297,0,0,0,53342
24723,24083976,24083976,24111287,0,0,0,27311
24571,23993397,23993397,24114118,0,0,0,120721
24738,24091495,24091495,24115074,0,0,0,23579
24747,24098705,24098705,24119377,0,0,0,20672
24741,24093507,24093507,24119761,0,0,0,26254
24748,24099235,24099235,24119794,0,0,0,20559
24720,24081945,24081945,24123557,0,0,0,41612
24744,24097227,24097227,24123591,0,0,0,26364
24637,24054874,24054874,24123624,0,0,0,68750
24752,24103933,24103933,24124927,0,0,0,20994
24753,24104015,24104015,24124975,0,0,0,20960
24763,24123933,24123933,24125410,0,0,0,1477
24766,24125746,24125746,24126958,0,0,0,1212
24749,24100646,24100646,24127397,0,0,0,26751
24768,24127560,24127560,24128639,0,0,0,1079
24701,24072487,24072487,24128973,0,0,0,56486
24769,24129373,24129373,24130346,0,0,0,973
24756,24108533,24108533,24130465,0,0,0,21932
24770,24131185,24131185,24132106,0,0,0,921
24750,24102218,24102218,24132198,0,0,0,29980
24772,24132400,24132400,24132463,0,0,0,63
24774,24132998,24132998,24133888,0,0,0,890
24737,24091427,24091427,24134627,0,0,0,43200
24775,24133918,24133918,24134758,0,0,0,840
24776,24134833,24134833,24135634,0,0,0,801
24777,24135546,24135546,24135733,0,0,0,187
24735,24088470,24088470,24135986,0,0,0,47516
24779,24136156,24136156,24136357,0,0,0,201
24778,24135739,24135739,24136540,0,0,0,801
24781,24136646,24136646,24137418,0,0,0,772
24755,24107970,24107970,24137994,0,0,0,30024
24758,24115014,24115014,24138264,0,0,0,23250
24783,24137553,24137553,24138292,0,0,0,739
24785,24138208,24138208,24138354,0,0,0,146
24788,24138695,24138695,24138749,0,0,0,54
24471,23875651,23879998,24139198,0,0,4347,263547
24787,24138460,24138460,24139203,0,0,0,743
24792,24139277,24139277,24139401,0,0,0,124
24790,24139031,24139031,24139530,0,0,0,499
24714,24077016,24077016,24139669,0,0,0,62653
24653,24058851,24058851,24139908,0,0,0,81057
24793,24139725,24139725,24139916,0,0,0,191
24773,24132589,24132589,24139938,0,0,0,7349
24636,24053799,24053799,24140038,0,0,0,86239
24794,24139971,24139971,24140118,0,0,0,147
24759,24119377,24119377,24140124,0,0,0,20747
24796,24140114,24140114,24140287,0,0,0,173
24798,24140148,24140148,24140302,0,0,0,154
24799,24140251,24140251,24140333,0,0,0,82
24795,24140082,24140082,24140460,0,0,0,378
24761,24119800,24119800,24140537,0,0,0,20737
24746,24098561,24098561,24140899,0,0,0,42338
24802,24140732,24140732,24140950,0,0,0,218
24800,24140286,24140286,24141091,0,0,0,805
24803,24140893,24140893,24141599,0,0,0,706
24791,24139047,24139047,24141771,0,0,0,2724
24804,24141360,24141360,24142214,0,0,0,854
24807,24142333,24142333,24142391,0,0,0,58
24789,24138748,24138748,24143332,0,0,0,4584
24805,24141605,24141605,24143333,0,0,0,1728
24808,24142361,24142361,24144321,0,0,0,1960
24760,24119688,24119688,24145912,0,0,0,26224
24764,24124933,24124933,24146046,0,0,0,21113
24765,24124996,24124996,24146109,0,0,0,21113
24815,24145942,24145942,24146568,0,0,0,626
24811,24144253,24144253,24146785,0,0,0,2532
24819,24146535,24146535,24147673,0,0,0,1138
24821,24147659,24147659,24147752,0,0,0,93
24822,24147870,24147870,24148212,0,0,0,342
24824,24148511,24148511,24148666,0,0,0,155
24825,24148569,24148569,24148724,0,0,0,155
24829,24148702,24148702,24148795,0,0,0,93
24826,24148580,24148580,24148797,0,0,0,217
24733,24088328,24088328,24148886,0,0,0,60558
24827,24148592,24148592,24148964,0,0,0,372
24828,24148603,24148603,24149223,0,0,0,620
24782,24137513,24137513,24149481,0,0,0,11968
24823,24148151,24148151,24149950,0,0,0,1799
24762,24123553,24123553,24149997,0,0,0,26444
24655,24060198,24060198,24150075,0,0,0,89877
24831,24149964,24149964,24151773,0,0,0,1809
24620,24050840,24050840,24153097,0,0,0,102257
24631,24052957,24052957,24153745,0,0,0,100788
24767,24127380,24127380,24153942,0,0,0,26562
24380,23808690,23809057,24154657,0,0,367,345967
24801,24140335,24140335,24154780,0,0,0,14445
24812,24145757,24145757,24155836,0,0,0,10079
24486,23897087,23897087,24156287,0,0,0,259200
24487,23897122,23897122,24156322,0,0,0,259200
24836,24155738,24155738,24156377,0,0,0,639
24488,23897358,23897358,24156558,0,0,0,259200
24489,23897359,23897359,24156559,0,0,0,259200
24490,23897360,23897360,24156560,0,0,0,259200
24491,23897360,23897360,24156560,0,0,0,259200
24492,23897480,23897480,24156680,0,0,0,259200
24493,23897481,23897481,24156681,0,0,0,259200
24841,24156645,24156645,24157065,0,0,0,420
24838,24156395,24156395,24157171,0,0,0,776
24839,24156601,24156601,24157172,0,0,0,571
24847,24157326,24157326,24157420,0,0,0,94
24846,24157240,24157240,24157506,0,0,0,266
24845,24157112,24157112,24157777,0,0,0,665
24497,23898964,23898964,24158164,0,0,0,259200
24850,24158207,24158207,24158287,0,0,0,80
24498,23899141,23899141,24158341,0,0,0,259200
24849,24157710,24157710,24159509,0,0,0,1799
24628,24052111,24052111,24159562,0,0,0,107451
24859,24159473,24159473,24159573,0,0,0,100
24858,24159308,24159308,24159574,0,0,0,266
24860,24159558,24159558,24159653,0,0,0,95
24797,24140134,24140134,24160201,0,0,0,20067
24786,24138255,24138255,24161276,0,0,0,23021
24867,24161326,24161326,24161481,0,0,0,155
24771,24132199,24132199,24161909,0,0,0,29710
24844,24157004,24157004,24162060,0,0,0,5056
24869,24162987,24162987,24163054,0,0,0,67
24870,24163301,24163301,24163390,0,0,0,89
24871,24163356,24163356,24163480,0,0,0,124
24873,24163796,24163796,24163920,0,0,0,124
24810,24144252,24144252,24164327,0,0,0,20075
24834,24152596,24152596,24164781,0,0,0,12185
24624,24051443,24051443,24165223,0,0,0,113780
24674,24064139,24064139,24165374,0,0,0,101235
24673,24063797,24063797,24165476,0,0,0,101679
24816,24146003,24146003,24166434,0,0,0,20431
24818,24146053,24146053,24166497,0,0,0,20444
24784,24137994,24137994,24167119,0,0,0,29125
24876,24167111,24167111,24167283,0,0,0,172
24879,24168731,24168731,24168799,0,0,0,68
24880,24168885,24168885,24169107,0,0,0,222
24814,24145920,24145920,24169539,0,0,0,23619
24751,24103122,24103122,24172328,0,0,0,69206
24817,24146008,24146008,24172410,0,0,0,26402
24813,24145867,24145867,24172732,0,0,0,26865
24865,24161236,24161236,24174673,0,0,0,13437
24832,24150007,24150007,24176096,0,0,0,26089
24887,24177910,24177910,24178081,0,0,0,171
24835,24153879,24153879,24180553,0,0,0,26674
24864,24160149,24160149,24180714,0,0,0,20565
24886,24176695,24176695,24181795,0,0,0,5100
24881,24169141,24169141,24184471,0,0,0,15330
24874,24164265,24164265,24184892,0,0,0,20627
24866,24161254,24161254,24184974,0,0,0,23720
24893,24186994,24186994,24187067,0,0,0,73
24875,24166473,24166473,24187353,0,0,0,20880
24729,24085814,24085814,24189160,0,0,0,103346
24780,24136235,24136235,24191192,0,0,0,54957
24868,24161846,24161846,24191516,0,0,0,29670
24883,24170456,24170456,24191557,0,0,0,21101
24882,24169603,24169603,24192890,0,0,0,23287
24894,24187021,24187021,24193465,0,0,0,6444
24877,24167229,24167229,24196591,0,0,0,29362
24884,24172460,24172460,24198200,0,0,0,25740
24854,24158321,24158321,24198756,0,0,0,40435
24885,24172669,24172669,24199289,0,0,0,26620
24809,24143270,24143270,24200918,0,0,0,57648
24872,24163755,24163755,24201962,0,0,0,38207
24890,24181819,24181819,24202349,0,0,0,20530
24820,24146751,24146751,24204535,0,0,0,57784
24888,24178019,24178019,24204654,0,0,0,26635
24891,24184821,24184821,24205337,0,0,0,20516
24852,24158289,24158289,24206561,0,0,0,48272
24730,24085876,24085876,24207497,0,0,0,121621
24889,24180554,24180554,24207701,0,0,0,27147
24892,24185721,24185721,24207879,0,0,0,22158
24895,24187314,24187314,24208260,0,0,0,20946
24896,24191490,24191490,24212353,0,0,0,20863
24726,24085556,24085556,24214107,0,0,0,128551
24728,24085685,24085685,24215078,0,0,0,129393
24898,24192826,24192826,24215864,0,0,0,23038
24573,23994815,23994815,24219635,0,0,0,224820
24910,24219822,24219822,24219957,0,0,0,135
24915,24221361,24221361,24221454,0,0,0,93
24912,24221310,24221310,24221474,0,0,0,164
24911,24221296,24221296,24221475,0,0,0,179
24916,24221381,24221381,24221475,0,0,0,94
24913,24221323,24221323,24221478,0,0,0,155
24914,24221337,24221337,24221524,0,0,0,187
24897,24192755,24192755,24222033,0,0,0,29278
24917,24221964,24221964,24222154,0,0,0,190
24918,24222084,24222084,24222247,0,0,0,163
24920,24222100,24222100,24222272,0,0,0,172
24921,24222111,24222111,24222272,0,0,0,161
24922,24222129,24222129,24222284,0,0,0,155
24902,24202286,24202286,24222768,0,0,0,20482
24924,24222730,24222730,24222843,0,0,0,113
24925,24222751,24222751,24222909,0,0,0,158
24926,24222768,24222768,24222934,0,0,0,166
24928,24222791,24222791,24222939,0,0,0,148
24927,24222781,24222781,24222940,0,0,0,159
24929,24222816,24222816,24222940,0,0,0,124
24900,24198137,24198137,24224515,0,0,0,26378
24904,24205283,24205283,24225519,0,0,0,20236
24935,24225358,24225358,24225552,0,0,0,194
24901,24199226,24199226,24225758,0,0,0,26532
24931,24224270,24224270,24226136,0,0,0,1866
24899,24196520,24196520,24226648,0,0,0,30128
24837,24156337,24156337,24227103,0,0,0,70766
24940,24226944,24226944,24227266,0,0,0,322
24941,24227021,24227021,24227327,0,0,0,306
24942,24228312,24228312,24228645,0,0,0,333
24907,24208189,24208189,24228793,0,0,0,20604
24944,24228756,24228756,24228882,0,0,0,126
24948,24229092,24229092,24229186,0,0,0,94
24949,24229116,24229116,24229210,0,0,0,94
24947,24229065,24229065,24229239,0,0,0,174
24946,24228839,24228839,24229420,0,0,0,581
24930,24222977,24222977,24229607,0,0,0,6630
24950,24229662,24229662,24229849,0,0,0,187
24903,24204591,24204591,24231292,0,0,0,26701
24906,24207816,24207816,24231520,0,0,0,23704
24954,24232833,24232833,24232896,0,0,0,63
24908,24212316,24212316,24232926,0,0,0,20610
24955,24232846,24232846,24232940,0,0,0,94
24957,24232884,24232896,24232990,0,0,12,106
24958,24232902,24232940,24233045,0,0,38,143
24960,24233431,24233431,24233515,0,0,0,84
24905,24207639,24207639,24234680,0,0,0,27041
24965,24234675,24234675,24234749,0,0,0,74
24978,24236770,24236770,24236899,0,0,0,129
24968,24235663,24235663,24238056,0,0,0,2393
24971,24235933,24235933,24238357,0,0,0,2424
24909,24215804,24215804,24239514,0,0,0,23710
24584,24006244,24006244,24240559,0,0,0,234315
24961,24233472,24233472,24241252,0,0,0,7780
24984,24242763,24242763,24242857,0,0,0,94
24970,24235884,24235884,24242881,0,0,0,6997
24962,24233890,24233890,24242919,0,0,0,9029
24985,24242853,24242853,24242957,0,0,0,104
24986,24243007,24243007,24243097,0,0,0,90
24923,24222686,24222686,24243151,0,0,0,20465
24989,24243121,24243121,24243591,0,0,0,470
24966,24235038,24235038,24243941,0,0,0,8903
24990,24244046,24244046,24244120,0,0,0,74
24732,24088257,24088257,24244635,0,0,0,156378
24936,24225458,24225458,24245887,0,0,0,20429
24987,24243046,24243046,24246427,0,0,0,3381
24991,24246373,24246373,24246447,0,0,0,74
24996,24249061,24249061,24249185,0,0,0,124
24945,24228762,24228762,24249551,0,0,0,20789
24999,24249509,24249509,24249562,0,0,0,53
24565,23990829,23990829,24250029,0,0,0,259200
24566,23990889,23990889,24250089,0,0,0,259200
24933,24224446,24224446,24250888,0,0,0,26442
24919,24222090,24222090,24250993,0,0,0,28903
24977,24236655,24236655,24251570,0,0,0,14915
24994,24246858,24246858,24251842,0,0,0,4984
24937,24225696,24225696,24252218,0,0,0,26522
24956,24232883,24232883,24253667,0,0,0,20784
24953,24231475,24231475,24253838,0,0,0,22363
24995,24247579,24247579,24254506,0,0,0,6927
24952,24231228,24231228,24254622,0,0,0,23394
24983,24242237,24242237,24254963,0,0,0,12726
24938,24226595,24226595,24255689,0,0,0,29094
24997,24249300,24249300,24256587,0,0,0,7287
25000,24249530,24249530,24256743,0,0,0,7213
25013,24259705,24259705,24260082,0,0,0,377
25012,24258304,24258304,24260163,0,0,0,1859
25011,24258299,24258299,24260169,0,0,0,1870
24964,24234635,24234635,24260710,0,0,0,26075
24830,24149029,24149029,24261158,0,0,0,112129
24981,24239451,24239451,24261601,0,0,0,22150
25014,24260123,24260123,24261991,0,0,0,1868
25015,24260128,24260128,24262016,0,0,0,1888
24988,24243064,24243064,24263221,0,0,0,20157
24980,24236989,24236989,24263351,0,0,0,26362
25019,24261950,24261950,24263833,0,0,0,1883
25020,24261959,24261959,24263862,0,0,0,1903
24833,24150720,24150720,24264136,0,0,0,113416
25025,24264714,24264714,24264807,0,0,0,93
25023,24263794,24263794,24265683,0,0,0,1889
25024,24263802,24263802,24265711,0,0,0,1909
24932,24224396,24224396,24266365,0,0,0,41969
24992,24246504,24246504,24266651,0,0,0,20147
25026,24265641,24265641,24267522,0,0,0,1881
25027,24265647,24265647,24267578,0,0,0,1931
25002,24250823,24250823,24269193,0,0,0,18370
25029,24267479,24267479,24269585,0,0,0,2106
25030,24267518,24267518,24269613,0,0,0,2095
24998,24249495,24249495,24270011,0,0,0,20516
24963,24234219,24234219,24270219,0,0,0,36000
24967,24235551,24235551,24271551,0,0,0,36000
24969,24235786,24235786,24271786,0,0,0,36000
24972,24235995,24235995,24271995,0,0,0,36000
24973,24236071,24236071,24272071,0,0,0,36000
24974,24236092,24236092,24272092,0,0,0,36000
24975,24236133,24236133,24272133,0,0,0,36000
24976,24236160,24236160,24272160,0,0,0,36000
25005,24253623,24253623,24274132,0,0,0,20509
25006,24253779,24253779,24276180,0,0,0,22401
25004,24252624,24252624,24278751,0,0,0,26127
24993,24246791,24246791,24279496,0,0,0,32705
25007,24254561,24254561,24280393,0,0,0,25832
25003,24250930,24250930,24280759,0,0,0,29829
25041,24280751,24280751,24280928,0,0,0,177
25042,24280863,24280863,24281035,0,0,0,172
25043,24280979,24280979,24281148,0,0,0,169
25044,24281085,24281085,24281267,0,0,0,182
25022,24263252,24263252,24283452,0,0,0,20200
25008,24255618,24255618,24283497,0,0,0,27879
24736,24088650,24088650,24283815,0,0,0,195165
25018,24261623,24261623,24285311,0,0,0,23688
25028,24266674,24266674,24286986,0,0,0,20312
25017,24260710,24260710,24287375,0,0,0,26665
25034,24271348,24271348,24291960,0,0,0,20612
24806,24142090,24142090,24294527,0,0,0,152437
25036,24274287,24274287,24294838,0,0,0,20551
25031,24269306,24269306,24295377,0,0,0,26071
25021,24262883,24262883,24298883,0,0,0,36000
25037,24276957,24276957,24299664,0,0,0,22707
25047,24283389,24283389,24303994,0,0,0,20605
25032,24269533,24269533,24305533,0,0,0,36000
25033,24269554,24269554,24305554,0,0,0,36000
25040,24279724,24279724,24306372,0,0,0,26648
25050,24286923,24286923,24307540,0,0,0,20617
25049,24285258,24285258,24307617,0,0,0,22359
25045,24281192,24281192,24307763,0,0,0,26571
24878,24168454,24168454,24309056,0,0,0,140602
25067,24308289,24308289,24309429,0,0,0,1140
25010,24256245,24256245,24309652,0,0,0,53407
25075,24310009,24310009,24310108,0,0,0,99
25076,24310020,24310020,24310113,0,0,0,93
25077,24310064,24310064,24310158,0,0,0,94
25061,24308086,24308086,24310338,0,0,0,2252
25079,24310594,24310594,24310749,0,0,0,155
25046,24282455,24282455,24310855,0,0,0,28400
25074,24309371,24309371,24311400,0,0,0,2029
24629,24052310,24052310,24311510,0,0,0,259200
25082,24311573,24311573,24311688,0,0,0,115
25071,24308445,24308445,24312306,0,0,0,3861
25078,24310294,24310294,24312597,0,0,0,2303
25052,24291891,24291891,24312881,0,0,0,20990
25048,24283505,24283505,24313436,0,0,0,29931
25081,24311330,24311330,24313583,0,0,0,2253
25087,24313508,24313508,24313590,0,0,0,82
25080,24310799,24310799,24313830,0,0,0,3031
25051,24287316,24287316,24313872,0,0,0,26556
25084,24312552,24312552,24314510,0,0,0,1958
25088,24313529,24313529,24314557,0,0,0,1028
25053,24294791,24294791,24315782,0,0,0,20991
25094,24314514,24314514,24316492,0,0,0,1978
25083,24312239,24312239,24317422,0,0,0,5183
25098,24317518,24317518,24317586,0,0,0,68
25099,24317633,24317633,24317700,0,0,0,67
25096,24316430,24316430,24318594,0,0,0,2164
25102,24318928,24318928,24319107,0,0,0,179
25104,24318957,24318957,24319138,0,0,0,181
25105,24318973,24318973,24319169,0,0,0,196
25106,24318988,24318988,24319199,0,0,0,211
25107,24319002,24319002,24319220,0,0,0,218
25103,24318942,24318942,24319386,0,0,0,444
25097,24317370,24317370,24319521,0,0,0,2151
25090,24313798,24313798,24319552,0,0,0,5754
25109,24320016,24320016,24320153,0,0,0,137
24934,24224532,24224532,24320403,0,0,0,95871
25101,24318547,24318547,24320799,0,0,0,2252
25054,24295310,24295310,24321679,0,0,0,26369
25110,24320539,24320539,24321726,0,0,0,1187
25108,24319456,24319456,24321733,0,0,0,2277
25112,24321613,24321613,24321790,0,0,0,177
25055,24299607,24299607,24321841,0,0,0,22234
25116,24322423,24322423,24322697,0,0,0,274
25016,24260486,24260486,24322941,0,0,0,62455
25111,24320742,24320742,24323022,0,0,0,2280
25118,24323064,24323064,24323131,0,0,0,67
25100,24317980,24317980,24323176,0,0,0,5196
25119,24323186,24323186,24323280,0,0,0,94
25113,24321689,24321689,24323931,0,0,0,2242
25092,24313914,24313914,24324060,0,0,0,10146
25056,24303924,24303924,24324355,0,0,0,20431
25122,24324312,24324312,24324417,0,0,0,105
25124,24324617,24324617,24324691,0,0,0,74
25117,24322960,24322960,24324879,0,0,0,1919
25126,24324880,24324880,24324974,0,0,0,94
25127,24324999,24324999,24325104,0,0,0,105
25125,24324838,24324838,24326324,0,0,0,1486
25070,24308301,24308301,24326910,0,0,0,18609
25129,24325777,24325777,24326939,0,0,0,1162
25069,24308297,24308297,24327216,0,0,0,18919
25132,24326261,24326261,24327420,0,0,0,1159
25135,24327582,24327582,24327696,0,0,0,114
25137,24327723,24327723,24327817,0,0,0,94
25058,24307480,24307480,24327905,0,0,0,20425
25139,24327864,24327864,24327957,0,0,0,93
25062,24308229,24308229,24328010,0,0,0,19781
25140,24327963,24327963,24328062,0,0,0,99
25066,24308285,24308285,24328307,0,0,0,20022
25133,24326401,24326401,24328347,0,0,0,1946
25143,24328374,24328374,24328479,0,0,0,105
25134,24327376,24327376,24329252,0,0,0,1876
25146,24329023,24329023,24329349,0,0,0,326
25147,24329079,24329079,24329407,0,0,0,328
25148,24329192,24329192,24329516,0,0,0,324
25150,24329254,24329254,24329577,0,0,0,323
25059,24307554,24307554,24329788,0,0,0,22234
25151,24329375,24329375,24329866,0,0,0,491
25142,24328284,24328284,24330159,0,0,0,1875
25156,24330202,24330202,24330296,0,0,0,94
25144,24328479,24328479,24330695,0,0,0,2216
25149,24329204,24329204,24330725,0,0,0,1521
24694,24071577,24071577,24330777,0,0,0,259200
25064,24308277,24308277,24331129,0,0,0,22852
25068,24308293,24308293,24331196,0,0,0,22903
25158,24331290,24331290,24331383,0,0,0,93
25159,24331442,24331442,24331536,0,0,0,94
25153,24330006,24330006,24331671,0,0,0,1665
25065,24308280,24308280,24332189,0,0,0,23909
25162,24332245,24332245,24332339,0,0,0,94
25163,24332348,24332348,24332439,0,0,0,91
25164,24332404,24332404,24332471,0,0,0,67
25154,24330086,24330086,24332609,0,0,0,2523
25167,24332700,24332700,24332773,0,0,0,73
25165,24332526,24332526,24332837,0,0,0,311
25166,24332570,24332570,24332896,0,0,0,326
25057,24306309,24306309,24333099,0,0,0,26790
25063,24308241,24308241,24333237,0,0,0,24996
25170,24333179,24333179,24333505,0,0,0,326
25085,24312826,24312826,24333734,0,0,0,20908
25168,24332903,24332903,24333789,0,0,0,886
25161,24331943,24331943,24333843,0,0,0,1900
25172,24333803,24333803,24334140,0,0,0,337
25060,24307701,24307701,24334466,0,0,0,26765
25175,24334399,24334399,24334572,0,0,0,173
25177,24334622,24334622,24334747,0,0,0,125
24713,24076099,24076099,24335299,0,0,0,259200
25136,24327669,24327669,24335635,0,0,0,7966
24939,24226683,24226683,24335702,0,0,0,109019
25095,24315724,24315724,24336566,0,0,0,20842
25178,24334929,24334929,24336803,0,0,0,1874
25131,24326233,24326233,24336863,0,0,0,10630
25186,24337264,24337264,24337378,0,0,0,114
25183,24336759,24336759,24338410,0,0,0,1651
25185,24337102,24337102,24338440,0,0,0,1338
25184,24336775,24336775,24338446,0,0,0,1671
25155,24330121,24330121,24339696,0,0,0,9575
25192,24340178,24340178,24340242,0,0,0,64
25091,24313825,24313825,24340270,0,0,0,26445
25194,24340343,24340343,24340941,0,0,0,598
25009,24255902,24255902,24341654,0,0,0,85752
24943,24228365,24228365,24341949,0,0,0,113584
25160,24331670,24331670,24343086,0,0,0,11416
25089,24313780,24313780,24343253,0,0,0,29473
25086,24313373,24313373,24343512,0,0,0,30139
25115,24321799,24321799,24343884,0,0,0,22085
25123,24324316,24324316,24344473,0,0,0,20157
25181,24336122,24336122,24347940,0,0,0,11818
25114,24321730,24321730,24347975,0,0,0,26245
25138,24327863,24327863,24348013,0,0,0,20150
24951,24231181,24231181,24349846,0,0,0,118665
25093,24314446,24314446,24350446,0,0,0,36000
25120,24323475,24323475,24351355,0,0,0,27880
24740,24092690,24092690,24351890,0,0,0,259200
25152,24329726,24329726,24352408,0,0,0,22682
25171,24333664,24333664,24354223,0,0,0,20559
25189,24338366,24338366,24354320,0,0,0,15954
25191,24339858,24339858,24354351,0,0,0,14493
25206,24354277,24354277,24356194,0,0,0,1917
25207,24354281,24354281,24357067,0,0,0,2786
25182,24336523,24336523,24357072,0,0,0,20549
25209,24356123,24356123,24357976,0,0,0,1853
25208,24354916,24354916,24358196,0,0,0,3280
25212,24357031,24357031,24358927,0,0,0,1896
25169,24333063,24333063,24359247,0,0,0,26184
25213,24357937,24357937,24359813,0,0,0,1876
25176,24334514,24334514,24360572,0,0,0,26058
25216,24359771,24359771,24363451,0,0,0,3680
24982,24240599,24240599,24363953,0,0,0,123354
25200,24344414,24344414,24364915,0,0,0,20501
25193,24340213,24340213,24366622,0,0,0,26409
25199,24343824,24343824,24366905,0,0,0,23081
25202,24347947,24347947,24368455,0,0,0,20508
25197,24343189,24343189,24371423,0,0,0,28234
25223,24371362,24371362,24371534,0,0,0,172
25224,24371471,24371471,24371642,0,0,0,171
25225,24371579,24371579,24371747,0,0,0,168
25204,24353363,24353363,24372949,0,0,0,19586
25187,24337357,24337357,24373357,0,0,0,36000
25188,24337411,24337411,24373411,0,0,0,36000
25198,24343469,24343469,24373532,0,0,0,30063
25201,24347903,24347903,24373890,0,0,0,25987
25228,24373833,24373833,24374004,0,0,0,171
25190,24338384,24338384,24374384,0,0,0,36000
25203,24352362,24352362,24374690,0,0,0,22328
25205,24354169,24354169,24375036,0,0,0,20867
25211,24356998,24356998,24377834,0,0,0,20836
25145,24328953,24328953,24380918,0,0,0,51965
25219,24364850,24364850,24385339,0,0,0,20489
25215,24359207,24359207,24385925,0,0,0,26718
25217,24360500,24360500,24386713,0,0,0,26213
25236,24388196,24388196,24388290,0,0,0,94
25222,24368396,24368396,24388924,0,0,0,20528
25221,24366852,24366852,24390496,0,0,0,23644
24979,24236882,24236882,24391979,0,0,0,155097
25001,24249804,24249804,24392874,0,0,0,143070
25220,24366551,24366551,24392940,0,0,0,26389
25214,24358866,24358866,24394866,0,0,0,36000
25240,24393896,24393896,24394900,0,0,0,1004
25242,24395689,24395689,24395771,0,0,0,82
25231,24374974,24374974,24395876,0,0,0,20902
25245,24395740,24395771,24395939,0,0,31,199
25243,24395710,24395710,24396404,0,0,0,694
25244,24395715,24395771,24396735,0,0,56,1020
25230,24374622,24374622,24397211,0,0,0,22589
25232,24377775,24377775,24398729,0,0,0,20954
25250,24398549,24398549,24398884,0,0,0,335
25251,24398579,24398579,24398915,0,0,0,336
25218,24363394,24363394,24399394,0,0,0,36000
25226,24371686,24371686,24400002,0,0,0,28316
25253,24399939,24399939,24400136,0,0,0,197
25255,24400105,24400105,24400229,0,0,0,124
25229,24373941,24373941,24400312,0,0,0,26371
25257,24400875,24400875,24400935,0,0,0,60
25259,24401540,24401540,24401579,0,0,0,39
25260,24401969,24401969,24402119,0,0,0,150
25262,24402220,24402220,24402324,0,0,0,104
25173,24333851,24333851,24402442,0,0,0,68591
25174,24333949,24333949,24402467,0,0,0,68518
25258,24401431,24401431,24403125,0,0,0,1694
25227,24373472,24373472,24403246,0,0,0,29774
25233,24385279,24385279,24405676,0,0,0,20397
25263,24402371,24402371,24406329,0,0,0,3958
25274,24407580,24407580,24407674,0,0,0,94
25275,24407594,24407594,24407729,0,0,0,135
25276,24407613,24407729,24407823,0,0,116,210
25237,24388861,24388861,24409240,0,0,0,20379
25073,24308915,24308915,24409797,0,0,0,100882
25235,24386660,24386660,24412396,0,0,0,25736
25283,24412349,24412349,24412526,0,0,0,177
25234,24385863,24385863,24412615,0,0,0,26752
25284,24412466,24412466,24412663,0,0,0,197
25072,24308834,24308834,24413070,0,0,0,104236
25238,24390426,24390426,24413275,0,0,0,22849
25288,24413714,24413714,24413793,0,0,0,79
25289,24413939,24413939,24414006,0,0,0,67
25290,24414099,24414099,24414259,0,0,0,160
24840,24156601,24156601,24415801,0,0,0,259200
24842,24156709,24156709,24415909,0,0,0,259200
25246,24395833,24395833,24416555,0,0,0,20722
25241,24395232,24395232,24416586,0,0,0,21354
24848,24157599,24157599,24416799,0,0,0,259200
24851,24158264,24158264,24417464,0,0,0,259200
24853,24158299,24158299,24417499,0,0,0,259200
24855,24158338,24158338,24417538,0,0,0,259200
24856,24158379,24158379,24417579,0,0,0,259200
25280,24409941,24409941,24418165,0,0,0,8224
24857,24159112,24159112,24418312,0,0,0,259200
24861,24159667,24159667,24418867,0,0,0,259200
24862,24159702,24159702,24418902,0,0,0,259200
25239,24392878,24392878,24419046,0,0,0,26168
24863,24160019,24160019,24419219,0,0,0,259200
25252,24398666,24398666,24419403,0,0,0,20737
25247,24397177,24397177,24420287,0,0,0,23110
25121,24323776,24323776,24425887,0,0,0,102111
25272,24405605,24405605,24426124,0,0,0,20519
25256,24400250,24400250,24426481,0,0,0,26231
25196,24341653,24341653,24426941,0,0,0,85288
25254,24400049,24400049,24428861,0,0,0,28812
25279,24409172,24409172,24429700,0,0,0,20528
25291,24415140,24417464,24430785,0,0,2324,15645
25039,24279170,24279170,24430944,0,0,0,151774
25038,24279079,24279079,24431287,0,0,0,152208
25310,24429105,24429105,24432537,0,0,0,3432
25266,24403209,24403209,24432982,0,0,0,29773
25249,24398410,24398410,24434410,0,0,0,36000
25287,24413220,24413220,24436216,0,0,0,22996
25294,24416494,24416494,24437404,0,0,0,20910
25286,24412582,24412615,24438590,0,0,33,26008
25285,24412537,24412537,24439031,0,0,0,26494
25265,24403198,24403198,24439198,0,0,0,36000
25267,24403211,24403211,24439211,0,0,0,36000
25268,24403609,24403609,24439609,0,0,0,36000
25304,24419340,24419340,24440262,0,0,0,20922
25270,24404364,24404364,24440364,0,0,0,36000
25305,24420227,24420227,24443902,0,0,0,23675
25301,24419011,24419011,24445820,0,0,0,26809
25306,24426066,24426066,24446638,0,0,0,20572
25311,24429638,24429638,24450081,0,0,0,20443
25248,24397367,24397367,24450086,0,0,0,52719
25319,24441409,24441409,24452071,0,0,0,10662
25307,24426413,24426413,24452372,0,0,0,25959
25325,24452316,24452316,24452485,0,0,0,169
25326,24452422,24452422,24452592,0,0,0,170
25327,24452529,24452529,24452696,0,0,0,167
24757,24108787,24108787,24454387,0,0,0,345600
25309,24428777,24428777,24457216,0,0,0,28439
25330,24457174,24457174,24457344,0,0,0,170
25315,24437334,24437334,24458278,0,0,0,20944
25314,24436153,24436153,24459509,0,0,0,23356
25318,24440191,24440191,24461061,0,0,0,20870
25312,24432922,24432922,24462332,0,0,0,29410
25316,24438497,24438497,24465041,0,0,0,26544
25336,24464997,24464997,24465174,0,0,0,177
25337,24465108,24465108,24465276,0,0,0,168
25338,24465221,24465221,24465389,0,0,0,168
25339,24465327,24465327,24465496,0,0,0,169
25317,24438994,24438994,24465816,0,0,0,26822
25321,24443839,24443839,24466610,0,0,0,22771
25323,24446569,24446569,24467197,0,0,0,20628
25324,24450024,24450024,24470595,0,0,0,20571
25322,24445774,24445774,24472298,0,0,0,26524
24843,24156995,24156995,24475167,0,0,0,318172
25328,24452634,24452634,24479089,0,0,0,26455
25332,24458240,24458240,24479189,0,0,0,20949
25313,24435997,24435997,24481833,0,0,0,45836
25334,24461001,24461001,24481979,0,0,0,20978
25333,24459442,24459442,24482407,0,0,0,22965
25335,24462285,24462285,24485087,0,0,0,22802
25331,24457288,24457288,24485251,0,0,0,27963
25343,24467137,24467137,24487712,0,0,0,20575
25342,24466548,24466548,24489517,0,0,0,22969
25345,24470532,24470532,24491131,0,0,0,20599
25340,24465433,24465433,24491768,0,0,0,26335
25356,24491707,24491707,24491867,0,0,0,160
25357,24491815,24491815,24491971,0,0,0,156
25358,24491923,24491923,24492111,0,0,0,188
25341,24465753,24465753,24492146,0,0,0,26393
24959,24233266,24233266,24492466,0,0,0,259200
25035,24273567,24273567,24495908,0,0,0,222341
25346,24472241,24472241,24498552,0,0,0,26311
25195,24340413,24340413,24500086,0,0,0,159673
25348,24479146,24479146,24500166,0,0,0,21020
25141,24328104,24328104,24500904,0,0,0,172800
25264,24402407,24402407,24501102,0,0,0,98695
25349,24481916,24481916,24502922,0,0,0,21006
25273,24405665,24405665,24504999,0,0,0,99334
25347,24479021,24479021,24505656,0,0,0,26635
25350,24482349,24482349,24505859,0,0,0,23510
25180,24336072,24336072,24507203,0,0,0,171131
25351,24485029,24485029,24508066,0,0,0,23037
25353,24487673,24487673,24508261,0,0,0,20588
25278,24408957,24408957,24509072,0,0,0,100115
25355,24491060,24491060,24511614,0,0,0,20554
25281,24410249,24410249,24511863,0,0,0,101614
25277,24408706,24408706,24512577,0,0,0,103871
25354,24489455,24489455,24512824,0,0,0,23369
25282,24410317,24413070,24513867,0,0,2753,103550
25352,24485187,24485187,24514160,0,0,0,28973
25308,24426920,24426920,24515076,0,0,0,88156
25364,24501509,24501509,24515414,0,0,0,13905
25359,24492034,24492034,24517843,0,0,0,25809
25360,24492081,24492081,24518368,0,0,0,26287
25363,24500110,24500110,24521028,0,0,0,20918
25366,24502868,24502868,24523842,0,0,0,20974
25362,24498489,24498489,24525300,0,0,0,26811
25269,24404119,24404119,24525641,0,0,0,121522
25271,24404959,24404959,24527969,0,0,0,123010
25370,24508201,24508201,24528667,0,0,0,20466
25368,24505795,24505795,24528774,0,0,0,22979
25369,24508015,24508015,24530705,0,0,0,22690
25261,24402031,24402031,24530988,0,0,0,128957
25367,24505600,24505600,24531549,0,0,0,25949
25388,24531486,24531486,24531656,0,0,0,170
25389,24531593,24531593,24531764,0,0,0,171
25390,24531701,24531701,24531868,0,0,0,167
25371,24511561,24511561,24532067,0,0,0,20506
25372,24512780,24512780,24535694,0,0,0,22914
25377,24520982,24520982,24541875,0,0,0,20893
25373,24514106,24514106,24543486,0,0,0,29380
25375,24517788,24517788,24543968,0,0,0,26180
25396,24543908,24543908,24544066,0,0,0,158
25378,24523795,24523795,24544693,0,0,0,20898
25376,24518311,24518311,24545391,0,0,0,27080
25380,24528605,24528605,24548753,0,0,0,20148
25379,24525256,24525256,24552059,0,0,0,26803
25392,24532005,24532005,24552216,0,0,0,20211
25381,24528714,24528714,24552246,0,0,0,23532
25391,24531820,24531820,24558005,0,0,0,26185
25404,24557966,24557966,24558143,0,0,0,177
25405,24558076,24558076,24558242,0,0,0,166
25406,24558187,24558187,24558366,0,0,0,179
25393,24535649,24535649,24559127,0,0,0,23478
25386,24530642,24530642,24559478,0,0,0,28836
25407,24558305,24558305,24560085,0,0,0,1780
25394,24541817,24541817,24562366,0,0,0,20549
25398,24544631,24544631,24565175,0,0,0,20544
25400,24548691,24548691,24569267,0,0,0,20576
25397,24544017,24544017,24570252,0,0,0,26235
25414,24570189,24570189,24570359,0,0,0,170
25409,24559437,24559437,24570688,0,0,0,11251
25399,24545319,24545319,24572000,0,0,0,26681
25395,24543414,24543414,24572072,0,0,0,28658
25402,24552162,24552162,24572721,0,0,0,20559
25403,24552184,24552184,24576063,0,0,0,23879
25401,24551994,24551994,24578387,0,0,0,26393
25416,24570631,24570631,24581887,0,0,0,11256
25408,24559063,24559063,24582107,0,0,0,23044
25411,24562319,24562319,24583237,0,0,0,20918
25128,24325209,24325209,24584409,0,0,0,259200
25130,24326000,24326000,24585200,0,0,0,259200
25412,24565112,24565112,24586042,0,0,0,20930
25410,24560015,24560015,24586392,0,0,0,26377
25413,24569207,24569207,24589609,0,0,0,20402
25320,24443818,24450086,24589756,0,0,6268,145938
25157,24330975,24330975,24590175,0,0,0,259200
25344,24470374,24470374,24592044,0,0,0,121670
25419,24572662,24572662,24593112,0,0,0,20450
25179,24335641,24335641,24594841,0,0,0,259200
25415,24570296,24570296,24596313,0,0,0,26017
25374,24515020,24515020,24598336,0,0,0,83316
25417,24571947,24571947,24598595,0,0,0,26648
25420,24576001,24576001,24599661,0,0,0,23660
25418,24572015,24572015,24600626,0,0,0,28611
25433,24600569,24600569,24600721,0,0,0,152
25434,24600678,24600678,24600856,0,0,0,178
25435,24600785,24600785,24600954,0,0,0,169
25436,24600900,24600900,24601072,0,0,0,172
25424,24583174,24583174,24604030,0,0,0,20856
25421,24578330,24578330,24604853,0,0,0,26523
25423,24582048,24582048,24605583,0,0,0,23535
25425,24585985,24585985,24606808,0,0,0,20823
25427,24589569,24589569,24610062,0,0,0,20493
25422,24581844,24581844,24611739,0,0,0,29895
25426,24586336,24586336,24612338,0,0,0,26002
25428,24593043,24593043,24613533,0,0,0,20490
25210,24356756,24356756,24615956,0,0,0,259200
25448,24615855,24615855,24619390,0,0,0,3535
25449,24615912,24615912,24620022,0,0,0,4110
25429,24596250,24596250,24622314,0,0,0,26064
25450,24622271,24622271,24622449,0,0,0,178
25451,24622380,24622380,24622552,0,0,0,172
25452,24622497,24622497,24622665,0,0,0,168
25453,24622602,24622602,24622770,0,0,0,168
25454,24622708,24622708,24622998,0,0,0,290
25432,24599595,24599595,24623460,0,0,0,23865
25447,24615815,24615815,24623990,0,0,0,8175
25438,24603968,24603968,24624869,0,0,0,20901
25431,24598549,24598549,24625185,0,0,0,26636
25446,24615773,24615773,24625779,0,0,0,10006
25384,24530377,24530377,24626530,0,0,0,96153
25383,24530292,24530292,24626631,0,0,0,96339
25385,24530572,24530572,24627022,0,0,0,96450
25441,24606760,24606760,24627624,0,0,0,20864
25440,24605525,24605525,24629359,0,0,0,23834
25437,24601010,24601010,24630086,0,0,0,29076
25461,24630039,24630039,24630217,0,0,0,178
25462,24630151,24630151,24630317,0,0,0,166
25463,24630258,24630258,24630427,0,0,0,169
25442,24609995,24609995,24630499,0,0,0,20504
25464,24630369,24630369,24630537,0,0,0,168
25466,24630475,24630475,24630646,0,0,0,171
25439,24604786,24604786,24631286,0,0,0,26500
25387,24531040,24531040,24632855,0,0,0,101815
25445,24613471,24613471,24633976,0,0,0,20505
25444,24612269,24612269,24638642,0,0,0,26373
25443,24611677,24611677,24639707,0,0,0,28030
25457,24624812,24624812,24645975,0,0,0,21163
25456,24623393,24623393,24646442,0,0,0,23049
25459,24627585,24627585,24648504,0,0,0,20919
25455,24622954,24622954,24648980,0,0,0,26026
25475,24648913,24648913,24649080,0,0,0,167
25465,24630441,24630441,24651115,0,0,0,20674
25458,24625127,24625127,24651624,0,0,0,26497
25460,24629313,24629313,24652979,0,0,0,23666
25469,24633939,24633939,24654589,0,0,0,20650
25482,24657230,24657230,24657297,0,0,0,67
25481,24656890,24656890,24657399,0,0,0,509
25484,24657659,24657659,24657764,0,0,0,105
25468,24631228,24631228,24657903,0,0,0,26675
25485,24657834,24657834,24658092,0,0,0,258
25483,24657473,24657473,24658126,0,0,0,653
25486,24658023,24658023,24658164,0,0,0,141
25487,24658159,24658159,24658295,0,0,0,136
25488,24658382,24658382,24658449,0,0,0,67
25490,24658792,24658792,24658980,0,0,0,188
25491,24658918,24658918,24659012,0,0,0,94
25467,24630584,24630584,24659192,0,0,0,28608
25493,24659129,24659129,24659280,0,0,0,151
25495,24659231,24659231,24659413,0,0,0,182
25494,24659223,24659223,24659622,0,0,0,399
25489,24658468,24658468,24660239,0,0,0,1771
25497,24660133,24660133,24660521,0,0,0,388
25492,24658970,24658970,24661212,0,0,0,2242
25499,24660833,24660833,24661723,0,0,0,890
25500,24661279,24661279,24661911,0,0,0,632
25303,24419129,24419129,24661967,0,0,0,242838
25329,24455064,24455064,24661970,0,0,0,206906
25292,24416113,24416113,24661974,0,0,0,245861
25293,24416155,24416155,24661974,0,0,0,245819
25300,24418572,24418572,24661977,0,0,0,243405
25302,24419097,24419097,24661978,0,0,0,242881
25297,24417683,24418165,24662456,0,0,482,244773
25470,24638588,24638588,24664717,0,0,0,26129
25502,24662880,24662880,24665089,0,0,0,2209
25472,24645913,24645913,24666989,0,0,0,21076
25507,24667964,24667964,24668031,0,0,0,67
25509,24668113,24668113,24668149,0,0,0,36
25471,24639644,24639644,24669350,0,0,0,29706
25474,24648438,24648438,24669479,0,0,0,21041
25473,24646384,24646384,24670438,0,0,0,24054
25503,24663274,24663274,24670598,0,0,0,7324
25504,24663390,24663390,24670598,0,0,0,7208
25515,24671119,24671119,24671507,0,0,0,388
25477,24651054,24651054,24671658,0,0,0,20604
25518,24671800,24671800,24672276,0,0,0,476
25519,24672242,24672242,24672601,0,0,0,359
25513,24670120,24670120,24672641,0,0,0,2521
25521,24672553,24672553,24672672,0,0,0,119
25520,24672421,24672421,24672869,0,0,0,448
25476,24649025,24649025,24675060,0,0,0,26035
25480,24654528,24654528,24675158,0,0,0,20630
25527,24675013,24675013,24675185,0,0,0,172
25479,24652921,24652921,24676782,0,0,0,23861
25295,24417600,24417600,24676800,0,0,0,259200
25296,24417644,24417644,24676844,0,0,0,259200
25532,24676898,24676898,24677035,0,0,0,137
25530,24676056,24676056,24677143,0,0,0,1087
25298,24417733,24418165,24677365,0,0,432,259632
25299,24417773,24418165,24677365,0,0,392,259592
25478,24651553,24651553,24677817,0,0,0,26264
25535,24677949,24677949,24678009,0,0,0,60
25536,24677982,24677982,24678129,0,0,0,147
25544,24678773,24678773,24678858,0,0,0,85
25547,24679036,24679036,24679813,0,0,0,777
25542,24678236,24678236,24679844,0,0,0,1608
25549,24679969,24679969,24680031,0,0,0,62
25548,24679911,24679911,24680544,0,0,0,633
25539,24678082,24678082,24681544,0,0,0,3462
25534,24677898,24677898,24681664,0,0,0,3766
25553,24681624,24681624,24681810,0,0,0,186
25517,24671747,24671747,24682157,0,0,0,10410
25430,24598274,24598274,24682729,0,0,0,84455
25525,24672904,24672904,24684646,0,0,0,11742
25498,24660428,24660428,24687249,0,0,0,26821
25506,24666924,24666924,24687954,0,0,0,21030
25496,24659346,24659346,24688511,0,0,0,29165
25382,24529353,24529353,24689057,0,0,0,159704
25559,24689345,24689345,24689501,0,0,0,156
25512,24669413,24669413,24690426,0,0,0,21013
25501,24662636,24662636,24690463,0,0,0,27827
25554,24682236,24682236,24691024,0,0,0,8788
25516,24671595,24671595,24692080,0,0,0,20485
25514,24670376,24670376,24694000,0,0,0,23624
25562,24692661,24692661,24694718,0,0,0,2057
25528,24675084,24675084,24695495,0,0,0,20411
25511,24669287,24669287,24697337,0,0,0,28050
25567,24697290,24697290,24697467,0,0,0,177
25565,24696647,24696647,24697745,0,0,0,1098
25508,24668043,24668043,24698172,0,0,0,30129
25569,24698140,24698140,24698265,0,0,0,125
25566,24697262,24697262,24698484,0,0,0,1222
25531,24676720,24676720,24699809,0,0,0,23089
25523,24672609,24672609,24700212,0,0,0,27603
25573,24698695,24698695,24700484,0,0,0,1789
25545,24678828,24678828,24700822,0,0,0,21994
25529,24675127,24675127,24701521,0,0,0,26394
25365,24502139,24502139,24701570,0,0,0,199431
25576,24701567,24701567,24701598,0,0,0,31
25575,24701458,24701458,24701639,0,0,0,181
25533,24677733,24677733,24701661,0,0,0,23928
25568,24697404,24697404,24701665,0,0,0,4261
25556,24687194,24687194,24701670,0,0,0,14476
25558,24688456,24688456,24701670,0,0,0,13214
25522,24672587,24672587,24701941,0,0,0,29354
25537,24678063,24678063,24701948,0,0,0,23885
25526,24674521,24674521,24701981,0,0,0,27460
25551,24681487,24681487,24701981,0,0,0,20494
25552,24681611,24681611,24701981,0,0,0,20370
25541,24678124,24678124,24702038,0,0,0,23914
25555,24685660,24685660,24702095,0,0,0,16435
25505,24664649,24664649,24707849,0,0,0,43200
25557,24687894,24687894,24708668,0,0,0,20774
25584,24705346,24705346,24708946,0,0,0,3600
25581,24702389,24702389,24709531,0,0,0,7142
25560,24690390,24690390,24711193,0,0,0,20803
25561,24692012,24692012,24712560,0,0,0,20548
25564,24695423,24695423,24715989,0,0,0,20566
25563,24693934,24693934,24717800,0,0,0,23866
25574,24699739,24699739,24723762,0,0,0,24023
25585,24708620,24708620,24729636,0,0,0,21016
25586,24711124,24711124,24732080,0,0,0,20956
25587,24712505,24712505,24733001,0,0,0,20496
25588,24715936,24715936,24736435,0,0,0,20499
25595,24736495,24736495,24736555,0,0,0,60
25524,24672681,24672681,24737409,0,0,0,64728
25570,24698328,24698328,24738406,0,0,0,40078
25596,24738350,24738350,24738465,0,0,0,115
25597,24738482,24738482,24738576,0,0,0,94
25598,24739407,24739407,24739466,0,0,0,59
25361,24495971,24495971,24740483,0,0,0,244512
25589,24717746,24717746,24741592,0,0,0,23846
25599,24739457,24739457,24742438,0,0,0,2981
25578,24702207,24702207,24743586,0,0,0,41379
25603,24743516,24743516,24743786,0,0,0,270
25601,24743434,24743434,24743856,0,0,0,422
25606,24744304,24744304,24744397,0,0,0,93
25607,24744500,24744500,24744567,0,0,0,67
25602,24743462,24743462,24744699,0,0,0,1237
25604,24743523,24743523,24746600,0,0,0,3077
25611,24747328,24747328,24747388,0,0,0,60
25590,24723707,24723707,24747466,0,0,0,23759
25613,24747709,24747709,24747844,0,0,0,135
25608,24745257,24745257,24748651,0,0,0,3394
25605,24743743,24743743,24749096,0,0,0,5353
25620,24749303,24749303,24749551,0,0,0,248
25629,24749905,24749905,24750154,0,0,0,249
25591,24729596,24729596,24750617,0,0,0,21021
25577,24702176,24702176,24750618,0,0,0,48442
25630,24750560,24750560,24750664,0,0,0,104
25632,24750565,24750565,24750700,0,0,0,135
25614,24747928,24747928,24751528,0,0,0,3600
25592,24732028,24732028,24753073,0,0,0,21045
25593,24732958,24732958,24753425,0,0,0,20467
25641,24756020,24756020,24756198,0,0,0,178
25644,24756130,24756130,24756253,0,0,0,123
25645,24756144,24756144,24756309,0,0,0,165
25646,24756167,24756167,24756344,0,0,0,177
25647,24756257,24756257,24756426,0,0,0,169
25594,24736372,24736372,24756900,0,0,0,20528
25579,24702356,24702356,24758886,0,0,0,56530
25580,24702372,24702372,24758959,0,0,0,56587
25583,24702402,24702402,24758980,0,0,0,56578
25582,24702396,24702396,24758985,0,0,0,56589
25628,24749859,24749859,24758989,0,0,0,9130
25634,24750585,24750585,24759466,0,0,0,8881
25660,24760178,24760178,24760349,0,0,0,171
25658,24759523,24759523,24760689,0,0,0,1166
25656,24759075,24759075,24761515,0,0,0,2440
25657,24759439,24759439,24761626,0,0,0,2187
25654,24758911,24758911,24761668,0,0,0,2757
25655,24758927,24758927,24761728,0,0,0,2801
25676,24761727,24761727,24761821,0,0,0,94
25671,24761367,24761367,24761890,0,0,0,523
25662,24760882,24760882,24762382,0,0,0,1500
25664,24760967,24760967,24762467,0,0,0,1500
25665,24761025,24761025,24762525,0,0,0,1500
25666,24761112,24761112,24762612,0,0,0,1500
25668,24761182,24761182,24762682,0,0,0,1500
25673,24761563,24761563,24764657,0,0,0,3094
25661,24760255,24760255,24764701,0,0,0,4446
25672,24761454,24761454,24764714,0,0,0,3260
25652,24758836,24758836,24764730,0,0,0,5894
25653,24758886,24758886,24764744,0,0,0,5858
25675,24761684,24761684,24764763,0,0,0,3079
25674,24761630,24761630,24764769,0,0,0,3139
25692,24764866,24764866,24764996,0,0,0,130
25691,24764845,24764845,24765036,0,0,0,191
25693,24765008,24765008,24765176,0,0,0,168
25694,24765417,24765417,24765576,0,0,0,159
25600,24741524,24741524,24765685,0,0,0,24161
25697,24765760,24765760,24765915,0,0,0,155
25615,24748174,24748174,24766174,0,0,0,18000
25616,24748271,24748271,24766271,0,0,0,18000
25700,24766099,24766099,24766273,0,0,0,174
25617,24748313,24748313,24766313,0,0,0,18000
25618,24748341,24748341,24766341,0,0,0,18000
25705,24766788,24766788,24766881,0,0,0,93
25677,24761859,24761859,24766957,0,0,0,5098
25659,24759675,24759675,24767542,0,0,0,7867
25633,24750569,24750569,24767908,0,0,0,17339
25684,24764667,24764667,24768267,0,0,0,3600
25635,24750640,24750640,24768347,0,0,0,17707
25670,24761300,24761300,24769189,0,0,0,7889
25612,24747412,24747412,24771407,0,0,0,23995
25631,24750563,24750563,24771485,0,0,0,20922
25707,24770799,24770799,24773306,0,0,0,2507
25637,24753011,24753011,24773827,0,0,0,20816
25638,24753363,24753363,24773900,0,0,0,20537
25714,24775373,24775373,24775466,0,0,0,93
25711,24773366,24773366,24776966,0,0,0,3600
25651,24756837,24756837,24777091,0,0,0,20254
25706,24768325,24768325,24777174,0,0,0,8849
25636,24750764,24750764,24777866,0,0,0,27102
25669,24761197,24761197,24779197,0,0,0,18000
25648,24756276,24756276,24782834,0,0,0,26558
25716,24782778,24782778,24782951,0,0,0,173
25717,24782888,24782888,24783056,0,0,0,168
25718,24782994,24782994,24783163,0,0,0,169
25643,24756125,24756125,24783296,0,0,0,27171
25642,24756095,24756095,24783433,0,0,0,27338
25650,24756367,24756367,24783474,0,0,0,27107
25722,24783394,24783394,24783571,0,0,0,177
25723,24783507,24783507,24783673,0,0,0,166
25640,24755934,24755934,24784722,0,0,0,28788
25619,24748841,24748841,24784841,0,0,0,36000
25621,24749600,24749600,24785600,0,0,0,36000
25622,24749635,24749635,24785635,0,0,0,36000
25623,24749651,24749651,24785651,0,0,0,36000
25649,24756350,24756350,24785769,0,0,0,29419
25727,24785757,24785757,24786023,0,0,0,266
25728,24786381,24786381,24786463,0,0,0,82
25729,24786431,24786431,24786525,0,0,0,94
25730,24786807,24786807,24786962,0,0,0,155
25732,24787309,24787309,24787402,0,0,0,93
25733,24787835,24787835,24787908,0,0,0,73
25571,24698486,24698486,24789238,0,0,0,90752
25696,24765629,24765629,24789591,0,0,0,23962
25734,24788264,24788264,24790149,0,0,0,1885
25736,24790387,24790387,24790480,0,0,0,93
25709,24771446,24771446,24792071,0,0,0,20625
25737,24790541,24790541,24792901,0,0,0,2360
25713,24773853,24773853,24794375,0,0,0,20522
25712,24773763,24773763,24794378,0,0,0,20615
25609,24746201,24746201,24794966,0,0,0,48765
25708,24771354,24771354,24795237,0,0,0,23883
25731,24787131,24787131,24796124,0,0,0,8993
25715,24777028,24777028,24797524,0,0,0,20496
25572,24698628,24698628,24799122,0,0,0,100494
25510,24668147,24668147,24800879,0,0,0,132732
25724,24783617,24783617,24809635,0,0,0,26018
25719,24783101,24783101,24809698,0,0,0,26597
25720,24783235,24783235,24809728,0,0,0,26493
25721,24783387,24783387,24810015,0,0,0,26628
25738,24792010,24792010,24812906,0,0,0,20896
25725,24784659,24784659,24813196,0,0,0,28537
25735,24789591,24789591,24813281,0,0,0,23690
25748,24813128,24813128,24813305,0,0,0,177
25750,24813247,24813247,24813418,0,0,0,171
25739,24794302,24794302,24814635,0,0,0,20333
25726,24785706,24785706,24814895,0,0,0,29189
25740,24794337,24794337,24815188,0,0,0,20851
25742,24797489,24797489,24817848,0,0,0,20359
25741,24795174,24795174,24819196,0,0,0,24022
25757,24823591,24823591,24823695,0,0,0,104
25759,24825143,24825143,24825396,0,0,0,253
25758,24823697,24823697,24825785,0,0,0,2088
25683,24764650,24764650,24826532,0,0,0,61882
25685,24764671,24764671,24826618,0,0,0,61947
25686,24764682,24764682,24826629,0,0,0,61947
25687,24764692,24764692,24826685,0,0,0,61993
25688,24764720,24764720,24826704,0,0,0,61984
25689,24764731,24764731,24826715,0,0,0,61984
25690,24764744,24764744,24826759,0,0,0,62015
25769,24827245,24827245,24827556,0,0,0,311
25770,24827587,24827587,24828285,0,0,0,698
25772,24828175,24828175,24828618,0,0,0,443
25773,24828328,24828328,24828866,0,0,0,538
25775,24828427,24828427,24829019,0,0,0,592
25776,24828491,24828491,24829154,0,0,0,663
25787,24832305,24832305,24832398,0,0,0,93
25747,24812842,24812842,24833616,0,0,0,20774
25752,24814579,24814579,24835120,0,0,0,20541
25743,24809575,24809575,24835563,0,0,0,25988
25754,24815143,24815143,24835892,0,0,0,20749
25744,24809646,24809646,24836214,0,0,0,26568
25746,24809954,24809954,24836315,0,0,0,26361
25794,24836172,24836172,24836345,0,0,0,173
25745,24809666,24809666,24836421,0,0,0,26755
25749,24813230,24813230,24836923,0,0,0,23693
25755,24817789,24817789,24838286,0,0,0,20497
25765,24826677,24826677,24838629,0,0,0,11952
25767,24826736,24826736,24838629,0,0,0,11893
25768,24826759,24826759,24838660,0,0,0,11901
25786,24831470,24831470,24838781,0,0,0,7311
25785,24831059,24831059,24838784,0,0,0,7725
25760,24825239,24825239,24840797,0,0,0,15558
25751,24813358,24813358,24841759,0,0,0,28401
25810,24842736,24842736,24842766,0,0,0,30
25756,24819129,24819129,24843043,0,0,0,23914
25811,24842962,24842962,24843110,0,0,0,148
25807,24840566,24840566,24844456,0,0,0,3890
25753,24814833,24814833,24844607,0,0,0,29774
25816,24844538,24844538,24844612,0,0,0,74
25819,24844626,24844626,24844712,0,0,0,86
25804,24838565,24838565,24846168,0,0,0,7603
25774,24828405,24828405,24846405,0,0,0,18000
25771,24827943,24827943,24846681,0,0,0,18738
25610,24746599,24746599,24847037,0,0,0,100438
25830,24848150,24848150,24848495,0,0,0,345
25832,24848812,24848812,24848886,0,0,0,74
25806,24838587,24838587,24848940,0,0,0,10353
25805,24838579,24838579,24848943,0,0,0,10364
25824,24846106,24846106,24848952,0,0,0,2846
25835,24849035,24849035,24849128,0,0,0,93
25836,24849271,24849271,24849365,0,0,0,94
25837,24849392,24849392,24849702,0,0,0,310
25838,24849674,24849674,24849830,0,0,0,156
25788,24832421,24832421,24850421,0,0,0,18000
25831,24848298,24848298,24850919,0,0,0,2621
25840,24851049,24851049,24851122,0,0,0,73
25827,24846566,24846566,24851550,0,0,0,4984
25839,24850168,24850168,24851640,0,0,0,1472
25841,24851239,24851239,24851870,0,0,0,631
25550,24681257,24681257,24852010,0,0,0,170753
25842,24851884,24851884,24852368,0,0,0,484
25846,24852336,24852336,24852398,0,0,0,62
25843,24851896,24851896,24852399,0,0,0,503
25833,24848827,24848827,24852427,0,0,0,3600
25845,24851918,24851918,24852428,0,0,0,510
25844,24851906,24851906,24852493,0,0,0,587
25789,24833556,24833556,24854466,0,0,0,20910
25790,24835057,24835057,24855511,0,0,0,20454
25828,24847010,24847010,24855665,0,0,0,8655
25859,24855477,24855477,24855942,0,0,0,465
25829,24847045,24847045,24856420,0,0,0,9375
25834,24849025,24849025,24856428,0,0,0,7403
25793,24835825,24835825,24856719,0,0,0,20894
25853,24853134,24853134,24856722,0,0,0,3588
25854,24853564,24853564,24856759,0,0,0,3195
25866,24857456,24857456,24857777,0,0,0,321
25803,24838223,24838223,24858605,0,0,0,20382
25766,24826709,24826709,24858793,0,0,0,32084
25814,24843267,24843267,24858795,0,0,0,15528
25817,24844541,24844541,24858795,0,0,0,14254
25849,24852529,24852529,24858795,0,0,0,6266
25860,24856678,24856678,24858795,0,0,0,2117
25879,24858764,24858764,24858795,0,0,0,31
25862,24856679,24856679,24858796,0,0,0,2117
25864,24856690,24856690,24858796,0,0,0,2106
25825,24846490,24846490,24858797,0,0,0,12307
25857,24855431,24855431,24858797,0,0,0,3366
25781,24829076,24829076,24858798,0,0,0,29722
25871,24858018,24858018,24858798,0,0,0,780
25851,24852576,24852576,24858800,0,0,0,6224
25808,24841695,24841695,24858801,0,0,0,17106
25847,24852513,24852513,24858801,0,0,0,6288
25867,24857720,24857720,24858801,0,0,0,1081
25873,24858032,24858032,24858801,0,0,0,769
25877,24858563,24858563,24858802,0,0,0,239
25777,24829021,24829021,24858803,0,0,0,29782
25791,24835502,24835502,24858803,0,0,0,23301
25799,24836379,24836379,24858803,0,0,0,22424
25820,24844680,24844680,24858803,0,0,0,14123
25822,24845439,24845439,24858803,0,0,0,13364
25869,24857930,24857930,24858803,0,0,0,873
25875,24858067,24858067,24858803,0,0,0,736
25779,24829050,24829050,24858804,0,0,0,29754
25783,24829546,24829546,24858804,0,0,0,29258
25795,24836232,24836232,24858804,0,0,0,22572
25797,24836286,24836286,24858804,0,0,0,22518
25801,24836870,24836870,24858804,0,0,0,21934
25812,24842985,24842985,24858804,0,0,0,15819
25855,24854404,24854404,24858804,0,0,0,4400
25762,24826520,24826520,24858871,0,0,0,32351
25763,24826596,24826596,24858912,0,0,0,32316
25764,24826621,24826621,24858913,0,0,0,32292
25861,24856678,24856678,24859027,0,0,0,2349
25874,24858032,24858032,24859033,0,0,0,1001
25865,24856690,24856690,24859121,0,0,0,2431
25885,24860118,24860118,24860258,0,0,0,140
25667,24761120,24761120,24860987,0,0,0,99867
25802,24836870,24836870,24861074,0,0,0,24204
25815,24843267,24843267,24861267,0,0,0,18000
25868,24857720,24857720,24861610,0,0,0,3890
25792,24835502,24835502,24861749,0,0,0,26247
25887,24861687,24861687,24861977,0,0,0,290
25888,24861906,24861906,24862165,0,0,0,259
25798,24836286,24836286,24862285,0,0,0,25999
25821,24844680,24844680,24862680,0,0,0,18000
25796,24836232,24836232,24862747,0,0,0,26515
25800,24836379,24836379,24862831,0,0,0,26452
25823,24845439,24845439,24863439,0,0,0,18000
25826,24846490,24846490,24864490,0,0,0,18000
25893,24864633,24864633,24864727,0,0,0,94
25678,24762761,24762761,24864872,0,0,0,102111
25663,24760917,24760917,24864935,0,0,0,104018
25894,24864942,24864942,24865006,0,0,0,64
25813,24842985,24842985,24866686,0,0,0,23701
25809,24841695,24841695,24869510,0,0,0,27815
25901,24872065,24872065,24872125,0,0,0,60
25899,24871366,24871366,24872655,0,0,0,1289
25626,24749707,24749707,24873399,0,0,0,123692
25818,24844541,24844541,24873879,0,0,0,29338
25856,24854404,24854404,24875213,0,0,0,20809
25900,24871851,24871851,24875265,0,0,0,3414
25858,24855431,24855431,24875530,0,0,0,20099
25680,24763048,24763048,24876897,0,0,0,113849
25863,24856679,24856679,24877473,0,0,0,20794
25679,24762994,24762994,24877910,0,0,0,114916
25872,24858018,24858018,24878436,0,0,0,20418
25878,24858563,24858563,24878676,0,0,0,20113
25540,24678090,24678090,24882560,0,0,0,204470
25886,24861012,24861012,24884743,0,0,0,23731
25681,24763107,24763107,24884949,0,0,0,121842
25852,24852576,24852576,24887365,0,0,0,34789
25889,24862131,24862131,24888040,0,0,0,25909
25890,24862223,24862223,24888176,0,0,0,25953
25909,24888133,24888133,24888310,0,0,0,177
25682,24763174,24763174,24888439,0,0,0,125265
25908,24887994,24887994,24888689,0,0,0,695
25911,24888648,24888648,24889321,0,0,0,673
25891,24862680,24862680,24889410,0,0,0,26730
25892,24862772,24862772,24889511,0,0,0,26739
25639,24755502,24755502,24889790,0,0,0,134288
25912,24889283,24889283,24889987,0,0,0,704
25897,24866624,24866624,24890371,0,0,0,23747
25848,24852513,24852513,24892580,0,0,0,40067
25850,24852529,24852529,24893329,0,0,0,40800
25624,24749668,24749668,24893668,0,0,0,144000
25625,24749687,24749687,24893687,0,0,0,144000
25627,24749721,24749721,24893721,0,0,0,144000
25903,24875150,24875150,24895644,0,0,0,20494
25904,24875474,24875474,24896026,0,0,0,20552
25702,24766180,24766180,24897280,0,0,0,131100
25896,24865050,24865050,24897556,0,0,0,32506
25905,24877409,24877409,24897942,0,0,0,20533
25898,24869450,24869450,24898667,0,0,0,29217
25920,24898590,24898590,24898770,0,0,0,180
25701,24766102,24766102,24899171,0,0,0,133069
25906,24878615,24878615,24899184,0,0,0,20569
25902,24873825,24873825,24903535,0,0,0,29710
25870,24857930,24857930,24905127,0,0,0,47197
25907,24884678,24884678,24908376,0,0,0,23698
25704,24766241,24766241,24908987,0,0,0,142746
25703,24766210,24766210,24909693,0,0,0,143483
25925,24910026,24910026,24910093,0,0,0,67
25926,24910130,24910130,24910378,0,0,0,248
25927,24910421,24910421,24910494,0,0,0,73
25928,24910459,24910459,24910552,0,0,0,93
25695,24765481,24765481,24911525,0,0,0,146044
25931,24911583,24911583,24911656,0,0,0,73
25930,24911330,24911330,24911899,0,0,0,569
25932,24911960,24911960,24912054,0,0,0,94
25929,24910620,24910620,24912237,0,0,0,1617
25933,24912328,24912328,24912401,0,0,0,73
25934,24912696,24912696,24912770,0,0,0,74
25937,24913279,24913279,24913346,0,0,0,67
25916,24890300,24890300,24914488,0,0,0,24188
25910,24888244,24888244,24914491,0,0,0,26247
25943,24914449,24914449,24914812,0,0,0,363
25913,24889349,24889349,24915942,0,0,0,26593
25914,24889457,24889457,24916046,0,0,0,26589
25918,24895964,24895964,24916122,0,0,0,20158
25915,24889921,24889921,24916503,0,0,0,26582
25917,24895581,24895581,24916508,0,0,0,20927
25950,24916472,24916472,24916604,0,0,0,132
25948,24916421,24916421,24916608,0,0,0,187
25952,24916551,24916551,24916673,0,0,0,122
25951,24916524,24916524,24916677,0,0,0,153
25955,24916677,24916677,24916781,0,0,0,104
25883,24858870,24858870,24916897,0,0,0,58027
25882,24858854,24858854,24916923,0,0,0,58069
25881,24858828,24858828,24916929,0,0,0,58101
25880,24858764,24858764,24916951,0,0,0,58187
25963,24917304,24917304,24917398,0,0,0,94
25940,24914151,24914151,24917581,0,0,0,3430
25876,24858067,24858067,24917855,0,0,0,59788
25884,24859018,24859018,24917929,0,0,0,58911
25966,24918657,24918657,24918905,0,0,0,248
25919,24897889,24897889,24919050,0,0,0,21161
25922,24899122,24899122,24919322,0,0,0,20200
25970,24919347,24919347,24919440,0,0,0,93
25972,24921316,24921316,24921415,0,0,0,99
25973,24921496,24921496,24921589,0,0,0,93
25969,24919290,24919290,24921661,0,0,0,2371
25974,24921659,24921659,24921775,0,0,0,116
25975,24921747,24921747,24921841,0,0,0,94
25976,24921925,24921925,24922018,0,0,0,93
25977,24923079,24923079,24923160,0,0,0,81
25978,24923128,24923128,24923190,0,0,0,62
25979,24923637,24923637,24923700,0,0,0,63
25980,24923751,24923751,24923855,0,0,0,104
25981,24923855,24923855,24923948,0,0,0,93
25985,24927179,24927179,24927290,0,0,0,111
25987,24927296,24927296,24927391,0,0,0,95
25989,24927390,24927390,24927461,0,0,0,71
25698,24766040,24766040,24927463,0,0,0,161423
25990,24927416,24927416,24928406,0,0,0,990
25921,24898699,24898699,24928476,0,0,0,29777
25992,24928443,24928443,24928589,0,0,0,146
25964,24917794,24917794,24928705,0,0,0,10911
25993,24928548,24928548,24928736,0,0,0,188
25965,24917863,24917863,24928774,0,0,0,10911
25959,24916888,24916888,24929100,0,0,0,12212
25956,24916864,24916864,24929214,0,0,0,12350
25958,24916880,24916880,24929260,0,0,0,12380
25957,24916870,24916870,24929261,0,0,0,12391
26002,24929653,24929653,24929746,0,0,0,93
26003,24930224,24930224,24930318,0,0,0,94
26004,24930330,24930330,24930424,0,0,0,94
25991,24927544,24927544,24930621,0,0,0,3077
25935,24912729,24912729,24930729,0,0,0,18000
26005,24930576,24930576,24930878,0,0,0,302
26006,24930777,24930777,24930905,0,0,0,128
25936,24913153,24913153,24931153,0,0,0,18000
26008,24931065,24931065,24931182,0,0,0,117
26010,24931186,24931186,24931292,0,0,0,106
26011,24931269,24931269,24931363,0,0,0,94
26009,24931088,24931088,24931435,0,0,0,347
26013,24931466,24931466,24931581,0,0,0,115
26014,24931542,24931542,24931783,0,0,0,241
26015,24931760,24931760,24931854,0,0,0,94
25924,24908317,24908317,24932121,0,0,0,23804
25923,24903473,24903473,24932247,0,0,0,28774
25941,24914375,24914375,24932375,0,0,0,18000
25939,24913672,24913672,24932515,0,0,0,18843
25971,24919501,24919501,24932519,0,0,0,13018
26017,24932131,24932131,24932830,0,0,0,699
26012,24931395,24931395,24932925,0,0,0,1530
26019,24932943,24932943,24934153,0,0,0,1210
25994,24928653,24928653,24934372,0,0,0,5719
25996,24928709,24928709,24934386,0,0,0,5677
25953,24916570,24916570,24934570,0,0,0,18000
26025,24934428,24934428,24935125,0,0,0,697
26026,24934440,24934440,24935126,0,0,0,686
26027,24934448,24934448,24935154,0,0,0,706
25761,24825754,24825754,24935318,0,0,0,109564
25947,24916061,24916061,24935959,0,0,0,19898
26029,24936371,24936371,24936477,0,0,0,106
25949,24916465,24916465,24936928,0,0,0,20463
26033,24937035,24937035,24937191,0,0,0,156
25538,24678080,24678080,24937280,0,0,0,259200
25543,24678312,24678312,24937512,0,0,0,259200
26022,24934327,24934327,24937861,0,0,0,3534
26023,24934349,24934349,24937923,0,0,0,3574
26020,24934170,24934170,24938016,0,0,0,3846
25942,24914423,24914423,24938112,0,0,0,23689
25546,24678962,24678962,24938162,0,0,0,259200
25968,24919277,24919277,24939118,0,0,0,19841
25967,24918989,24918989,24939444,0,0,0,20455
26040,24939496,24939496,24939526,0,0,0,30
26034,24937826,24937826,24939894,0,0,0,2068
26035,24937861,24937861,24939928,0,0,0,2067
26024,24934388,24934388,24940651,0,0,0,6263
26043,24939865,24939865,24940833,0,0,0,968
26042,24939846,24939846,24940858,0,0,0,1012
25944,24914774,24914774,24941214,0,0,0,26440
26046,24941153,24941153,24941326,0,0,0,173
26050,24941712,24941712,24941788,0,0,0,76
26051,24941725,24941725,24941867,0,0,0,142
25945,24915879,24915879,24942250,0,0,0,26371
25946,24916000,24916000,24942798,0,0,0,26798
25954,24916632,24916632,24942900,0,0,0,26268
26057,24942856,24942856,24943039,0,0,0,183
26041,24939649,24939649,24943064,0,0,0,3415
26021,24934303,24934303,24943625,0,0,0,9322
26055,24942416,24942416,24946025,0,0,0,3609
25938,24913522,24913522,24946117,0,0,0,32595
25998,24929104,24929104,24947104,0,0,0,18000
25960,24917011,24917011,24947593,0,0,0,30582
25961,24917103,24917103,24947669,0,0,0,30566
25962,24917162,24917162,24947671,0,0,0,30509
26030,24936463,24936463,24947978,0,0,0,11515
25982,24926667,24926667,24948009,0,0,0,21342
25895,24864976,24864976,24948011,0,0,0,83035
25986,24927269,24927269,24948011,0,0,0,20742
25699,24766073,24766073,24948012,0,0,0,181939
25983,24927029,24927029,24948012,0,0,0,20983
25984,24927178,24927178,24948012,0,0,0,20834
25988,24927364,24927364,24948012,0,0,0,20648
26036,24938037,24938037,24948012,0,0,0,9975
26052,24942159,24942159,24948012,0,0,0,5853
26060,24946614,24946614,24948032,0,0,0,1418
26054,24942214,24942214,24948099,0,0,0,5885
26016,24932059,24932059,24956097,0,0,0,24038
26028,24935897,24935897,24956128,0,0,0,20231
25995,24928666,24928666,24957065,0,0,0,28399
26032,24936883,24936883,24957101,0,0,0,20218
26076,24957543,24957543,24957792,0,0,0,249
26038,24939055,24939055,24959286,0,0,0,20231
26048,24941400,24941400,24959400,0,0,0,18000
26049,24941438,24941438,24959438,0,0,0,18000
25784,24829546,24829546,24959445,0,0,0,129899
26039,24939399,24939399,24959627,0,0,0,20228
26007,24930795,24930795,24961252,0,0,0,30457
26037,24938069,24938069,24961718,0,0,0,23649
26018,24932184,24932184,24962071,0,0,0,29887
26081,24962007,24962007,24962182,0,0,0,175
26084,24962823,24962823,24962916,0,0,0,93
25778,24829021,24829021,24965980,0,0,0,136959
26083,24962722,24962722,24966290,0,0,0,3568
25782,24829076,24829076,24966486,0,0,0,137410
26047,24941264,24941264,24967605,0,0,0,26341
26087,24967541,24967541,24967708,0,0,0,167
26053,24942177,24942177,24968869,0,0,0,26692
26059,24942968,24942968,24969257,0,0,0,26289
26090,24969203,24969203,24969375,0,0,0,172
26056,24942735,24942735,24969456,0,0,0,26721
26091,24969312,24969312,24969489,0,0,0,177
26093,24969420,24969420,24969590,0,0,0,170
26094,24969535,24969535,24969701,0,0,0,166
25780,24829050,24829050,24969794,0,0,0,140744
26031,24936583,24936583,24973801,0,0,0,37218
26073,24956065,24956065,24976684,0,0,0,20619
26075,24957040,24957040,24977696,0,0,0,20656
26077,24957897,24957897,24979566,0,0,0,21669
26072,24956036,24956036,24979824,0,0,0,23788
26078,24959226,24959226,24979824,0,0,0,20598
26079,24959566,24959566,24980214,0,0,0,20648
26080,24961657,24961657,24985460,0,0,0,23803
26074,24956990,24956990,24985943,0,0,0,28953
26063,24947608,24947608,24988634,0,0,0,41026
26082,24962121,24962121,24991418,0,0,0,29297
26061,24947539,24947539,24991634,0,0,0,44095
26088,24967647,24967647,24993837,0,0,0,26190
26089,24968827,24968827,24995856,0,0,0,27029
26095,24969654,24969654,24995904,0,0,0,26250
26092,24969384,24969384,24995939,0,0,0,26555
26062,24947592,24947592,24996095,0,0,0,48503
26096,24976623,24976623,24996650,0,0,0,20027
25710,24772998,24772998,24997470,0,0,0,224472
26097,24977633,24977633,24998640,0,0,0,21007
26098,24979783,24979783,24999876,0,0,0,20093
26114,24999752,24999752,25000997,0,0,0,1245
26118,25000567,25000567,25001033,0,0,0,466
26100,24980152,24980152,25001168,0,0,0,21016
26001,24929213,24929213,25002842,0,0,0,73629
26044,24940785,24940785,25002930,0,0,0,62145
26045,24940796,24940796,25002930,0,0,0,62134
26099,24979784,24979784,25003477,0,0,0,23693
26000,24929208,24929208,25003575,0,0,0,74367
25999,24929147,24929147,25003576,0,0,0,74429
25997,24929067,24929067,25003580,0,0,0,74513
26122,25003837,25003837,25003905,0,0,0,68
26124,25004404,25004404,25004472,0,0,0,68
26125,25004526,25004526,25004594,0,0,0,68
26126,25004607,25004607,25004737,0,0,0,130
26127,25004647,25004647,25004737,0,0,0,90
26128,25004680,25004680,25004769,0,0,0,89
26129,25004688,25004688,25004777,0,0,0,89
26130,25004734,25004734,25004826,0,0,0,92
26131,25004834,25004834,25004927,0,0,0,93
26132,25005033,25005033,25005126,0,0,0,93
26133,25005297,25005297,25005390,0,0,0,93
26134,25005637,25005637,25005741,0,0,0,104
26136,25006459,25006459,25006568,0,0,0,109
26137,25006537,25006537,25006630,0,0,0,93
26138,25006655,25006655,25006749,0,0,0,94
26123,25004216,25004216,25007457,0,0,0,3241
26186,25008811,25008811,25008904,0,0,0,93
26187,25009070,25009070,25009219,0,0,0,149
26188,25009189,25009189,25009283,0,0,0,94
26120,25002284,25002284,25009345,0,0,0,7061
26101,24985388,24985388,25009462,0,0,0,24074
26190,25009413,25009413,25009590,0,0,0,177
26184,25007650,25007650,25009619,0,0,0,1969
26192,25009433,25009433,25009723,0,0,0,290
26194,25010813,25010813,25010912,0,0,0,99
26191,25009414,25009414,25011032,0,0,0,1618
26195,25011034,25011034,25011113,0,0,0,79
26196,25011351,25011351,25011443,0,0,0,92
26197,25011357,25011357,25012150,0,0,0,793
26198,25011381,25011381,25012186,0,0,0,805
26203,25013037,25013037,25013136,0,0,0,99
26199,25011622,25011622,25013784,0,0,0,2162
26205,25013875,25013875,25013942,0,0,0,67
26102,24985881,24985881,25015251,0,0,0,29370
26207,25015188,25015188,25015357,0,0,0,169
26111,24997366,24997366,25015366,0,0,0,18000
26112,24997432,24997432,25015432,0,0,0,18000
26208,25015295,25015295,25015468,0,0,0,173
26209,25015404,25015404,25015565,0,0,0,161
26210,25015517,25015517,25015699,0,0,0,182
26211,25015626,25015626,25015705,0,0,0,79
26213,25015741,25015741,25015834,0,0,0,93
26201,25012691,25012691,25016116,0,0,0,3425
26214,25016181,25016181,25016260,0,0,0,79
26217,25016314,25016314,25016407,0,0,0,93
26216,25016290,25016290,25016438,0,0,0,148
26215,25016234,25016234,25016496,0,0,0,262
26218,25016579,25016579,25016964,0,0,0,385
26109,24996579,24996579,25017014,0,0,0,20435
26220,25016770,25016770,25017222,0,0,0,452
26223,25017439,25017439,25017905,0,0,0,466
26224,25018111,25018111,25018258,0,0,0,147
26225,25018512,25018512,25018729,0,0,0,217
26113,24998596,24998596,25019005,0,0,0,20409
26227,25019169,25019169,25019564,0,0,0,395
26228,25019522,25019522,25019575,0,0,0,53
26230,25019574,25019574,25019641,0,0,0,67
26229,25019534,25019534,25019693,0,0,0,159
26231,25019695,25019695,25019830,0,0,0,135
26185,25008480,25008480,25019924,0,0,0,11444
26104,24993776,24993776,25020002,0,0,0,26226
26233,25019938,25019938,25020128,0,0,0,190
26115,24999813,24999813,25020357,0,0,0,20544
26239,25020539,25020539,25021165,0,0,0,626
26103,24991373,24991373,25021265,0,0,0,29892
26244,25020911,25020911,25021361,0,0,0,450
26232,25019815,25019815,25021387,0,0,0,1572
26241,25020832,25020832,25021425,0,0,0,593
26240,25020825,25020825,25021429,0,0,0,604
26243,25020845,25020845,25021449,0,0,0,604
26119,25001126,25001126,25021546,0,0,0,20420
26234,25020032,25020032,25021556,0,0,0,1524
26235,25020044,25020044,25021608,0,0,0,1564
26236,25020056,25020056,25021608,0,0,0,1552
26248,25021521,25021521,25021641,0,0,0,120
26107,24995862,24995862,25022057,0,0,0,26195
26206,25014745,25014745,25022211,0,0,0,7466
26249,25022019,25022019,25022213,0,0,0,194
26246,25021498,25021498,25022394,0,0,0,896
26254,25022293,25022293,25022419,0,0,0,126
26106,24995822,24995822,25022422,0,0,0,26600
26108,24995868,24995868,25022554,0,0,0,26686
26257,25022375,25022375,25022820,0,0,0,445
26263,25022651,25022651,25023104,0,0,0,453
26268,25023706,25023706,25023830,0,0,0,124
26266,25023657,25023657,25024124,0,0,0,467
26270,25024150,25024150,25024223,0,0,0,73
26271,25025531,25025531,25025624,0,0,0,93
26193,25009629,25009629,25025710,0,0,0,16081
26273,25025906,25025906,25025999,0,0,0,93
26272,25025833,25025833,25026298,0,0,0,465
26275,25026920,25026920,25027038,0,0,0,118
26121,25003425,25003425,25027068,0,0,0,23643
26276,25026995,25026995,25027099,0,0,0,104
26242,25020844,25020844,25027231,0,0,0,6387
26200,25011649,25011649,25027944,0,0,0,16295
26279,25028092,25028092,25028196,0,0,0,104
26280,25028159,25028159,25028287,0,0,0,128
26281,25028262,25028262,25028387,0,0,0,125
26282,25028574,25028574,25028715,0,0,0,141
26283,25028693,25028693,25028798,0,0,0,105
26284,25028761,25028761,25028854,0,0,0,93
26285,25028915,25028915,25029042,0,0,0,127
26287,25029010,25029010,25029135,0,0,0,125
26288,25029138,25029138,25029262,0,0,0,124
26289,25029281,25029281,25029406,0,0,0,125
26290,25029526,25029526,25029599,0,0,0,73
26291,25029600,25029600,25029704,0,0,0,104
26135,25006281,25006281,25030729,0,0,0,24448
26293,25032613,25032613,25032687,0,0,0,74
26294,25032615,25032615,25032689,0,0,0,74
26286,25028916,25028916,25033057,0,0,0,4141
26189,25009379,25009379,25033169,0,0,0,23790
26221,25016964,25016964,25037354,0,0,0,20390
26219,25016653,25016653,25038317,0,0,0,21664
26226,25018944,25018944,25039778,0,0,0,20834
26238,25020289,25020289,25040748,0,0,0,20459
26301,25039567,25039567,25041204,0,0,0,1637
26222,25017035,25017035,25041362,0,0,0,24327
26274,25026019,25026019,25042138,0,0,0,16119
26247,25021514,25021514,25042344,0,0,0,20830
26292,25030507,25030507,25042402,0,0,0,11895
26278,25027200,25027200,25043347,0,0,0,16147
26212,25015632,25015632,25044456,0,0,0,28824
26308,25044410,25044410,25044564,0,0,0,154
26116,25000504,25000504,25044702,0,0,0,44198
26309,25044527,25044527,25044704,0,0,0,177
26237,25020058,25020058,25046258,0,0,0,26200
26250,25022140,25022140,25048388,0,0,0,26248
26256,25022371,25022371,25049086,0,0,0,26715
26261,25022518,25022518,25049157,0,0,0,26639
26117,25000548,25000548,25050020,0,0,0,49472
26311,25046201,25046201,25050464,0,0,0,4263
26245,25021205,25021205,25050679,0,0,0,29474
26319,25050616,25050616,25050789,0,0,0,173
26320,25050726,25050726,25050908,0,0,0,182
26277,25027000,25027000,25050933,0,0,0,23933
26163,25007124,25007124,25053734,0,0,0,46610
26152,25007119,25007119,25053960,0,0,0,46841
26169,25007126,25007126,25054139,0,0,0,47013
26147,25007118,25007118,25054207,0,0,0,47089
26165,25007125,25007125,25054231,0,0,0,47106
26153,25007119,25007119,25054239,0,0,0,47120
26166,25007125,25007125,25054418,0,0,0,47293
26173,25007127,25007127,25054451,0,0,0,47324
26157,25007120,25007120,25054458,0,0,0,47338
26158,25007120,25007120,25054520,0,0,0,47400
26159,25007120,25007120,25054582,0,0,0,47462
26167,25007125,25007125,25054604,0,0,0,47479
26154,25007119,25007119,25054612,0,0,0,47493
26164,25007124,25007124,25054634,0,0,0,47510
26155,25007119,25007119,25054674,0,0,0,47555
26160,25007120,25007120,25054706,0,0,0,47586
26161,25007120,25007120,25054737,0,0,0,47617
26148,25007118,25007118,25054766,0,0,0,47648
26168,25007125,25007125,25054790,0,0,0,47665
26142,25007117,25007117,25054796,0,0,0,47679
26143,25007117,25007117,25054951,0,0,0,47834
26144,25007117,25007117,25054982,0,0,0,47865
26149,25007118,25007118,25055045,0,0,0,47927
26162,25007120,25007120,25055109,0,0,0,47989
26139,25007116,25007116,25055136,0,0,0,48020
26170,25007126,25007126,25055163,0,0,0,48037
26174,25007127,25007127,25055164,0,0,0,48037
26140,25007116,25007116,25055229,0,0,0,48113
26150,25007118,25007118,25055231,0,0,0,48113
26145,25007117,25007117,25055427,0,0,0,48310
26317,25050419,25050419,25055589,0,0,0,5170
26171,25007126,25007126,25055663,0,0,0,48537
26323,25055530,25055530,25055698,0,0,0,168
26141,25007116,25007116,25055760,0,0,0,48644
26146,25007117,25007117,25056040,0,0,0,48923
26151,25007118,25007118,25056258,0,0,0,49140
26172,25007126,25007126,25056593,0,0,0,49467
26298,25033114,25033114,25056782,0,0,0,23668
26300,25037295,25037295,25057486,0,0,0,20191
26305,25042091,25042091,25057864,0,0,0,15773
26304,25041847,25041847,25057942,0,0,0,16095
26307,25043288,25043288,25059343,0,0,0,16055
26302,25039714,25039714,25060530,0,0,0,20816
26303,25040691,25040691,25060931,0,0,0,20240
26306,25042282,25042282,25063108,0,0,0,20826
26312,25047760,25047760,25063597,0,0,0,15837
26058,24942866,24942866,25070751,0,0,0,127885
26327,25057826,25057826,25073781,0,0,0,15955
26310,25044635,25044635,25073894,0,0,0,29259
26328,25057875,25057875,25073929,0,0,0,16054
26334,25073829,25073829,25074007,0,0,0,178
26322,25050871,25050871,25074077,0,0,0,23206
26336,25073938,25073938,25074108,0,0,0,170
26313,25048323,25048323,25074557,0,0,0,26234
26339,25074493,25074493,25074752,0,0,0,259
26340,25074693,25074693,25074964,0,0,0,271
26329,25059279,25059279,25075137,0,0,0,15858
26341,25074903,25074903,25075170,0,0,0,267
26315,25049098,25049098,25075748,0,0,0,26650
26314,25049024,25049024,25075884,0,0,0,26860
26251,25022193,25022193,25076193,0,0,0,54000
26252,25022214,25022214,25076214,0,0,0,54000
26253,25022243,25022243,25076243,0,0,0,54000
26255,25022296,25022296,25076296,0,0,0,54000
26326,25057442,25057442,25077758,0,0,0,20316
26325,25056719,25056719,25080385,0,0,0,23666
26321,25050835,25050835,25080665,0,0,0,29830
26330,25060468,25060468,25081046,0,0,0,20578
26331,25060869,25060869,25081187,0,0,0,20318
26324,25055640,25055640,25082278,0,0,0,26638
26332,25063045,25063045,25083656,0,0,0,20611
26316,25050384,25050384,25085496,0,0,0,35112
26318,25050424,25050424,25085926,0,0,0,35502
26355,25087708,25087708,25087769,0,0,0,61
26356,25087742,25087742,25087779,0,0,0,37
26357,25087990,25087990,25088037,0,0,0,47
26358,25088280,25088280,25088317,0,0,0,37
26333,25073735,25073735,25089668,0,0,0,15933
26335,25073871,25073871,25089703,0,0,0,15832
26299,25034997,25034997,25090302,0,0,0,55305
26361,25090146,25090146,25090674,0,0,0,528
26342,25075084,25075084,25091153,0,0,0,16069
26297,25033090,25033090,25092227,0,0,0,59137
26156,25007119,25007119,25093519,0,0,0,86400
26175,25007127,25007127,25093527,0,0,0,86400
26176,25007127,25007127,25093527,0,0,0,86400
26177,25007128,25007128,25093528,0,0,0,86400
26178,25007128,25007128,25093528,0,0,0,86400
26179,25007128,25007128,25093528,0,0,0,86400
26180,25007128,25007128,25093528,0,0,0,86400
26181,25007129,25007129,25093529,0,0,0,86400
26182,25007129,25007129,25093529,0,0,0,86400
26183,25007129,25007129,25093529,0,0,0,86400
26337,25074027,25074027,25096274,0,0,0,22247
26366,25097033,25097033,25097151,0,0,0,118
26367,25097102,25097102,25097208,0,0,0,106
26368,25097126,25097126,25097243,0,0,0,117
26346,25077697,25077697,25097973,0,0,0,20276
26202,25012772,25012772,25099172,0,0,0,86400
26204,25013660,25013660,25100060,0,0,0,86400
26343,25075107,25075107,25101334,0,0,0,26227
26350,25081125,25081125,25101417,0,0,0,20292
26371,25101271,25101271,25101449,0,0,0,178
26373,25101381,25101381,25101551,0,0,0,170
26374,25101494,25101494,25101684,0,0,0,190
26349,25080976,25080976,25101705,0,0,0,20729
26375,25101611,25101611,25101789,0,0,0,178
26377,25101719,25101719,25101892,0,0,0,173
26345,25075837,25075837,25102632,0,0,0,26795
26344,25075685,25075685,25102771,0,0,0,27086
26338,25074052,25074052,25102999,0,0,0,28947
26353,25085517,25085517,25103517,0,0,0,18000
26354,25085691,25085691,25103691,0,0,0,18000
26347,25080319,25080319,25104245,0,0,0,23926
26352,25083593,25083593,25104292,0,0,0,20699
26360,25089633,25089633,25105627,0,0,0,15994
26359,25089630,25089630,25105747,0,0,0,16117
26105,24995400,24995400,25106202,0,0,0,110802
26370,25100878,25100878,25106555,0,0,0,5677
26364,25093361,25093361,25106675,0,0,0,13314
26362,25091086,25091086,25107057,0,0,0,15971
26363,25093318,25093318,25108091,0,0,0,14773
26351,25082234,25082234,25108416,0,0,0,26182
26348,25080603,25080603,25110394,0,0,0,29791
26085,24962954,24962954,25113500,0,0,0,150546
26086,24966305,24966305,25113507,0,0,0,147202
26265,25022881,25022881,25114718,0,0,0,91837
26264,25022866,25022866,25116648,0,0,0,93782
26369,25097930,25097930,25118029,0,0,0,20099
26365,25096202,25096202,25119105,0,0,0,22903
26372,25101372,25101372,25121470,0,0,0,20098
26384,25105568,25105568,25121609,0,0,0,16041
26385,25105686,25105686,25121867,0,0,0,16181
26376,25101650,25101650,25122375,0,0,0,20725
26296,25032655,25032655,25122742,0,0,0,90087
26295,25032654,25032654,25123098,0,0,0,90444
26386,25107015,25107015,25123135,0,0,0,16120
26390,25113503,25113503,25124654,0,0,0,11151
26383,25104250,25104250,25125000,0,0,0,20750
26382,25104181,25104181,25127353,0,0,0,23172
26378,25101837,25101837,25128199,0,0,0,26362
26379,25102590,25102590,25128796,0,0,0,26206
26380,25102707,25102707,25129200,0,0,0,26493
26258,25022383,25022383,25130383,0,0,0,108000
26259,25022448,25022448,25130448,0,0,0,108000
26260,25022514,25022514,25130514,0,0,0,108000
26262,25022582,25022582,25130582,0,0,0,108000
26381,25102954,25102954,25132086,0,0,0,29132
26405,25132131,25132131,25132415,0,0,0,284
26387,25108346,25108346,25134995,0,0,0,26649
26406,25134936,25134936,25135110,0,0,0,174
26394,25121553,25121553,25137743,0,0,0,16190
26395,25121806,25121806,25138070,0,0,0,16264
26391,25117968,25117968,25138429,0,0,0,20461
26397,25123078,25123078,25139288,0,0,0,16210
26388,25110347,25110347,25140043,0,0,0,29696
26413,25139985,25139985,25140152,0,0,0,167
26414,25140090,25140090,25140260,0,0,0,170
26415,25140198,25140198,25140368,0,0,0,170
26416,25140305,25140305,25140474,0,0,0,169
26417,25140412,25140412,25140581,0,0,0,169
26393,25121408,25121408,25141705,0,0,0,20297
26396,25122316,25122316,25142747,0,0,0,20431
26392,25119045,25119045,25143250,0,0,0,24205
26398,25124940,25124940,25145464,0,0,0,20524
26389,25113366,25113366,25146737,0,0,0,33371
26399,25127297,25127297,25149534,0,0,0,22237
26408,25137674,25137674,25153927,0,0,0,16253
26409,25137997,25137997,25154262,0,0,0,16265
26401,25128137,25128137,25154870,0,0,0,26733
26411,25139225,25139225,25155440,0,0,0,16215
26403,25129139,25129139,25155729,0,0,0,26590
26402,25128731,25128731,25155827,0,0,0,27096
26410,25138359,25138359,25158751,0,0,0,20392
26407,25135055,25135055,25161546,0,0,0,26491
26431,25161483,25161483,25161655,0,0,0,172
26404,25132027,25132027,25161800,0,0,0,29773
26419,25141642,25141642,25162037,0,0,0,20395
26420,25142684,25142684,25163649,0,0,0,20965
26412,25139849,25139849,25165284,0,0,0,25435
26422,25145409,25145409,25166076,0,0,0,20667
26421,25143195,25143195,25166867,0,0,0,23672
26110,24996766,24996766,25169566,0,0,0,172800
26418,25140519,25140519,25170082,0,0,0,29563
26424,25153869,25153869,25170161,0,0,0,16292
26425,25154217,25154217,25170532,0,0,0,16315
26427,25155373,25155373,25171601,0,0,0,16228
26423,25149473,25149473,25172434,0,0,0,22961
26430,25158696,25158696,25178981,0,0,0,20285
26426,25154808,25154808,25180812,0,0,0,26004
26445,25180741,25180741,25180908,0,0,0,167
26446,25180854,25180854,25181024,0,0,0,170
26447,25180962,25180962,25181131,0,0,0,169
26448,25181069,25181069,25181267,0,0,0,198
26449,25181177,25181177,25181346,0,0,0,169
26450,25181284,25181284,25181453,0,0,0,169
26451,25181391,25181391,25181560,0,0,0,169
26452,25181498,25181498,25181668,0,0,0,170
26428,25155661,25155661,25182138,0,0,0,26477
26434,25161979,25161979,25182202,0,0,0,20223
26429,25155763,25155763,25182224,0,0,0,26461
26435,25163581,25163581,25184342,0,0,0,20761
26439,25170019,25170019,25185498,0,0,0,15479
26458,25185431,25185431,25185603,0,0,0,172
26440,25170102,25170102,25186364,0,0,0,16262
26436,25166015,25166015,25186709,0,0,0,20694
26441,25170493,25170493,25186808,0,0,0,16315
26432,25161592,25161592,25187382,0,0,0,25790
26442,25171561,25171561,25187897,0,0,0,16336
26437,25166809,25166809,25190780,0,0,0,23971
26433,25161737,25161737,25191070,0,0,0,29333
26443,25172367,25172367,25196544,0,0,0,24177
26444,25178910,25178910,25199610,0,0,0,20700
26460,25186317,25186317,25202670,0,0,0,16353
26455,25182159,25182159,25202867,0,0,0,20708
26462,25186750,25186750,25203063,0,0,0,16313
26464,25187837,25187837,25204170,0,0,0,16333
26472,25204089,25204089,25204217,0,0,0,128
26457,25184280,25184280,25204950,0,0,0,20670
26461,25186664,25186664,25207326,0,0,0,20662
26453,25181605,25181605,25207898,0,0,0,26293
26476,25207834,25207834,25208005,0,0,0,171
26454,25182082,25182082,25208587,0,0,0,26505
26456,25182160,25182160,25208940,0,0,0,26780
26064,24950956,24950956,25210156,0,0,0,259200
26065,24952529,24952529,25211729,0,0,0,259200
26066,24952578,24952578,25211778,0,0,0,259200
26067,24952931,24952931,25212131,0,0,0,259200
26068,24952964,24952964,25212164,0,0,0,259200
26069,24953028,24953028,25212228,0,0,0,259200
26070,24953330,24953330,25212530,0,0,0,259200
26071,24953794,24953794,25212994,0,0,0,259200
26463,25187336,25187336,25213829,0,0,0,26493
26400,25127440,25127440,25213840,0,0,0,86400
26480,25213788,25213788,25213928,0,0,0,140
26465,25190718,25190718,25214634,0,0,0,23916
26481,25214390,25214390,25214687,0,0,0,297
26483,25214552,25214552,25214692,0,0,0,140
26482,25214471,25214471,25214782,0,0,0,311
26484,25214586,25214586,25214866,0,0,0,280
26485,25214785,25214785,25215080,0,0,0,295
26459,25185545,25185545,25215831,0,0,0,30286
26486,25215768,25215768,25215908,0,0,0,140
26267,25023687,25023687,25218087,0,0,0,194400
26269,25023960,25023960,25218360,0,0,0,194400
26469,25202611,25202611,25218954,0,0,0,16343
26487,25218910,25218910,25219038,0,0,0,128
26471,25202993,25202993,25219225,0,0,0,16232
26488,25219171,25219171,25219299,0,0,0,128
26467,25196486,25196486,25220148,0,0,0,23662
26489,25220086,25220086,25220226,0,0,0,140
26468,25199549,25199549,25220252,0,0,0,20703
26490,25220197,25220197,25220337,0,0,0,140
26473,25204124,25204124,25220483,0,0,0,16359
26491,25220425,25220425,25220553,0,0,0,128
26466,25191023,25191023,25220772,0,0,0,29749
26492,25220712,25220712,25220852,0,0,0,140
26470,25202788,25202788,25223484,0,0,0,20696
26493,25223421,25223421,25223561,0,0,0,140
26474,25204889,25204889,25225992,0,0,0,21103
26494,25225930,25225930,25226070,0,0,0,140
26475,25207265,25207265,25228355,0,0,0,21090
26495,25228288,25228288,25228428,0,0,0,140
26438,25167044,25167044,25231844,0,0,0,64800
26477,25207945,25207945,25234074,0,0,0,26129
26496,25234011,25234011,25234151,0,0,0,140
26478,25208518,25208518,25234793,0,0,0,26275
26497,25234738,25234738,25234890,0,0,0,152
26479,25208888,25208888,25235372,0,0,0,26484
26498,25235309,25235309,25235449,0,0,0,140
26499,25427821,25427821,25428074,0,0,0,253
26501,25432982,25432982,25433018,0,0,0,36
26500,25432936,25432936,25433084,0,0,0,148
26502,25433530,25433530,25433624,0,0,0,94
26503,25433690,25433690,25433768,0,0,0,78
26504,25433731,25433731,25433981,0,0,0,250
26505,25433736,25433768,25433997,0,0,32,261
26506,25442000,25442000,25442106,0,0,0,106
26507,25442074,25442074,25442329,0,0,0,255
26508,25442330,25442330,25442425,0,0,0,95
26510,25442450,25442450,25442576,0,0,0,126
26509,25442445,25442445,25442664,0,0,0,219
26511,25443118,25443118,25443192,0,0,0,74
26512,25443364,25443364,25443459,0,0,0,95
26513,25443508,25443508,25443743,0,0,0,235
26514,25443796,25443796,25443891,0,0,0,95
26515,25444048,25444048,25444143,0,0,0,95
26516,25444297,25444297,25444392,0,0,0,95
26517,25444946,25444946,25445072,0,0,0,126
26518,25445836,25445836,25446436,0,0,0,600
26519,25455524,25455524,25455713,0,0,0,189
26520,25455541,25455541,25455759,0,0,0,218
26521,25456008,25456008,25456232,0,0,0,224
26522,25456378,25456378,25456602,0,0,0,224
26528,25456819,25456819,25456895,0,0,0,76
26525,25456737,25456737,25456919,0,0,0,182
26524,25456563,25456563,25456993,0,0,0,430
26523,25456398,25456398,25457139,0,0,0,741
26531,25457264,25457264,25457338,0,0,0,74
26532,25457316,25457316,25457400,0,0,0,84
26529,25456874,25456874,25457529,0,0,0,655
26533,25457395,25457395,25457621,0,0,0,226
26537,25457635,25457635,25457727,0,0,0,92
26538,25457796,25457796,25457899,0,0,0,103
26539,25457833,25457833,25457905,0,0,0,72
26541,25458015,25458015,25458099,0,0,0,84
26542,25458131,25458131,25458222,0,0,0,91
26543,25458188,25458188,25458307,0,0,0,119
26544,25458203,25458203,25458310,0,0,0,107
26546,25458291,25458291,25458387,0,0,0,96
26526,25456778,25456778,25458411,0,0,0,1633
26547,25458401,25458401,25458493,0,0,0,92
26545,25458287,25458287,25458542,0,0,0,255
26549,25458534,25458534,25458597,0,0,0,63
26551,25458843,25458843,25458907,0,0,0,64
26550,25458745,25458745,25458932,0,0,0,187
26552,25458861,25458861,25458983,0,0,0,122
26548,25458434,25458434,25459073,0,0,0,639
26553,25458965,25458965,25459113,0,0,0,148
26565,25459197,25459197,25459302,0,0,0,105
26566,25459258,25459258,25459348,0,0,0,90
26567,25459335,25459335,25459403,0,0,0,68
26568,25459440,25459440,25459514,0,0,0,74
26556,25459119,25459119,25459547,0,0,0,428
26569,25459598,25459598,25459666,0,0,0,68
26570,25459608,25459608,25459676,0,0,0,68
26572,25459704,25459704,25460424,0,0,0,720
26579,25460411,25460411,25460526,0,0,0,115
26534,25457491,25457491,25460927,0,0,0,3436
26577,25460286,25460286,25461003,0,0,0,717
26571,25459654,25459654,25461137,0,0,0,1483
26580,25460691,25460691,25461242,0,0,0,551
26586,25460945,25460945,25461360,0,0,0,415
26578,25460304,25460304,25461781,0,0,0,1477
26559,25459179,25459179,25461941,0,0,0,2762
26593,25462698,25462698,25462771,0,0,0,73
26540,25457868,25457868,25463167,0,0,0,5299
26536,25457623,25457623,25464739,0,0,0,7116
26595,25464780,25464780,25465469,0,0,0,689
26594,25463253,25463253,25465516,0,0,0,2263
26587,25461479,25461479,25465621,0,0,0,4142
26555,25459111,25459111,25465779,0,0,0,6668
26601,25466679,25466679,25466752,0,0,0,73
26602,25466802,25466802,25467129,0,0,0,327
26604,25467233,25467233,25467565,0,0,0,332
26603,25467218,25467218,25467614,0,0,0,396
26589,25461848,25461848,25468267,0,0,0,6419
26581,25460691,25460691,25468670,0,0,0,7979
26596,25465684,25465684,25468715,0,0,0,3031
26597,25465797,25465797,25470394,0,0,0,4597
26599,25466108,25466108,25472246,0,0,0,6138
26588,25461774,25461774,25475058,0,0,0,13284
26609,25473729,25473729,25475158,0,0,0,1429
26611,25476968,25476968,25477084,0,0,0,116
26612,25477048,25477048,25477121,0,0,0,73
26613,25477161,25477161,25477234,0,0,0,73
26614,25477325,25477325,25477696,0,0,0,371
26615,25477328,25477328,25477761,0,0,0,433
26590,25461873,25461873,25481681,0,0,0,19808
26610,25473924,25473924,25481792,0,0,0,7868
26605,25468802,25468802,25486164,0,0,0,17362
26608,25473118,25473118,25487052,0,0,0,13934
26616,25477549,25477549,25491000,0,0,0,13451
26618,25496801,25496801,25496885,0,0,0,84
26617,25496790,25496790,25496886,0,0,0,96
26592,25462122,25462122,25500277,0,0,0,38155
26621,25497133,25497133,25504343,0,0,0,7210
26606,25470449,25470449,25504579,0,0,0,34130
26598,25465890,25465890,25505969,0,0,0,40079
26574,25459889,25459889,25507762,0,0,0,47873
26530,25457156,25457156,25510492,0,0,0,53336
26619,25496890,25496890,25510640,0,0,0,13750
26622,25510691,25510691,25511429,0,0,0,738
26624,25511348,25511348,25511865,0,0,0,517
26625,25511619,25511619,25512095,0,0,0,476
26627,25512229,25512229,25512358,0,0,0,129
26629,25512347,25512347,25512540,0,0,0,193
26626,25512169,25512169,25512609,0,0,0,440
26628,25512319,25512319,25512852,0,0,0,533
26632,25512835,25512835,25512910,0,0,0,75
26630,25512561,25512561,25512915,0,0,0,354
26633,25512888,25512888,25513031,0,0,0,143
26631,25512632,25512632,25513117,0,0,0,485
26634,25512995,25512995,25513204,0,0,0,209
26636,25513229,25513229,25513429,0,0,0,200
26635,25513014,25513014,25513744,0,0,0,730
26637,25513676,25513676,25513915,0,0,0,239
26639,25513894,25513915,25513988,0,0,21,94
26638,25513893,25513893,25514131,0,0,0,238
26642,25514110,25514110,25514179,0,0,0,69
26643,25514495,25514495,25514614,0,0,0,119
26644,25515235,25515235,25515320,0,0,0,85
26647,25517523,25517523,25517583,0,0,0,60
26650,25517812,25517812,25517872,0,0,0,60
26641,25514098,25514098,25517918,0,0,0,3820
26651,25518416,25518416,25518441,0,0,0,25
26648,25517652,25517652,25518880,0,0,0,1228
26649,25517715,25517715,25518901,0,0,0,1186
26654,25519321,25519321,25519351,0,0,0,30
26655,25519474,25519474,25519504,0,0,0,30
26656,25519882,25519882,25519904,0,0,0,22
26659,25520359,25520359,25520364,0,0,0,5
26657,25520173,25520173,25520441,0,0,0,268
26661,25520447,25520447,25520560,0,0,0,113
26640,25514079,25514079,25520592,0,0,0,6513
26535,25457615,25457615,25520624,0,0,0,63009
26663,25520559,25520559,25520688,0,0,0,129
26665,25520705,25520705,25520811,0,0,0,106
26668,25521277,25521277,25521344,0,0,0,67
26667,25521044,25521044,25521488,0,0,0,444
26664,25520574,25520574,25521603,0,0,0,1029
26670,25523389,25523389,25523457,0,0,0,68
26671,25523551,25523551,25523622,0,0,0,71
26673,25523694,25523694,25523767,0,0,0,73
26672,25523566,25523566,25523858,0,0,0,292
26674,25523867,25523867,25523962,0,0,0,95
26675,25523920,25523920,25523969,0,0,0,49
26660,25520365,25520365,25524129,0,0,0,3764
26676,25524138,25524138,25524187,0,0,0,49
26678,25524223,25524223,25524330,0,0,0,107
26527,25456783,25456783,25524348,0,0,0,67565
26677,25524166,25524166,25524399,0,0,0,233
26680,25524517,25524517,25524568,0,0,0,51
26682,25524725,25524725,25524777,0,0,0,52
26646,25516860,25516860,25524798,0,0,0,7938
26683,25524911,25524911,25525026,0,0,0,115
26684,25525017,25525017,25525124,0,0,0,107
26690,25525674,25525674,25525799,0,0,0,125
26691,25526249,25526249,25526341,0,0,0,92
26692,25526289,25526289,25526397,0,0,0,108
26662,25520542,25520542,25526560,0,0,0,6018
26696,25526893,25526893,25526972,0,0,0,79
26607,25472557,25472557,25527301,0,0,0,54744
26669,25521667,25521667,25527369,0,0,0,5702
26701,25527404,25527404,25527480,0,0,0,76
26708,25528242,25528242,25528880,0,0,0,638
26710,25528269,25528269,25528896,0,0,0,627
26709,25528257,25528257,25528906,0,0,0,649
26575,25459899,25459899,25529155,0,0,0,69256
26694,25526788,25526788,25529365,0,0,0,2577
26645,25516691,25516691,25529423,0,0,0,12732
26666,25520789,25520789,25529912,0,0,0,9123
26718,25530015,25530015,25530048,0,0,0,33
26702,25527409,25527409,25530056,0,0,0,2647
26719,25530357,25530357,25530418,0,0,0,61
26721,25530617,25530617,25530650,0,0,0,33
26722,25530705,25530705,25530834,0,0,0,129
26715,25529773,25529773,25530917,0,0,0,1144
26723,25531114,25531114,25531241,0,0,0,127
26725,25531499,25531499,25531614,0,0,0,115
26591,25461939,25461939,25531978,0,0,0,70039
26728,25532584,25532584,25532621,0,0,0,37
26729,25532626,25532626,25532670,0,0,0,44
26730,25532660,25532660,25532690,0,0,0,30
26686,25525313,25525313,25532857,0,0,0,7544
26711,25528527,25528527,25532904,0,0,0,4377
26573,25459834,25459834,25533213,0,0,0,73379
26734,25533739,25533739,25533762,0,0,0,23
26735,25534237,25534237,25534286,0,0,0,49
26736,25534425,25534425,25534448,0,0,0,23
26653,25518942,25518942,25534489,0,0,0,15547
26738,25534507,25534507,25534562,0,0,0,55
26652,25518902,25518902,25535527,0,0,0,16625
26740,25535704,25535704,25535743,0,0,0,39
26741,25535710,25535710,25535743,0,0,0,33
26743,25536401,25536401,25536448,0,0,0,47
26658,25520352,25520352,25536547,0,0,0,16195
26720,25530424,25530424,25536734,0,0,0,6310
26712,25528984,25528984,25536765,0,0,0,7781
26706,25527829,25527829,25536830,0,0,0,9001
26744,25536786,25536786,25536840,0,0,0,54
26745,25536787,25536787,25537019,0,0,0,232
26747,25537068,25537068,25537184,0,0,0,116
26733,25533612,25533612,25537212,0,0,0,3600
26748,25537318,25537318,25537384,0,0,0,66
26557,25459178,25459178,25537393,0,0,0,78215
26560,25459179,25459179,25537394,0,0,0,78215
26561,25459179,25459179,25537406,0,0,0,78227
26562,25459179,25459179,25537406,0,0,0,78227
26563,25459180,25459180,25537407,0,0,0,78227
26564,25459180,25459180,25537407,0,0,0,78227
26576,25459911,25459911,25537407,0,0,0,77496
26600,25466186,25466186,25537409,0,0,0,71223
26554,25459018,25459018,25537412,0,0,0,78394
26583,25460692,25460692,25537414,0,0,0,76722
26584,25460692,25460692,25537414,0,0,0,76722
26585,25460692,25460692,25537414,0,0,0,76722
26726,25531698,25531698,25537415,0,0,0,5717
26558,25459178,25459178,25537416,0,0,0,78238
26688,25525386,25525386,25537494,0,0,0,12108
26697,25526919,25526919,25537494,0,0,0,10575
26623,25511174,25511174,25537495,0,0,0,26321
26689,25525452,25525452,25537495,0,0,0,12043
26699,25527308,25527308,25537495,0,0,0,10187
26705,25527607,25527607,25537496,0,0,0,9889
26698,25527256,25527256,25537498,0,0,0,10242
26700,25527392,25527392,25537500,0,0,0,10108
26707,25527972,25527972,25537500,0,0,0,9528
26727,25532268,25532268,25537501,0,0,0,5233
26620,25496911,25496911,25537503,0,0,0,40592
26732,25533205,25533205,25537503,0,0,0,4298
26687,25525339,25525339,25537504,0,0,0,12165
26685,25525270,25525270,25537507,0,0,0,12237
26681,25524577,25524577,25537509,0,0,0,12932
26679,25524269,25524269,25537510,0,0,0,13241
26731,25533055,25533055,25537510,0,0,0,4455
26704,25527565,25527565,25537511,0,0,0,9946
26739,25534528,25534528,25537511,0,0,0,2983
26714,25529112,25529112,25537538,0,0,0,8426
26703,25527444,25527444,25537590,0,0,0,10146
26754,25537606,25537606,25537645,0,0,0,39
26713,25528986,25528986,25537707,0,0,0,8721
26742,25535867,25535867,25537727,0,0,0,1860
26717,25529861,25529861,25537815,0,0,0,7954
26746,25537067,25537067,25537840,0,0,0,773
26716,25529829,25529829,25537849,0,0,0,8020
26724,25531378,25531378,25537880,0,0,0,6502
26761,25537861,25537861,25537899,0,0,0,38
26762,25537861,25537861,25537961,0,0,0,100
26737,25534441,25534441,25537994,0,0,0,3553
26582,25460691,25460691,25537998,0,0,0,77307
26759,25537814,25537814,25538099,0,0,0,285
26755,25537672,25537672,25538882,0,0,0,1210
26760,25537828,25537828,25538919,0,0,0,1091
26756,25537688,25537688,25538951,0,0,0,1263
26770,25539187,25539187,25539573,0,0,0,386
26752,25537580,25537580,25539582,0,0,0,2002
26772,25539629,25539629,25539746,0,0,0,117
26775,25539779,25539779,25539801,0,0,0,22
26774,25539735,25539735,25539838,0,0,0,103
26768,25538855,25538855,25539853,0,0,0,998
26753,25537599,25537599,25539859,0,0,0,2260
26776,25539867,25539867,25539900,0,0,0,33
26777,25539906,25539906,25539996,0,0,0,90
26779,25539948,25539948,25540048,0,0,0,100
26780,25540063,25540063,25540163,0,0,0,100
26781,25540243,25540243,25540342,0,0,0,99
26751,25537567,25537567,25540362,0,0,0,2795
26771,25539441,25539441,25540473,0,0,0,1032
26782,25540691,25540691,25541345,0,0,0,654
26766,25538279,25538279,25542013,0,0,0,3734
26786,25542090,25542090,25542163,0,0,0,73
26789,25543435,25543435,25543528,0,0,0,93
26788,25543100,25543100,25543756,0,0,0,656
26750,25537518,25537518,25543956,0,0,0,6438
26796,25544376,25544376,25544401,0,0,0,25
26797,25544411,25544411,25544434,0,0,0,23
26798,25544569,25544569,25544608,0,0,0,39
26801,25544795,25544795,25544872,0,0,0,77
26802,25544857,25544857,25544918,0,0,0,61
26785,25541152,25541152,25545595,0,0,0,4443
26773,25539644,25539644,25545599,0,0,0,5955
26795,25544351,25544351,25545637,0,0,0,1286
26811,25546582,25546582,25546605,0,0,0,23
26809,25546392,25546392,25546915,0,0,0,523
26763,25537921,25537921,25546921,0,0,0,9000
26749,25537516,25537516,25547081,0,0,0,9565
26814,25547238,25547238,25547262,0,0,0,24
26800,25544763,25544763,25548014,0,0,0,3251
26787,25542512,25542512,25548533,0,0,0,6021
26813,25547094,25547094,25548729,0,0,0,1635
26816,25548488,25548488,25548799,0,0,0,311
26806,25545927,25545927,25551702,0,0,0,5775
26817,25549798,25549798,25551777,0,0,0,1979
26757,25537705,25537705,25552063,0,0,0,14358
26812,25547075,25547075,25552710,0,0,0,5635
26764,25538018,25538018,25553289,0,0,0,15271
26819,25554204,25554204,25554275,0,0,0,71
26820,25555065,25555065,25555302,0,0,0,237
26778,25539907,25539907,25555489,0,0,0,15582
26693,25526325,25526325,25555649,0,0,0,29324
26822,25555583,25555583,25555672,0,0,0,89
26823,25556884,25556884,25556964,0,0,0,80
26824,25557428,25557428,25557504,0,0,0,76
26810,25546581,25546581,25557909,0,0,0,11328
26825,25557860,25557860,25557938,0,0,0,78
26826,25557977,25557977,25558058,0,0,0,81
26827,25558106,25558106,25558188,0,0,0,82
26828,25558432,25558432,25558514,0,0,0,82
26758,25537794,25537794,25559218,0,0,0,21424
26829,25558652,25558652,25559758,0,0,0,1106
26790,25543551,25543551,25559855,0,0,0,16304
26791,25543685,25543685,25559923,0,0,0,16238
26792,25543778,25543778,25560010,0,0,0,16232
26804,25545561,25545561,25560373,0,0,0,14812
26837,25561344,25561344,25561398,0,0,0,54
26834,25561267,25561267,25561433,0,0,0,166
26839,25561389,25561389,25561540,0,0,0,151
26842,25561501,25561501,25561656,0,0,0,155
26765,25538130,25538130,25561723,0,0,0,23593
26844,25561612,25561612,25561754,0,0,0,142
26769,25538946,25538946,25561815,0,0,0,22869
26818,25553361,25553361,25561838,0,0,0,8477
26767,25538841,25538841,25562036,0,0,0,23195
26853,25561738,25561738,25562046,0,0,0,308
26846,25561653,25561653,25562247,0,0,0,594
26848,25561687,25561687,25562252,0,0,0,565
26860,25562335,25562335,25562357,0,0,0,22
26854,25561803,25561803,25562378,0,0,0,575
26861,25562437,25562437,25562470,0,0,0,33
26862,25562505,25562505,25562527,0,0,0,22
26864,25562931,25562931,25562954,0,0,0,23
26866,25562977,25562977,25563001,0,0,0,24
26865,25562973,25562973,25563007,0,0,0,34
26867,25563070,25563070,25563127,0,0,0,57
26868,25563486,25563486,25563514,0,0,0,28
26870,25563572,25563572,25563605,0,0,0,33
26871,25563633,25563633,25563658,0,0,0,25
26863,25562508,25562508,25563784,0,0,0,1276
26873,25563963,25563963,25563988,0,0,0,25
26874,25565284,25565284,25565307,0,0,0,23
26875,25565332,25565332,25565365,0,0,0,33
26876,25565370,25565370,25565403,0,0,0,33
26856,25562049,25562049,25565429,0,0,0,3380
26878,25565713,25565713,25567575,0,0,0,1862
26869,25563492,25563492,25570623,0,0,0,7131
26880,25571140,25571140,25571163,0,0,0,23
26872,25563634,25563634,25571169,0,0,0,7535
26881,25571226,25571226,25571248,0,0,0,22
26882,25571275,25571275,25571297,0,0,0,22
26857,25562205,25562205,25575458,0,0,0,13253
26832,25559969,25559969,25576167,0,0,0,16198
26831,25559883,25559883,25576187,0,0,0,16304
26883,25571278,25571278,25576188,0,0,0,4910
26830,25559814,25559814,25576206,0,0,0,16392
26879,25571114,25571114,25576844,0,0,0,5730
26859,25562308,25562308,25577411,0,0,0,15103
26695,25526855,25526855,25580855,0,0,0,54000
26887,25581332,25581332,25581595,0,0,0,263
26799,25544677,25544677,25581850,0,0,0,37173
26852,25561737,25561737,25582304,0,0,0,20567
26850,25561715,25561715,25582339,0,0,0,20624
26815,25547266,25547266,25582617,0,0,0,35351
26847,25561679,25561679,25582739,0,0,0,21060
26849,25561696,25561696,25582883,0,0,0,21187
26877,25565444,25565444,25584171,0,0,0,18727
26843,25561593,25561593,25584323,0,0,0,22730
26845,25561647,25561647,25585548,0,0,0,23901
26840,25561400,25561400,25587326,0,0,0,25926
26841,25561425,25561425,25587354,0,0,0,25929
26895,25587324,25587324,25587469,0,0,0,145
26836,25561327,25561327,25587542,0,0,0,26215
26838,25561379,25561379,25587885,0,0,0,26506
26851,25561716,25561716,25590430,0,0,0,28714
26835,25561293,25561293,25591177,0,0,0,29884
26900,25591146,25591146,25591295,0,0,0,149
26821,25555562,25555562,25591338,0,0,0,35776
26901,25591253,25591253,25591401,0,0,0,148
26884,25576126,25576126,25592391,0,0,0,16265
26885,25576134,25576134,25592422,0,0,0,16288
26886,25576163,25576163,25592436,0,0,0,16273
26906,25597545,25597545,25597577,0,0,0,32
26803,25545541,25545541,25598725,0,0,0,53184
26907,25599297,25599297,25599329,0,0,0,32
26807,25545961,25545961,25599961,0,0,0,54000
26890,25582693,25582693,25600300,0,0,0,17607
26902,25591361,25591361,25600300,0,0,0,8939
26794,25543834,25543834,25600302,0,0,0,56468
26891,25582837,25582837,25600304,0,0,0,17467
26896,25587433,25587433,25600307,0,0,0,12874
26894,25587283,25587283,25600311,0,0,0,13028
26903,25592345,25592345,25600311,0,0,0,7966
26793,25543822,25543822,25600312,0,0,0,56490
26808,25545974,25545974,25600312,0,0,0,54338
26897,25587511,25587511,25600312,0,0,0,12801
26904,25592372,25592372,25600314,0,0,0,7942
26905,25592396,25592396,25600316,0,0,0,7920
26783,25540820,25540820,25600319,0,0,0,59499
26888,25582299,25582299,25600319,0,0,0,18020
26899,25590386,25590386,25600319,0,0,0,9933
26893,25585509,25585509,25600320,0,0,0,14811
26898,25587843,25587843,25600320,0,0,0,12477
26892,25584275,25584275,25600321,0,0,0,16046
26784,25540889,25540889,25600322,0,0,0,59433
26858,25562238,25562238,25600803,0,0,0,38565
26805,25545601,25545601,25600814,0,0,0,55213
26855,25561986,25561986,25600814,0,0,0,38828
26833,25560473,25560473,25600815,0,0,0,40342
26908,25601018,25601018,25601114,0,0,0,96
26889,25582350,25582350,25601570,0,0,0,19220
26909,25601640,25601640,25601665,0,0,0,25
26910,25601877,25601877,25602023,0,0,0,146
26912,25602385,25602385,25602409,0,0,0,24
26911,25601989,25601989,25602454,0,0,0,465
26914,25603047,25603047,25603078,0,0,0,31
26913,25603034,25603034,25603188,0,0,0,154
26915,25603059,25603059,25603213,0,0,0,154
26918,25604812,25604812,25605388,0,0,0,576
26919,25604986,25604986,25605392,0,0,0,406
26917,25604598,25604598,25605408,0,0,0,810
26929,25606462,25606462,25606494,0,0,0,32
26930,25606541,25606541,25606628,0,0,0,87
26931,25606633,25606633,25606726,0,0,0,93
26934,25608170,25608170,25608264,0,0,0,94
26935,25608456,25608456,25608487,0,0,0,31
26939,25608703,25608703,25608734,0,0,0,31
26942,25608751,25608751,25608782,0,0,0,31
26936,25608672,25608672,25608814,0,0,0,142
26937,25608684,25608684,25608845,0,0,0,161
26938,25608693,25608693,25608873,0,0,0,180
26941,25608724,25608724,25608902,0,0,0,178
26940,25608715,25608715,25608904,0,0,0,189
26944,25609151,25609151,25609327,0,0,0,176
26945,25609161,25609161,25609368,0,0,0,207
26946,25609172,25609172,25609462,0,0,0,290
26943,25609140,25609140,25609815,0,0,0,675
26950,25611136,25611136,25611221,0,0,0,85
26951,25611194,25611194,25611408,0,0,0,214
26952,25611216,25611221,25611511,0,0,5,295
26949,25611032,25611032,25611560,0,0,0,528
26953,25611230,25611408,25611688,0,0,178,458
26954,25611288,25611688,25611761,0,0,400,473
26958,25612503,25612503,25612658,0,0,0,155
26955,25611596,25611596,25612664,0,0,0,1068
26956,25612014,25612014,25612698,0,0,0,684
26957,25612491,25612491,25612896,0,0,0,405
26948,25610395,25610395,25613478,0,0,0,3083
26966,25613460,25613460,25613491,0,0,0,31
26965,25613446,25613446,25613533,0,0,0,87
26967,25613671,25613671,25613745,0,0,0,74
26947,25610146,25610146,25613783,0,0,0,3637
26962,25613121,25613121,25613802,0,0,0,681
26933,25607358,25607358,25613849,0,0,0,6491
26923,25605373,25605373,25613854,0,0,0,8481
26963,25613190,25613190,25613857,0,0,0,667
26961,25612901,25612901,25613862,0,0,0,961
26932,25607355,25607355,25613901,0,0,0,6546
26973,25613861,25613861,25614016,0,0,0,155
26972,25613852,25613852,25614085,0,0,0,233
26974,25614064,25614064,25614095,0,0,0,31
26978,25614118,25614118,25614149,0,0,0,31
26976,25614090,25614090,25614182,0,0,0,92
26977,25614109,25614109,25614183,0,0,0,74
26979,25614338,25614338,25614501,0,0,0,163
26975,25614079,25614079,25614571,0,0,0,492
26985,25614466,25614466,25614637,0,0,0,171
26993,25614867,25614867,25614961,0,0,0,94
26970,25613807,25613807,25615853,0,0,0,2046
26971,25613826,25613826,25615872,0,0,0,2046
26996,25616377,25616377,25616451,0,0,0,74
26997,25616492,25616492,25616566,0,0,0,74
26998,25616493,25616566,25616640,0,0,73,147
26999,25616958,25616958,25617140,0,0,0,182
27003,25618227,25618227,25618388,0,0,0,161
27008,25618373,25618373,25618407,0,0,0,34
27011,25618382,25618382,25618408,0,0,0,26
27004,25618237,25618237,25618409,0,0,0,172
27005,25618247,25618247,25618419,0,0,0,172
27007,25618357,25618357,25618435,0,0,0,78
27006,25618344,25618344,25618444,0,0,0,100
27013,25618545,25618545,25618659,0,0,0,114
27015,25618982,25618982,25619073,0,0,0,91
27017,25619081,25619081,25619141,0,0,0,60
27016,25619062,25619062,25619239,0,0,0,177
27018,25619156,25619156,25619344,0,0,0,188
27022,25619401,25619401,25619469,0,0,0,68
27020,25619386,25619386,25619487,0,0,0,101
27019,25619383,25619383,25619574,0,0,0,191
27021,25619394,25619394,25619574,0,0,0,180
27023,25619676,25619676,25619771,0,0,0,95
27024,25619851,25619851,25619920,0,0,0,69
26959,25612659,25612659,25620190,0,0,0,7531
26960,25612740,25612740,25620198,0,0,0,7458
27025,25619932,25619932,25620236,0,0,0,304
26994,25616260,25616260,25620587,0,0,0,4327
26995,25616263,25616263,25620636,0,0,0,4373
26968,25613729,25613729,25620647,0,0,0,6918
26969,25613757,25613757,25620755,0,0,0,6998
27030,25621590,25621590,25621663,0,0,0,73
27031,25621850,25621850,25622039,0,0,0,189
27032,25622028,25622028,25622340,0,0,0,312
26926,25606153,25606153,25622386,0,0,0,16233
26927,25606243,25606243,25622483,0,0,0,16240
26928,25606261,25606261,25622596,0,0,0,16335
27036,25623373,25623373,25624043,0,0,0,670
27039,25626251,25626251,25626324,0,0,0,73
27040,25626324,25626324,25626563,0,0,0,239
27042,25627205,25627205,25627278,0,0,0,73
27037,25625588,25625588,25627498,0,0,0,1910
27028,25620614,25620614,25627681,0,0,0,7067
27029,25620716,25620716,25627683,0,0,0,6967
27046,25628205,25628205,25628278,0,0,0,73
27045,25628146,25628146,25628459,0,0,0,313
27047,25628289,25628289,25628786,0,0,0,497
27044,25627766,25627766,25628948,0,0,0,1182
27026,25620548,25620548,25629449,0,0,0,8901
27027,25620588,25620588,25629461,0,0,0,8873
27049,25628867,25628867,25629479,0,0,0,612
27050,25628882,25628882,25629484,0,0,0,602
27052,25628922,25628922,25629503,0,0,0,581
27051,25628903,25628903,25629518,0,0,0,615
27054,25631053,25631053,25631166,0,0,0,113
27057,25631241,25631241,25631264,0,0,0,23
27048,25628583,25628583,25632862,0,0,0,4279
26992,25614605,25614605,25635239,0,0,0,20634
26988,25614540,25614540,25635574,0,0,0,21034
26989,25614568,25614568,25635602,0,0,0,21034
26991,25614587,25614587,25635748,0,0,0,21161
27041,25626470,25626470,25636403,0,0,0,9933
26986,25614480,25614480,25637213,0,0,0,22733
27043,25627332,25627332,25638085,0,0,0,10753
26987,25614506,25614506,25638391,0,0,0,23885
27033,25622345,25622345,25638575,0,0,0,16230
27034,25622443,25622443,25638684,0,0,0,16241
27035,25622555,25622555,25638816,0,0,0,16261
26984,25614454,25614454,25640581,0,0,0,26127
26982,25614416,25614416,25640837,0,0,0,26421
26981,25614396,25614396,25640934,0,0,0,26538
26983,25614432,25614432,25641114,0,0,0,26682
27073,25641073,25641073,25641225,0,0,0,152
26980,25614363,25614363,25643846,0,0,0,29483
26916,25604430,25604430,25650758,0,0,0,46328
27067,25638535,25638535,25654768,0,0,0,16233
27068,25638647,25638647,25654899,0,0,0,16252
27061,25635197,25635197,25655696,0,0,0,20499
27064,25635715,25635715,25656249,0,0,0,20534
27062,25635525,25635525,25656614,0,0,0,21089
27063,25635564,25635564,25656635,0,0,0,21071
26990,25614570,25614570,25657770,0,0,0,43200
27065,25637172,25637172,25660551,0,0,0,23379
27066,25638346,25638346,25661155,0,0,0,22809
27070,25640539,25640539,25666900,0,0,0,26361
27072,25640902,25640902,25666959,0,0,0,26057
27074,25641233,25641233,25667255,0,0,0,26022
27071,25640796,25640796,25667787,0,0,0,26991
27076,25654730,25654730,25671017,0,0,0,16287
27077,25654850,25654850,25671126,0,0,0,16276
27038,25626057,25626057,25672098,0,0,0,46041
27075,25643801,25643801,25673449,0,0,0,29648
27078,25655655,25655655,25676088,0,0,0,20433
27079,25656211,25656211,25676670,0,0,0,20459
27080,25656579,25656579,25677519,0,0,0,20940
27081,25656593,25656593,25677553,0,0,0,20960
26922,25605368,25605368,25681369,0,0,0,76001
27069,25638776,25638776,25681976,0,0,0,43200
27083,25661160,25661160,25683824,0,0,0,22664
27082,25660556,25660556,25683917,0,0,0,23361
27088,25670976,25670976,25687064,0,0,0,16088
27089,25671088,25671088,25687301,0,0,0,16213
27009,25618377,25618377,25687884,0,0,0,69507
27084,25666902,25666902,25692820,0,0,0,25918
27099,25692784,25692784,25692952,0,0,0,168
27100,25692904,25692904,25693088,0,0,0,184
27085,25666969,25666969,25693113,0,0,0,26144
27086,25667248,25667248,25693179,0,0,0,25931
27101,25693057,25693057,25693202,0,0,0,145
27087,25667795,25667795,25695048,0,0,0,27253
27103,25693144,25693144,25695873,0,0,0,2729
27091,25676046,25676046,25696777,0,0,0,20731
27092,25676627,25676627,25697327,0,0,0,20700
27093,25677480,25677480,25698355,0,0,0,20875
27094,25677517,25677517,25698369,0,0,0,20852
27097,25687022,25687022,25703155,0,0,0,16133
27090,25673452,25673452,25703247,0,0,0,29795
27098,25687261,25687261,25703426,0,0,0,16165
27095,25683787,25683787,25707165,0,0,0,23378
27096,25683880,25683880,25707314,0,0,0,23434
27113,25707266,25707266,25707334,0,0,0,68
27000,25617893,25617893,25710000,0,0,0,92107
27115,25711221,25711221,25711562,0,0,0,341
27109,25703114,25703114,25719121,0,0,0,16007
27104,25693164,25693164,25719404,0,0,0,26240
27102,25693071,25693071,25719418,0,0,0,26347
27108,25698332,25698332,25719418,0,0,0,21086
27107,25698304,25698304,25719440,0,0,0,21136
27111,25703379,25703379,25719446,0,0,0,16067
27117,25719360,25719360,25719507,0,0,0,147
27120,25719464,25719464,25719614,0,0,0,150
27055,25631209,25631209,25719615,0,0,0,88406
27121,25719572,25719572,25719728,0,0,0,156
27122,25719677,25719677,25719827,0,0,0,150
27058,25631242,25631242,25720512,0,0,0,89270
27105,25695000,25695000,25721215,0,0,0,26215
27125,25721645,25721645,25721718,0,0,0,73
27106,25695830,25695830,25721923,0,0,0,26093
27127,25722380,25722380,25722454,0,0,0,74
27056,25631221,25631221,25722541,0,0,0,91320
27139,25723975,25723975,25724048,0,0,0,73
27141,25724583,25724583,25724656,0,0,0,73
27142,25725067,25725067,25725141,0,0,0,74
27143,25725246,25725246,25725330,0,0,0,84
27144,25725315,25725315,25725419,0,0,0,104
27145,25726309,25726309,25726413,0,0,0,104
27146,25726591,25726591,25726858,0,0,0,267
27147,25727617,25727617,25728135,0,0,0,518
27148,25728592,25728592,25728727,0,0,0,135
27149,25729095,25729095,25729169,0,0,0,74
27112,25707117,25707117,25730572,0,0,0,23455
27114,25707270,25707270,25730892,0,0,0,23622
27152,25731022,25731022,25731095,0,0,0,73
27153,25731121,25731121,25731194,0,0,0,73
27001,25618039,25618039,25731918,0,0,0,113879
27110,25703207,25703207,25732851,0,0,0,29644
26964,25613301,25613301,25732854,0,0,0,119553
27154,25732808,25732808,25732959,0,0,0,151
27116,25719078,25719078,25734993,0,0,0,15915
27119,25719401,25719401,25735438,0,0,0,16037
27123,25719786,25719786,25745511,0,0,0,25725
27158,25745470,25745470,25745658,0,0,0,188
27118,25719384,25719384,25745992,0,0,0,26608
27124,25721182,25721182,25747875,0,0,0,26693
27002,25618064,25618064,25747981,0,0,0,129917
27126,25721880,25721880,25748229,0,0,0,26349
27162,25748185,25748185,25748334,0,0,0,149
27156,25734952,25734952,25750929,0,0,0,15977
27157,25735392,25735392,25751312,0,0,0,15920
27150,25730538,25730538,25753935,0,0,0,23397
27151,25730853,25730853,25754352,0,0,0,23499
26921,25605353,25605353,25756053,0,0,0,150700
27155,25732917,25732917,25762524,0,0,0,29607
27060,25631441,25631441,25766661,0,0,0,135220
27164,25750893,25750893,25766716,0,0,0,15823
27165,25751274,25751274,25767209,0,0,0,15935
27159,25745617,25745617,25771338,0,0,0,25721
27160,25745951,25745951,25772401,0,0,0,26450
27161,25747828,25747828,25773963,0,0,0,26135
27163,25748293,25748293,25773998,0,0,0,25705
27166,25753890,25753890,25777430,0,0,0,23540
27167,25754310,25754310,25778352,0,0,0,24042
27169,25766673,25766673,25782447,0,0,0,15774
27170,25767168,25767168,25782971,0,0,0,15803
26920,25605344,25605344,25783757,0,0,0,178413
27179,25787253,25787253,25787276,0,0,0,23
27168,25762480,25762480,25792155,0,0,0,29675
27187,25793617,25793617,25793640,0,0,0,23
27171,25771296,25771296,25797655,0,0,0,26359
27177,25782403,25782403,25798115,0,0,0,15712
27178,25782933,25782933,25798735,0,0,0,15802
27172,25772359,25772359,25798903,0,0,0,26544
27174,25773954,25773954,25800021,0,0,0,26067
27173,25773917,25773917,25800138,0,0,0,26221
27175,25777389,25777389,25800786,0,0,0,23397
27176,25778310,25778310,25802567,0,0,0,24257
27198,25805559,25805559,25805636,0,0,0,77
27199,25805760,25805760,25805831,0,0,0,71
27200,25806566,25806566,25806645,0,0,0,79
27201,25807071,25807071,25807217,0,0,0,146
27202,25810428,25810428,25810506,0,0,0,78
27203,25810984,25810984,25811085,0,0,0,101
27204,25811108,25811108,25811209,0,0,0,101
27206,25811213,25811213,25811237,0,0,0,24
27205,25811180,25811180,25811302,0,0,0,122
27208,25811474,25811474,25811497,0,0,0,23
27209,25813738,25813738,25813796,0,0,0,58
27191,25798070,25798070,25813967,0,0,0,15897
27192,25798691,25798691,25814414,0,0,0,15723
27010,25618380,25618380,25814598,0,0,0,196218
27212,25814674,25814674,25814697,0,0,0,23
27012,25618433,25618433,25814707,0,0,0,196274
27207,25811263,25811263,25814792,0,0,0,3529
27213,25815688,25815688,25815711,0,0,0,23
27185,25792112,25792112,25822140,0,0,0,30028
27218,25824077,25824077,25824116,0,0,0,39
27190,25797614,25797614,25824228,0,0,0,26614
27196,25800742,25800742,25824828,0,0,0,24086
27193,25798854,25798854,25825490,0,0,0,26636
27194,25799979,25799979,25826212,0,0,0,26233
27197,25802523,25802523,25826530,0,0,0,24007
27195,25800102,25800102,25826739,0,0,0,26637
27210,25813932,25813932,25830035,0,0,0,16103
27211,25814368,25814368,25830319,0,0,0,15951
27214,25818159,25818159,25834454,0,0,0,16295
27188,25793676,25793676,25836532,0,0,0,42856
27217,25824038,25824038,25837039,0,0,0,13001
27053,25629761,25629761,25838561,0,0,0,208800
27059,25631370,25631370,25840170,0,0,0,208800
27226,25829994,25829994,25846149,0,0,0,16155
27227,25830274,25830274,25846367,0,0,0,16093
27219,25824129,25824129,25846389,0,0,0,22260
27215,25818275,25818275,25848098,0,0,0,29823
27231,25848048,25848048,25848199,0,0,0,151
27221,25824778,25824778,25848985,0,0,0,24207
27220,25824178,25824178,25849872,0,0,0,25694
27228,25834412,25834412,25850694,0,0,0,16282
27224,25826489,25826489,25850708,0,0,0,24219
27216,25822092,25822092,25851501,0,0,0,29409
27222,25825454,25825454,25851977,0,0,0,26523
27223,25826170,25826170,25852361,0,0,0,26191
27225,25826696,25826696,25853544,0,0,0,26848
27242,25860128,25860128,25860152,0,0,0,24
27244,25860780,25860780,25860803,0,0,0,23
27241,25857424,25857424,25861106,0,0,0,3682
27246,25862151,25862151,25862180,0,0,0,29
27247,25862166,25862166,25862193,0,0,0,27
27248,25862176,25862193,25862261,0,0,17,85
27249,25862184,25862261,25862333,0,0,77,149
27229,25846108,25846108,25862351,0,0,0,16243
27250,25862309,25862333,25862510,0,0,24,201
27230,25846319,25846319,25862548,0,0,0,16229
27253,25862586,25862586,25862636,0,0,0,50
27255,25862750,25862750,25862773,0,0,0,23
27257,25863109,25863109,25863132,0,0,0,23
27258,25863302,25863302,25863325,0,0,0,23
27259,25863316,25863316,25863339,0,0,0,23
27261,25863415,25863415,25863439,0,0,0,24
27262,25863585,25863585,25863608,0,0,0,23
27256,25862926,25862926,25863658,0,0,0,732
27263,25864069,25864069,25864093,0,0,0,24
27264,25864084,25864084,25864167,0,0,0,83
27189,25793732,25793732,25864371,0,0,0,70639
27265,25864595,25864595,25864678,0,0,0,83
26924,25606086,25606086,25865286,0,0,0,259200
26925,25606088,25606088,25865288,0,0,0,259200
27266,25865329,25865329,25865422,0,0,0,93
27235,25850653,25850653,25866884,0,0,0,16231
27277,25867268,25867268,25867292,0,0,0,24
27278,25867586,25867586,25867624,0,0,0,38
27279,25867860,25867860,25867909,0,0,0,49
27281,25867941,25867941,25867990,0,0,0,49
27282,25868015,25868015,25868069,0,0,0,54
27284,25868050,25868050,25868088,0,0,0,38
27269,25866548,25866548,25868097,0,0,0,1549
27272,25866588,25866588,25868116,0,0,0,1528
27243,25860470,25860470,25868416,0,0,0,7946
27276,25867162,25867162,25868453,0,0,0,1291
27273,25866596,25866596,25868561,0,0,0,1965
27287,25868733,25868733,25868786,0,0,0,53
27288,25868759,25868759,25868845,0,0,0,86
27290,25869064,25869064,25869107,0,0,0,43
27291,25869075,25869075,25869259,0,0,0,184
27270,25866562,25866562,25869301,0,0,0,2739
27271,25866571,25866571,25869305,0,0,0,2734
27268,25865833,25865833,25869314,0,0,0,3481
27014,25618629,25618629,25869315,0,0,0,250686
27274,25866636,25866636,25869315,0,0,0,2679
27128,25722892,25722892,25869330,0,0,0,146438
27129,25722892,25722892,25869330,0,0,0,146438
27130,25722893,25722893,25869331,0,0,0,146438
27131,25722893,25722893,25869331,0,0,0,146438
27132,25722893,25722893,25869331,0,0,0,146438
27133,25722893,25722893,25869331,0,0,0,146438
27134,25722893,25722893,25869331,0,0,0,146438
27294,25869330,25869330,25869367,0,0,0,37
27280,25867912,25867912,25869406,0,0,0,1494
27289,25868779,25868779,25869408,0,0,0,629
27251,25862312,25862312,25869414,0,0,0,7102
27240,25853503,25853503,25869416,0,0,0,15913
27286,25868586,25868586,25869416,0,0,0,830
27237,25851456,25851456,25869418,0,0,0,17962
27239,25852313,25852313,25869420,0,0,0,17107
27252,25862517,25862517,25869420,0,0,0,6903
27232,25848165,25848165,25869421,0,0,0,21256
27236,25850666,25850666,25869421,0,0,0,18755
27233,25848949,25848949,25869422,0,0,0,20473
27285,25868236,25868236,25869422,0,0,0,1186
27238,25851931,25851931,25869423,0,0,0,17492
27275,25866846,25866846,25869423,0,0,0,2577
27292,25869146,25869146,25869423,0,0,0,277
27234,25849838,25849838,25869426,0,0,0,19588
27283,25868015,25868015,25869426,0,0,0,1411
27295,25869401,25869401,25869485,0,0,0,84
27267,25865603,25865603,25869530,0,0,0,3927
27186,25793490,25793490,25869531,0,0,0,76041
27137,25723192,25723192,25869532,0,0,0,146340
27182,25788237,25788237,25869533,0,0,0,81296
27245,25862054,25862054,25869534,0,0,0,7480
27135,25723029,25723029,25869538,0,0,0,146509
27254,25862747,25862747,25869538,0,0,0,6791
27136,25723191,25723191,25869543,0,0,0,146352
27140,25724293,25724293,25869543,0,0,0,145250
27180,25787799,25787799,25869543,0,0,0,81744
27181,25787952,25787952,25869543,0,0,0,81591
27183,25788373,25788373,25869543,0,0,0,81170
27184,25788500,25788500,25869543,0,0,0,81043
27260,25863346,25863346,25869565,0,0,0,6219
27293,25869272,25869272,25869602,0,0,0,330
27297,25869752,25869752,25869792,0,0,0,40
27138,25723192,25723192,25870137,0,0,0,146945
27298,25871044,25871044,25871111,0,0,0,67
27300,25871212,25871212,25871235,0,0,0,23
27302,25871684,25871684,25871718,0,0,0,34
27303,25871822,25871822,25871860,0,0,0,38
27296,25869671,25869671,25872165,0,0,0,2494
27299,25871161,25871161,25872179,0,0,0,1018
27312,25872773,25872773,25872797,0,0,0,24
27313,25873366,25873366,25873438,0,0,0,72
27317,25874964,25874964,25875029,0,0,0,65
27308,25872029,25872029,25875224,0,0,0,3195
27320,25875362,25875362,25875387,0,0,0,25
27322,25876563,25876563,25876614,0,0,0,51
27323,25876592,25876592,25876693,0,0,0,101
27315,25873435,25873435,25876704,0,0,0,3269
27324,25876999,25876999,25877097,0,0,0,98
27301,25871436,25871436,25877288,0,0,0,5852
27325,25877470,25877470,25877493,0,0,0,23
27327,25877537,25877537,25877634,0,0,0,97
27328,25877553,25877553,25877657,0,0,0,104
27326,25877504,25877504,25877699,0,0,0,195
27329,25877946,25877946,25878015,0,0,0,69
27330,25877972,25877972,25878070,0,0,0,98
27331,25878051,25878051,25878124,0,0,0,73
27332,25878122,25878122,25878213,0,0,0,91
27333,25878154,25878154,25878229,0,0,0,75
27335,25878270,25878270,25878292,0,0,0,22
27334,25878242,25878242,25878303,0,0,0,61
27336,25878271,25878271,25878392,0,0,0,121
27337,25878322,25878322,25878419,0,0,0,97
27338,25878614,25878614,25878718,0,0,0,104
27341,25878697,25878697,25878730,0,0,0,33
27339,25878650,25878650,25878731,0,0,0,81
27316,25874682,25874682,25878765,0,0,0,4083
27343,25878911,25878911,25878973,0,0,0,62
27344,25878999,25878999,25879105,0,0,0,106
27345,25879185,25879185,25879252,0,0,0,67
27342,25878769,25878769,25879282,0,0,0,513
27348,25879380,25879380,25879449,0,0,0,69
27347,25879265,25879265,25879568,0,0,0,303
27349,25879520,25879520,25879575,0,0,0,55
27350,25879536,25879536,25879667,0,0,0,131
27351,25879659,25879659,25879770,0,0,0,111
27353,25879867,25879867,25879936,0,0,0,69
27354,25879957,25879957,25880035,0,0,0,78
27352,25879754,25879754,25880069,0,0,0,315
27355,25880019,25880019,25880074,0,0,0,55
27357,25880048,25880048,25880120,0,0,0,72
27356,25880038,25880038,25880165,0,0,0,127
27360,25880134,25880134,25880212,0,0,0,78
27366,25880412,25880412,25880689,0,0,0,277
27369,25880695,25880695,25880750,0,0,0,55
27361,25880206,25880206,25880754,0,0,0,548
27346,25879215,25879215,25881239,0,0,0,2024
27370,25880710,25880710,25881310,0,0,0,600
27371,25880809,25880809,25881409,0,0,0,600
27372,25881169,25881169,25881568,0,0,0,399
27374,25882613,25882613,25882636,0,0,0,23
27318,25875007,25875007,25883917,0,0,0,8910
27311,25872731,25872731,25884022,0,0,0,11291
27306,25871975,25871975,25884124,0,0,0,12149
27340,25878651,25878651,25884124,0,0,0,5473
27367,25880591,25880591,25884124,0,0,0,3533
27368,25880613,25880613,25884124,0,0,0,3511
27314,25873402,25873402,25884125,0,0,0,10723
27365,25880359,25880359,25884125,0,0,0,3766
27362,25880255,25880255,25884127,0,0,0,3872
27363,25880290,25880290,25884128,0,0,0,3838
27307,25871994,25871994,25884132,0,0,0,12138
27309,25872195,25872195,25884132,0,0,0,11937
27319,25875256,25875256,25884132,0,0,0,8876
27304,25871830,25871830,25884134,0,0,0,12304
27358,25880107,25880107,25884134,0,0,0,4027
27305,25871974,25871974,25884135,0,0,0,12161
27310,25872228,25872228,25884135,0,0,0,11907
27321,25875653,25875653,25884135,0,0,0,8482
27364,25880325,25880325,25884135,0,0,0,3810
27375,25884201,25884201,25884438,0,0,0,237
27380,25884659,25884659,25884692,0,0,0,33
27381,25884690,25884690,25884907,0,0,0,217
27382,25884716,25884716,25885000,0,0,0,284
27383,25884926,25884926,25885242,0,0,0,316
27385,25885275,25885275,25885363,0,0,0,88
27379,25884493,25884493,25885819,0,0,0,1326
27386,25885780,25885780,25885952,0,0,0,172
27387,25886089,25886089,25886164,0,0,0,75
27388,25886312,25886312,25886401,0,0,0,89
27402,25887277,25887277,25887362,0,0,0,85
27403,25887355,25887362,25887437,0,0,7,82
27404,25887618,25887618,25887788,0,0,0,170
27405,25887619,25887619,25887800,0,0,0,181
27406,25887619,25887619,25888146,0,0,0,527
27413,25890875,25890875,25890899,0,0,0,24
27414,25891193,25891193,25891381,0,0,0,188
27415,25891258,25891258,25891422,0,0,0,164
27419,25891572,25891572,25891681,0,0,0,109
27420,25891879,25891879,25892069,0,0,0,190
27422,25892426,25892426,25892474,0,0,0,48
27421,25892232,25892232,25892751,0,0,0,519
27430,25892664,25892664,25892818,0,0,0,154
27426,25892571,25892571,25892847,0,0,0,276
27433,25892802,25892802,25893070,0,0,0,268
27435,25894053,25894053,25894104,0,0,0,51
27436,25894661,25894661,25894683,0,0,0,22
27437,25895126,25895126,25895149,0,0,0,23
27438,25895819,25895819,25895841,0,0,0,22
27441,25895890,25895890,25895913,0,0,0,23
27439,25895871,25895871,25896113,0,0,0,242
27440,25895882,25895882,25896113,0,0,0,231
27442,25896171,25896171,25896193,0,0,0,22
27445,25897044,25897044,25897066,0,0,0,22
27431,25892706,25892706,25898344,0,0,0,5638
27447,25899535,25899535,25899588,0,0,0,53
27449,25899618,25899618,25899640,0,0,0,22
27448,25899577,25899577,25899708,0,0,0,131
27450,25900181,25900181,25900204,0,0,0,23
27452,25900230,25900230,25900252,0,0,0,22
27444,25896619,25896619,25900336,0,0,0,3717
27454,25900349,25900349,25903390,0,0,0,3041
27457,25903486,25903486,25903508,0,0,0,22
27456,25903473,25903473,25903640,0,0,0,167
27458,25903841,25903841,25903863,0,0,0,22
27459,25904211,25904211,25904234,0,0,0,23
27451,25900215,25900215,25907009,0,0,0,6794
27418,25891488,25891488,25907695,0,0,0,16207
27416,25891434,25891434,25907762,0,0,0,16328
27417,25891458,25891458,25907762,0,0,0,16304
27463,25908004,25908004,25908026,0,0,0,22
27464,25908137,25908137,25908160,0,0,0,23
27466,25908969,25908969,25909023,0,0,0,54
27467,25909027,25909027,25909049,0,0,0,22
27423,25892499,25892499,25916107,0,0,0,23608
27424,25892519,25892519,25916603,0,0,0,24084
27428,25892613,25892613,25918574,0,0,0,25961
27432,25892779,25892779,25919092,0,0,0,26313
27429,25892644,25892644,25919130,0,0,0,26486
27478,25919050,25919050,25919215,0,0,0,165
27427,25892592,25892592,25919442,0,0,0,26850
27434,25893073,25893073,25920960,0,0,0,27887
27425,25892541,25892541,25921906,0,0,0,29365
27460,25907650,25907650,25923803,0,0,0,16153
27461,25907712,25907712,25924038,0,0,0,16326
27462,25907728,25907728,25924067,0,0,0,16339
27470,25913769,25913769,25924966,0,0,0,11197
27471,25913795,25913795,25929715,0,0,0,15920
27472,25913844,25913844,25935301,0,0,0,21457
27475,25916064,25916064,25939591,0,0,0,23527
27483,25923760,25923760,25939919,0,0,0,16159
27484,25924003,25924003,25940311,0,0,0,16308
27485,25924082,25924082,25940420,0,0,0,16338
27476,25916559,25916559,25940787,0,0,0,24228
27408,25889559,25889559,25942846,0,0,0,53287
27486,25942863,25942863,25942938,0,0,0,75
27465,25908507,25908507,25943072,0,0,0,34565
27373,25881881,25881881,25944794,0,0,0,62913
27479,25919087,25919087,25945119,0,0,0,26032
27477,25918687,25918687,25945684,0,0,0,26997
27480,25919402,25919402,25946115,0,0,0,26713
27376,25884331,25884331,25947657,0,0,0,63326
27446,25899471,25899471,25948468,0,0,0,48997
27474,25913921,25913921,25948958,0,0,0,35037
27481,25920971,25920971,25949781,0,0,0,28810
27492,25950367,25950367,25950657,0,0,0,290
27482,25921864,25921864,25951531,0,0,0,29667
27493,25952364,25952364,25952652,0,0,0,288
27494,25952604,25952604,25953204,0,0,0,600
27489,25947070,25947070,25954453,0,0,0,7383
27496,25954782,25954782,25954960,0,0,0,178
27497,25954843,25954843,25954982,0,0,0,139
27498,25954977,25954977,25955116,0,0,0,139
27495,25954718,25954718,25955675,0,0,0,957
27500,25957587,25957587,25957657,0,0,0,70
27501,25957829,25957829,25957900,0,0,0,71
27499,25957528,25957528,25958198,0,0,0,670
27502,25958333,25958333,25958491,0,0,0,158
27503,25958792,25958792,25958861,0,0,0,69
27504,25958972,25958972,25959134,0,0,0,162
27505,25959655,25959655,25960127,0,0,0,472
27506,25960440,25960440,25960587,0,0,0,147
27507,25961926,25961926,25962020,0,0,0,94
27508,25962138,25962138,25962317,0,0,0,179
27509,25962240,25962240,25962327,0,0,0,87
27510,25962998,25962998,25963305,0,0,0,307
27511,25963007,25963305,25963484,0,0,298,477
27512,25963009,25963305,25963484,0,0,296,475
27513,25963011,25963305,25963495,0,0,294,484
27514,25964211,25964211,25964390,0,0,0,179
27515,25964625,25964625,25964712,0,0,0,87
27516,25965004,25965004,25965185,0,0,0,181
27455,25903408,25903408,25965455,0,0,0,62047
27443,25896505,25896505,25965465,0,0,0,68960
27517,25965251,25965251,25965533,0,0,0,282
27518,25967031,25967031,25967209,0,0,0,178
27519,25967364,25967364,25967412,0,0,0,48
27520,25967593,25967593,25967632,0,0,0,39
27521,25967766,25967766,25967813,0,0,0,47
27522,25968310,25968310,25968354,0,0,0,44
27395,25886818,25886818,25970914,0,0,0,84096
27391,25886817,25886817,25976910,0,0,0,90093
27528,25976450,25976450,25976986,0,0,0,536
27529,25976955,25976955,25977072,0,0,0,117
27530,25977378,25977378,25977978,0,0,0,600
27527,25975084,25975084,25978648,0,0,0,3564
27491,25949098,25949098,25980159,0,0,0,31061
27409,25889599,25889599,25980369,0,0,0,90770
27410,25889659,25889659,25980419,0,0,0,90760
27473,25913875,25913875,25981847,0,0,0,67972
27359,25880124,25880124,25982656,0,0,0,102532
27396,25886818,25886818,25988683,0,0,0,101865
27397,25886818,25886818,25990713,0,0,0,103895
27536,25994562,25994562,25994713,0,0,0,151
27523,25968696,25968696,25994792,0,0,0,26096
27537,25994675,25994675,25994825,0,0,0,150
27487,25946088,25946088,25995515,0,0,0,49427
27542,25997336,25997336,25997482,0,0,0,146
27412,25889732,25889732,25997813,0,0,0,108081
27544,25998196,25998196,25998342,0,0,0,146
27545,25998299,25998299,25998449,0,0,0,150
27531,25984680,25984680,26000688,0,0,0,16008
27532,25984834,25984834,26001194,0,0,0,16360
27533,25984868,25984868,26001213,0,0,0,16345
27389,25886605,25886605,26001912,0,0,0,115307
27392,25886817,25886817,26005823,0,0,0,119006
27534,25992053,25992053,26015939,0,0,0,23886
27535,25992758,25992758,26016382,0,0,0,23624
27547,26000654,26000654,26016594,0,0,0,15940
27549,26001172,26001172,26017437,0,0,0,16265
27548,26001144,26001144,26017451,0,0,0,16307
27538,25994753,25994753,26020954,0,0,0,26201
27525,25971788,25971788,26020963,0,0,0,49175
27539,25994784,25994784,26020967,0,0,0,26183
27554,26020913,26020913,26021068,0,0,0,155
27556,26021027,26021027,26021177,0,0,0,150
27557,26021138,26021138,26021294,0,0,0,156
27558,26021253,26021253,26021400,0,0,0,147
27559,26021359,26021359,26021506,0,0,0,147
27540,25995238,25995238,26021689,0,0,0,26451
27555,26020927,26020927,26021851,0,0,0,924
27541,25995526,25995526,26021894,0,0,0,26368
27562,26021805,26021805,26022734,0,0,0,929
27543,25997444,25997444,26027931,0,0,0,30487
27546,25998407,25998407,26028115,0,0,0,29708
27566,26028073,26028073,26028221,0,0,0,148
27569,26029065,26029065,26029545,0,0,0,480
27571,26029202,26029202,26029743,0,0,0,541
27570,26029113,26029113,26029749,0,0,0,636
27568,26028959,26028959,26030185,0,0,0,1226
27384,25885149,25885149,26032531,0,0,0,147382
27490,25947704,25947704,26032565,0,0,0,84861
27551,26016551,26016551,26032577,0,0,0,16026
27526,25974062,25974062,26032659,0,0,0,58597
27488,25946318,25946318,26032718,0,0,0,86400
27574,26032510,26032510,26032744,0,0,0,234
27572,26032335,26032335,26032899,0,0,0,564
27578,26032666,26032666,26032927,0,0,0,261
27581,26032823,26032823,26032981,0,0,0,158
27583,26033087,26033087,26033171,0,0,0,84
27577,26032637,26032637,26033237,0,0,0,600
27584,26033222,26033222,26033299,0,0,0,77
27585,26033320,26033320,26033396,0,0,0,76
27586,26033475,26033475,26033539,0,0,0,64
27580,26032727,26032727,26033557,0,0,0,830
27582,26032867,26032867,26033616,0,0,0,749
27588,26033543,26033543,26033632,0,0,0,89
27552,26017393,26017393,26033673,0,0,0,16280
27587,26033521,26033521,26033696,0,0,0,175
27553,26017410,26017410,26033698,0,0,0,16288
27573,26032404,26032404,26033736,0,0,0,1332
27589,26033574,26033574,26033748,0,0,0,174
27593,26033692,26033692,26033788,0,0,0,96
27377,25884337,25884337,26033855,0,0,0,149518
27378,25884343,25884343,26033861,0,0,0,149518
27595,26033765,26033765,26033870,0,0,0,105
27596,26033845,26033845,26033963,0,0,0,118
27598,26033954,26033954,26034178,0,0,0,224
27599,26034165,26034165,26034299,0,0,0,134
27600,26034275,26034275,26034361,0,0,0,86
27594,26033714,26033714,26034396,0,0,0,682
27601,26034409,26034409,26034505,0,0,0,96
27602,26034493,26034493,26034625,0,0,0,132
27524,25969407,25969407,26034823,0,0,0,65416
27579,26032689,26032689,26034841,0,0,0,2152
27591,26033642,26033642,26034929,0,0,0,1287
27603,26034802,26034802,26034937,0,0,0,135
27597,26033927,26033927,26035056,0,0,0,1129
27605,26035355,26035355,26035440,0,0,0,85
27607,26035790,26035790,26035848,0,0,0,58
27614,26036775,26036775,26036848,0,0,0,73
27610,26036175,26036175,26037078,0,0,0,903
27617,26037045,26037045,26037129,0,0,0,84
27576,26032565,26032565,26037262,0,0,0,4697
27618,26037181,26037181,26037269,0,0,0,88
27619,26037330,26037330,26037426,0,0,0,96
27620,26037485,26037485,26037541,0,0,0,56
27628,26038800,26038800,26038873,0,0,0,73
27627,26038786,26038786,26038881,0,0,0,95
27608,26035843,26035843,26038994,0,0,0,3151
27606,26035435,26035435,26039035,0,0,0,3600
27623,26038650,26038650,26039325,0,0,0,675
27624,26038671,26038671,26039344,0,0,0,673
27625,26038680,26038680,26039352,0,0,0,672
27626,26038699,26038699,26039375,0,0,0,676
27550,26016335,26016335,26039601,0,0,0,23266
27629,26039239,26039239,26039605,0,0,0,366
27621,26037561,26037561,26039929,0,0,0,2368
27631,26039684,26039684,26040025,0,0,0,341
27632,26040165,26040165,26040228,0,0,0,63
27635,26040253,26040253,26040326,0,0,0,73
27636,26040324,26040324,26040402,0,0,0,78
27633,26040165,26040165,26040518,0,0,0,353
27637,26040331,26040331,26040684,0,0,0,353
27639,26040696,26040696,26040739,0,0,0,43
27640,26040717,26040717,26040757,0,0,0,40
27634,26040193,26040193,26040924,0,0,0,731
27643,26041038,26041038,26041122,0,0,0,84
27641,26040811,26040811,26041182,0,0,0,371
27642,26040992,26040992,26041202,0,0,0,210
27644,26041219,26041219,26041454,0,0,0,235
27622,26038507,26038507,26041724,0,0,0,3217
27638,26040352,26040352,26041747,0,0,0,1395
27646,26041782,26041782,26041850,0,0,0,68
27648,26041875,26041875,26041964,0,0,0,89
27652,26042345,26042345,26042431,0,0,0,86
27653,26042409,26042409,26042489,0,0,0,80
27651,26042064,26042064,26042547,0,0,0,483
27654,26042435,26042435,26042798,0,0,0,363
27655,26042730,26042730,26042824,0,0,0,94
27647,26041792,26041792,26045059,0,0,0,3267
27407,25887633,25887633,26045200,0,0,0,157567
27657,26045408,26045408,26045481,0,0,0,73
27649,26041910,26041910,26045523,0,0,0,3613
27650,26042015,26042015,26045977,0,0,0,3962
27656,26045049,26045049,26046537,0,0,0,1488
27658,26046143,26046143,26047284,0,0,0,1141
27666,26047271,26047271,26047350,0,0,0,79
27662,26047226,26047226,26047427,0,0,0,201
27667,26047318,26047318,26047508,0,0,0,190
27670,26047454,26047454,26047771,0,0,0,317
27664,26047252,26047252,26047829,0,0,0,577
27673,26047603,26047603,26047839,0,0,0,236
27560,26021474,26021474,26047976,0,0,0,26502
27663,26047250,26047250,26048048,0,0,0,798
27665,26047265,26047265,26048052,0,0,0,787
27676,26047934,26047934,26048095,0,0,0,161
27668,26047396,26047396,26048138,0,0,0,742
27677,26048054,26048054,26048203,0,0,0,149
27561,26021652,26021652,26048220,0,0,0,26568
27672,26047544,26047544,26048267,0,0,0,723
27575,26032531,26032531,26048483,0,0,0,15952
27564,26022686,26022686,26048558,0,0,0,25872
27563,26021845,26021845,26048667,0,0,0,26822
27684,26048541,26048541,26048692,0,0,0,151
27675,26047749,26047749,26048714,0,0,0,965
27674,26047703,26047703,26048880,0,0,0,1177
27689,26049106,26049106,26049270,0,0,0,164
27688,26049057,26049057,26049307,0,0,0,250
27687,26049051,26049051,26049369,0,0,0,318
27690,26049129,26049129,26049390,0,0,0,261
27411,25889713,25889713,26049445,0,0,0,159732
27590,26033628,26033628,26049890,0,0,0,16262
27592,26033651,26033651,26049911,0,0,0,16260
27693,26050255,26050255,26050410,0,0,0,155
27694,26050448,26050448,26050604,0,0,0,156
27696,26051251,26051251,26051401,0,0,0,150
27695,26050935,26050935,26051466,0,0,0,531
27697,26051982,26051982,26052139,0,0,0,157
27698,26052288,26052288,26052376,0,0,0,88
27680,26048212,26048212,26052407,0,0,0,4195
27700,26052764,26052764,26052952,0,0,0,188
27701,26052782,26052782,26053310,0,0,0,528
27705,26053688,26053688,26053743,0,0,0,55
27393,25886817,25886817,26054074,0,0,0,167257
27704,26053464,26053464,26054178,0,0,0,714
27707,26054289,26054289,26054378,0,0,0,89
27706,26053741,26053741,26054622,0,0,0,881
27671,26047504,26047504,26055164,0,0,0,7660
27710,26055330,26055330,26055400,0,0,0,70
27660,26046584,26046584,26055797,0,0,0,9213
27703,26053445,26053445,26055893,0,0,0,2448
27711,26055527,26055527,26055924,0,0,0,397
27713,26056110,26056110,26056297,0,0,0,187
27659,26046555,26046555,26056312,0,0,0,9757
27715,26056656,26056656,26056791,0,0,0,135
27714,26056427,26056427,26056836,0,0,0,409
27699,26052659,26052659,26056980,0,0,0,4321
27681,26048269,26048269,26056992,0,0,0,8723
27604,26034802,26034802,26057281,0,0,0,22479
27565,26027883,26027883,26057732,0,0,0,29849
27719,26057695,26057695,26057847,0,0,0,152
27720,26057800,26057800,26057962,0,0,0,162
27567,26028179,26028179,26058121,0,0,0,29942
27717,26056933,26056933,26059555,0,0,0,2622
27716,26056931,26056931,26059582,0,0,0,2651
27723,26059537,26059537,26059865,0,0,0,328
27724,26059557,26059557,26059869,0,0,0,312
27718,26057552,26057552,26061132,0,0,0,3580
27725,26059821,26059821,26061612,0,0,0,1791
27728,26062726,26062726,26062773,0,0,0,47
27729,26062930,26062930,26062977,0,0,0,47
27730,26063021,26063021,26063079,0,0,0,58
27630,26039563,26039563,26063465,0,0,0,23902
27712,26055870,26055870,26063545,0,0,0,7675
27732,26063482,26063482,26063545,0,0,0,63
27682,26048443,26048443,26064292,0,0,0,15849
27735,26065701,26065701,26065810,0,0,0,109
27691,26049842,26049842,26066156,0,0,0,16314
27692,26049877,26049877,26066213,0,0,0,16336
27453,25900256,25900256,26069802,0,0,0,169546
27678,26048167,26048167,26074481,0,0,0,26314
27683,26048516,26048516,26074574,0,0,0,26058
27679,26048177,26048177,26074876,0,0,0,26699
27685,26048632,26048632,26075040,0,0,0,26408
27645,26041612,26041612,26075280,0,0,0,33668
27734,26064260,26064260,26079978,0,0,0,15718
27745,26076055,26076055,26080507,0,0,0,4452
27468,25909071,25909071,26081871,0,0,0,172800
27738,26066163,26066163,26082458,0,0,0,16295
27737,26066121,26066121,26082469,0,0,0,16348
27609,26036002,26036002,26084786,0,0,0,48784
27731,26063147,26063147,26084878,0,0,0,21731
27613,26036627,26036627,26085420,0,0,0,48793
27722,26058071,26058071,26087924,0,0,0,29853
27721,26057911,26057911,26088278,0,0,0,30367
27753,26087890,26087890,26088742,0,0,0,852
27755,26088701,26088701,26089548,0,0,0,847
27727,26061566,26061566,26091985,0,0,0,30419
27394,25886817,25886817,26095075,0,0,0,208258
27750,26079941,26079941,26095988,0,0,0,16047
27748,26076610,26076610,26097906,0,0,0,21296
27752,26082428,26082428,26098719,0,0,0,16291
27751,26082426,26082426,26098757,0,0,0,16331
27741,26074438,26074438,26100187,0,0,0,25749
27742,26074539,26074539,26100695,0,0,0,26156
27726,26059842,26059842,26101147,0,0,0,41305
27743,26074835,26074835,26101382,0,0,0,26547
27744,26074998,26074998,26101614,0,0,0,26616
27740,26072389,26072389,26106829,0,0,0,34440
27757,26095946,26095946,26112209,0,0,0,16263
27758,26098685,26098685,26114867,0,0,0,16182
27759,26098717,26098717,26114985,0,0,0,16268
27747,26076586,26076586,26116912,0,0,0,40326
27616,26036990,26036990,26117874,0,0,0,80884
27754,26088237,26088237,26118070,0,0,0,29833
27756,26089512,26089512,26119158,0,0,0,29646
27772,26119478,26119478,26119522,0,0,0,44
27773,26119758,26119758,26119829,0,0,0,71
27774,26120577,26120577,26120650,0,0,0,73
27775,26121035,26121035,26121111,0,0,0,76
27777,26123024,26123024,26123459,0,0,0,435
27778,26123338,26123338,26123532,0,0,0,194
27779,26123479,26123479,26123564,0,0,0,85
27780,26123622,26123622,26123670,0,0,0,48
27781,26123871,26123871,26124052,0,0,0,181
27782,26124065,26124065,26124138,0,0,0,73
27783,26124152,26124152,26124220,0,0,0,68
27784,26124196,26124196,26124316,0,0,0,120
27785,26124313,26124313,26124403,0,0,0,90
27786,26124575,26124575,26124687,0,0,0,112
27788,26124678,26124678,26124796,0,0,0,118
27790,26124824,26124824,26124944,0,0,0,120
27789,26124780,26124780,26124965,0,0,0,185
27794,26124955,26124955,26125071,0,0,0,116
27787,26124668,26124668,26125091,0,0,0,423
27791,26124922,26124922,26125117,0,0,0,195
27796,26125105,26125105,26125251,0,0,0,146
27749,26076924,26076924,26125295,0,0,0,48371
27797,26125261,26125261,26125409,0,0,0,148
27792,26124933,26125117,26125411,0,0,184,478
27469,25913682,25913682,26125645,0,0,0,211963
27793,26124948,26125411,26125674,0,0,463,726
27799,26125683,26125683,26125779,0,0,0,96
27798,26125406,26125406,26125848,0,0,0,442
27800,26125747,26125747,26125904,0,0,0,157
27801,26125876,26125876,26125915,0,0,0,39
27802,26126041,26126041,26126081,0,0,0,40
27760,26100144,26100144,26126209,0,0,0,26065
27804,26126166,26126166,26126316,0,0,0,150
27806,26126428,26126428,26126460,0,0,0,32
27803,26126149,26126149,26126475,0,0,0,326
27761,26100644,26100644,26126893,0,0,0,26249
27807,26126534,26126534,26126956,0,0,0,422
27611,26036340,26036340,26127110,0,0,0,90770
27816,26127363,26127363,26127489,0,0,0,126
27812,26127268,26127268,26127524,0,0,0,256
27763,26101570,26101570,26128193,0,0,0,26623
27764,26112163,26112163,26128349,0,0,0,16186
27762,26101340,26101340,26128365,0,0,0,27025
27820,26128018,26128018,26128417,0,0,0,399
27824,26128342,26128342,26129918,0,0,0,1576
27825,26128354,26128354,26129971,0,0,0,1617
27827,26130376,26130376,26130491,0,0,0,115
27828,26130447,26130447,26130529,0,0,0,82
27829,26130478,26130478,26130554,0,0,0,76
27831,26130831,26130831,26130926,0,0,0,95
27765,26114825,26114825,26131060,0,0,0,16235
27830,26130528,26130528,26131079,0,0,0,551
27767,26114938,26114938,26131113,0,0,0,16175
27835,26131969,26131969,26132037,0,0,0,68
27836,26131986,26131986,26132054,0,0,0,68
27826,26128780,26128780,26132359,0,0,0,3579
27837,26132161,26132161,26132450,0,0,0,289
27838,26132177,26132177,26132463,0,0,0,286
27839,26132383,26132383,26132793,0,0,0,410
27661,26046602,26046602,26133002,0,0,0,86400
27840,26133356,26133356,26133766,0,0,0,410
27669,26047402,26047402,26133802,0,0,0,86400
27733,26063525,26063525,26134277,0,0,0,70752
27841,26134170,26134170,26134425,0,0,0,255
27842,26134596,26134596,26134721,0,0,0,125
27686,26048848,26048848,26135248,0,0,0,86400
27843,26135504,26135504,26135563,0,0,0,59
27866,26135697,26135697,26135753,0,0,0,56
27854,26135694,26135694,26135828,0,0,0,134
27873,26135698,26135753,26135839,0,0,55,141
27858,26135695,26135695,26135845,0,0,0,150
27863,26135696,26135696,26135846,0,0,0,150
27844,26135654,26135654,26135851,0,0,0,197
27846,26135655,26135655,26135879,0,0,0,224
27848,26135686,26135686,26135879,0,0,0,193
27893,26135805,26135839,26135881,0,0,34,76
27860,26135695,26135695,26135885,0,0,0,190
27859,26135695,26135695,26135894,0,0,0,199
27880,26135699,26135828,26135903,0,0,129,204
27898,26135806,26135851,26135909,0,0,45,103
27847,26135655,26135655,26135912,0,0,0,257
27851,26135693,26135693,26135914,0,0,0,221
27855,26135694,26135694,26135915,0,0,0,221
27919,26135809,26135881,26135924,0,0,72,115
27867,26135697,26135846,26135943,0,0,149,246
27926,26135810,26135903,26135952,0,0,93,142
27869,26135697,26135845,26135953,0,0,148,256
27845,26135654,26135654,26135961,0,0,0,307
27849,26135692,26135692,26135980,0,0,0,288
27874,26135698,26135885,26135982,0,0,187,284
27875,26135698,26135879,26135987,0,0,181,289
27894,26135805,26135912,26135992,0,0,107,187
27852,26135693,26135693,26135993,0,0,0,300
27868,26135697,26135885,26135993,0,0,188,296
27850,26135692,26135692,26136000,0,0,0,308
27912,26135808,26135924,26136000,0,0,116,192
27856,26135694,26135694,26136004,0,0,0,310
27888,26135700,26135915,26136006,0,0,215,306
27899,26135806,26135943,26136023,0,0,137,217
27876,26135698,26135894,26136028,0,0,196,330
27864,26135696,26135885,26136035,0,0,189,339
27920,26135809,26135953,26136036,0,0,144,227
27906,26135807,26135879,26136037,0,0,72,230
27881,26135699,26135912,26136046,0,0,213,347
27887,26135700,26135912,26136046,0,0,212,346
27895,26135805,26135993,26136069,0,0,188,264
27882,26135699,26135980,26136071,0,0,281,372
27900,26135806,26136004,26136075,0,0,198,269
27928,26135810,26135987,26136076,0,0,177,266
27905,26135807,26136000,26136076,0,0,193,269
27913,26135808,26136006,26136077,0,0,198,269
27870,26135697,26135993,26136083,0,0,296,386
27889,26135700,26135982,26136084,0,0,282,384
27901,26135806,26136028,26136095,0,0,222,289
27927,26135810,26136023,26136101,0,0,213,291
27907,26135807,26136035,26136113,0,0,228,306
27934,26135827,26136046,26136135,0,0,219,308
27951,26136018,26136076,26136145,0,0,58,127
27914,26135808,26136069,26136147,0,0,261,339
27921,26135809,26136071,26136149,0,0,262,340
27929,26135810,26136071,26136149,0,0,261,339
27935,26135827,26136075,26136153,0,0,248,326
27865,26135696,26135961,26136157,0,0,265,461
27947,26136017,26136037,26136161,0,0,20,144
27922,26135809,26136095,26136173,0,0,286,364
27884,26135699,26136083,26136183,0,0,384,484
27861,26135695,26136000,26136197,0,0,305,502
27958,26136019,26136101,26136200,0,0,82,181
27972,26136021,26136145,26136205,0,0,124,184
27948,26136017,26136046,26136214,0,0,29,197
27908,26135807,26135914,26136218,0,0,107,411
27930,26135810,26136147,26136225,0,0,337,415
27961,26136019,26136149,26136230,0,0,130,211
27877,26135698,26136157,26136245,0,0,459,547
27966,26136020,26136149,26136248,0,0,129,228
27857,26135694,26135961,26136250,0,0,267,556
27938,26136014,26136014,26136259,0,0,0,245
27883,26135699,26135912,26136264,0,0,213,565
27965,26136020,26136076,26136266,0,0,56,246
27974,26136021,26136153,26136268,0,0,132,247
27952,26136018,26136113,26136271,0,0,95,253
27890,26135700,26136183,26136280,0,0,483,580
27871,26135697,26136197,26136284,0,0,500,587
27979,26136022,26136200,26136293,0,0,178,271
27980,26136022,26136218,26136322,0,0,196,300
27939,26136015,26136036,26136337,0,0,21,322
27959,26136019,26136264,26136345,0,0,245,326
27891,26135700,26136250,26136347,0,0,550,647
27902,26135806,26136280,26136355,0,0,474,549
27885,26135699,26136245,26136364,0,0,546,665
27949,26136017,26136225,26136371,0,0,208,354
27967,26136020,26136271,26136375,0,0,251,355
27943,26136016,26136076,26136377,0,0,60,361
27944,26136016,26136084,26136390,0,0,68,374
27878,26135698,26136284,26136397,0,0,586,699
27903,26135806,26136347,26136424,0,0,541,618
27909,26135807,26136355,26136424,0,0,548,617
27973,26136021,26136322,26136426,0,0,301,405
27910,26135807,26136364,26136434,0,0,557,627
27960,26136019,26136135,26136441,0,0,116,422
27915,26135808,26136375,26136444,0,0,567,636
27953,26136018,26136077,26136461,0,0,59,443
27975,26136021,26136149,26136462,0,0,128,441
27968,26136020,26136135,26136464,0,0,115,444
27940,26136015,26136173,26136479,0,0,158,464
27886,26135699,26136397,26136491,0,0,698,792
27916,26135808,26136424,26136494,0,0,616,686
27923,26135809,26136424,26136494,0,0,615,685
27936,26135827,26136426,26136496,0,0,599,669
27931,26135810,26136434,26136501,0,0,624,691
27896,26135805,26136491,26136564,0,0,686,759
27937,26135827,26136494,26136564,0,0,667,737
27962,26136019,26136496,26136582,0,0,477,563
27904,26135806,26136564,26136637,0,0,758,831
27954,26136018,26136494,26136645,0,0,476,627
27969,26136020,26136582,26136682,0,0,562,662
27917,26135808,26136637,26136712,0,0,829,904
27955,26136018,26136564,26136716,0,0,546,698
27981,26136022,26136645,26136748,0,0,623,726
27945,26136016,26136444,26136756,0,0,428,740
27924,26135809,26136712,26136785,0,0,903,976
27963,26136019,26136716,26136804,0,0,697,785
27946,26136016,26136501,26136815,0,0,485,799
27976,26136021,26136748,26136843,0,0,727,822
27932,26135810,26136785,26136858,0,0,975,1048
27982,26136022,26136804,26136910,0,0,782,888
27950,26136017,26136858,26137017,0,0,841,1000
27815,26127335,26127335,26137100,0,0,0,9765
27956,26136018,26137017,26137101,0,0,999,1083
27941,26136015,26136843,26137156,0,0,828,1141
27970,26136020,26137100,26137199,0,0,1080,1179
27977,26136021,26137101,26137201,0,0,1080,1180
27853,26135693,26137199,26137574,0,0,1506,1881
27862,26135695,26137574,26137809,0,0,1879,2114
27872,26135697,26137809,26137902,0,0,2112,2205
27879,26135698,26137902,26138038,0,0,2204,2340
27834,26131742,26131742,26138084,0,0,0,6342
27892,26135700,26138038,26138154,0,0,2338,2454
27897,26135805,26138154,26138222,0,0,2349,2417
27911,26135807,26138222,26138298,0,0,2415,2491
27918,26135808,26138298,26138373,0,0,2490,2565
27925,26135809,26138373,26138449,0,0,2564,2640
27933,26135826,26138449,26138534,0,0,2623,2708
27942,26136015,26138534,26138940,0,0,2519,2925
27746,26076369,26076369,26139072,0,0,0,62703
27957,26136018,26138940,26139107,0,0,2922,3089
27964,26136019,26139107,26139212,0,0,3088,3193
27971,26136020,26139212,26139328,0,0,3192,3308
27978,26136021,26139328,26139428,0,0,3307,3407
27983,26136051,26136345,26139916,0,0,294,3865
27984,26139710,26139710,26140575,0,0,0,865
27988,26140921,26140921,26140994,0,0,0,73
27990,26141313,26141313,26141567,0,0,0,254
27819,26127796,26127796,26142141,0,0,0,14345
27991,26142138,26142138,26142192,0,0,0,54
27992,26142323,26142323,26142427,0,0,0,104
27993,26142743,26142743,26142840,0,0,0,97
27994,26143188,26143188,26143241,0,0,0,53
27995,26143288,26143288,26143381,0,0,0,93
27769,26117679,26117679,26143472,0,0,0,25793
27822,26128303,26128303,26144562,0,0,0,16259
27996,26144001,26144001,26144601,0,0,0,600
28000,26145092,26145092,26145522,0,0,0,430
28001,26145529,26145529,26145809,0,0,0,280
27390,25886675,25886675,26145875,0,0,0,259200
28002,26145599,26145599,26145889,0,0,0,290
27399,25887050,25887050,26146250,0,0,0,259200
27400,25887050,25887050,26146250,0,0,0,259200
27401,25887050,25887050,26146250,0,0,0,259200
27814,26127306,26127306,26146572,0,0,0,19266
28003,26146023,26146023,26146772,0,0,0,749
28005,26146085,26146085,26146837,0,0,0,752
27770,26118035,26118035,26146870,0,0,0,28835
28006,26146165,26146165,26146902,0,0,0,737
27832,26131018,26131018,26147139,0,0,0,16121
27833,26131077,26131077,26147204,0,0,0,16127
27998,26144526,26144526,26147210,0,0,0,2684
27818,26127512,26127512,26147398,0,0,0,19886
27985,26139740,26139740,26147700,0,0,0,7960
27808,26126618,26126618,26148461,0,0,0,21843
27771,26119122,26119122,26148531,0,0,0,29409
28013,26148486,26148486,26148643,0,0,0,157
28015,26150002,26150002,26150041,0,0,0,39
28016,26150565,26150565,26150603,0,0,0,38
28017,26151058,26151058,26151415,0,0,0,357
27805,26126278,26126278,26152302,0,0,0,26024
27809,26126860,26126860,26153650,0,0,0,26790
27739,26072167,26072167,26153736,0,0,0,81569
27811,26126945,26126945,26153736,0,0,0,26791
27810,26126900,26126900,26153744,0,0,0,26844
28020,26153605,26153605,26153765,0,0,0,160
27989,26141083,26141083,26153872,0,0,0,12789
28025,26153998,26153998,26154109,0,0,0,111
27821,26128152,26128152,26154725,0,0,0,26573
27986,26139881,26139881,26155003,0,0,0,15122
27823,26128320,26128320,26155171,0,0,0,26851
28026,26154443,26154443,26155809,0,0,0,1366
28031,26157926,26157926,26158030,0,0,0,104
28030,26156872,26156872,26158146,0,0,0,1274
28012,26147292,26147292,26159405,0,0,0,12113
28021,26153713,26153713,26161510,0,0,0,7797
28024,26153751,26153751,26162333,0,0,0,8582
27813,26127288,26127288,26162959,0,0,0,35671
28011,26147093,26147093,26163189,0,0,0,16096
27795,26124959,26162959,26163292,0,0,38000,38333
28004,26146082,26146082,26164291,0,0,0,18209
28023,26153734,26153734,26165461,0,0,0,11727
28032,26165366,26165366,26165920,0,0,0,554
27615,26036839,26036839,26165944,0,0,0,129105
28039,26166106,26166106,26166173,0,0,0,67
27768,26117451,26117451,26166272,0,0,0,48821
28049,26169165,26169165,26169204,0,0,0,39
28019,26153344,26153344,26169410,0,0,0,16066
28043,26166176,26166176,26169599,0,0,0,3423
28048,26166237,26166237,26169652,0,0,0,3415
28045,26166200,26166200,26169741,0,0,0,3541
28056,26169699,26169699,26169752,0,0,0,53
28042,26166165,26166165,26169804,0,0,0,3639
28041,26166153,26166153,26169876,0,0,0,3723
28038,26166092,26166092,26170493,0,0,0,4401
28047,26166224,26166224,26170731,0,0,0,4507
28037,26166078,26166078,26170740,0,0,0,4662
28040,26166141,26166141,26170869,0,0,0,4728
28044,26166190,26166190,26171334,0,0,0,5144
28036,26166065,26166065,26171439,0,0,0,5374
28046,26166212,26166212,26171743,0,0,0,5531
28035,26166052,26166052,26172340,0,0,0,6288
28034,26166038,26166038,26174664,0,0,0,8626
28050,26169209,26169209,26174765,0,0,0,5556
28051,26169314,26169314,26174878,0,0,0,5564
28053,26169431,26169431,26175001,0,0,0,5570
28054,26169514,26169514,26175006,0,0,0,5492
28055,26169635,26169635,26175138,0,0,0,5503
28010,26146827,26146827,26175348,0,0,0,28521
28058,26175306,26175306,26175456,0,0,0,150
28057,26170016,26170016,26175539,0,0,0,5523
28018,26152255,26152255,26178096,0,0,0,25841
28014,26148598,26148598,26178966,0,0,0,30368
28022,26153717,26153717,26180470,0,0,0,26753
28033,26166022,26166022,26181115,0,0,0,15093
28027,26154674,26154674,26181422,0,0,0,26748
28028,26155125,26155125,26182062,0,0,0,26937
28052,26169373,26169373,26185442,0,0,0,16069
28060,26175505,26175505,26199633,0,0,0,24128
28066,26185396,26185396,26201303,0,0,0,15907
27766,26114920,26114920,26201320,0,0,0,86400
28070,26201045,26201045,26201451,0,0,0,406
27612,26036520,26036520,26201654,0,0,0,165134
28073,26202030,26202030,26202115,0,0,0,85
28075,26204392,26204392,26204432,0,0,0,40
28059,26175415,26175415,26204525,0,0,0,29110
28061,26178056,26178056,26204617,0,0,0,26561
28077,26204488,26204488,26204638,0,0,0,150
28076,26204435,26204435,26204672,0,0,0,237
28078,26204574,26204574,26204724,0,0,0,150
28079,26204597,26204597,26204746,0,0,0,149
28080,26204693,26204693,26204841,0,0,0,148
28082,26204793,26204793,26204945,0,0,0,152
28083,26204905,26204905,26205056,0,0,0,151
28085,26206118,26206118,26206153,0,0,0,35
28086,26206155,26206155,26206567,0,0,0,412
28063,26180435,26180435,26206724,0,0,0,26289
28064,26181383,26181383,26207678,0,0,0,26295
28089,26207651,26207651,26207710,0,0,0,59
28090,26207696,26207696,26207743,0,0,0,47
28091,26207732,26207732,26207837,0,0,0,105
28092,26207909,26207909,26207949,0,0,0,40
28093,26207962,26207962,26208068,0,0,0,106
28094,26208103,26208103,26208163,0,0,0,60
28095,26208156,26208156,26208214,0,0,0,58
28096,26208232,26208232,26208273,0,0,0,41
28062,26178930,26178930,26208332,0,0,0,29402
28097,26208289,26208289,26208437,0,0,0,148
28099,26208509,26208509,26208727,0,0,0,218
28101,26208860,26208860,26208900,0,0,0,40
28065,26182025,26182025,26209046,0,0,0,27021
28102,26208910,26208910,26209150,0,0,0,240
28106,26209156,26209156,26209206,0,0,0,50
28104,26209034,26209034,26209264,0,0,0,230
28108,26209221,26209221,26209301,0,0,0,80
28109,26209242,26209242,26209322,0,0,0,80
28107,26209182,26209182,26209414,0,0,0,232
28105,26209095,26209095,26209445,0,0,0,350
28110,26209298,26209298,26209511,0,0,0,213
28111,26209318,26209318,26209542,0,0,0,224
28100,26208595,26208595,26209593,0,0,0,998
28112,26209360,26209360,26209709,0,0,0,349
28116,26209681,26209681,26209734,0,0,0,53
28117,26209761,26209761,26209801,0,0,0,40
28113,26209495,26209495,26209873,0,0,0,378
28115,26209592,26209592,26209989,0,0,0,397
28114,26209582,26209582,26210031,0,0,0,449
28119,26209996,26209996,26210257,0,0,0,261
28120,26209999,26209999,26210548,0,0,0,549
28121,26210658,26210658,26210789,0,0,0,131
28122,26210691,26210691,26210819,0,0,0,128
28123,26210744,26210744,26210870,0,0,0,126
28124,26210792,26210792,26210929,0,0,0,137
28125,26210849,26210849,26210974,0,0,0,125
28126,26210878,26210878,26210993,0,0,0,115
28127,26210946,26210946,26211074,0,0,0,128
28128,26210976,26210976,26211097,0,0,0,121
28118,26209822,26209822,26211460,0,0,0,1638
28131,26211717,26211717,26211843,0,0,0,126
28132,26212089,26212089,26212190,0,0,0,101
28130,26211434,26211434,26212230,0,0,0,796
28134,26212524,26212524,26212573,0,0,0,49
28133,26212312,26212312,26212835,0,0,0,523
28136,26212807,26212807,26212902,0,0,0,95
28137,26213135,26213135,26213187,0,0,0,52
28138,26213144,26213144,26213483,0,0,0,339
28068,26200227,26200227,26213551,0,0,0,13324
28139,26213490,26213490,26213738,0,0,0,248
27817,26127467,26127467,26213867,0,0,0,86400
28140,26213768,26213768,26214073,0,0,0,305
28144,26214426,26214426,26214474,0,0,0,48
28142,26214114,26214114,26214665,0,0,0,551
28141,26214104,26214104,26214885,0,0,0,781
28145,26214491,26214491,26215091,0,0,0,600
28143,26214197,26214197,26215152,0,0,0,955
28069,26200749,26200749,26215220,0,0,0,14471
28146,26215296,26215296,26216021,0,0,0,725
28071,26201265,26201265,26217232,0,0,0,15967
28150,26218505,26218505,26218546,0,0,0,41
28152,26218628,26218628,26218667,0,0,0,39
28151,26218599,26218599,26218834,0,0,0,235
28153,26218818,26218818,26218954,0,0,0,136
28155,26219283,26219283,26219367,0,0,0,84
28154,26219282,26219282,26219377,0,0,0,95
28156,26219451,26219451,26219520,0,0,0,69
28157,26219472,26219472,26219592,0,0,0,120
28158,26219526,26219526,26219599,0,0,0,73
28159,26219674,26219674,26219746,0,0,0,72
28161,26219725,26219725,26219769,0,0,0,44
28160,26219700,26219700,26219772,0,0,0,72
28164,26220059,26220059,26220098,0,0,0,39
28165,26220132,26220132,26220171,0,0,0,39
28168,26220267,26220267,26220372,0,0,0,105
28166,26220256,26220256,26220389,0,0,0,133
28162,26219742,26219742,26220412,0,0,0,670
28170,26220381,26220381,26220457,0,0,0,76
28171,26220390,26220390,26220494,0,0,0,104
28172,26220465,26220465,26220598,0,0,0,133
28148,26217074,26217074,26220674,0,0,0,3600
28174,26220892,26220892,26220994,0,0,0,102
28175,26221008,26221008,26221066,0,0,0,58
28176,26221059,26221059,26221128,0,0,0,69
28173,26220667,26220667,26221267,0,0,0,600
28177,26221242,26221242,26221397,0,0,0,155
28178,26221381,26221381,26221467,0,0,0,86
28180,26221457,26221457,26221515,0,0,0,58
28181,26221527,26221527,26221574,0,0,0,47
28179,26221449,26221449,26221672,0,0,0,223
28182,26221648,26221648,26221725,0,0,0,77
28183,26221778,26221778,26221900,0,0,0,122
27736,26065924,26065924,26222232,0,0,0,156308
28186,26222186,26222186,26222306,0,0,0,120
28185,26221978,26221978,26222410,0,0,0,432
28187,26222706,26222706,26222810,0,0,0,104
28188,26222888,26222888,26222957,0,0,0,69
28190,26223006,26223006,26223121,0,0,0,115
28189,26222902,26222902,26223909,0,0,0,1007
28191,26223939,26223939,26224044,0,0,0,105
28192,26224035,26224035,26224212,0,0,0,177
28194,26224341,26224341,26224425,0,0,0,84
28195,26224455,26224455,26224559,0,0,0,104
28196,26224542,26224542,26224619,0,0,0,77
28193,26224268,26224268,26224658,0,0,0,390
28197,26224737,26224737,26224817,0,0,0,80
28198,26224758,26224758,26224827,0,0,0,69
27776,26121057,26121057,26224916,0,0,0,103859
28200,26224853,26224853,26225032,0,0,0,179
28199,26224847,26224847,26225278,0,0,0,431
28202,26225298,26225298,26225371,0,0,0,73
28203,26225682,26225682,26225867,0,0,0,185
28204,26226096,26226096,26226154,0,0,0,58
28205,26226147,26226147,26226187,0,0,0,40
28207,26226489,26226489,26226532,0,0,0,43
28206,26226215,26226215,26226539,0,0,0,324
28209,26226555,26226555,26226628,0,0,0,73
27987,26140580,26140580,26226980,0,0,0,86400
28208,26226508,26226508,26227108,0,0,0,600
28210,26226982,26226982,26227114,0,0,0,132
27997,26144501,26144501,26227447,0,0,0,82946
27708,26055156,26055156,26227956,0,0,0,172800
27709,26055212,26055212,26228012,0,0,0,172800
28214,26228502,26228502,26228612,0,0,0,110
28216,26228651,26228651,26228711,0,0,0,60
28217,26229397,26229397,26229446,0,0,0,49
28218,26229457,26229457,26229545,0,0,0,88
28212,26227501,26227501,26229554,0,0,0,2053
28084,26205020,26205020,26231383,0,0,0,26363
28220,26231466,26231466,26231524,0,0,0,58
28221,26231882,26231882,26231913,0,0,0,31
28222,26232112,26232112,26232202,0,0,0,90
27398,25886887,25886887,26232487,0,0,0,345600
28223,26232450,26232450,26232543,0,0,0,93
28224,26232514,26232514,26232603,0,0,0,89
28225,26232573,26232573,26232623,0,0,0,50
28087,26206681,26206681,26232871,0,0,0,26190
28149,26217182,26217182,26233142,0,0,0,15960
28228,26233344,26233344,26233385,0,0,0,41
28081,26204703,26204703,26233773,0,0,0,29070
28088,26207642,26207642,26234439,0,0,0,26797
28229,26233373,26233373,26235022,0,0,0,1649
28235,26234986,26234986,26235036,0,0,0,50
28234,26234969,26234969,26235053,0,0,0,84
28236,26235067,26235067,26235104,0,0,0,37
28239,26235240,26235240,26235297,0,0,0,57
28241,26235282,26235282,26235321,0,0,0,39
28240,26235249,26235249,26235355,0,0,0,106
28244,26235658,26235658,26235696,0,0,0,38
28242,26235318,26235318,26235698,0,0,0,380
28245,26235681,26235681,26235833,0,0,0,152
28247,26235803,26235803,26235853,0,0,0,50
28243,26235504,26235504,26236120,0,0,0,616
28248,26236104,26236104,26236153,0,0,0,49
28103,26208996,26208996,26236162,0,0,0,27166
28251,26236258,26236258,26236298,0,0,0,40
28252,26236633,26236633,26236672,0,0,0,39
28253,26237587,26237587,26237702,0,0,0,115
28163,26220013,26220013,26238013,0,0,0,18000
28246,26235721,26235721,26238161,0,0,0,2440
28098,26208392,26208392,26238175,0,0,0,29783
28255,26238137,26238137,26238290,0,0,0,153
28233,26234946,26234946,26238546,0,0,0,3600
28258,26238458,26238458,26238633,0,0,0,175
28257,26238426,26238426,26238791,0,0,0,365
28254,26237761,26237761,26242318,0,0,0,4557
28227,26233108,26233108,26249279,0,0,0,16171
28147,26215473,26215473,26250691,0,0,0,35218
28219,26231332,26231332,26257901,0,0,0,26569
28226,26232823,26232823,26259211,0,0,0,26388
28129,26211222,26211222,26259993,0,0,0,48771
28231,26234394,26234394,26261244,0,0,0,26850
28249,26236125,26236125,26262570,0,0,0,26445
28230,26233731,26233731,26262976,0,0,0,29245
28264,26262934,26262934,26263089,0,0,0,155
28265,26263044,26263044,26263194,0,0,0,150
28259,26249228,26249228,26265555,0,0,0,16327
28256,26238250,26238250,26268352,0,0,0,30102
28267,26265521,26265521,26281820,0,0,0,16299
28260,26257868,26257868,26284470,0,0,0,26602
28261,26259170,26259170,26285478,0,0,0,26308
28262,26261203,26261203,26287716,0,0,0,26513
28263,26262519,26262519,26289456,0,0,0,26937
28266,26263154,26263154,26293129,0,0,0,29975
28074,26202517,26202517,26296272,0,0,0,93755
28067,26199718,26199718,26296277,0,0,0,96559
28029,26155845,26155845,26296288,0,0,0,140443
28275,26296645,26296645,26296703,0,0,0,58
28269,26281777,26281777,26298061,0,0,0,16284
28268,26268309,26268309,26298073,0,0,0,29764
28278,26297376,26297376,26298601,0,0,0,1225
28135,26212727,26212727,26299127,0,0,0,86400
28279,26297400,26297400,26304589,0,0,0,7189
28211,26227407,26227407,26310675,0,0,0,83268
28169,26220270,26220270,26311016,0,0,0,90746
28270,26284424,26284424,26311181,0,0,0,26757
28201,26225083,26225083,26311483,0,0,0,86400
27702,26053321,26053321,26312521,0,0,0,259200
28281,26298019,26298019,26314332,0,0,0,16313
28271,26287674,26287674,26314826,0,0,0,27152
28215,26228586,26228586,26314986,0,0,0,86400
28167,26220262,26220262,26316492,0,0,0,96230
28280,26297415,26297415,26318838,0,0,0,21423
28237,26235178,26235178,26321578,0,0,0,86400
28238,26235199,26235199,26321599,0,0,0,86400
28272,26293086,26293086,26322642,0,0,0,29556
28295,26326250,26326250,26326323,0,0,0,73
28296,26326524,26326524,26326597,0,0,0,73
28282,26298034,26298034,26327394,0,0,0,29360
28286,26314294,26314294,26330611,0,0,0,16317
28285,26311138,26311138,26337369,0,0,0,26231
28184,26221840,26221840,26340085,0,0,0,118245
28287,26314784,26314784,26341524,0,0,0,26740
28298,26330561,26330561,26346863,0,0,0,16302
28304,26347536,26347536,26347646,0,0,0,110
28305,26347634,26347634,26347726,0,0,0,92
28306,26347671,26347671,26347780,0,0,0,109
28308,26347774,26347774,26347988,0,0,0,214
28307,26347758,26347758,26347994,0,0,0,236
28310,26348215,26348215,26349695,0,0,0,1480
28290,26322596,26322596,26352684,0,0,0,30088
28297,26327351,26327351,26356769,0,0,0,29418
27999,26144762,26144762,26358635,0,0,0,213873
28274,26296594,26296594,26359840,0,0,0,63246
28277,26296811,26296811,26361603,0,0,0,64792
28276,26296764,26296764,26361786,0,0,0,65022
28303,26346828,26346828,26363147,0,0,0,16319
28299,26337322,26337322,26363826,0,0,0,26504
28300,26341481,26341481,26368167,0,0,0,26686
28288,26321241,26321241,26372633,0,0,0,51392
28072,26201995,26201995,26373128,0,0,0,171133
28289,26322339,26322339,26373875,0,0,0,51536
28291,26323216,26323216,26374698,0,0,0,51482
28292,26323359,26323359,26374971,0,0,0,51612
28293,26323594,26323594,26375292,0,0,0,51698
28294,26325651,26325651,26377194,0,0,0,51543
28319,26363099,26363099,26379431,0,0,0,16332
28317,26352647,26352647,26382804,0,0,0,30157
28322,26382763,26382763,26382913,0,0,0,150
28323,26382883,26382883,26383034,0,0,0,151
28324,26382997,26382997,26383146,0,0,0,149
28325,26383104,26383104,26383254,0,0,0,150
28309,26348198,26348198,26383999,0,0,0,35801
28311,26348219,26348219,26385459,0,0,0,37240
28318,26356725,26356725,26386572,0,0,0,29847
28343,26388582,26388582,26388655,0,0,0,73
28347,26390778,26390778,26390835,0,0,0,57
28316,26351176,26351176,26390940,0,0,0,39764
28356,26391078,26391078,26391164,0,0,0,86
28357,26391598,26391598,26391663,0,0,0,65
28358,26391791,26391791,26391864,0,0,0,73
28374,26392371,26392371,26392444,0,0,0,73
28375,26392540,26392540,26392613,0,0,0,73
28376,26392878,26392878,26392950,0,0,0,72
28377,26393028,26393028,26393113,0,0,0,85
28378,26393414,26393414,26393498,0,0,0,84
28250,26236147,26236147,26393564,0,0,0,157417
28284,26310633,26310633,26393565,0,0,0,82932
28379,26393568,26393568,26393649,0,0,0,81
28213,26227679,26227679,26394033,0,0,0,166354
28380,26394457,26394457,26394541,0,0,0,84
28381,26394617,26394617,26394706,0,0,0,89
28382,26394864,26394864,26394949,0,0,0,85
28320,26368126,26368126,26395275,0,0,0,27149
28383,26395333,26395333,26395417,0,0,0,84
28337,26387699,26387699,26395786,0,0,0,8087
28321,26379389,26379389,26395818,0,0,0,16429
28342,26387721,26387721,26395851,0,0,0,8130
28339,26387709,26387709,26396079,0,0,0,8370
28336,26387693,26387693,26396274,0,0,0,8581
28335,26387688,26387688,26396453,0,0,0,8765
28354,26391010,26391010,26396656,0,0,0,5646
28355,26391040,26391040,26396697,0,0,0,5657
28353,26390986,26390986,26397775,0,0,0,6789
28341,26387717,26387717,26397971,0,0,0,10254
28333,26387680,26387680,26398186,0,0,0,10506
28352,26390908,26390908,26398538,0,0,0,7630
28332,26387675,26387675,26398728,0,0,0,11053
28334,26387684,26387684,26398925,0,0,0,11241
28351,26390884,26390884,26398939,0,0,0,8055
28338,26387705,26387705,26399946,0,0,0,12241
28345,26390745,26390745,26400240,0,0,0,9495
28331,26387672,26387672,26400603,0,0,0,12931
28340,26387712,26387712,26400838,0,0,0,13126
28385,26402072,26402072,26402157,0,0,0,85
28373,26392205,26392205,26402307,0,0,0,10102
28368,26392192,26392192,26402392,0,0,0,10200
28387,26402586,26402586,26402685,0,0,0,99
28330,26387667,26387667,26402689,0,0,0,15022
28370,26392197,26392197,26402737,0,0,0,10540
28367,26392188,26392188,26403076,0,0,0,10888
28366,26392185,26392185,26403289,0,0,0,11104
28349,26390829,26390829,26404251,0,0,0,13422
28346,26390773,26390773,26404763,0,0,0,13990
28348,26390808,26390808,26404837,0,0,0,14029
28344,26390725,26390725,26405125,0,0,0,14400
28350,26390855,26390855,26405255,0,0,0,14400
28372,26392202,26392202,26405294,0,0,0,13092
28007,26146545,26146545,26405745,0,0,0,259200
28008,26146546,26146546,26405746,0,0,0,259200
28009,26146546,26146546,26405746,0,0,0,259200
28363,26392177,26392177,26406163,0,0,0,13986
28365,26392182,26392182,26406354,0,0,0,14172
28369,26392194,26392194,26407766,0,0,0,15572
28388,26407893,26407893,26407968,0,0,0,75
28329,26387664,26387664,26408076,0,0,0,20412
28302,26342964,26342964,26408158,0,0,0,65194
28273,26296379,26296379,26408169,0,0,0,111790
28301,26342459,26342459,26408171,0,0,0,65712
28364,26392179,26392179,26408253,0,0,0,16074
28362,26392171,26392171,26408403,0,0,0,16232
28371,26392199,26392199,26408709,0,0,0,16510
28361,26392168,26392168,26411126,0,0,0,18958
28384,26395783,26395783,26412121,0,0,0,16338
28326,26383213,26383213,26413381,0,0,0,30168
28399,26413311,26413311,26414069,0,0,0,758
28389,26407937,26407937,26414666,0,0,0,6729
28409,26414750,26414750,26415558,0,0,0,808
28395,26408805,26408805,26415665,0,0,0,6860
28396,26408826,26408826,26415683,0,0,0,6857
28397,26408849,26408849,26415705,0,0,0,6856
28392,26408741,26408741,26415998,0,0,0,7257
28393,26408760,26408760,26416032,0,0,0,7272
28327,26386531,26386531,26416159,0,0,0,29628
28328,26387658,26387658,26416458,0,0,0,28800
28360,26392165,26392165,26417845,0,0,0,25680
28402,26413350,26413350,26418993,0,0,0,5643
28394,26408781,26408781,26419577,0,0,0,10796
28400,26413330,26413330,26420477,0,0,0,7147
28359,26392161,26392161,26420961,0,0,0,28800
28411,26415546,26415546,26426341,0,0,0,10795
28390,26407949,26407949,26426440,0,0,0,18491
28398,26412079,26412079,26428398,0,0,0,16319
28403,26413367,26413367,26442340,0,0,0,28973
28401,26413332,26413332,26443416,0,0,0,30084
28419,26443377,26443377,26443528,0,0,0,151
28410,26415086,26415086,26444002,0,0,0,28916
28418,26428354,26428354,26444665,0,0,0,16311
28412,26416117,26416117,26445486,0,0,0,29369
28422,26445446,26445446,26445603,0,0,0,157
28283,26308263,26308263,26447031,0,0,0,138768
28404,26413388,26413388,26454807,0,0,0,41419
28421,26444616,26444616,26460994,0,0,0,16378
28391,26408228,26408228,26462370,0,0,0,54142
28427,26462375,26462375,26462442,0,0,0,67
28429,26462961,26462961,26463349,0,0,0,388
28315,26350102,26350102,26464179,0,0,0,114077
28431,26464364,26464364,26464405,0,0,0,41
28433,26464474,26464474,26464543,0,0,0,69
28434,26464483,26464483,26464553,0,0,0,70
28436,26464528,26464528,26464606,0,0,0,78
28438,26464663,26464663,26464732,0,0,0,69
28440,26464794,26464794,26464874,0,0,0,80
28442,26464846,26464846,26464926,0,0,0,80
28443,26464893,26464893,26464968,0,0,0,75
28452,26465909,26465909,26466014,0,0,0,105
28451,26465357,26465357,26466529,0,0,0,1172
28453,26467036,26467036,26467076,0,0,0,40
28455,26467605,26467605,26467722,0,0,0,117
28460,26467831,26467831,26467935,0,0,0,104
28462,26468058,26468058,26468941,0,0,0,883
28461,26467929,26467929,26469115,0,0,0,1186
28463,26469153,26469153,26469193,0,0,0,40
28454,26467421,26467421,26470059,0,0,0,2638
28464,26470065,26470065,26470115,0,0,0,50
28465,26470103,26470103,26470146,0,0,0,43
28466,26470124,26470124,26470213,0,0,0,89
28467,26470148,26470148,26470235,0,0,0,87
28469,26470346,26470346,26470448,0,0,0,102
28470,26470436,26470436,26470536,0,0,0,100
28471,26470502,26470502,26470598,0,0,0,96
28468,26470286,26470286,26470644,0,0,0,358
28472,26470616,26470616,26470687,0,0,0,71
28435,26464512,26464512,26470976,0,0,0,6464
28437,26464557,26464557,26471028,0,0,0,6471
28475,26471038,26471038,26471122,0,0,0,84
28459,26467727,26467727,26472357,0,0,0,4630
28457,26467684,26467684,26472358,0,0,0,4674
28458,26467696,26467696,26472359,0,0,0,4663
28456,26467668,26467668,26472364,0,0,0,4696
28476,26471174,26471174,26472486,0,0,0,1312
28420,26443488,26443488,26473271,0,0,0,29783
28423,26445556,26445556,26473490,0,0,0,27934
28477,26471645,26471645,26474617,0,0,0,2972
28489,26474342,26474342,26475646,0,0,0,1304
28491,26475652,26475652,26475715,0,0,0,63
28490,26475651,26475651,26475726,0,0,0,75
28492,26475787,26475787,26475861,0,0,0,74
28495,26476100,26476100,26476173,0,0,0,73
28496,26476826,26476826,26476899,0,0,0,73
28314,26349617,26349617,26477163,0,0,0,127546
28439,26464773,26464773,26477175,0,0,0,12402
28425,26460952,26460952,26477182,0,0,0,16230
28499,26477266,26477266,26477341,0,0,0,75
28500,26477277,26477277,26477341,0,0,0,64
28498,26477252,26477252,26477391,0,0,0,139
28503,26477390,26477390,26477443,0,0,0,53
28507,26477448,26477448,26477497,0,0,0,49
28502,26477323,26477323,26477511,0,0,0,188
28501,26477316,26477316,26477526,0,0,0,210
28506,26477436,26477436,26477591,0,0,0,155
28510,26477611,26477611,26477699,0,0,0,88
28511,26477639,26477639,26477790,0,0,0,151
28513,26477759,26477759,26477808,0,0,0,49
28514,26477996,26477996,26478040,0,0,0,44
28430,26464161,26464161,26479259,0,0,0,15098
28516,26479786,26479786,26479834,0,0,0,48
28515,26478034,26478034,26480306,0,0,0,2272
28518,26480403,26480403,26480455,0,0,0,52
28517,26479823,26479823,26480983,0,0,0,1160
28519,26481071,26481071,26481134,0,0,0,63
28520,26481112,26481112,26481158,0,0,0,46
28522,26481339,26481339,26481377,0,0,0,38
28521,26481153,26481153,26481378,0,0,0,225
28524,26481994,26481994,26482052,0,0,0,58
28525,26482081,26482081,26482121,0,0,0,40
28523,26481356,26481356,26483011,0,0,0,1655
28529,26483394,26483394,26483536,0,0,0,142
28530,26483446,26483446,26483597,0,0,0,151
28531,26483612,26483612,26483758,0,0,0,146
28532,26483906,26483906,26483979,0,0,0,73
28312,26349136,26349136,26484520,0,0,0,135384
28533,26484508,26484508,26484610,0,0,0,102
28313,26349156,26349156,26484651,0,0,0,135495
28526,26482370,26482370,26484675,0,0,0,2305
28527,26482384,26482384,26484681,0,0,0,2297
28528,26482393,26482393,26484690,0,0,0,2297
28432,26464463,26464463,26484789,0,0,0,20326
28536,26484950,26484950,26485010,0,0,0,60
28535,26484929,26484929,26485053,0,0,0,124
28534,26484866,26484866,26485090,0,0,0,224
28537,26485705,26485705,26485745,0,0,0,40
28538,26485717,26485717,26485752,0,0,0,35
28541,26485815,26485815,26485948,0,0,0,133
28539,26485767,26485767,26486947,0,0,0,1180
28543,26487026,26487026,26487130,0,0,0,104
28544,26488540,26488540,26488613,0,0,0,73
28512,26477667,26477667,26490696,0,0,0,13029
28497,26477143,26477143,26493354,0,0,0,16211
28232,26234534,26234534,26493734,0,0,0,259200
28553,26494164,26494164,26494223,0,0,0,59
28545,26488714,26488714,26494373,0,0,0,5659
28551,26493908,26493908,26494506,0,0,0,598
28555,26494752,26494752,26494811,0,0,0,59
28554,26494527,26494527,26495072,0,0,0,545
28546,26488760,26488760,26495085,0,0,0,6325
28556,26495032,26495032,26495285,0,0,0,253
28557,26495570,26495570,26495727,0,0,0,157
28558,26495689,26495689,26495841,0,0,0,152
28560,26495925,26495925,26495963,0,0,0,38
28561,26495929,26495929,26496098,0,0,0,169
28405,26413410,26413410,26497967,0,0,0,84557
28447,26465049,26465049,26498065,0,0,0,33016
28448,26465069,26465069,26498082,0,0,0,33013
28449,26465086,26465086,26498170,0,0,0,33084
28450,26465105,26465105,26498183,0,0,0,33078
28562,26498651,26498651,26499069,0,0,0,418
28406,26413435,26413435,26499835,0,0,0,86400
28407,26413459,26413459,26499859,0,0,0,86400
28408,26413481,26413481,26499881,0,0,0,86400
28441,26464819,26464819,26501101,0,0,0,36282
28488,26473444,26473444,26502236,0,0,0,28792
28563,26502204,26502204,26502355,0,0,0,151
28487,26473234,26473234,26502739,0,0,0,29505
28494,26475914,26475914,26502987,0,0,0,27073
28493,26475913,26475913,26503019,0,0,0,27106
28504,26477409,26477409,26503056,0,0,0,25647
28505,26477433,26477433,26503131,0,0,0,25698
28508,26477469,26477469,26503327,0,0,0,25858
28509,26477484,26477484,26503342,0,0,0,25858
28570,26503285,26503285,26506199,0,0,0,2914
28571,26503311,26503311,26506221,0,0,0,2910
28582,26507081,26507081,26507746,0,0,0,665
28584,26507227,26507227,26508302,0,0,0,1075
28549,26493305,26493305,26509429,0,0,0,16124
28580,26506820,26506820,26510171,0,0,0,3351
28581,26506836,26506836,26514822,0,0,0,7986
28547,26490926,26490926,26518439,0,0,0,27513
28473,26470629,26470629,26522537,0,0,0,51908
28474,26470896,26470896,26522537,0,0,0,51641
28480,26471959,26471959,26523555,0,0,0,51596
28479,26471865,26471865,26523677,0,0,0,51812
28481,26472274,26472274,26524147,0,0,0,51873
28482,26472514,26472514,26524330,0,0,0,51816
28586,26509394,26509394,26525438,0,0,0,16044
28565,26502689,26502689,26532636,0,0,0,29947
28564,26502313,26502313,26532655,0,0,0,30342
28591,26532619,26532619,26533060,0,0,0,441
28577,26506488,26506488,26533447,0,0,0,26959
28414,26417289,26417289,26535726,0,0,0,118437
28590,26525387,26525387,26541369,0,0,0,15982
28585,26508317,26508317,26544551,0,0,0,36234
28583,26507194,26507194,26544593,0,0,0,37399
28594,26546366,26546366,26546439,0,0,0,73
28596,26548771,26548771,26548892,0,0,0,121
28597,26548953,26548953,26549000,0,0,0,47
28575,26506483,26506483,26550432,0,0,0,43949
28576,26506487,26506487,26550448,0,0,0,43961
28599,26550091,26550091,26553739,0,0,0,3648
28606,26556019,26556019,26556154,0,0,0,135
28609,26557189,26557189,26557305,0,0,0,116
28593,26541337,26541337,26557403,0,0,0,16066
28603,26554854,26554854,26557587,0,0,0,2733
28598,26549631,26549631,26557702,0,0,0,8071
28611,26557822,26557822,26557939,0,0,0,117
28613,26558032,26558032,26558212,0,0,0,180
28615,26558192,26558192,26558241,0,0,0,49
28622,26558654,26558654,26558730,0,0,0,76
28483,26472687,26472687,26559087,0,0,0,86400
28484,26472698,26472698,26559098,0,0,0,86400
28626,26559026,26559026,26559101,0,0,0,75
28485,26472707,26472707,26559107,0,0,0,86400
28486,26472718,26472718,26559118,0,0,0,86400
28627,26559075,26559075,26559152,0,0,0,77
28628,26559131,26559131,26559208,0,0,0,77
28629,26559260,26559260,26559324,0,0,0,64
28630,26559450,26559450,26559527,0,0,0,77
28631,26559472,26559472,26559600,0,0,0,128
28632,26559604,26559604,26559678,0,0,0,74
28633,26559702,26559702,26559773,0,0,0,71
28634,26559764,26559764,26559807,0,0,0,43
28635,26559836,26559836,26559911,0,0,0,75
28637,26560020,26560020,26560111,0,0,0,91
28638,26560188,26560188,26560370,0,0,0,182
28640,26560501,26560501,26560585,0,0,0,84
28641,26561539,26561539,26561629,0,0,0,90
28642,26561926,26561926,26561993,0,0,0,67
28643,26562205,26562205,26562277,0,0,0,72
28644,26562429,26562429,26562507,0,0,0,78
28645,26562572,26562572,26562650,0,0,0,78
28646,26562813,26562813,26562891,0,0,0,78
28592,26533021,26533021,26563002,0,0,0,29981
28648,26563344,26563344,26563453,0,0,0,109
28649,26563529,26563529,26563607,0,0,0,78
28559,26495849,26495849,26563650,0,0,0,67801
28650,26564075,26564075,26564148,0,0,0,73
28651,26564105,26564105,26564183,0,0,0,78
28608,26557150,26557150,26564328,0,0,0,7178
28652,26564730,26564730,26564808,0,0,0,78
28653,26565069,26565069,26565142,0,0,0,73
28654,26565177,26565177,26565289,0,0,0,112
28655,26565228,26565228,26565299,0,0,0,71
28656,26565306,26565306,26565379,0,0,0,73
28657,26565395,26565395,26565470,0,0,0,75
28659,26565451,26565451,26565531,0,0,0,80
28660,26565502,26565502,26565574,0,0,0,72
28604,26555466,26555466,26565576,0,0,0,10110
28661,26565515,26565515,26565615,0,0,0,100
28605,26555486,26555486,26565618,0,0,0,10132
28662,26565553,26565553,26565631,0,0,0,78
28665,26565779,26565779,26565852,0,0,0,73
28658,26565410,26565410,26565929,0,0,0,519
28667,26566227,26566227,26566340,0,0,0,113
28671,26566284,26566284,26566435,0,0,0,151
28672,26566356,26566356,26566437,0,0,0,81
28666,26565992,26565992,26566505,0,0,0,513
28674,26566481,26566481,26566574,0,0,0,93
28676,26566704,26566704,26566796,0,0,0,92
28677,26566881,26566881,26566957,0,0,0,76
28675,26566483,26566483,26566993,0,0,0,510
28679,26567135,26567135,26567273,0,0,0,138
28681,26567287,26567287,26567327,0,0,0,40
28680,26567272,26567272,26567367,0,0,0,95
28668,26566246,26566246,26567706,0,0,0,1460
28670,26566270,26566270,26567731,0,0,0,1461
28669,26566251,26566251,26567908,0,0,0,1657
28682,26568410,26568410,26568493,0,0,0,83
28683,26568681,26568681,26568763,0,0,0,82
28567,26503001,26503001,26568884,0,0,0,65883
28569,26503091,26503091,26568886,0,0,0,65795
28601,26550409,26550409,26568886,0,0,0,18477
28568,26503027,26503027,26568888,0,0,0,65861
28573,26506156,26506156,26568888,0,0,0,62732
28600,26550389,26550389,26568888,0,0,0,18499
28566,26502984,26502984,26568889,0,0,0,65905
28572,26503825,26503825,26568892,0,0,0,65067
28574,26506189,26506189,26568892,0,0,0,62703
28684,26568850,26568850,26568934,0,0,0,84
28607,26556227,26556227,26568944,0,0,0,12717
28664,26565597,26565597,26569061,0,0,0,3464
28673,26566409,26566409,26569061,0,0,0,2652
28663,26565570,26565570,26569067,0,0,0,3497
28686,26569030,26569030,26569131,0,0,0,101
28697,26569209,26569209,26569291,0,0,0,82
28698,26569365,26569365,26569460,0,0,0,95
28639,26560376,26560376,26569539,0,0,0,9163
28700,26569514,26569514,26569602,0,0,0,88
28701,26569699,26569699,26569800,0,0,0,101
28703,26569910,26569910,26569994,0,0,0,84
28704,26570036,26570036,26570112,0,0,0,76
28706,26571053,26571053,26571192,0,0,0,139
28707,26571062,26571062,26571200,0,0,0,138
28708,26571076,26571076,26571212,0,0,0,136
28710,26571468,26571468,26571569,0,0,0,101
28712,26571739,26571739,26571823,0,0,0,84
28714,26571874,26571874,26571978,0,0,0,104
28715,26572035,26572035,26572119,0,0,0,84
28717,26572183,26572183,26572267,0,0,0,84
28718,26572526,26572526,26572622,0,0,0,96
28720,26572659,26572659,26572744,0,0,0,85
28719,26572632,26572632,26572845,0,0,0,213
28685,26569022,26569022,26572926,0,0,0,3904
28722,26572951,26572951,26572996,0,0,0,45
28687,26569041,26569041,26572997,0,0,0,3956
28724,26572971,26572971,26573083,0,0,0,112
28610,26557362,26557362,26573311,0,0,0,15949
28725,26573222,26573222,26573324,0,0,0,102
28727,26573386,26573386,26573479,0,0,0,93
28386,26402436,26402436,26573534,0,0,0,171098
28728,26573760,26573760,26573883,0,0,0,123
28729,26574216,26574216,26574342,0,0,0,126
28730,26574321,26574321,26574374,0,0,0,53
28734,26575049,26575049,26575162,0,0,0,113
28735,26575141,26575141,26575209,0,0,0,68
28721,26572883,26572883,26575429,0,0,0,2546
28723,26572958,26572958,26575537,0,0,0,2579
28738,26575409,26575409,26575574,0,0,0,165
28733,26574853,26574853,26575818,0,0,0,965
28739,26575508,26575508,26576728,0,0,0,1220
28740,26575535,26575535,26576744,0,0,0,1209
28743,26575916,26575916,26576859,0,0,0,943
28742,26575559,26575559,26577066,0,0,0,1507
28741,26575555,26575555,26577169,0,0,0,1614
28749,26577361,26577361,26577490,0,0,0,129
28746,26577050,26577050,26577875,0,0,0,825
28750,26577609,26577609,26578433,0,0,0,824
28752,26578380,26578380,26579109,0,0,0,729
28416,26424195,26424195,26579151,0,0,0,154956
28756,26579449,26579449,26579502,0,0,0,53
28751,26577840,26577840,26580064,0,0,0,2224
28758,26580520,26580520,26580573,0,0,0,53
28759,26582296,26582296,26582356,0,0,0,60
28760,26582662,26582662,26582722,0,0,0,60
28614,26558058,26558058,26583371,0,0,0,25313
28747,26577212,26577212,26583855,0,0,0,6643
28748,26577235,26577235,26584545,0,0,0,7310
28731,26574522,26574522,26585577,0,0,0,11055
28732,26574527,26574527,26587012,0,0,0,12485
28726,26573275,26573275,26589104,0,0,0,15829
28612,26557875,26557875,26590351,0,0,0,32476
28617,26558294,26558294,26592015,0,0,0,33721
28616,26558215,26558215,26592035,0,0,0,33820
28578,26506498,26506498,26592898,0,0,0,86400
28579,26506517,26506517,26592917,0,0,0,86400
28647,26562965,26562965,26593222,0,0,0,30257
28762,26593180,26593180,26593330,0,0,0,150
28763,26593290,26593290,26593448,0,0,0,158
28764,26593411,26593411,26593568,0,0,0,157
28618,26558455,26558455,26593813,0,0,0,35358
28623,26558719,26558719,26594021,0,0,0,35302
28619,26558559,26558559,26594268,0,0,0,35709
28624,26558909,26558909,26594595,0,0,0,35686
28595,26546601,26546601,26596339,0,0,0,49738
28625,26559017,26559017,26596374,0,0,0,37357
28761,26589065,26589065,26604857,0,0,0,15792
28696,26569101,26569101,26605491,0,0,0,36390
28699,26569462,26569462,26605710,0,0,0,36248
28709,26571401,26571401,26607612,0,0,0,36211
28711,26571698,26571698,26608033,0,0,0,36335
28713,26571818,26571818,26608159,0,0,0,36341
28716,26572078,26572078,26608372,0,0,0,36294
28736,26575350,26575350,26618550,0,0,0,43200
28737,26575359,26575359,26618559,0,0,0,43200
28768,26604814,26604814,26620876,0,0,0,16062
28765,26593525,26593525,26623417,0,0,0,29892
28769,26623375,26623375,26624301,0,0,0,926
28770,26624260,26624260,26625188,0,0,0,928
28767,26594718,26594718,26627572,0,0,0,32854
28636,26559989,26559989,26631115,0,0,0,71126
28426,26461136,26461136,26633936,0,0,0,172800
28773,26636321,26636321,26636775,0,0,0,454
28775,26637054,26637054,26637497,0,0,0,443
28444,26464986,26464986,26637786,0,0,0,172800
28445,26465010,26465010,26637810,0,0,0,172800
28446,26465026,26465026,26637826,0,0,0,172800
28542,26485831,26485831,26638244,0,0,0,152413
28602,26551895,26551895,26638295,0,0,0,86400
28745,26576706,26576706,26638377,0,0,0,61671
28744,26576684,26576684,26638378,0,0,0,61694
28694,26569065,26569065,26638945,0,0,0,69880
28540,26485810,26485810,26639287,0,0,0,153477
28478,26471714,26471714,26639366,0,0,0,167652
28780,26639138,26639138,26639697,0,0,0,559
28788,26642464,26642464,26642548,0,0,0,84
28790,26643142,26643142,26643181,0,0,0,39
28791,26643204,26643204,26643325,0,0,0,121
28793,26644262,26644262,26644378,0,0,0,116
28620,26558590,26558590,26644990,0,0,0,86400
28693,26569063,26569063,26645024,0,0,0,75961
28621,26558642,26558642,26645042,0,0,0,86400
28789,26642946,26642946,26645501,0,0,0,2555
28690,26569055,26569055,26645507,0,0,0,76452
28695,26569066,26569066,26645507,0,0,0,76441
28688,26569048,26569048,26645511,0,0,0,76463
28691,26569059,26569059,26645511,0,0,0,76452
28689,26569049,26569049,26645512,0,0,0,76463
28692,26569061,26569061,26645513,0,0,0,76452
28814,26646987,26646987,26647046,0,0,0,59
28815,26647761,26647761,26647920,0,0,0,159
28817,26647947,26647947,26648005,0,0,0,58
28822,26649706,26649706,26649790,0,0,0,84
28823,26649936,26649936,26650816,0,0,0,880
28766,26594700,26594700,26651717,0,0,0,57017
28824,26653249,26653249,26653303,0,0,0,54
28771,26625144,26625144,26653808,0,0,0,28664
28825,26653764,26653764,26653921,0,0,0,157
28827,26653881,26653881,26654029,0,0,0,148
28826,26653878,26653878,26654564,0,0,0,686
28772,26636150,26636150,26655341,0,0,0,19191
28831,26655638,26655638,26656106,0,0,0,468
28702,26569717,26569717,26656117,0,0,0,86400
28829,26654569,26654569,26657957,0,0,0,3388
28550,26493774,26493774,26666574,0,0,0,172800
28784,26641268,26641268,26666682,0,0,0,25414
28781,26639648,26639648,26666723,0,0,0,27075
28782,26639662,26639662,26666742,0,0,0,27080
28816,26647937,26647937,26667017,0,0,0,19080
28995,26666609,26666723,26667057,0,0,114,448
28818,26649394,26649394,26668320,0,0,0,18926
28819,26649476,26649476,26668517,0,0,0,19041
28820,26649572,26649572,26668529,0,0,0,18957
28821,26649659,26649659,26668569,0,0,0,18910
28424,26455715,26455715,26668802,0,0,0,213087
29001,26671857,26671857,26672059,0,0,0,202
29002,26673630,26673630,26673787,0,0,0,157
29003,26674192,26674192,26674369,0,0,0,177
28413,26417288,26417288,26676488,0,0,0,259200
28415,26417289,26417289,26676489,0,0,0,259200
28828,26653988,26653988,26682553,0,0,0,28565
28996,26666633,26682553,26682669,0,0,15920,16036
28587,26509988,26509988,26682788,0,0,0,172800
28588,26515148,26515148,26687948,0,0,0,172800
28589,26515215,26515215,26688015,0,0,0,172800
28792,26643958,26643958,26690795,0,0,0,46837
28798,26644997,26644997,26691349,0,0,0,46352
28799,26644997,26644997,26691588,0,0,0,46591
28794,26644996,26644996,26691733,0,0,0,46737
28800,26644997,26644997,26691889,0,0,0,46892
28795,26644996,26644996,26692145,0,0,0,47149
28796,26644996,26644996,26692187,0,0,0,47191
28804,26644998,26644998,26692304,0,0,0,47306
28801,26644997,26644997,26692345,0,0,0,47348
28802,26644997,26644997,26692429,0,0,0,47432
28803,26644997,26644997,26692803,0,0,0,47806
28797,26644996,26644996,26693035,0,0,0,48039
28774,26636756,26636756,26696788,0,0,0,60032
28932,26656111,26696788,26697257,0,0,40677,41146
28839,26656021,26656021,26704627,0,0,0,48606
28835,26656020,26656020,26704653,0,0,0,48633
28887,26656078,26656078,26704689,0,0,0,48611
28836,26656020,26656020,26704839,0,0,0,48819
28884,26656077,26656077,26704908,0,0,0,48831
28840,26656021,26656021,26704940,0,0,0,48919
28892,26656078,26656078,26704996,0,0,0,48918
28882,26656076,26656076,26705038,0,0,0,48962
28837,26656020,26656020,26705161,0,0,0,49141
28841,26656021,26656021,26705173,0,0,0,49152
28883,26656077,26656077,26705229,0,0,0,49152
28833,26656019,26656019,26705320,0,0,0,49301
28890,26656078,26656078,26705453,0,0,0,49375
28886,26656078,26656078,26705499,0,0,0,49421
28832,26656018,26656018,26705509,0,0,0,49491
28834,26656019,26656019,26705583,0,0,0,49564
28885,26656077,26656077,26705604,0,0,0,49527
28838,26656020,26656020,26705899,0,0,0,49879
28889,26656078,26656078,26705928,0,0,0,49850
28870,26656027,26656027,26705933,0,0,0,49906
28888,26656078,26656078,26706019,0,0,0,49941
28863,26656026,26656026,26706209,0,0,0,50183
28861,26656025,26656025,26706624,0,0,0,50599
28871,26656027,26656027,26706654,0,0,0,50627
28866,26656026,26656026,26706884,0,0,0,50858
28864,26656026,26656026,26706974,0,0,0,50948
28865,26656026,26656026,26707058,0,0,0,51032
28868,26656026,26656026,26707204,0,0,0,51178
28867,26656026,26656026,26707213,0,0,0,51187
28850,26656024,26656024,26707306,0,0,0,51282
28869,26656026,26656026,26707417,0,0,0,51391
28891,26656078,26656078,26707521,0,0,0,51443
28899,26656080,26656106,26707696,0,0,26,51616
28847,26656023,26656023,26707784,0,0,0,51761
28894,26656079,26656079,26708076,0,0,0,51997
28843,26656022,26656022,26708096,0,0,0,52074
28842,26656021,26656021,26708173,0,0,0,52152
28900,26656080,26656106,26708275,0,0,26,52195
28844,26656022,26656022,26708384,0,0,0,52362
28897,26656079,26656079,26708440,0,0,0,52361
28848,26656023,26656023,26708507,0,0,0,52484
28893,26656079,26656079,26708511,0,0,0,52432
28896,26656079,26656079,26708608,0,0,0,52529
28895,26656079,26656079,26708641,0,0,0,52562
28851,26656024,26656024,26708698,0,0,0,52674
28845,26656022,26656022,26708940,0,0,0,52918
28898,26656079,26656106,26708992,0,0,27,52913
28846,26656022,26656022,26709378,0,0,0,53356
28857,26656025,26656025,26709800,0,0,0,53775
28994,26666547,26666682,26709882,0,0,135,43335
28852,26656024,26656024,26710119,0,0,0,54095
29005,26682511,26710119,26710276,0,0,27608,27765
28901,26656080,26657957,26710519,0,0,1877,54439
29008,26687223,26710519,26710592,0,0,23296,23369
29009,26687331,26710592,26710665,0,0,23261,23334
29010,26687415,26710665,26710749,0,0,23250,23334
29012,26687891,26710749,26710837,0,0,22858,22946
29013,26688123,26710837,26710957,0,0,22714,22834
29017,26688375,26710957,26711077,0,0,22582,22702
29018,26688924,26711077,26711197,0,0,22153,22273
28853,26656024,26656024,26711305,0,0,0,55281
28858,26656025,26656025,26711434,0,0,0,55409
29019,26711743,26711743,26711908,0,0,0,165
28860,26656025,26656025,26712022,0,0,0,55997
28859,26656025,26656025,26712029,0,0,0,56004
29014,26688334,26712022,26712110,0,0,23688,23776
29004,26674371,26674371,26712171,0,0,0,37800
28983,26658892,26712110,26712183,0,0,53218,53291
28862,26656025,26656025,26712247,0,0,0,56222
28879,26656028,26656028,26712407,0,0,0,56379
28854,26656024,26656024,26712419,0,0,0,56395
28985,26660132,26712247,26712421,0,0,52115,52289
28855,26656024,26656024,26712463,0,0,0,56439
28986,26660279,26712421,26712494,0,0,52142,52215
28856,26656024,26656024,26712628,0,0,0,56604
28984,26659225,26712183,26712642,0,0,52958,53417
28987,26660437,26712494,26712959,0,0,52057,52522
28989,26660944,26712642,26713100,0,0,51698,52156
28872,26656027,26656027,26713145,0,0,0,57118
28880,26656028,26656028,26713290,0,0,0,57262
28993,26666464,26712959,26713421,0,0,46495,46957
28877,26656028,26656028,26713529,0,0,0,57501
28873,26656027,26656027,26713706,0,0,0,57679
28878,26656028,26656028,26714016,0,0,0,57988
28876,26656028,26656028,26714095,0,0,0,58067
28874,26656027,26656027,26714782,0,0,0,58755
28875,26656027,26656027,26715046,0,0,0,59019
28881,26656028,26656028,26715717,0,0,0,59689
28905,26656081,26666574,26720623,0,0,10493,64542
28902,26656080,26666574,26721634,0,0,10494,65554
28906,26656081,26666574,26721723,0,0,10493,65642
28907,26656081,26666742,26722161,0,0,10661,66080
28903,26656080,26666574,26722432,0,0,10494,66352
28908,26656081,26668802,26723011,0,0,12721,66930
29021,26724829,26724829,26724867,0,0,0,38
28909,26656081,26668802,26725016,0,0,12721,68935
29022,26725460,26725460,26725507,0,0,0,47
28997,26666641,26682669,26725869,0,0,16028,59228
28912,26656082,26676489,26726245,0,0,20407,70163
28830,26655426,26655426,26726249,0,0,0,70823
28990,26664218,26722432,26727183,0,0,58214,62965
29025,26727765,26727765,26727951,0,0,0,186
29023,26725541,26725541,26728428,0,0,0,2887
28904,26656080,26666574,26728475,0,0,10494,72395
29031,26728463,26728463,26728655,0,0,0,192
29032,26728672,26728672,26728908,0,0,0,236
29033,26728881,26728881,26729025,0,0,0,144
29034,26730259,26730259,26730410,0,0,0,151
28805,26644998,26644998,26731398,0,0,0,86400
28806,26644998,26644998,26731398,0,0,0,86400
28807,26644998,26644998,26731398,0,0,0,86400
28808,26644999,26644999,26731399,0,0,0,86400
28809,26644999,26644999,26731399,0,0,0,86400
28810,26644999,26644999,26731399,0,0,0,86400
28811,26644999,26644999,26731399,0,0,0,86400
28812,26644999,26644999,26731399,0,0,0,86400
28813,26645001,26645001,26731401,0,0,0,86400
28913,26656082,26682553,26732657,0,0,26471,76575
28914,26656082,26682788,26733289,0,0,26706,77207
28915,26656082,26682788,26733736,0,0,26706,77654
29036,26732015,26732657,26733756,0,0,642,1741
28910,26656081,26668802,26735964,0,0,12721,79883
29039,26735199,26735199,26736116,0,0,0,917
28785,26641360,26641360,26737272,0,0,0,95912
28919,26656083,26688015,26738041,0,0,31932,81958
28918,26656083,26688015,26738506,0,0,31932,82423
29040,26738507,26738507,26738842,0,0,0,335
29041,26738825,26738825,26738951,0,0,0,126
29026,26727816,26727816,26739138,0,0,0,11322
29006,26682664,26710276,26739355,0,0,27612,56691
29048,26739600,26739600,26739674,0,0,0,74
29049,26739600,26739600,26739674,0,0,0,74
28783,26639724,26639724,26739713,0,0,0,99989
29050,26739600,26739600,26739727,0,0,0,127
29051,26739600,26739600,26739738,0,0,0,138
29043,26739599,26739599,26739749,0,0,0,150
29044,26739599,26739599,26739749,0,0,0,150
29045,26739600,26739600,26739750,0,0,0,150
29046,26739600,26739600,26739750,0,0,0,150
29052,26739601,26739601,26739750,0,0,0,149
29047,26739600,26739600,26739761,0,0,0,161
29030,26728454,26737272,26739867,0,0,8818,11413
28916,26656082,26687948,26740362,0,0,31866,84280
29053,26740360,26740360,26740422,0,0,0,62
29054,26740360,26740360,26740422,0,0,0,62
29055,26740360,26740360,26740422,0,0,0,62
29056,26740360,26740360,26740433,0,0,0,73
29057,26740360,26740360,26740433,0,0,0,73
29058,26740360,26740360,26740444,0,0,0,84
29059,26740361,26740361,26740445,0,0,0,84
29060,26740361,26740361,26740456,0,0,0,95
29061,26740361,26740361,26740456,0,0,0,95
29062,26740361,26740361,26740456,0,0,0,95
29063,26740451,26740451,26740528,0,0,0,77
29064,26740453,26740453,26740541,0,0,0,88
29066,26740852,26740852,26740899,0,0,0,47
29073,26740963,26740963,26741011,0,0,0,48
29074,26741055,26741055,26741113,0,0,0,58
29067,26740945,26740945,26741116,0,0,0,171
29068,26740945,26740945,26741116,0,0,0,171
29069,26740945,26740945,26741116,0,0,0,171
29070,26740945,26740945,26741127,0,0,0,182
29071,26740945,26740945,26741127,0,0,0,182
29072,26740945,26740945,26741127,0,0,0,182
29075,26741141,26741141,26741189,0,0,0,48
29082,26741221,26741221,26741279,0,0,0,58
29083,26741323,26741323,26741371,0,0,0,48
29084,26741323,26741323,26741383,0,0,0,60
29085,26741324,26741324,26741384,0,0,0,60
29086,26741324,26741324,26741395,0,0,0,71
29087,26741324,26741324,26741395,0,0,0,71
28921,26656083,26691349,26741746,0,0,35266,85663
28920,26656083,26690795,26741935,0,0,34712,85852
28849,26656023,26656023,26742423,0,0,0,86400
29027,26727836,26731398,26742612,0,0,3562,14776
29020,26712952,26713100,26742690,0,0,148,29738
29088,26742542,26742542,26742735,0,0,0,193
29090,26742687,26742687,26742745,0,0,0,58
29091,26742687,26742687,26742745,0,0,0,58
29092,26742687,26742687,26742756,0,0,0,69
29093,26742687,26742687,26742756,0,0,0,69
29094,26742687,26742687,26742767,0,0,0,80
29095,26742859,26742859,26742906,0,0,0,47
29096,26742859,26742859,26742918,0,0,0,59
29097,26742859,26742859,26742929,0,0,0,70
29098,26742859,26742859,26742929,0,0,0,70
28705,26570156,26570156,26742956,0,0,0,172800
29099,26742859,26742859,26742977,0,0,0,118
29100,26742935,26742935,26743016,0,0,0,81
29101,26742935,26742935,26743027,0,0,0,92
29102,26742935,26742935,26743038,0,0,0,103
29103,26742936,26742936,26743039,0,0,0,103
29104,26742936,26742936,26743050,0,0,0,114
29105,26743092,26743092,26743170,0,0,0,78
29106,26743092,26743092,26743181,0,0,0,89
29107,26743093,26743093,26743193,0,0,0,100
29108,26743093,26743093,26743193,0,0,0,100
29109,26743093,26743093,26743193,0,0,0,100
28911,26656081,26676488,26743807,0,0,20407,87726
29110,26744678,26744678,26744726,0,0,0,48
29111,26744684,26744684,26744727,0,0,0,43
29112,26744684,26744684,26744738,0,0,0,54
29113,26744685,26744685,26744739,0,0,0,54
29114,26744685,26744685,26744739,0,0,0,54
29115,26744828,26744828,26745128,0,0,0,300
29116,26744828,26744828,26745128,0,0,0,300
29117,26744828,26744828,26745128,0,0,0,300
29118,26744828,26744828,26745128,0,0,0,300
29119,26744828,26744828,26745128,0,0,0,300
29120,26745107,26745107,26745145,0,0,0,38
29121,26745241,26745241,26745325,0,0,0,84
29122,26745242,26745242,26745337,0,0,0,95
29123,26745242,26745242,26745337,0,0,0,95
29124,26745242,26745242,26745348,0,0,0,106
29125,26745242,26745242,26745348,0,0,0,106
28935,26656123,26697257,26745571,0,0,41134,89448
28933,26656122,26697257,26745930,0,0,41135,89808
28934,26656123,26697257,26745941,0,0,41134,89818
29028,26728234,26731399,26746254,0,0,3165,18020
29029,26728253,26731401,26746256,0,0,3148,18003
28548,26490956,26490956,26746556,0,0,0,255600
28922,26656083,26691588,26748210,0,0,35505,92127
28928,26656085,26692345,26749224,0,0,36260,93139
28929,26656085,26692429,26749422,0,0,36344,93337
28927,26656085,26692304,26749686,0,0,36219,93601
28925,26656084,26692145,26749864,0,0,36061,93780
28923,26656083,26691733,26749984,0,0,35650,93901
28931,26656086,26693035,26750351,0,0,36949,94265
29130,26750333,26750333,26750419,0,0,0,86
29146,26750343,26750343,26750424,0,0,0,81
29131,26750339,26750339,26750425,0,0,0,86
29132,26750339,26750339,26750425,0,0,0,86
29147,26750343,26750343,26750425,0,0,0,82
29134,26750340,26750340,26750426,0,0,0,86
29142,26750342,26750342,26750427,0,0,0,85
29140,26750341,26750341,26750432,0,0,0,91
29145,26750342,26750342,26750434,0,0,0,92
29148,26750343,26750343,26750436,0,0,0,93
29143,26750342,26750342,26750438,0,0,0,96
29144,26750342,26750342,26750438,0,0,0,96
29149,26750343,26750343,26750447,0,0,0,104
29133,26750339,26750339,26750451,0,0,0,112
29135,26750340,26750340,26750452,0,0,0,112
29136,26750340,26750340,26750473,0,0,0,133
29137,26750340,26750340,26750473,0,0,0,133
29138,26750341,26750341,26750474,0,0,0,133
29139,26750341,26750341,26750474,0,0,0,133
29141,26750341,26750341,26750595,0,0,0,254
28926,26656084,26692187,26750620,0,0,36103,94536
29150,26750481,26750481,26750644,0,0,0,163
28924,26656083,26691889,26750680,0,0,35806,94597
29038,26734668,26734668,26750755,0,0,0,16087
29016,26688370,26712628,26751399,0,0,24258,63029
28930,26656085,26692803,26751652,0,0,36718,95567
28754,26579217,26579217,26752017,0,0,0,172800
28757,26579484,26579484,26752284,0,0,0,172800
29128,26750236,26750236,26752739,0,0,0,2503
29129,26750239,26750239,26752753,0,0,0,2514
28940,26656124,26704908,26752951,0,0,48784,96827
29000,26666772,26709882,26753082,0,0,43110,86310
28552,26493910,26493910,26753110,0,0,0,259200
28937,26656123,26704653,26753375,0,0,48530,97252
28936,26656123,26704627,26753529,0,0,48504,97406
29158,26753341,26753341,26753532,0,0,0,191
29157,26753333,26753333,26753641,0,0,0,308
28938,26656123,26704689,26753721,0,0,48566,97598
29156,26753319,26753319,26753829,0,0,0,510
28941,26656124,26704940,26753870,0,0,48816,97746
29163,26753896,26753896,26754003,0,0,0,107
29164,26753896,26753896,26754003,0,0,0,107
29165,26753897,26753897,26754004,0,0,0,107
29166,26753897,26753897,26754004,0,0,0,107
29167,26753897,26753897,26754004,0,0,0,107
29168,26753897,26753897,26754004,0,0,0,107
29169,26753897,26753897,26754004,0,0,0,107
29162,26753890,26753890,26754014,0,0,0,124
29170,26753898,26753898,26754027,0,0,0,129
29171,26753898,26753898,26754027,0,0,0,129
29172,26753898,26753898,26754038,0,0,0,140
29173,26753898,26753898,26754038,0,0,0,140
29174,26753899,26753899,26754050,0,0,0,151
29175,26753899,26753899,26754050,0,0,0,151
29176,26753899,26753899,26754061,0,0,0,162
29177,26753899,26753899,26754061,0,0,0,162
29178,26753900,26753900,26754185,0,0,0,285
29180,26754073,26754073,26754185,0,0,0,112
29181,26754073,26754073,26754185,0,0,0,112
29179,26753901,26753901,26754186,0,0,0,285
29182,26754074,26754074,26754186,0,0,0,112
29183,26754074,26754074,26754186,0,0,0,112
29184,26754074,26754074,26754186,0,0,0,112
29185,26754074,26754074,26754186,0,0,0,112
29186,26754074,26754074,26754186,0,0,0,112
29187,26754074,26754074,26754197,0,0,0,123
29188,26754074,26754074,26754197,0,0,0,123
29189,26754075,26754075,26754209,0,0,0,134
29127,26747677,26747677,26754212,0,0,0,6535
29190,26754075,26754075,26754220,0,0,0,145
29191,26754075,26754075,26754220,0,0,0,145
29192,26754075,26754075,26754220,0,0,0,145
29193,26754075,26754075,26754231,0,0,0,156
29194,26754075,26754075,26754242,0,0,0,167
29195,26754075,26754075,26754242,0,0,0,167
29196,26754076,26754076,26754243,0,0,0,167
29197,26754076,26754076,26754254,0,0,0,178
29198,26754076,26754076,26754254,0,0,0,178
29199,26754076,26754076,26754265,0,0,0,189
29215,26754323,26754323,26754409,0,0,0,86
29216,26754323,26754323,26754409,0,0,0,86
29217,26754323,26754323,26754420,0,0,0,97
29218,26754323,26754323,26754420,0,0,0,97
29203,26754321,26754321,26754495,0,0,0,174
29204,26754321,26754321,26754495,0,0,0,174
29205,26754321,26754321,26754495,0,0,0,174
29206,26754322,26754322,26754496,0,0,0,174
29207,26754322,26754322,26754496,0,0,0,174
29208,26754322,26754322,26754496,0,0,0,174
29209,26754322,26754322,26754496,0,0,0,174
29210,26754322,26754322,26754496,0,0,0,174
29211,26754322,26754322,26754507,0,0,0,185
29212,26754322,26754322,26754507,0,0,0,185
29213,26754323,26754323,26754519,0,0,0,196
29214,26754323,26754323,26754519,0,0,0,196
29220,26754445,26754445,26754553,0,0,0,108
29221,26754445,26754445,26754553,0,0,0,108
29219,26754323,26754323,26754623,0,0,0,300
28939,26656123,26704839,26754719,0,0,48716,98596
29246,26754657,26754657,26754733,0,0,0,76
29247,26754657,26754657,26754744,0,0,0,87
29235,26754656,26754656,26754755,0,0,0,99
29236,26754656,26754656,26754755,0,0,0,99
29237,26754656,26754656,26754755,0,0,0,99
29238,26754656,26754656,26754755,0,0,0,99
28942,26656124,26704996,26754760,0,0,48872,98636
29239,26754656,26754656,26754766,0,0,0,110
29240,26754656,26754656,26754766,0,0,0,110
29241,26754657,26754657,26754778,0,0,0,121
29242,26754657,26754657,26754778,0,0,0,121
29243,26754657,26754657,26754789,0,0,0,132
29244,26754657,26754657,26754789,0,0,0,132
29245,26754657,26754657,26754789,0,0,0,132
29222,26754654,26754654,26754853,0,0,0,199
29223,26754654,26754654,26754853,0,0,0,199
29224,26754654,26754654,26754853,0,0,0,199
29225,26754654,26754654,26754853,0,0,0,199
29226,26754654,26754654,26754853,0,0,0,199
29227,26754654,26754654,26754853,0,0,0,199
29228,26754655,26754655,26754854,0,0,0,199
29229,26754655,26754655,26754854,0,0,0,199
29230,26754655,26754655,26754854,0,0,0,199
29231,26754655,26754655,26754854,0,0,0,199
29232,26754655,26754655,26754854,0,0,0,199
29233,26754655,26754655,26754854,0,0,0,199
29248,26754779,26754779,26754877,0,0,0,98
29249,26754846,26754846,26754944,0,0,0,98
29234,26754655,26754655,26754955,0,0,0,300
28428,26462437,26462437,26755301,0,0,0,292864
29250,26755245,26755245,26755326,0,0,0,81
29152,26752166,26752166,26755776,0,0,0,3610
29126,26745927,26745927,26755891,0,0,0,9964
28943,26656124,26705038,26756771,0,0,48914,100647
28952,26656125,26705604,26757272,0,0,49479,101147
28944,26656124,26705161,26757282,0,0,49037,101158
28945,26656124,26705173,26757637,0,0,49049,101513
28959,26656127,26706654,26757809,0,0,50527,101682
28960,26656127,26706884,26758007,0,0,50757,101880
28947,26656125,26705320,26758255,0,0,49195,102130
28948,26656125,26705453,26758432,0,0,49328,102307
28966,26656128,26707417,26758452,0,0,51289,102324
28968,26656129,26707696,26758478,0,0,51567,102349
28967,26656129,26707521,26758525,0,0,51392,102396
28949,26656125,26705499,26758594,0,0,49374,102469
28969,26656129,26707784,26758753,0,0,51655,102624
28950,26656125,26705509,26759013,0,0,49384,102888
28946,26656124,26705229,26759075,0,0,49105,102951
28971,26656130,26708096,26759133,0,0,51966,103003
28972,26656130,26708173,26759150,0,0,52043,103020
28970,26656129,26708076,26759246,0,0,51947,103117
29252,26759283,26759283,26759356,0,0,0,73
28961,26656127,26706974,26759545,0,0,50847,103418
29253,26759462,26759462,26759578,0,0,0,116
29256,26760173,26760173,26760288,0,0,0,115
28951,26656125,26705583,26760846,0,0,49458,104721
28953,26656126,26705899,26761021,0,0,49773,104895
29251,26757824,26757824,26761424,0,0,0,3600
28962,26656127,26707058,26761507,0,0,50931,105380
28957,26656126,26706209,26761642,0,0,50083,105516
28963,26656127,26707204,26762215,0,0,51077,106088
28955,26656126,26705933,26762238,0,0,49807,106112
28956,26656126,26706019,26762275,0,0,49893,106149
28964,26656127,26707213,26762548,0,0,51086,106421
28954,26656126,26705928,26762722,0,0,49802,106596
28965,26656127,26707306,26763368,0,0,51179,107241
28958,26656126,26706624,26763771,0,0,50498,107645
28973,26656130,26708275,26765268,0,0,52145,109138
28975,26656131,26708440,26765544,0,0,52309,109413
28979,26656132,26708641,26765666,0,0,52509,109534
28976,26656131,26708507,26766623,0,0,52376,110492
28977,26656131,26708511,26766947,0,0,52380,110816
28978,26656131,26708608,26767223,0,0,52477,111092
28974,26656130,26708384,26767428,0,0,52254,111298
28980,26656132,26708698,26767450,0,0,52566,111318
29151,26751634,26751634,26767699,0,0,0,16065
28992,26666135,26713290,26768692,0,0,47155,102557
29042,26739111,26739111,26768995,0,0,0,29884
28786,26641430,26641430,26771030,0,0,0,129600
28787,26641479,26641479,26771079,0,0,0,129600
29037,26733504,26733504,26771304,0,0,0,37800
28981,26656132,26708940,26771702,0,0,52808,115570
29089,26742685,26742685,26771929,0,0,0,29244
29007,26685864,26726249,26772096,0,0,40385,86232
28982,26656132,26708992,26773522,0,0,52860,117390
28917,26656082,26687948,26774348,0,0,31866,118266
28991,26666127,26713706,26777605,0,0,47579,111478
29257,26767660,26767660,26783513,0,0,0,15853
29154,26753220,26753220,26796231,0,0,0,43011
28998,26666683,26709378,26796425,0,0,42695,129742
28999,26666699,26709800,26796768,0,0,43101,130069
29201,26754292,26754292,26796780,0,0,0,42488
29161,26753841,26753841,26797183,0,0,0,43342
29160,26753838,26753838,26797269,0,0,0,43431
29200,26754284,26754284,26798034,0,0,0,43750
29159,26753833,26753833,26798277,0,0,0,44444
29202,26754296,26754296,26798527,0,0,0,44231
29262,26783471,26783471,26799470,0,0,0,15999
29261,26771937,26771937,26801454,0,0,0,29517
29266,26806676,26806676,26806742,0,0,0,66
29268,26807899,26807899,26807984,0,0,0,85
29269,26808309,26808309,26808414,0,0,0,105
29153,26753213,26753213,26810134,0,0,0,56921
28776,26637445,26637445,26810245,0,0,0,172800
29265,26806532,26806532,26810590,0,0,0,4058
28777,26638311,26638311,26811111,0,0,0,172800
28778,26638326,26638326,26811126,0,0,0,172800
28779,26638336,26638336,26811136,0,0,0,172800
29277,26812401,26812401,26812540,0,0,0,139
29278,26812847,26812847,26812993,0,0,0,146
29279,26813845,26813845,26813903,0,0,0,58
29280,26813911,26813911,26813952,0,0,0,41
29281,26814028,26814028,26814069,0,0,0,41
29282,26814086,26814086,26814788,0,0,0,702
29263,26799427,26799427,26815390,0,0,0,15963
29284,26815367,26815367,26815485,0,0,0,118
29285,26815473,26815473,26815986,0,0,0,513
29286,26816920,26816920,26816993,0,0,0,73
29267,26806807,26806807,26817197,0,0,0,10390
29338,26817185,26817185,26817258,0,0,0,73
29337,26817159,26817159,26817381,0,0,0,222
29260,26771431,26771431,26820257,0,0,0,48826
29388,26817677,26820257,26820634,0,0,2580,2957
29035,26731792,26737272,26820656,0,0,5480,88864
29394,26820608,26820608,26820694,0,0,0,86
29393,26820588,26820588,26820719,0,0,0,131
29387,26817578,26820656,26820721,0,0,3078,3143
29395,26820678,26820678,26820731,0,0,0,53
29396,26820762,26820762,26820810,0,0,0,48
29389,26818112,26820721,26820836,0,0,2609,2724
29390,26818370,26820836,26820910,0,0,2466,2540
29398,26821295,26821295,26821500,0,0,0,205
29399,26821295,26821295,26821500,0,0,0,205
29400,26821295,26821295,26821500,0,0,0,205
29401,26821295,26821295,26821500,0,0,0,205
29391,26818387,26820910,26821510,0,0,2523,3123
29397,26821293,26821293,26821593,0,0,0,300
29402,26821295,26821500,26821705,0,0,205,410
29403,26821295,26821500,26821705,0,0,205,410
29404,26821296,26821500,26821705,0,0,204,409
29405,26821296,26821500,26821705,0,0,204,409
29406,26821296,26821593,26821798,0,0,297,502
29407,26821296,26821705,26821910,0,0,409,614
29408,26821296,26821705,26821910,0,0,409,614
29409,26821296,26821705,26821910,0,0,409,614
29410,26821297,26821705,26821910,0,0,408,613
29413,26821297,26821910,26821994,0,0,613,697
29411,26821297,26821798,26822003,0,0,501,706
29414,26821297,26821910,26822005,0,0,613,708
29415,26821297,26821910,26822016,0,0,613,719
29417,26821298,26822003,26822109,0,0,705,811
29416,26821297,26821994,26822111,0,0,697,814
29412,26821297,26821910,26822115,0,0,613,818
29418,26821298,26822005,26822122,0,0,707,824
29419,26821298,26822016,26822133,0,0,718,835
29420,26821298,26822109,26822237,0,0,811,939
29421,26821298,26822111,26822239,0,0,813,941
29422,26821298,26822115,26822254,0,0,817,956
29423,26821298,26822122,26822261,0,0,824,963
29424,26821426,26822133,26822283,0,0,707,857
29275,26811830,26811830,26823816,0,0,0,11986
29276,26811835,26811835,26824023,0,0,0,12188
29386,26817465,26817465,26824492,0,0,0,7027
29426,26824682,26824682,26824720,0,0,0,38
29427,26824817,26824817,26825196,0,0,0,379
28678,26566902,26566902,26826102,0,0,0,259200
29428,26827063,26827063,26827180,0,0,0,117
29429,26827683,26827683,26827723,0,0,0,40
29430,26827791,26827791,26827849,0,0,0,58
29435,26829927,26829927,26829967,0,0,0,40
29436,26830004,26830004,26830043,0,0,0,39
29437,26830078,26830078,26830117,0,0,0,39
29438,26830210,26830210,26830361,0,0,0,151
29264,26801411,26801411,26830603,0,0,0,29192
29439,26830557,26830557,26830722,0,0,0,165
29441,26830684,26830684,26830841,0,0,0,157
29440,26830678,26830678,26831045,0,0,0,367
29283,26815344,26815344,26831543,0,0,0,16199
29432,26828445,26828445,26833010,0,0,0,4565
29433,26829789,26833010,26833083,0,0,3221,3294
29434,26829886,26833010,26833373,0,0,3124,3487
28755,26579413,26579413,26838613,0,0,0,259200
29448,26832104,26832104,26840716,0,0,0,8612
29449,26836559,26836559,26844168,0,0,0,7609
29447,26831501,26831501,26847683,0,0,0,16182
29454,26847634,26847634,26847707,0,0,0,73
29455,26847673,26847673,26847748,0,0,0,75
29456,26847712,26847712,26847786,0,0,0,74
29457,26847743,26847743,26847817,0,0,0,74
29458,26847777,26847777,26847855,0,0,0,78
29459,26847806,26847806,26847879,0,0,0,73
29460,26847839,26847839,26847919,0,0,0,80
29461,26847872,26847872,26847945,0,0,0,73
29462,26847901,26847901,26847979,0,0,0,78
29463,26847930,26847930,26848007,0,0,0,77
29464,26847963,26847963,26848040,0,0,0,77
29465,26847993,26847993,26848059,0,0,0,66
29466,26848022,26848022,26848099,0,0,0,77
29467,26848051,26848051,26848129,0,0,0,78
29468,26848083,26848083,26848150,0,0,0,67
29469,26848111,26848111,26848189,0,0,0,78
29470,26848140,26848140,26848217,0,0,0,77
29471,26848173,26848173,26848246,0,0,0,73
29472,26848201,26848201,26848276,0,0,0,75
29473,26848239,26848239,26848307,0,0,0,68
29474,26848263,26848263,26848332,0,0,0,69
29475,26848291,26848291,26848370,0,0,0,79
29015,26688358,26712419,26852039,0,0,24061,163681
29442,26830803,26830803,26860755,0,0,0,29952
29476,26860711,26860711,26860784,0,0,0,73
29477,26860739,26860739,26860817,0,0,0,78
29478,26860766,26860766,26860832,0,0,0,66
29479,26860792,26860792,26860863,0,0,0,71
29480,26860821,26860821,26860889,0,0,0,68
29481,26860855,26860855,26860928,0,0,0,73
29287,26817111,26817111,26865123,0,0,0,48012
29346,26817188,26817188,26865163,0,0,0,47975
29341,26817187,26817187,26865387,0,0,0,48200
29345,26817188,26817188,26865512,0,0,0,48324
29342,26817187,26817187,26865545,0,0,0,48358
29339,26817186,26817186,26865584,0,0,0,48398
29347,26817188,26817188,26865675,0,0,0,48487
29291,26817112,26817112,26865725,0,0,0,48613
29348,26817188,26817188,26865947,0,0,0,48759
29290,26817112,26817112,26865961,0,0,0,48849
29296,26817113,26817113,26866128,0,0,0,49015
29288,26817111,26817111,26866240,0,0,0,49129
29343,26817187,26817187,26866421,0,0,0,49234
29293,26817112,26817112,26866619,0,0,0,49507
29344,26817187,26817187,26866695,0,0,0,49508
29292,26817112,26817112,26866717,0,0,0,49605
29325,26817121,26817121,26866946,0,0,0,49825
29366,26817193,26817193,26866984,0,0,0,49791
29373,26817194,26817381,26867014,0,0,187,49820
29289,26817111,26817111,26867017,0,0,0,49906
29321,26817120,26817120,26867202,0,0,0,50082
29315,26817119,26817119,26867233,0,0,0,50114
29370,26817193,26817258,26867383,0,0,65,50190
29316,26817119,26817119,26867417,0,0,0,50298
29319,26817120,26817120,26867502,0,0,0,50382
29320,26817120,26817120,26867559,0,0,0,50439
29322,26817120,26817120,26867681,0,0,0,50561
29374,26817194,26817381,26867842,0,0,187,50648
29369,26817193,26817258,26867873,0,0,65,50680
29367,26817193,26817193,26867904,0,0,0,50711
29326,26817121,26817121,26867986,0,0,0,50865
29353,26817190,26817190,26867993,0,0,0,50803
29371,26817193,26817258,26868091,0,0,65,50898
29358,26817191,26817191,26868092,0,0,0,50901
29304,26817116,26817116,26868101,0,0,0,50985
29368,26817193,26817193,26868209,0,0,0,51016
29352,26817189,26817189,26868304,0,0,0,51115
29300,26817113,26817113,26868320,0,0,0,51207
29372,26817193,26817381,26868355,0,0,188,51162
29302,26817115,26817115,26868416,0,0,0,51301
29299,26817113,26817113,26868525,0,0,0,51412
29323,26817120,26817120,26868591,0,0,0,51471
29349,26817189,26817189,26868641,0,0,0,51452
29297,26817113,26817113,26868725,0,0,0,51612
29298,26817113,26817113,26868804,0,0,0,51691
29350,26817189,26817189,26868953,0,0,0,51764
29351,26817189,26817189,26869144,0,0,0,51955
29306,26817116,26817116,26869264,0,0,0,52148
29354,26817190,26817190,26869573,0,0,0,52383
29355,26817190,26817190,26869696,0,0,0,52506
29305,26817116,26817116,26869868,0,0,0,52752
29357,26817191,26817191,26870038,0,0,0,52847
29361,26817192,26817192,26870078,0,0,0,52886
29301,26817113,26817113,26870093,0,0,0,52980
29303,26817115,26817115,26870182,0,0,0,53067
29311,26817118,26817118,26870494,0,0,0,53376
29317,26817119,26817119,26870601,0,0,0,53482
29375,26817194,26820257,26870646,0,0,3063,53452
29307,26817116,26817116,26871295,0,0,0,54179
29024,26727045,26727045,26871654,0,0,0,144609
29312,26817118,26817118,26871694,0,0,0,54576
29362,26817192,26817192,26871697,0,0,0,54505
29359,26817191,26817191,26871935,0,0,0,54744
29365,26817192,26817192,26872170,0,0,0,54978
29308,26817117,26817117,26872198,0,0,0,55081
29363,26817192,26817192,26872258,0,0,0,55066
29309,26817117,26817117,26872302,0,0,0,55185
29360,26817191,26817191,26872325,0,0,0,55134
29364,26817192,26817192,26872539,0,0,0,55347
29313,26817118,26817118,26872558,0,0,0,55440
29318,26817119,26817119,26872734,0,0,0,55615
29327,26817121,26817121,26872868,0,0,0,55747
29333,26817122,26817122,26873212,0,0,0,56090
29336,26817122,26817122,26873220,0,0,0,56098
29332,26817122,26817122,26873360,0,0,0,56238
29331,26817122,26817122,26873490,0,0,0,56368
29310,26817117,26817117,26873521,0,0,0,56404
29314,26817118,26817118,26873564,0,0,0,56446
29334,26817122,26817122,26874349,0,0,0,57227
29328,26817121,26817121,26874403,0,0,0,57282
29335,26817122,26817122,26874506,0,0,0,57384
29294,26817112,26817112,26875189,0,0,0,58077
29295,26817112,26817112,26875847,0,0,0,58735
29330,26817121,26817121,26875938,0,0,0,58817
29329,26817121,26817121,26876172,0,0,0,59051
29376,26817194,26820257,26876561,0,0,3063,59367
29382,26817195,26820257,26876894,0,0,3062,59699
29380,26817195,26820257,26877181,0,0,3062,59986
29379,26817195,26820257,26877402,0,0,3062,60207
29324,26817120,26817120,26877491,0,0,0,60371
29384,26817195,26820257,26877963,0,0,3062,60768
29385,26817195,26820257,26878083,0,0,3062,60888
29383,26817195,26820257,26878412,0,0,3062,61217
29381,26817195,26820257,26878468,0,0,3062,61273
29377,26817194,26820257,26878494,0,0,3063,61300
29378,26817194,26820257,26878581,0,0,3063,61387
29356,26817190,26817190,26881735,0,0,0,64545
29011,26687431,26711305,26884105,0,0,23874,196674
28988,26660884,26715717,26888517,0,0,54833,227633
29274,26810224,26810224,26896803,0,0,0,86579
29270,26810159,26810159,26897691,0,0,0,87532
29272,26810188,26810188,26897778,0,0,0,87590
29340,26817186,26817186,26899233,0,0,0,82047
29273,26810214,26810214,26900565,0,0,0,90351
29258,26771381,26771381,26900981,0,0,0,129600
29259,26771400,26771400,26901000,0,0,0,129600
28417,26424219,26424219,26907233,0,0,0,483014
29392,26819199,26821510,26907910,0,0,2311,88711
29425,26824530,26824530,26908700,0,0,0,84170
29482,26908645,26908645,26908945,0,0,0,300
29483,26908645,26908645,26908945,0,0,0,300
29484,26908646,26908646,26908946,0,0,0,300
29485,26908646,26908646,26908946,0,0,0,300
29486,26908646,26908646,26908946,0,0,0,300
29487,26908646,26908646,26908946,0,0,0,300
29488,26908646,26908646,26908946,0,0,0,300
29489,26908646,26908646,26908946,0,0,0,300
29490,26908646,26908646,26908946,0,0,0,300
29491,26908647,26908647,26908947,0,0,0,300
29492,26908647,26908647,26908947,0,0,0,300
29493,26908647,26908647,26908947,0,0,0,300
29494,26908647,26908647,26908947,0,0,0,300
29495,26908647,26908647,26908947,0,0,0,300
29496,26908647,26908647,26908947,0,0,0,300
29497,26908647,26908647,26908947,0,0,0,300
29498,26908821,26908821,26908954,0,0,0,133
29499,26908821,26908821,26908954,0,0,0,133
29500,26908821,26908821,26908954,0,0,0,133
29501,26908821,26908821,26908954,0,0,0,133
29503,26908822,26908822,26908955,0,0,0,133
29504,26908822,26908822,26908955,0,0,0,133
29505,26908822,26908822,26908955,0,0,0,133
29506,26908822,26908822,26908955,0,0,0,133
29507,26908823,26908823,26908956,0,0,0,133
29508,26908823,26908823,26908968,0,0,0,145
29509,26908823,26908823,26908968,0,0,0,145
29510,26908824,26908824,26908980,0,0,0,156
29511,26908824,26908824,26908980,0,0,0,156
29512,26908824,26908824,26908980,0,0,0,156
29515,26908825,26908825,26908981,0,0,0,156
29513,26908824,26908824,26908991,0,0,0,167
29514,26908824,26908824,26909002,0,0,0,178
29516,26908825,26908825,26909003,0,0,0,178
29519,26908826,26908826,26909004,0,0,0,178
29517,26908825,26908825,26909014,0,0,0,189
29518,26908825,26908825,26909014,0,0,0,189
29520,26908826,26908826,26909026,0,0,0,200
29502,26908821,26908821,26909032,0,0,0,211
29521,26908826,26908826,26909037,0,0,0,211
29523,26909897,26909897,26909992,0,0,0,95
29524,26909903,26909903,26909992,0,0,0,89
29525,26910062,26910062,26910156,0,0,0,94
29526,26910063,26910063,26910157,0,0,0,94
29527,26910176,26910176,26910270,0,0,0,94
29528,26910177,26910177,26910271,0,0,0,94
29529,26910285,26910285,26910368,0,0,0,83
29530,26910285,26910285,26910379,0,0,0,94
29531,26910401,26910401,26910538,0,0,0,137
29532,26910407,26910407,26910542,0,0,0,135
29533,26910571,26910571,26910713,0,0,0,142
29534,26910576,26910576,26910713,0,0,0,137
29535,26910743,26910743,26910875,0,0,0,132
29536,26910749,26910749,26910881,0,0,0,132
29537,26910900,26910900,26910958,0,0,0,58
29538,26911137,26911137,26911185,0,0,0,48
29539,26911188,26911188,26911247,0,0,0,59
29540,26911316,26911316,26911374,0,0,0,58
29541,26911455,26911455,26911504,0,0,0,49
29542,26911570,26911570,26911660,0,0,0,90
29543,26912147,26912147,26912236,0,0,0,89
29065,26740617,26740617,26913417,0,0,0,172800
29544,26914098,26914098,26914230,0,0,0,132
29545,26914104,26914104,26914231,0,0,0,127
29561,26914907,26914907,26915050,0,0,0,143
29562,26914907,26914907,26915050,0,0,0,143
29563,26914907,26914907,26915050,0,0,0,143
29564,26914907,26914907,26915050,0,0,0,143
29565,26914907,26914907,26915050,0,0,0,143
29566,26914908,26914908,26915051,0,0,0,143
29567,26914908,26914908,26915051,0,0,0,143
29568,26914908,26914908,26915051,0,0,0,143
29569,26914908,26914908,26915051,0,0,0,143
29570,26914908,26914908,26915051,0,0,0,143
29571,26914908,26914908,26915051,0,0,0,143
29572,26914909,26914909,26915064,0,0,0,155
29573,26914909,26914909,26915064,0,0,0,155
29574,26914909,26914909,26915064,0,0,0,155
29575,26914909,26914909,26915075,0,0,0,166
29576,26914909,26914909,26915086,0,0,0,177
29577,26914909,26914909,26915086,0,0,0,177
29578,26914909,26914909,26915086,0,0,0,177
29579,26914910,26914910,26915098,0,0,0,188
29580,26914910,26914910,26915098,0,0,0,188
29581,26914910,26914910,26915109,0,0,0,199
29582,26914910,26914910,26915109,0,0,0,199
29583,26914910,26914910,26915109,0,0,0,199
29584,26914910,26914910,26915120,0,0,0,210
29546,26914905,26914905,26915205,0,0,0,300
29547,26914905,26914905,26915205,0,0,0,300
29548,26914905,26914905,26915205,0,0,0,300
29549,26914905,26914905,26915205,0,0,0,300
29550,26914905,26914905,26915205,0,0,0,300
29551,26914905,26914905,26915205,0,0,0,300
29552,26914906,26914906,26915206,0,0,0,300
29553,26914906,26914906,26915206,0,0,0,300
29554,26914906,26914906,26915206,0,0,0,300
29555,26914906,26914906,26915206,0,0,0,300
29556,26914906,26914906,26915206,0,0,0,300
29557,26914906,26914906,26915206,0,0,0,300
29558,26914906,26914906,26915206,0,0,0,300
29559,26914907,26914907,26915207,0,0,0,300
29560,26914907,26914907,26915207,0,0,0,300
29585,26915084,26915084,26915305,0,0,0,221
29586,26915084,26915084,26915384,0,0,0,300
29587,26915375,26915375,26915675,0,0,0,300
29588,26915376,26915376,26915676,0,0,0,300
29589,26915376,26915376,26915676,0,0,0,300
29590,26915376,26915376,26915676,0,0,0,300
29591,26915376,26915376,26915676,0,0,0,300
29592,26915376,26915376,26915676,0,0,0,300
29593,26915376,26915376,26915676,0,0,0,300
29594,26915377,26915377,26915677,0,0,0,300
29595,26915377,26915377,26915677,0,0,0,300
29596,26915377,26915377,26915677,0,0,0,300
29613,26916538,26916538,26916631,0,0,0,93
29614,26916539,26916539,26916632,0,0,0,93
29615,26916539,26916539,26916632,0,0,0,93
29616,26916539,26916539,26916632,0,0,0,93
29617,26916539,26916539,26916632,0,0,0,93
29618,26916539,26916539,26916632,0,0,0,93
29619,26916539,26916539,26916632,0,0,0,93
29620,26916539,26916539,26916632,0,0,0,93
29621,26916540,26916540,26916645,0,0,0,105
29622,26916540,26916540,26916645,0,0,0,105
29623,26916540,26916540,26916645,0,0,0,105
29624,26916540,26916540,26916656,0,0,0,116
29625,26916540,26916540,26916656,0,0,0,116
29626,26916540,26916540,26916656,0,0,0,116
29627,26916540,26916540,26916667,0,0,0,127
29628,26916582,26916582,26916720,0,0,0,138
29597,26916535,26916535,26916756,0,0,0,221
29598,26916535,26916535,26916756,0,0,0,221
29599,26916535,26916535,26916756,0,0,0,221
29600,26916535,26916535,26916756,0,0,0,221
29601,26916536,26916536,26916757,0,0,0,221
29602,26916536,26916536,26916757,0,0,0,221
29603,26916536,26916536,26916757,0,0,0,221
29604,26916536,26916536,26916757,0,0,0,221
29605,26916537,26916537,26916758,0,0,0,221
29606,26916537,26916537,26916758,0,0,0,221
29607,26916537,26916537,26916758,0,0,0,221
29608,26916538,26916538,26916759,0,0,0,221
29609,26916538,26916538,26916759,0,0,0,221
29610,26916538,26916538,26916759,0,0,0,221
29611,26916538,26916538,26916759,0,0,0,221
29612,26916538,26916538,26916759,0,0,0,221
29450,26839873,26839873,26926273,0,0,0,86400
29451,26839886,26839886,26926286,0,0,0,86400
29452,26840695,26840695,26927095,0,0,0,86400
29453,26841371,26841371,26927771,0,0,0,86400
29629,26930399,26930399,26930593,0,0,0,194
29630,26930399,26930399,26930593,0,0,0,194
29631,26930399,26930399,26930593,0,0,0,194
29632,26930400,26930400,26930594,0,0,0,194
29633,26930400,26930400,26930594,0,0,0,194
29634,26930400,26930400,26930594,0,0,0,194
29635,26930400,26930400,26930594,0,0,0,194
29636,26930400,26930400,26930594,0,0,0,194
29637,26930401,26930401,26930595,0,0,0,194
29638,26930401,26930401,26930595,0,0,0,194
29639,26930401,26930401,26930595,0,0,0,194
29640,26930401,26930401,26930595,0,0,0,194
29641,26930401,26930401,26930595,0,0,0,194
29642,26930401,26930401,26930595,0,0,0,194
29643,26930402,26930402,26930596,0,0,0,194
29644,26930402,26930402,26930596,0,0,0,194
29645,26930402,26930402,26930596,0,0,0,194
29646,26930402,26930402,26930596,0,0,0,194
29647,26930402,26930402,26930596,0,0,0,194
29648,26930402,26930402,26930596,0,0,0,194
29649,26930402,26930402,26930596,0,0,0,194
29650,26930403,26930403,26930597,0,0,0,194
29651,26930403,26930403,26930597,0,0,0,194
29652,26930403,26930403,26930597,0,0,0,194
29653,26930403,26930403,26930597,0,0,0,194
29654,26930403,26930403,26930597,0,0,0,194
29655,26930403,26930403,26930597,0,0,0,194
29656,26930404,26930404,26930598,0,0,0,194
29657,26930404,26930404,26930610,0,0,0,206
29658,26930404,26930404,26930610,0,0,0,206
29659,26930404,26930404,26930610,0,0,0,206
29660,26930404,26930404,26930621,0,0,0,217
29661,26930404,26930404,26930621,0,0,0,217
29662,26930404,26930404,26930632,0,0,0,228
29663,26930405,26930405,26930633,0,0,0,228
29664,26930405,26930405,26930644,0,0,0,239
29254,26759699,26759699,26932499,0,0,0,172800
29255,26759754,26759754,26932554,0,0,0,172800
29665,26932587,26932587,26932780,0,0,0,193
29666,26932587,26932587,26932780,0,0,0,193
29667,26932588,26932588,26932781,0,0,0,193
29668,26932588,26932588,26932781,0,0,0,193
29669,26932588,26932588,26932781,0,0,0,193
29670,26932588,26932588,26932781,0,0,0,193
29671,26932588,26932588,26932781,0,0,0,193
29672,26932589,26932589,26932782,0,0,0,193
29673,26932589,26932589,26932782,0,0,0,193
29674,26932589,26932589,26932782,0,0,0,193
29675,26932589,26932589,26932782,0,0,0,193
29676,26932590,26932590,26932783,0,0,0,193
29677,26932590,26932590,26932783,0,0,0,193
29678,26932590,26932590,26932783,0,0,0,193
29679,26932590,26932590,26932783,0,0,0,193
29680,26932591,26932591,26932784,0,0,0,193
29681,26932591,26932591,26932784,0,0,0,193
29682,26932591,26932591,26932784,0,0,0,193
29683,26932591,26932591,26932784,0,0,0,193
29684,26932592,26932592,26932785,0,0,0,193
29685,26932592,26932592,26932785,0,0,0,193
29686,26932592,26932592,26932785,0,0,0,193
29687,26932592,26932592,26932785,0,0,0,193
29688,26932592,26932592,26932785,0,0,0,193
29689,26932592,26932592,26932785,0,0,0,193
29690,26932592,26932592,26932785,0,0,0,193
29691,26932593,26932593,26932893,0,0,0,300
29692,26932593,26932593,26932893,0,0,0,300
29693,26932593,26932593,26932893,0,0,0,300
29694,26932593,26932593,26932893,0,0,0,300
29695,26932593,26932593,26932893,0,0,0,300
29696,26932593,26932593,26932893,0,0,0,300
29697,26932593,26932593,26932893,0,0,0,300
29698,26932594,26932594,26932894,0,0,0,300
29699,26932594,26932594,26932894,0,0,0,300
29700,26932594,26932594,26932894,0,0,0,300
29701,26932780,26932780,26933080,0,0,0,300
29702,26933624,26933624,26933817,0,0,0,193
29703,26933625,26933625,26933818,0,0,0,193
29723,26933629,26933629,26933822,0,0,0,193
29704,26933625,26933625,26933925,0,0,0,300
29705,26933625,26933625,26933925,0,0,0,300
29706,26933626,26933626,26933926,0,0,0,300
29707,26933626,26933626,26933926,0,0,0,300
29708,26933626,26933626,26933926,0,0,0,300
29709,26933626,26933626,26933926,0,0,0,300
29710,26933627,26933627,26933927,0,0,0,300
29711,26933627,26933627,26933927,0,0,0,300
29712,26933627,26933627,26933927,0,0,0,300
29713,26933627,26933627,26933927,0,0,0,300
29714,26933627,26933627,26933927,0,0,0,300
29715,26933627,26933627,26933927,0,0,0,300
29716,26933627,26933627,26933927,0,0,0,300
29717,26933628,26933628,26933928,0,0,0,300
29718,26933628,26933628,26933928,0,0,0,300
29719,26933628,26933628,26933928,0,0,0,300
29720,26933628,26933628,26933928,0,0,0,300
29721,26933628,26933628,26933928,0,0,0,300
29722,26933628,26933628,26933928,0,0,0,300
29724,26933629,26933629,26933929,0,0,0,300
29725,26933629,26933629,26933929,0,0,0,300
29726,26933629,26933629,26933929,0,0,0,300
29727,26933629,26933629,26933929,0,0,0,300
29728,26933629,26933629,26933929,0,0,0,300
29729,26933630,26933630,26933930,0,0,0,300
29730,26933630,26933630,26933930,0,0,0,300
29731,26933630,26933630,26933930,0,0,0,300
29732,26933630,26933630,26933930,0,0,0,300
29733,26933630,26933630,26933930,0,0,0,300
29734,26933630,26933630,26933930,0,0,0,300
29735,26933630,26933630,26933930,0,0,0,300
29736,26933631,26933631,26933931,0,0,0,300
29737,26933631,26933631,26933931,0,0,0,300
29738,26934737,26934737,26935075,0,0,0,338
29739,26934737,26934737,26935086,0,0,0,349
29740,26934738,26934738,26935087,0,0,0,349
29741,26934738,26934738,26935098,0,0,0,360
29742,26934738,26934738,26935109,0,0,0,371
29743,26934738,26934738,26935109,0,0,0,371
29744,26934738,26934738,26935109,0,0,0,371
29745,26934738,26934738,26935120,0,0,0,382
29746,26934739,26934739,26935121,0,0,0,382
29747,26934739,26934739,26935132,0,0,0,393
29748,26934739,26934739,26935132,0,0,0,393
29749,26934739,26934739,26935132,0,0,0,393
29750,26934739,26934739,26935143,0,0,0,404
29751,26934739,26934739,26935154,0,0,0,415
29752,26934739,26934739,26935154,0,0,0,415
29753,26934740,26934740,26935166,0,0,0,426
29754,26934740,26934740,26935166,0,0,0,426
29755,26934740,26934740,26935166,0,0,0,426
29756,26934740,26934740,26935177,0,0,0,437
29757,26934740,26934740,26935177,0,0,0,437
29758,26934740,26934740,26935188,0,0,0,448
29760,26934741,26934741,26935189,0,0,0,448
29759,26934740,26934740,26935199,0,0,0,459
29761,26934741,26934741,26935200,0,0,0,459
29762,26934741,26934741,26935211,0,0,0,470
29763,26934741,26934741,26935211,0,0,0,470
29764,26934741,26934741,26935222,0,0,0,481
29765,26934741,26934741,26935222,0,0,0,481
29767,26934888,26934888,26935223,0,0,0,335
29766,26934741,26934741,26935233,0,0,0,492
29768,26934889,26934889,26935235,0,0,0,346
29769,26934889,26934889,26935246,0,0,0,357
29770,26934889,26934889,26935246,0,0,0,357
29771,26934889,26934889,26935257,0,0,0,368
29772,26934890,26934890,26935258,0,0,0,368
29773,26934890,26934890,26935269,0,0,0,379
29802,26936241,26936241,26936362,0,0,0,121
29795,26936239,26936239,26936371,0,0,0,132
29796,26936240,26936240,26936372,0,0,0,132
29797,26936240,26936240,26936383,0,0,0,143
29798,26936240,26936240,26936383,0,0,0,143
29799,26936240,26936240,26936394,0,0,0,154
29800,26936240,26936240,26936394,0,0,0,154
29801,26936240,26936240,26936405,0,0,0,165
29803,26936241,26936241,26936406,0,0,0,165
29804,26936241,26936241,26936417,0,0,0,176
29805,26936241,26936241,26936417,0,0,0,176
29806,26936241,26936241,26936428,0,0,0,187
29807,26936241,26936241,26936428,0,0,0,187
29808,26936241,26936241,26936428,0,0,0,187
29809,26936242,26936242,26936440,0,0,0,198
29810,26936242,26936242,26936451,0,0,0,209
29811,26936242,26936242,26936462,0,0,0,220
29774,26936235,26936235,26936496,0,0,0,261
29775,26936236,26936236,26936497,0,0,0,261
29776,26936236,26936236,26936497,0,0,0,261
29777,26936236,26936236,26936497,0,0,0,261
29778,26936236,26936236,26936497,0,0,0,261
29779,26936237,26936237,26936498,0,0,0,261
29780,26936237,26936237,26936498,0,0,0,261
29781,26936237,26936237,26936498,0,0,0,261
29782,26936238,26936238,26936499,0,0,0,261
29783,26936238,26936238,26936499,0,0,0,261
29784,26936238,26936238,26936499,0,0,0,261
29785,26936238,26936238,26936499,0,0,0,261
29786,26936238,26936238,26936499,0,0,0,261
29787,26936238,26936238,26936499,0,0,0,261
29788,26936238,26936238,26936499,0,0,0,261
29789,26936239,26936239,26936500,0,0,0,261
29790,26936239,26936239,26936500,0,0,0,261
29791,26936239,26936239,26936500,0,0,0,261
29792,26936239,26936239,26936512,0,0,0,273
29793,26936239,26936239,26936523,0,0,0,284
29794,26936239,26936239,26936523,0,0,0,284
29271,26810174,26810174,26939774,0,0,0,129600
29816,26946339,26946339,26946395,0,0,0,56
29817,26946339,26946339,26946395,0,0,0,56
29818,26946339,26946339,26946406,0,0,0,67
29819,26946339,26946339,26946406,0,0,0,67
29820,26946339,26946339,26946417,0,0,0,78
29821,26946339,26946339,26946417,0,0,0,78
29822,26946340,26946340,26946429,0,0,0,89
29823,26946340,26946340,26946429,0,0,0,89
29824,26946340,26946340,26946429,0,0,0,89
29825,26946709,26946709,26946784,0,0,0,75
29826,26946709,26946709,26946796,0,0,0,87
29827,26946709,26946709,26947609,0,0,0,900
29828,26946709,26946709,26947609,0,0,0,900
29829,26946709,26946709,26947609,0,0,0,900
29830,26946709,26946709,26947609,0,0,0,900
29831,26946709,26946709,26947609,0,0,0,900
29832,26946710,26946710,26947610,0,0,0,900
29833,26946710,26946710,26947610,0,0,0,900
29835,26948866,26948866,26949096,0,0,0,230
29836,26948866,26948866,26949096,0,0,0,230
29837,26948866,26948866,26949096,0,0,0,230
29838,26948866,26948866,26949096,0,0,0,230
29839,26948866,26948866,26949096,0,0,0,230
29840,26948867,26948867,26949097,0,0,0,230
29841,26948867,26948867,26949097,0,0,0,230
29842,26948867,26948867,26949097,0,0,0,230
29843,26948867,26948867,26949097,0,0,0,230
29844,26948867,26948867,26949097,0,0,0,230
29845,26948867,26948867,26949097,0,0,0,230
29846,26948868,26948868,26949098,0,0,0,230
29847,26948868,26948868,26949098,0,0,0,230
29848,26948868,26948868,26949098,0,0,0,230
29849,26948868,26948868,26949098,0,0,0,230
29850,26948868,26948868,26949109,0,0,0,241
29851,26948868,26948868,26949109,0,0,0,241
29834,26948858,26948858,26949110,0,0,0,252
29852,26948868,26948868,26949120,0,0,0,252
29856,26949013,26949013,26949150,0,0,0,137
29857,26949013,26949013,26949150,0,0,0,137
29858,26949013,26949013,26949161,0,0,0,148
29859,26949013,26949013,26949161,0,0,0,148
29860,26949014,26949014,26949173,0,0,0,159
29861,26949014,26949014,26949173,0,0,0,159
29862,26949014,26949014,26949184,0,0,0,170
29863,26949014,26949014,26949184,0,0,0,170
29864,26949015,26949015,26949185,0,0,0,170
29865,26949015,26949015,26949185,0,0,0,170
29866,26949015,26949015,26949196,0,0,0,181
29867,26949015,26949015,26949196,0,0,0,181
29868,26949016,26949016,26949208,0,0,0,192
29855,26949012,26949012,26949215,0,0,0,203
29853,26949012,26949012,26949264,0,0,0,252
29854,26949012,26949012,26949275,0,0,0,263
29889,26950342,26950342,26950490,0,0,0,148
29890,26950342,26950342,26950490,0,0,0,148
29891,26950342,26950342,26950490,0,0,0,148
29892,26950342,26950342,26950490,0,0,0,148
29895,26950343,26950343,26950491,0,0,0,148
29893,26950342,26950342,26950502,0,0,0,160
29894,26950342,26950342,26950502,0,0,0,160
29896,26950343,26950343,26950503,0,0,0,160
29897,26950343,26950343,26950514,0,0,0,171
29898,26950343,26950343,26950514,0,0,0,171
29899,26950343,26950343,26950525,0,0,0,182
29900,26950343,26950343,26950525,0,0,0,182
29901,26950343,26950343,26950525,0,0,0,182
29902,26950344,26950344,26950537,0,0,0,193
29903,26950344,26950344,26950548,0,0,0,204
29904,26950344,26950344,26950548,0,0,0,204
29905,26950344,26950344,26950559,0,0,0,215
29906,26950344,26950344,26950559,0,0,0,215
29907,26950344,26950344,26950570,0,0,0,226
29908,26950344,26950344,26950570,0,0,0,226
29909,26950345,26950345,26950571,0,0,0,226
29910,26950345,26950345,26950582,0,0,0,237
29911,26950345,26950345,26950582,0,0,0,237
29912,26950345,26950345,26950593,0,0,0,248
29913,26950345,26950345,26950593,0,0,0,248
29869,26950335,26950335,26950594,0,0,0,259
29914,26950345,26950345,26950604,0,0,0,259
29870,26950338,26950338,26950665,0,0,0,327
29871,26950338,26950338,26950665,0,0,0,327
29872,26950338,26950338,26950665,0,0,0,327
29873,26950339,26950339,26950666,0,0,0,327
29874,26950339,26950339,26950666,0,0,0,327
29875,26950339,26950339,26950666,0,0,0,327
29876,26950340,26950340,26950667,0,0,0,327
29877,26950340,26950340,26950667,0,0,0,327
29878,26950340,26950340,26950667,0,0,0,327
29879,26950340,26950340,26950667,0,0,0,327
29880,26950340,26950340,26950667,0,0,0,327
29881,26950340,26950340,26950667,0,0,0,327
29882,26950341,26950341,26950668,0,0,0,327
29883,26950341,26950341,26950668,0,0,0,327
29884,26950341,26950341,26950668,0,0,0,327
29885,26950341,26950341,26950668,0,0,0,327
29886,26950341,26950341,26950668,0,0,0,327
29887,26950341,26950341,26950668,0,0,0,327
29888,26950342,26950342,26950669,0,0,0,327
29925,26951182,26951182,26951310,0,0,0,128
29915,26951180,26951180,26951733,0,0,0,553
29916,26951180,26951180,26951733,0,0,0,553
29917,26951180,26951180,26951744,0,0,0,564
29919,26951181,26951181,26951756,0,0,0,575
29918,26951180,26951180,26951766,0,0,0,586
29920,26951181,26951181,26951778,0,0,0,597
29921,26951181,26951181,26951778,0,0,0,597
29922,26951181,26951181,26951778,0,0,0,597
29923,26951181,26951181,26951789,0,0,0,608
29924,26951181,26951181,26951789,0,0,0,608
29926,26951182,26951182,26951790,0,0,0,608
29927,26951182,26951182,26951801,0,0,0,619
29928,26951182,26951182,26951812,0,0,0,630
29929,26951182,26951182,26951812,0,0,0,630
29932,26951183,26951183,26951813,0,0,0,630
29930,26951182,26951182,26951823,0,0,0,641
29931,26951182,26951182,26951823,0,0,0,641
29933,26951183,26951183,26951846,0,0,0,663
29934,26951183,26951183,26951846,0,0,0,663
29935,26951183,26951183,26951857,0,0,0,674
29936,26953033,26953033,26953309,0,0,0,276
29937,26953033,26953033,26953309,0,0,0,276
29938,26953033,26953033,26953320,0,0,0,287
29939,26953033,26953033,26953320,0,0,0,287
29940,26953033,26953033,26953331,0,0,0,298
29941,26953034,26953034,26953332,0,0,0,298
29942,26953034,26953034,26953343,0,0,0,309
29943,26953034,26953034,26953343,0,0,0,309
29944,26953034,26953034,26953354,0,0,0,320
29945,26953034,26953034,26953365,0,0,0,331
29946,26953034,26953034,26953365,0,0,0,331
29948,26953035,26953035,26953366,0,0,0,331
29949,26953035,26953035,26953366,0,0,0,331
29947,26953034,26953034,26953376,0,0,0,342
29950,26953035,26953035,26953388,0,0,0,353
29951,26953035,26953035,26953388,0,0,0,353
29952,26953035,26953035,26953399,0,0,0,364
29953,26953035,26953035,26953399,0,0,0,364
29954,26953036,26953036,26953400,0,0,0,364
29955,26953036,26953036,26953400,0,0,0,364
29956,26953036,26953036,26953411,0,0,0,375
29957,26953036,26953036,26953422,0,0,0,386
29958,26953036,26953036,26953433,0,0,0,397
29959,26953036,26953036,26953433,0,0,0,397
29960,26953036,26953036,26953433,0,0,0,397
29961,26953164,26953164,26953445,0,0,0,281
29962,26953164,26953164,26953445,0,0,0,281
29963,26953164,26953164,26953456,0,0,0,292
29964,26953165,26953165,26953457,0,0,0,292
29965,26953165,26953165,26953457,0,0,0,292
29966,26953165,26953165,26953468,0,0,0,303
29967,26953165,26953165,26953468,0,0,0,303
29968,26953166,26953166,26953480,0,0,0,314
29969,26953166,26953166,26953491,0,0,0,325
29970,26953166,26953166,26953491,0,0,0,325
29971,26953166,26953166,26953491,0,0,0,325
29972,26953167,26953167,26953492,0,0,0,325
29973,26953167,26953167,26953503,0,0,0,336
29974,26953167,26953167,26953503,0,0,0,336
29975,26953167,26953167,26953514,0,0,0,347
29976,26953168,26953168,26953515,0,0,0,347
29977,26953168,26953168,26953515,0,0,0,347
29978,26953168,26953168,26953537,0,0,0,369
29979,26953168,26953168,26953537,0,0,0,369
29980,26953169,26953169,26953549,0,0,0,380
29981,26953169,26953169,26953549,0,0,0,380
29982,26953169,26953169,26953549,0,0,0,380
29983,26953169,26953169,26953560,0,0,0,391
29984,26953169,26953169,26953560,0,0,0,391
29985,26953169,26953169,26953571,0,0,0,402
30011,26954217,26954217,26954352,0,0,0,135
30012,26954218,26954218,26954353,0,0,0,135
30013,26954218,26954218,26954364,0,0,0,146
30014,26954218,26954218,26954364,0,0,0,146
30015,26954218,26954218,26954375,0,0,0,157
30016,26954218,26954218,26954386,0,0,0,168
30017,26954218,26954218,26954386,0,0,0,168
29986,26954208,26954208,26954387,0,0,0,179
29988,26954214,26954214,26954414,0,0,0,200
29989,26954214,26954214,26954414,0,0,0,200
29990,26954215,26954215,26954415,0,0,0,200
29991,26954215,26954215,26954415,0,0,0,200
29992,26954215,26954215,26954415,0,0,0,200
29993,26954215,26954215,26954415,0,0,0,200
29994,26954215,26954215,26954415,0,0,0,200
29995,26954215,26954215,26954415,0,0,0,200
29996,26954215,26954215,26954415,0,0,0,200
29997,26954215,26954215,26954415,0,0,0,200
29998,26954216,26954216,26954416,0,0,0,200
29999,26954216,26954216,26954428,0,0,0,212
30000,26954216,26954216,26954439,0,0,0,223
30001,26954216,26954216,26954439,0,0,0,223
30002,26954216,26954216,26954439,0,0,0,223
30004,26954217,26954217,26954451,0,0,0,234
30005,26954217,26954217,26954451,0,0,0,234
30003,26954216,26954216,26954461,0,0,0,245
30006,26954217,26954217,26954462,0,0,0,245
30007,26954217,26954217,26954473,0,0,0,256
30008,26954217,26954217,26954473,0,0,0,256
30009,26954217,26954217,26954484,0,0,0,267
30010,26954217,26954217,26954484,0,0,0,267
30018,26954361,26954361,26954540,0,0,0,179
29987,26954214,26954214,26954562,0,0,0,348
30042,26955394,26955394,26955533,0,0,0,139
30043,26955394,26955394,26955544,0,0,0,150
30044,26955394,26955394,26955555,0,0,0,161
30045,26955394,26955394,26955555,0,0,0,161
30046,26955394,26955394,26955555,0,0,0,161
30047,26955394,26955394,26955566,0,0,0,172
30048,26955394,26955394,26955566,0,0,0,172
30049,26955394,26955394,26955577,0,0,0,183
30050,26955394,26955394,26955577,0,0,0,183
30051,26955394,26955394,26955577,0,0,0,183
30019,26955394,26955394,26955609,0,0,0,215
30020,26955394,26955394,26955609,0,0,0,215
30021,26955394,26955394,26955609,0,0,0,215
30022,26955394,26955394,26955609,0,0,0,215
30023,26955394,26955394,26955609,0,0,0,215
30024,26955394,26955394,26955609,0,0,0,215
30025,26955394,26955394,26955609,0,0,0,215
30026,26955394,26955394,26955609,0,0,0,215
30027,26955394,26955394,26955609,0,0,0,215
30028,26955394,26955394,26955609,0,0,0,215
30029,26955394,26955394,26955620,0,0,0,226
30030,26955394,26955394,26955620,0,0,0,226
30031,26955394,26955394,26955620,0,0,0,226
30032,26955394,26955394,26955620,0,0,0,226
30033,26955394,26955394,26955620,0,0,0,226
30034,26955394,26955394,26955631,0,0,0,237
30035,26955394,26955394,26955642,0,0,0,248
30036,26955394,26955394,26955642,0,0,0,248
30037,26955394,26955394,26955642,0,0,0,248
30038,26955394,26955394,26955653,0,0,0,259
30039,26955394,26955394,26955653,0,0,0,259
30040,26955394,26955394,26955664,0,0,0,270
30041,26955394,26955394,26955664,0,0,0,270
30060,26957563,26957563,26957623,0,0,0,60
30061,26957563,26957563,26957623,0,0,0,60
30062,26957563,26957563,26957623,0,0,0,60
30063,26957563,26957563,26957623,0,0,0,60
30064,26957563,26957563,26957623,0,0,0,60
30065,26957563,26957563,26957623,0,0,0,60
30052,26956727,26956727,26957627,0,0,0,900
30053,26956727,26956727,26957627,0,0,0,900
30054,26956727,26956727,26957627,0,0,0,900
30055,26956727,26956727,26957627,0,0,0,900
30066,26957725,26957725,26957785,0,0,0,60
30067,26957725,26957725,26957785,0,0,0,60
30068,26957725,26957725,26957785,0,0,0,60
30069,26957725,26957725,26957785,0,0,0,60
30070,26957725,26957725,26957785,0,0,0,60
30071,26957725,26957725,26957785,0,0,0,60
30056,26957015,26957015,26957915,0,0,0,900
30057,26957015,26957015,26957915,0,0,0,900
30058,26957015,26957015,26957915,0,0,0,900
30059,26957015,26957015,26957915,0,0,0,900
30072,26957893,26957893,26957953,0,0,0,60
30073,26957893,26957893,26957953,0,0,0,60
30074,26957893,26957893,26957953,0,0,0,60
30075,26957893,26957893,26957953,0,0,0,60
30076,26957893,26957893,26957953,0,0,0,60
30077,26957893,26957893,26957953,0,0,0,60
30078,26957924,26957924,26957984,0,0,0,60
30079,26957925,26957925,26957985,0,0,0,60
30080,26957925,26957925,26957985,0,0,0,60
30081,26957925,26957925,26957985,0,0,0,60
30082,26957925,26957925,26957985,0,0,0,60
30083,26957925,26957925,26957985,0,0,0,60
30084,26957925,26957925,26957985,0,0,0,60
30085,26957925,26957925,26957985,0,0,0,60
30086,26957925,26957925,26957985,0,0,0,60
30087,26957925,26957925,26957985,0,0,0,60
30088,26957925,26957925,26957985,0,0,0,60
30089,26957925,26957925,26957985,0,0,0,60
30090,26957925,26957925,26957985,0,0,0,60
30091,26957925,26957925,26957985,0,0,0,60
30092,26958006,26958006,26958066,0,0,0,60
30093,26958006,26958006,26958066,0,0,0,60
30094,26958006,26958006,26958066,0,0,0,60
30095,26958006,26958006,26958066,0,0,0,60
30096,26958006,26958006,26958066,0,0,0,60
30097,26958006,26958006,26958066,0,0,0,60
30098,26958006,26958006,26958066,0,0,0,60
30099,26958006,26958006,26958066,0,0,0,60
30100,26958006,26958006,26958066,0,0,0,60
30101,26958006,26958006,26958066,0,0,0,60
30102,26958717,26958717,26958777,0,0,0,60
30103,26958717,26958717,26958777,0,0,0,60
30104,26958717,26958717,26958777,0,0,0,60
30105,26958717,26958717,26958777,0,0,0,60
30106,26958717,26958717,26958777,0,0,0,60
30107,26958717,26958717,26958777,0,0,0,60
30108,26958717,26958717,26958777,0,0,0,60
30109,26958717,26958717,26958777,0,0,0,60
30110,26958717,26958717,26958777,0,0,0,60
30111,26958717,26958717,26958777,0,0,0,60
30112,26958966,26958966,26959026,0,0,0,60
30113,26958966,26958966,26959026,0,0,0,60
30114,26958966,26958966,26959026,0,0,0,60
30115,26958966,26958966,26959026,0,0,0,60
30116,26958966,26958966,26959026,0,0,0,60
30117,26958966,26958966,26959026,0,0,0,60
30118,26958966,26958966,26959026,0,0,0,60
30119,26958966,26958966,26959026,0,0,0,60
30120,26958966,26958966,26959026,0,0,0,60
30121,26958966,26958966,26959026,0,0,0,60
30122,26959193,26959193,26959253,0,0,0,60
30123,26959193,26959193,26959253,0,0,0,60
30124,26959193,26959193,26959253,0,0,0,60
30125,26959354,26959354,26959414,0,0,0,60
30126,26959354,26959354,26959414,0,0,0,60
30127,26959354,26959354,26959414,0,0,0,60
30128,26959510,26959510,26959570,0,0,0,60
30129,26959510,26959510,26959570,0,0,0,60
30130,26959510,26959510,26959570,0,0,0,60
30131,26959663,26959663,26959723,0,0,0,60
30132,26959663,26959663,26959723,0,0,0,60
30133,26959663,26959663,26959723,0,0,0,60
30134,26959702,26959702,26959762,0,0,0,60
30135,26959702,26959702,26959762,0,0,0,60
30136,26959702,26959702,26959762,0,0,0,60
30137,26960149,26960149,26960209,0,0,0,60
30138,26960149,26960149,26960209,0,0,0,60
30139,26960149,26960149,26960209,0,0,0,60
30140,26960233,26960233,26960293,0,0,0,60
30141,26960233,26960233,26960293,0,0,0,60
30142,26960233,26960233,26960293,0,0,0,60
30143,26960609,26960609,26960669,0,0,0,60
30144,26960609,26960609,26960669,0,0,0,60
30145,26960609,26960609,26960669,0,0,0,60
30146,26960643,26960643,26960703,0,0,0,60
30147,26960643,26960643,26960703,0,0,0,60
30148,26960643,26960643,26960703,0,0,0,60
30149,26960689,26960689,26960749,0,0,0,60
30150,26960689,26960689,26960749,0,0,0,60
30151,26960689,26960689,26960749,0,0,0,60
29522,26909401,26909401,26992639,0,0,0,83238
29076,26741214,26741214,27000414,0,0,0,259200
29077,26741214,26741214,27000414,0,0,0,259200
29078,26741214,26741214,27000414,0,0,0,259200
29079,26741214,26741214,27000414,0,0,0,259200
29080,26741215,26741215,27000415,0,0,0,259200
29081,26741215,26741215,27000415,0,0,0,259200
30156,26999316,26999316,27000637,0,0,0,1321
30164,27004391,27004391,27004762,0,0,0,371
30165,27004435,27004435,27004766,0,0,0,331
30166,27004545,27004545,27004902,0,0,0,357
30167,27004598,27004598,27004950,0,0,0,352
30168,27004641,27004641,27004970,0,0,0,329
30158,27002875,27002875,27005195,0,0,0,2320
30170,27005089,27005089,27005448,0,0,0,359
30169,27005080,27005080,27005456,0,0,0,376
30171,27005138,27005138,27005514,0,0,0,376
30172,27005181,27005181,27005564,0,0,0,383
30173,27005253,27005253,27005627,0,0,0,374
29444,26831222,26833010,27005810,0,0,1788,174588
29445,26831235,26833010,27005810,0,0,1775,174575
29446,26831261,26833083,27005883,0,0,1822,174622
29155,26753281,26753281,27012481,0,0,0,259200
30152,26990786,26990786,27035806,0,0,0,45020
30153,26990936,26990936,27039719,0,0,0,48783
29431,26827850,26827850,27041721,0,0,0,213871
29443,26831118,26833373,27065049,0,0,2255,233931
30189,27067226,27067226,27067315,0,0,0,89
30154,26990998,26990998,27069618,0,0,0,78620
30191,27068868,27068868,27074036,0,0,0,5168
30192,27073996,27073996,27074069,0,0,0,73
30193,27074084,27074084,27074230,0,0,0,146
30194,27074241,27074241,27074319,0,0,0,78
30195,27074441,27074441,27074509,0,0,0,68
30196,27077401,27077401,27077485,0,0,0,84
30155,26992599,26992599,27077975,0,0,0,85376
30190,27067433,27067433,27082133,0,0,0,14700
30199,27082199,27082199,27083372,0,0,0,1173
30200,27083792,27083792,27084222,0,0,0,430
30437,27084566,27084566,27084944,0,0,0,378
30438,27086016,27086016,27086804,0,0,0,788
30441,27087698,27087698,27087745,0,0,0,47
30440,27087609,27087609,27087834,0,0,0,225
30439,27086757,27086804,27087851,0,0,47,1094
30443,27087835,27087835,27088805,0,0,0,970
30445,27088832,27088832,27088871,0,0,0,39
30447,27089681,27089681,27089734,0,0,0,53
30448,27089819,27089819,27090789,0,0,0,970
30442,27087803,27087851,27093264,0,0,48,5461
30455,27096581,27096581,27096624,0,0,0,43
30456,27096599,27096599,27096657,0,0,0,58
30457,27096758,27096758,27096803,0,0,0,45
28753,26579173,26579173,27097573,0,0,0,518400
30449,27089825,27093264,27097964,0,0,3439,8139
30459,27099500,27099500,27099593,0,0,0,93
30460,27099500,27099593,27099686,0,0,93,186
30452,27091729,27097964,27099800,0,0,6235,8071
30461,27099500,27099686,27099800,0,0,186,300
30462,27099500,27099800,27099914,0,0,300,414
30463,27099500,27099914,27100028,0,0,414,528
30464,27099500,27100028,27100168,0,0,528,668
30465,27099500,27100168,27100308,0,0,668,808
30466,27099500,27100308,27100469,0,0,808,969
30467,27099500,27100469,27100630,0,0,969,1130
30468,27099500,27100630,27100791,0,0,1130,1291
30469,27099500,27100791,27100978,0,0,1291,1478
30470,27099500,27100978,27101093,0,0,1478,1593
30471,27099500,27101093,27101208,0,0,1593,1708
30472,27099500,27101208,27101323,0,0,1708,1823
30473,27099500,27101323,27101438,0,0,1823,1938
30474,27099500,27101438,27101553,0,0,1938,2053
30475,27099500,27101553,27101668,0,0,2053,2168
30476,27099500,27101668,27101783,0,0,2168,2283
30477,27099500,27101783,27101898,0,0,2283,2398
30478,27099500,27101898,27102013,0,0,2398,2513
30479,27099500,27102013,27102128,0,0,2513,2628
30480,27099500,27102128,27102430,0,0,2628,2930
30481,27099500,27102430,27102545,0,0,2930,3045
30482,27099500,27102545,27102660,0,0,3045,3160
30483,27099500,27102660,27102780,0,0,3160,3280
30484,27099500,27102780,27102900,0,0,3280,3400
30485,27099500,27102900,27102999,0,0,3400,3499
30486,27099500,27102999,27103124,0,0,3499,3624
30487,27099500,27103124,27103249,0,0,3624,3749
30488,27099500,27103249,27103369,0,0,3749,3869
30489,27099500,27103369,27103489,0,0,3869,3989
30490,27099500,27103489,27103588,0,0,3989,4088
30491,27099500,27103588,27103713,0,0,4088,4213
30492,27099500,27103713,27103838,0,0,4213,4338
30493,27099500,27103838,27103937,0,0,4338,4437
30494,27099500,27103937,27104062,0,0,4437,4562
30495,27099500,27104062,27104161,0,0,4562,4661
30496,27099500,27104161,27104281,0,0,4661,4781
30497,27099500,27104281,27104401,0,0,4781,4901
30498,27099500,27104401,27104516,0,0,4901,5016
30499,27099500,27104516,27104647,0,0,5016,5147
30500,27099500,27104647,27104757,0,0,5147,5257
30501,27099500,27104757,27104867,0,0,5257,5367
30502,27099500,27104867,27104977,0,0,5367,5477
30503,27099500,27104977,27105092,0,0,5477,5592
30504,27099500,27105092,27105207,0,0,5592,5707
30505,27099500,27105207,27105442,0,0,5707,5942
30506,27099500,27105442,27105578,0,0,5942,6078
30507,27099500,27105578,27105688,0,0,6078,6188
30508,27099501,27105688,27105798,0,0,6187,6297
30509,27099501,27105798,27105918,0,0,6297,6417
30510,27099501,27105918,27106038,0,0,6417,6537
30511,27099501,27106038,27106158,0,0,6537,6657
30512,27099501,27106158,27106262,0,0,6657,6761
30513,27099501,27106262,27106366,0,0,6761,6865
30514,27099501,27106366,27106496,0,0,6865,6995
30515,27099501,27106496,27106626,0,0,6995,7125
30516,27099501,27106626,27106725,0,0,7125,7224
30517,27099501,27106725,27106850,0,0,7224,7349
30518,27099501,27106850,27106954,0,0,7349,7453
30519,27099501,27106954,27107058,0,0,7453,7557
30520,27099501,27107058,27107188,0,0,7557,7687
30521,27099501,27107188,27107287,0,0,7687,7786
30522,27099501,27107287,27107407,0,0,7786,7906
30523,27099501,27107407,27107506,0,0,7906,8005
30524,27099501,27107506,27107626,0,0,8005,8125
30525,27099501,27107626,27107746,0,0,8125,8245
30526,27099501,27107746,27107861,0,0,8245,8360
30527,27099501,27107861,27107976,0,0,8360,8475
30528,27099501,27107976,27108091,0,0,8475,8590
30529,27099501,27108091,27108206,0,0,8590,8705
30530,27099501,27108206,27108321,0,0,8705,8820
30531,27099501,27108321,27108436,0,0,8820,8935
30453,27095063,27099800,27108440,0,0,4737,13377
30532,27099501,27108436,27108681,0,0,8935,9180
30533,27099501,27108681,27108796,0,0,9180,9295
30534,27099501,27108796,27108911,0,0,9295,9410
30535,27099501,27108911,27109031,0,0,9410,9530
30536,27099501,27109031,27109151,0,0,9530,9650
30537,27099501,27109151,27109250,0,0,9650,9749
30538,27099501,27109250,27109375,0,0,9749,9874
30539,27099501,27109375,27109479,0,0,9874,9978
30540,27099501,27109479,27109604,0,0,9978,10103
30541,27099501,27109604,27109703,0,0,10103,10202
30542,27099501,27109703,27109849,0,0,10202,10348
30543,27099501,27109849,27109969,0,0,10348,10468
30544,27099501,27109969,27110089,0,0,10468,10588
30545,27099501,27110089,27110209,0,0,10588,10708
30546,27099501,27110209,27110329,0,0,10708,10828
30547,27099501,27110329,27110444,0,0,10828,10943
30548,27099501,27110444,27110559,0,0,10943,11058
30549,27099501,27110559,27110674,0,0,11058,11173
30550,27099501,27110674,27110789,0,0,11173,11288
30551,27099501,27110789,27110904,0,0,11288,11403
30552,27099501,27110904,27111019,0,0,11403,11518
30553,27099501,27111019,27111134,0,0,11518,11633
30554,27099501,27111134,27111249,0,0,11633,11748
30555,27099501,27111249,27111364,0,0,11748,11863
30187,27035935,27035935,27111405,0,0,0,75470
30556,27099501,27111364,27111479,0,0,11863,11978
30557,27099501,27111479,27111594,0,0,11978,12093
30558,27099501,27111594,27111850,0,0,12093,12349
30559,27099502,27111850,27111965,0,0,12348,12463
30560,27099502,27111965,27112080,0,0,12463,12578
30561,27099502,27112080,27112195,0,0,12578,12693
30562,27099502,27112195,27112310,0,0,12693,12808
30563,27099502,27112310,27112430,0,0,12808,12928
30564,27099502,27112430,27112550,0,0,12928,13048
30565,27099502,27112550,27112649,0,0,13048,13147
30566,27099502,27112649,27112753,0,0,13147,13251
30567,27099502,27112753,27112857,0,0,13251,13355
30568,27099502,27112857,27113003,0,0,13355,13501
30569,27099502,27113003,27113128,0,0,13501,13626
30570,27099502,27113128,27113227,0,0,13626,13725
30571,27099502,27113227,27113352,0,0,13725,13850
30572,27099502,27113352,27113456,0,0,13850,13954
30573,27099502,27113456,27113560,0,0,13954,14058
30574,27099502,27113560,27113690,0,0,14058,14188
30575,27099502,27113690,27113789,0,0,14188,14287
30576,27099502,27113789,27113909,0,0,14287,14407
30577,27099502,27113909,27114029,0,0,14407,14527
30578,27099502,27114029,27114144,0,0,14527,14642
30579,27099502,27114144,27114259,0,0,14642,14757
30580,27099502,27114259,27114353,0,0,14757,14851
30581,27099502,27114353,27114473,0,0,14851,14971
30582,27099502,27114473,27114593,0,0,14971,15091
30583,27099502,27114593,27114709,0,0,15091,15207
30584,27099502,27114709,27114825,0,0,15207,15323
30585,27099502,27114825,27114941,0,0,15323,15439
30586,27099502,27114941,27115187,0,0,15439,15685
30587,27099502,27115187,27115303,0,0,15685,15801
30588,27099502,27115303,27115419,0,0,15801,15917
30589,27099502,27115419,27115540,0,0,15917,16038
30590,27099502,27115540,27115661,0,0,16038,16159
29813,26942873,26942873,27115673,0,0,0,172800
29814,26942894,26942894,27115694,0,0,0,172800
30591,27099502,27115661,27115761,0,0,16159,16259
30592,27099502,27115761,27115877,0,0,16259,16375
30593,27099502,27115877,27115993,0,0,16375,16491
30594,27099502,27115993,27116094,0,0,16491,16592
30595,27099502,27116094,27116195,0,0,16592,16693
30596,27099502,27116195,27116296,0,0,16693,16794
30597,27099502,27116296,27116397,0,0,16794,16895
30598,27099502,27116397,27116509,0,0,16895,17007
30599,27099502,27116509,27116606,0,0,17007,17104
30600,27099502,27116606,27116714,0,0,17104,17212
30601,27099502,27116714,27116818,0,0,17212,17316
30602,27099502,27116818,27117058,0,0,17316,17556
30454,27095258,27108440,27117136,0,0,13182,21878
30603,27101382,27117058,27117185,0,0,15676,15803
30604,27101382,27117185,27117329,0,0,15803,15947
30605,27101382,27117329,27117473,0,0,15947,16091
30606,27101382,27117473,27117617,0,0,16091,16235
30607,27101382,27117617,27117787,0,0,16235,16405
30608,27101382,27117787,27117957,0,0,16405,16575
30609,27101382,27117957,27118127,0,0,16575,16745
30610,27101382,27118127,27118297,0,0,16745,16915
30611,27101382,27118297,27118467,0,0,16915,17085
30612,27101382,27118467,27118674,0,0,17085,17292
30613,27101382,27118674,27118881,0,0,17292,17499
30614,27101382,27118881,27119088,0,0,17499,17706
30615,27101382,27119088,27119214,0,0,17706,17832
30616,27101382,27119214,27119350,0,0,17832,17968
30617,27101444,27119350,27119486,0,0,17906,18042
30618,27101444,27119486,27119622,0,0,18042,18178
30619,27101444,27119622,27119758,0,0,18178,18314
30620,27101444,27119758,27119894,0,0,18314,18450
30621,27101444,27119894,27120030,0,0,18450,18586
30622,27101444,27120030,27120192,0,0,18586,18748
30623,27101444,27120192,27120354,0,0,18748,18910
30624,27101444,27120354,27120479,0,0,18910,19035
30625,27101444,27120479,27120630,0,0,19035,19186
30626,27101444,27120630,27120781,0,0,19186,19337
30627,27101444,27120781,27120911,0,0,19337,19467
30628,27101444,27120911,27121038,0,0,19467,19594
30629,27101444,27121038,27121182,0,0,19594,19738
30630,27101444,27121182,27121326,0,0,19738,19882
30631,27101444,27121326,27121465,0,0,19882,20021
30632,27101444,27121465,27121604,0,0,20021,20160
30633,27101444,27121604,27121743,0,0,20160,20299
30634,27101444,27121743,27121882,0,0,20299,20438
30635,27101444,27121882,27122021,0,0,20438,20577
30636,27101444,27122021,27122160,0,0,20577,20716
30637,27101444,27122160,27122299,0,0,20716,20855
30638,27101444,27122299,27122438,0,0,20855,20994
30639,27101444,27122438,27122573,0,0,20994,21129
30640,27101444,27122573,27122711,0,0,21129,21267
30641,27101444,27122711,27122848,0,0,21267,21404
30642,27101444,27122848,27122985,0,0,21404,21541
30643,27101444,27122985,27123122,0,0,21541,21678
30644,27101444,27123122,27123259,0,0,21678,21815
30645,27101444,27123259,27123417,0,0,21815,21973
30646,27101444,27123417,27123549,0,0,21973,22105
30647,27101444,27123549,27123681,0,0,22105,22237
30648,27101444,27123681,27123839,0,0,22237,22395
30649,27101444,27123839,27123987,0,0,22395,22543
30650,27101444,27123987,27124135,0,0,22543,22691
30651,27101444,27124135,27124283,0,0,22691,22839
30652,27101444,27124283,27124420,0,0,22839,22976
30653,27101444,27124420,27124557,0,0,22976,23113
30654,27101445,27124557,27124694,0,0,23112,23249
30655,27101445,27124694,27124831,0,0,23249,23386
30656,27101445,27124831,27124968,0,0,23386,23523
30657,27101445,27124968,27125105,0,0,23523,23660
30658,27101445,27125105,27125242,0,0,23660,23797
30659,27101445,27125242,27125379,0,0,23797,23934
30660,27101445,27125379,27125516,0,0,23934,24071
30661,27101445,27125516,27125653,0,0,24071,24208
30458,27096765,27117136,27125713,0,0,20371,28948
30662,27101445,27125653,27125774,0,0,24208,24329
30664,27101445,27125713,27125834,0,0,24268,24389
30665,27101445,27125713,27125850,0,0,24268,24405
30663,27101445,27125713,27125855,0,0,24268,24410
30666,27101445,27125774,27125911,0,0,24329,24466
30668,27101445,27125850,27125982,0,0,24405,24537
30667,27101445,27125834,27125987,0,0,24389,24542
30669,27101445,27125855,27126008,0,0,24410,24563
30670,27101445,27125911,27126043,0,0,24466,24598
30671,27101445,27125982,27126135,0,0,24537,24690
30673,27101445,27126008,27126135,0,0,24563,24690
30672,27101445,27125987,27126140,0,0,24542,24695
30674,27101445,27126043,27126196,0,0,24598,24751
30675,27101445,27126135,27126267,0,0,24690,24822
30676,27101445,27126135,27126267,0,0,24690,24822
30677,27101445,27126140,27126277,0,0,24695,24832
30678,27101445,27126196,27126333,0,0,24751,24888
30679,27101445,27126267,27126404,0,0,24822,24959
30681,27101445,27126277,27126409,0,0,24832,24964
30680,27101445,27126267,27126420,0,0,24822,24975
30682,27101445,27126333,27126465,0,0,24888,25020
30683,27101445,27126404,27126541,0,0,24959,25096
30684,27101445,27126409,27126546,0,0,24964,25101
30685,27101445,27126420,27126557,0,0,24975,25112
30686,27101445,27126465,27126602,0,0,25020,25157
30687,27101445,27126541,27126694,0,0,25096,25249
30689,27101445,27126557,27126694,0,0,25112,25249
30688,27101445,27126546,27126699,0,0,25101,25254
30690,27101445,27126602,27126739,0,0,25157,25294
30691,27101445,27126694,27126831,0,0,25249,25386
30692,27101445,27126694,27126831,0,0,25249,25386
30693,27101445,27126699,27126836,0,0,25254,25391
30694,27101445,27126739,27126897,0,0,25294,25452
30695,27101445,27126831,27126963,0,0,25386,25518
30696,27101445,27126831,27126984,0,0,25386,25539
30697,27101445,27126836,27126989,0,0,25391,25544
30698,27101445,27126897,27127045,0,0,25452,25600
30699,27101445,27126963,27127095,0,0,25518,25650
30701,27101445,27126989,27127121,0,0,25544,25676
30700,27101445,27126984,27127137,0,0,25539,25692
30702,27101445,27127045,27127182,0,0,25600,25737
30703,27101445,27127095,27127232,0,0,25650,25787
30704,27101445,27127121,27127258,0,0,25676,25813
30705,27101445,27127137,27127274,0,0,25692,25829
30706,27101445,27127182,27127319,0,0,25737,25874
30707,27101446,27127232,27127369,0,0,25786,25923
30708,27101446,27127258,27127395,0,0,25812,25949
30709,27101446,27127274,27127411,0,0,25828,25965
30710,27101446,27127319,27127456,0,0,25873,26010
30711,27101446,27127369,27127506,0,0,25923,26060
30712,27101446,27127395,27127532,0,0,25949,26086
30713,27101446,27127411,27127548,0,0,25965,26102
30714,27101446,27127456,27127593,0,0,26010,26147
30715,27101446,27127506,27127643,0,0,26060,26197
30716,27101446,27127532,27127669,0,0,26086,26223
30717,27101446,27127548,27127685,0,0,26102,26239
30718,27101446,27127593,27127730,0,0,26147,26284
30719,27101446,27127643,27127780,0,0,26197,26334
30720,27101446,27127669,27127806,0,0,26223,26360
30721,27101446,27127685,27127838,0,0,26239,26392
30722,27101446,27127730,27127862,0,0,26284,26416
30723,27101446,27127780,27127933,0,0,26334,26487
30724,27101446,27127806,27127938,0,0,26360,26492
30725,27101446,27127838,27127991,0,0,26392,26545
30726,27101446,27127862,27127994,0,0,26416,26548
30727,27101446,27127933,27128070,0,0,26487,26624
30728,27101446,27127938,27128075,0,0,26492,26629
30729,27101446,27127991,27128128,0,0,26545,26682
30730,27101446,27127994,27128131,0,0,26548,26685
30731,27101446,27128070,27128207,0,0,26624,26761
30732,27101446,27128075,27128212,0,0,26629,26766
30733,27101446,27128128,27128265,0,0,26682,26819
30734,27101446,27128131,27128268,0,0,26685,26822
30735,27101446,27128207,27128345,0,0,26761,26899
30736,27101446,27128212,27128350,0,0,26766,26904
30737,27101446,27128265,27128404,0,0,26819,26958
30738,27101446,27128268,27128407,0,0,26822,26961
30739,27101446,27128345,27128485,0,0,26899,27039
30740,27101446,27128350,27128485,0,0,26904,27039
30741,27101446,27128404,27128539,0,0,26958,27093
30742,27101446,27128407,27128543,0,0,26961,27097
30743,27101446,27128485,27128621,0,0,27039,27175
30745,27103445,27128485,27128751,0,0,25040,25306
30746,27103445,27128539,27128821,0,0,25094,25376
30747,27103445,27128543,27128825,0,0,25098,25380
30748,27103461,27128621,27128898,0,0,25160,25437
30749,27103468,27128751,27129028,0,0,25283,25560
30750,27103468,27128821,27129098,0,0,25353,25630
30751,27103469,27128825,27129102,0,0,25356,25633
30752,27103469,27128898,27129206,0,0,25429,25737
30753,27103469,27129028,27129336,0,0,25559,25867
30754,27103469,27129098,27129406,0,0,25629,25937
30755,27103469,27129102,27129410,0,0,25633,25941
30756,27103469,27129206,27129545,0,0,25737,26076
30757,27103469,27129336,27129611,0,0,25867,26142
30758,27103470,27129406,27129681,0,0,25936,26211
30759,27103470,27129410,27129685,0,0,25940,26215
30760,27103470,27129545,27129820,0,0,26075,26350
30761,27103470,27129611,27129886,0,0,26141,26416
30763,27103470,27129685,27129950,0,0,26215,26480
30762,27103470,27129681,27129977,0,0,26211,26507
30764,27103470,27129820,27130116,0,0,26350,26646
30765,27103471,27129886,27130151,0,0,26415,26680
30766,27103471,27129950,27130215,0,0,26479,26744
30767,27103471,27129977,27130274,0,0,26506,26803
30768,27103471,27130116,27130382,0,0,26645,26911
30770,27103471,27130215,27130481,0,0,26744,27010
30771,27103471,27130274,27130545,0,0,26803,27074
30769,27103471,27130151,27130577,0,0,26680,27106
30772,27103518,27130382,27130653,0,0,26864,27135
30773,27103675,27130481,27131081,0,0,26806,27406
30774,27103675,27130545,27131145,0,0,26870,27470
30775,27103700,27130577,27131177,0,0,26877,27477
30776,27103701,27130653,27131253,0,0,26952,27552
30203,27084244,27084244,27131397,0,0,0,47153
30777,27104034,27131081,27131681,0,0,27047,27647
30778,27104034,27131145,27131745,0,0,27111,27711
30779,27104066,27131177,27131777,0,0,27111,27711
30207,27084245,27084245,27131836,0,0,0,47591
30780,27104082,27131253,27131853,0,0,27171,27771
30236,27084251,27084251,27131902,0,0,0,47651
30201,27084243,27084243,27131939,0,0,0,47696
30210,27084246,27084246,27131964,0,0,0,47718
30251,27084293,27084293,27132037,0,0,0,47744
30208,27084245,27084245,27132057,0,0,0,47812
30204,27084244,27084244,27132079,0,0,0,47835
30252,27084293,27084293,27132096,0,0,0,47803
30781,27104083,27131681,27132281,0,0,27598,28198
30253,27084294,27084294,27132284,0,0,0,47990
30782,27104135,27131745,27132345,0,0,27610,28210
30211,27084246,27084246,27132373,0,0,0,48127
30783,27104135,27131777,27132377,0,0,27642,28242
30249,27084293,27084293,27132429,0,0,0,48136
30784,27104154,27131853,27132453,0,0,27699,28299
30205,27084244,27084244,27132468,0,0,0,48224
30209,27084245,27084245,27132483,0,0,0,48238
30206,27084244,27084244,27132524,0,0,0,48280
30212,27084246,27084246,27132557,0,0,0,48311
30250,27084293,27084293,27132619,0,0,0,48326
30229,27084250,27084250,27132841,0,0,0,48591
30230,27084250,27084250,27132849,0,0,0,48599
30785,27104154,27132281,27132881,0,0,28127,28727
30786,27104171,27132345,27132945,0,0,28174,28774
30787,27104172,27132377,27132977,0,0,28205,28805
30214,27084247,27084247,27132987,0,0,0,48740
30788,27104207,27132453,27133053,0,0,28246,28846
30231,27084250,27084250,27133063,0,0,0,48813
30202,27084243,27084243,27133132,0,0,0,48889
30234,27084251,27084251,27133173,0,0,0,48922
30221,27084248,27084248,27133255,0,0,0,49007
30235,27084251,27084251,27133257,0,0,0,49006
30213,27084246,27084246,27133373,0,0,0,49127
30218,27084248,27084248,27133418,0,0,0,49170
30789,27104207,27132881,27133481,0,0,28674,29274
30790,27104250,27132945,27133545,0,0,28695,29295
30215,27084247,27084247,27133567,0,0,0,49320
30791,27104251,27132977,27133577,0,0,28726,29326
30792,27104267,27133053,27133653,0,0,28786,29386
30232,27084250,27084250,27133676,0,0,0,49426
30223,27084249,27084249,27133962,0,0,0,49713
30233,27084250,27084250,27133976,0,0,0,49726
30793,27104268,27133481,27134081,0,0,29213,29813
30225,27084249,27084249,27134099,0,0,0,49850
30794,27104303,27133545,27134145,0,0,29242,29842
30795,27104303,27133577,27134177,0,0,29274,29874
30796,27104323,27133653,27134253,0,0,29330,29930
30216,27084247,27084247,27134638,0,0,0,50391
30797,27104323,27134081,27134681,0,0,29758,30358
30798,27104334,27134145,27134745,0,0,29811,30411
30799,27104334,27134177,27134777,0,0,29843,30443
30800,27104345,27134253,27134853,0,0,29908,30508
30801,27104345,27134681,27135281,0,0,30336,30936
30802,27104375,27134745,27135345,0,0,30370,30970
30803,27104375,27134777,27135377,0,0,30402,31002
30804,27105146,27134853,27135453,0,0,29707,30307
30217,27084247,27084247,27135482,0,0,0,51235
30237,27084251,27084251,27135559,0,0,0,51308
30246,27084253,27084253,27135766,0,0,0,51513
30805,27105147,27135281,27135881,0,0,30134,30734
30226,27084249,27084249,27136231,0,0,0,51982
30227,27084249,27084249,27136731,0,0,0,52482
30239,27084252,27084252,27137034,0,0,0,52782
30228,27084249,27084249,27137743,0,0,0,53494
30240,27084252,27084252,27137756,0,0,0,53504
30241,27084252,27084252,27138690,0,0,0,54438
30245,27084253,27084253,27138768,0,0,0,54515
30222,27084248,27084248,27140047,0,0,0,55799
30248,27084253,27084253,27141453,0,0,0,57200
30224,27084249,27084249,27141568,0,0,0,57319
30238,27084252,27084252,27142323,0,0,0,58071
30244,27084253,27084253,27142434,0,0,0,58181
30219,27084248,27084248,27142539,0,0,0,58291
30242,27084252,27084252,27143675,0,0,0,59423
30243,27084252,27084252,27144041,0,0,0,59789
30247,27084253,27084253,27144138,0,0,0,59885
30220,27084248,27084248,27145379,0,0,0,61131
30254,27084294,27097573,27145951,0,0,13279,61657
30811,27147259,27147259,27147670,0,0,0,411
30812,27147826,27147826,27147931,0,0,0,105
30813,27148003,27148003,27148222,0,0,0,219
30814,27148111,27148222,27148423,0,0,111,312
30815,27149146,27149146,27149365,0,0,0,219
30816,27149350,27149365,27149564,0,0,15,214
30818,27150886,27150886,27151048,0,0,0,162
30819,27151018,27151048,27151203,0,0,30,185
30820,27151371,27151371,27151529,0,0,0,158
30821,27151701,27151701,27151852,0,0,0,151
30822,27151942,27151942,27152093,0,0,0,151
30823,27152236,27152236,27152388,0,0,0,152
30824,27152249,27152388,27152540,0,0,139,291
30825,27152686,27152686,27152994,0,0,0,308
30826,27152697,27152994,27153320,0,0,297,623
30828,27155434,27155434,27155757,0,0,0,323
30829,27155739,27155739,27155808,0,0,0,69
30830,27155830,27155830,27155891,0,0,0,61
30832,27155963,27155963,27155997,0,0,0,34
30833,27156014,27156014,27156076,0,0,0,62
30834,27156438,27156438,27156494,0,0,0,56
30835,27156460,27156460,27156521,0,0,0,61
30836,27156526,27156526,27156594,0,0,0,68
30837,27156548,27156548,27156607,0,0,0,59
30831,27155901,27155901,27156884,0,0,0,983
30838,27156873,27156873,27157112,0,0,0,239
30839,27157222,27157222,27157548,0,0,0,326
30840,27157246,27157548,27157867,0,0,302,621
30841,27157798,27157798,27158776,0,0,0,978
30842,27158682,27158682,27158998,0,0,0,316
30843,27158784,27158998,27159319,0,0,214,535
30255,27084294,27111405,27159333,0,0,27111,75039
30256,27084294,27111405,27159351,0,0,27111,75057
30266,27084296,27111405,27159536,0,0,27109,75240
30257,27084294,27111405,27159549,0,0,27111,75255
30258,27084294,27111405,27159612,0,0,27111,75318
30844,27158847,27159319,27159635,0,0,472,788
30267,27084296,27111405,27159685,0,0,27109,75389
30259,27084295,27111405,27159837,0,0,27110,75542
30260,27084295,27111405,27159864,0,0,27110,75569
30847,27159677,27159677,27159909,0,0,0,232
30845,27158909,27159635,27159986,0,0,726,1077
30848,27159677,27159909,27160141,0,0,232,464
30849,27159681,27160141,27160276,0,0,460,595
30846,27158969,27159986,27160317,0,0,1017,1348
30853,27159682,27160317,27160410,0,0,635,728
30850,27159681,27160276,27160411,0,0,595,730
30852,27159681,27160317,27160498,0,0,636,817
30854,27159682,27160410,27160503,0,0,728,821
30855,27159682,27160411,27160504,0,0,729,822
30851,27159681,27160317,27160519,0,0,636,838
30261,27084295,27111405,27160585,0,0,27110,76290
30856,27159682,27160498,27160591,0,0,816,909
30857,27159686,27160503,27160596,0,0,817,910
30858,27159686,27160504,27160623,0,0,818,937
30859,27159686,27160519,27160638,0,0,833,952
30860,27159686,27160591,27160731,0,0,905,1045
30862,27159774,27160623,27160742,0,0,849,968
30863,27159774,27160638,27160757,0,0,864,983
30861,27159773,27160596,27160758,0,0,823,985
30262,27084295,27111405,27160779,0,0,27110,76484
30864,27159774,27160731,27160798,0,0,957,1024
30867,27159929,27160758,27160830,0,0,829,901
30868,27159929,27160798,27160881,0,0,869,952
30869,27159929,27160830,27160935,0,0,901,1006
30865,27159774,27160742,27160937,0,0,968,1163
30866,27159774,27160757,27160952,0,0,983,1178
30870,27159930,27160881,27160964,0,0,951,1034
30872,27159930,27160937,27161002,0,0,1007,1072
30871,27159930,27160935,27161029,0,0,1005,1099
30873,27159930,27160952,27161090,0,0,1022,1160
30876,27159931,27161029,27161094,0,0,1098,1163
30263,27084295,27111405,27161128,0,0,27110,76833
30874,27159930,27160964,27161135,0,0,1034,1205
30875,27159930,27161002,27161195,0,0,1072,1265
30879,27160458,27161094,27161243,0,0,636,785
30880,27160459,27161135,27161284,0,0,676,825
30881,27160460,27161195,27161344,0,0,735,884
30882,27160460,27161243,27161392,0,0,783,932
30883,27160460,27161284,27161433,0,0,824,973
30878,27160457,27161090,27161449,0,0,633,992
30264,27084296,27111405,27161469,0,0,27109,77173
30884,27160460,27161344,27161493,0,0,884,1033
30197,27077935,27077935,27161528,0,0,0,83593
30885,27160460,27161392,27161541,0,0,932,1081
30888,27160461,27161493,27161555,0,0,1032,1094
30886,27160460,27161433,27161594,0,0,973,1134
30889,27160461,27161541,27161603,0,0,1080,1142
30887,27160460,27161449,27161632,0,0,989,1172
30890,27160583,27161555,27161640,0,0,972,1057
30891,27160583,27161594,27161701,0,0,1011,1118
30894,27160584,27161640,27161714,0,0,1056,1130
30892,27160583,27161603,27161743,0,0,1020,1160
30895,27160584,27161701,27161786,0,0,1117,1202
30893,27160583,27161632,27161794,0,0,1049,1211
30896,27160584,27161714,27161799,0,0,1130,1215
30897,27160584,27161743,27161839,0,0,1159,1255
30265,27084296,27111405,27162320,0,0,27109,78024
30902,27165017,27165017,27165178,0,0,0,161
30903,27165017,27165017,27165178,0,0,0,161
30904,27165018,27165018,27165179,0,0,0,161
30907,27165021,27165179,27165319,0,0,158,298
30905,27165018,27165178,27165339,0,0,160,321
30906,27165020,27165178,27165479,0,0,158,459
30908,27165021,27165319,27165480,0,0,298,459
30909,27165021,27165339,27165500,0,0,318,479
30268,27084296,27115673,27165580,0,0,31377,81284
30911,27165021,27165480,27165636,0,0,459,615
30910,27165021,27165479,27165640,0,0,458,619
30912,27165021,27165500,27165656,0,0,479,635
30913,27165021,27165636,27165792,0,0,615,771
30914,27165139,27165640,27165796,0,0,501,657
30915,27165140,27165656,27165812,0,0,516,672
30918,27165144,27165812,27165963,0,0,668,819
30916,27165143,27165792,27165964,0,0,649,821
30917,27165144,27165796,27165968,0,0,652,824
30919,27165144,27165963,27166114,0,0,819,970
30920,27165144,27165964,27166115,0,0,820,971
30921,27165144,27165968,27166130,0,0,824,986
30270,27084297,27115694,27166247,0,0,31397,81950
30922,27165144,27166114,27166276,0,0,970,1132
30923,27165145,27166115,27166277,0,0,970,1132
30924,27165145,27166130,27166292,0,0,985,1147
30925,27165145,27166276,27166438,0,0,1131,1293
30926,27165145,27166277,27166440,0,0,1132,1295
30927,27165145,27166292,27166455,0,0,1147,1310
30928,27165145,27166438,27166601,0,0,1293,1456
30929,27165146,27166440,27166603,0,0,1294,1457
30930,27165146,27166455,27166618,0,0,1309,1472
30931,27165146,27166601,27166759,0,0,1455,1613
30932,27165147,27166603,27166761,0,0,1456,1614
30933,27165147,27166618,27166776,0,0,1471,1629
30934,27165147,27166759,27166917,0,0,1612,1770
30936,27165148,27166776,27166928,0,0,1628,1780
30935,27165148,27166761,27166950,0,0,1613,1802
30937,27165149,27166917,27167069,0,0,1768,1920
30938,27165149,27166928,27167080,0,0,1779,1931
30939,27165149,27166950,27167102,0,0,1801,1953
30941,27165151,27167080,27167242,0,0,1929,2091
30942,27165151,27167102,27167264,0,0,1951,2113
30940,27165151,27167069,27167268,0,0,1918,2117
30943,27165151,27167242,27167404,0,0,2091,2253
30944,27165152,27167264,27167426,0,0,2112,2274
30945,27165154,27167268,27167436,0,0,2114,2282
30946,27165154,27167404,27167572,0,0,2250,2418
30947,27165154,27167426,27167594,0,0,2272,2440
30948,27165155,27167436,27167604,0,0,2281,2449
30949,27165155,27167572,27167740,0,0,2417,2585
30950,27165155,27167594,27167761,0,0,2439,2606
30951,27165156,27167604,27167771,0,0,2448,2615
30952,27165156,27167740,27167907,0,0,2584,2751
30953,27165156,27167761,27167928,0,0,2605,2772
30954,27165156,27167771,27167938,0,0,2615,2782
30956,27165157,27167928,27168084,0,0,2771,2927
30957,27165157,27167938,27168094,0,0,2781,2937
30955,27165156,27167907,27168209,0,0,2751,3053
30958,27165157,27168084,27168240,0,0,2927,3083
30959,27165157,27168094,27168276,0,0,2937,3119
30961,27165158,27168240,27168385,0,0,3082,3227
30960,27165157,27168209,27168391,0,0,3052,3234
30962,27165158,27168276,27168421,0,0,3118,3263
30963,27165159,27168385,27168556,0,0,3226,3397
30964,27165159,27168391,27168562,0,0,3232,3403
30965,27165159,27168421,27168592,0,0,3262,3433
30966,27165159,27168556,27168727,0,0,3397,3568
30967,27165159,27168562,27168733,0,0,3403,3574
30968,27165160,27168592,27168759,0,0,3432,3599
30969,27165160,27168727,27168894,0,0,3567,3734
30970,27165160,27168733,27168900,0,0,3573,3740
30971,27165160,27168759,27168926,0,0,3599,3766
30972,27165160,27168894,27169036,0,0,3734,3876
30973,27165160,27168900,27169053,0,0,3740,3893
30974,27165161,27168926,27169079,0,0,3765,3918
30975,27165161,27169036,27169174,0,0,3875,4013
30976,27165162,27169053,27169191,0,0,3891,4029
30977,27165162,27169079,27169228,0,0,3917,4066
30978,27165162,27169174,27169323,0,0,4012,4161
30979,27165162,27169191,27169331,0,0,4029,4169
30980,27165163,27169228,27169368,0,0,4065,4205
30981,27165163,27169323,27169474,0,0,4160,4311
30982,27165163,27169331,27169482,0,0,4168,4319
30983,27165163,27169368,27169530,0,0,4205,4367
30985,27165164,27169482,27169613,0,0,4318,4449
30984,27165164,27169474,27169636,0,0,4310,4472
30986,27165164,27169530,27169672,0,0,4366,4508
31000,27169237,27169672,27169723,0,0,435,486
30987,27165165,27169613,27169755,0,0,4448,4590
31001,27169243,27169723,27169772,0,0,480,529
30988,27165165,27169636,27169789,0,0,4471,4624
31002,27169243,27169755,27169815,0,0,512,572
30198,27078594,27078594,27171228,0,0,0,92634
31003,27171198,27171198,27171281,0,0,0,83
31004,27171204,27171204,27171287,0,0,0,83
31005,27171205,27171205,27171299,0,0,0,94
31006,27171458,27171458,27171594,0,0,0,136
31007,27171458,27171458,27171606,0,0,0,148
31008,27171458,27171458,27171606,0,0,0,148
31013,27173776,27173776,27173856,0,0,0,80
31014,27173776,27173776,27173856,0,0,0,80
31015,27173777,27173777,27173878,0,0,0,101
31016,27173777,27173856,27173957,0,0,79,180
31017,27173777,27173856,27173978,0,0,79,201
31018,27173777,27173878,27174000,0,0,101,223
31019,27173777,27173957,27174037,0,0,180,260
31021,27173778,27174000,27174075,0,0,222,297
31022,27173778,27174037,27174112,0,0,259,334
31020,27173777,27173978,27174196,0,0,201,419
31023,27173815,27174075,27174213,0,0,260,398
31024,27173815,27174112,27174250,0,0,297,435
31025,27173815,27174196,27174275,0,0,381,460
31027,27173815,27174250,27174334,0,0,435,519
31026,27173815,27174213,27174356,0,0,398,541
31028,27173815,27174275,27174359,0,0,460,544
31029,27173815,27174334,27174434,0,0,519,619
31030,27173815,27174356,27174451,0,0,541,636
31031,27173816,27174359,27174470,0,0,543,654
31032,27173816,27174434,27174519,0,0,618,703
31033,27173816,27174451,27174536,0,0,635,720
31035,27173817,27174519,27174609,0,0,702,792
31036,27173830,27174536,27174610,0,0,706,780
31034,27173816,27174470,27174661,0,0,654,845
31037,27173830,27174609,27174689,0,0,779,859
31038,27173831,27174610,27174711,0,0,779,880
31039,27173831,27174661,27174757,0,0,830,926
31040,27173831,27174689,27174806,0,0,858,975
31041,27173831,27174711,27174806,0,0,880,975
31042,27173831,27174757,27174847,0,0,926,1016
31043,27173831,27174806,27174896,0,0,975,1065
31045,27173832,27174847,27174937,0,0,1015,1105
31047,27174033,27174896,27174986,0,0,863,953
31044,27173831,27174806,27174991,0,0,975,1160
31048,27174033,27174937,27175027,0,0,904,994
31049,27174034,27174986,27175076,0,0,952,1042
31050,27174034,27174991,27175081,0,0,957,1047
31051,27174034,27175027,27175122,0,0,993,1088
31053,27174035,27175081,27175155,0,0,1046,1120
31052,27174034,27175076,27175192,0,0,1042,1158
31071,27174438,27174438,27175206,0,0,0,768
31054,27174035,27175122,27175217,0,0,1087,1182
31055,27174035,27175155,27175229,0,0,1120,1194
31056,27174035,27175192,27175292,0,0,1157,1257
31057,27174037,27175217,27175301,0,0,1180,1264
31058,27174037,27175229,27175308,0,0,1192,1271
31060,27174038,27175301,27175396,0,0,1263,1358
31061,27174038,27175308,27175398,0,0,1270,1360
31059,27174037,27175292,27175484,0,0,1255,1447
31062,27174038,27175396,27175502,0,0,1358,1464
31063,27174038,27175398,27175504,0,0,1360,1466
31064,27174038,27175484,27175564,0,0,1446,1526
31066,27174038,27175504,27175585,0,0,1466,1547
31065,27174038,27175502,27175588,0,0,1464,1550
31067,27174065,27175564,27175697,0,0,1499,1632
31068,27174065,27175585,27175723,0,0,1520,1658
31069,27174066,27175588,27175731,0,0,1522,1665
30188,27066909,27066909,27175823,0,0,0,108914
31072,27174479,27175697,27175833,0,0,1218,1354
31073,27174479,27175723,27175854,0,0,1244,1375
31074,27174480,27175731,27175868,0,0,1251,1388
31076,27174992,27175833,27175959,0,0,841,967
31077,27174992,27175854,27175992,0,0,862,1000
31078,27174992,27175868,27176006,0,0,876,1014
31079,27175513,27175959,27176101,0,0,446,588
31080,27175513,27175992,27176134,0,0,479,621
31081,27175514,27176006,27176148,0,0,492,634
31082,27175614,27176101,27176174,0,0,487,560
31083,27175620,27176134,27176207,0,0,514,587
31084,27175620,27176148,27176237,0,0,528,617
31085,27175621,27176174,27176263,0,0,553,642
31086,27175621,27176207,27176280,0,0,586,659
31087,27175621,27176237,27176322,0,0,616,701
31089,27175622,27176280,27176365,0,0,658,743
31090,27175622,27176322,27176392,0,0,700,770
31091,27175773,27176365,27176439,0,0,592,666
31088,27175621,27176263,27176458,0,0,642,837
31092,27175773,27176392,27176482,0,0,619,709
31093,27175773,27176439,27176529,0,0,666,756
31094,27175774,27176458,27176548,0,0,684,774
31095,27175774,27176482,27176598,0,0,708,824
31096,27175774,27176529,27176645,0,0,755,871
31097,27175774,27176548,27176664,0,0,774,890
31098,27175774,27176598,27176669,0,0,824,895
31099,27175774,27176645,27176717,0,0,871,943
31101,27175776,27176669,27176741,0,0,893,965
31102,27175776,27176717,27176810,0,0,941,1034
31103,27175776,27176741,27176824,0,0,965,1048
31100,27175774,27176664,27176859,0,0,890,1085
31104,27175776,27176810,27176893,0,0,1034,1117
31105,27175776,27176824,27176907,0,0,1048,1131
31106,27175777,27176859,27176939,0,0,1082,1162
31107,27175777,27176893,27176972,0,0,1116,1195
31108,27175777,27176907,27176986,0,0,1130,1209
31109,27175777,27176939,27177023,0,0,1162,1246
31110,27175777,27176972,27177056,0,0,1195,1279
31111,27175815,27176986,27177070,0,0,1171,1255
31112,27175816,27177023,27177107,0,0,1207,1291
31114,27175816,27177070,27177138,0,0,1254,1322
31113,27175816,27177056,27177140,0,0,1240,1324
31115,27175816,27177107,27177196,0,0,1291,1380
31116,27175817,27177138,27177217,0,0,1321,1400
31117,27175817,27177140,27177219,0,0,1323,1402
31118,27175817,27177196,27177275,0,0,1379,1458
31120,27175818,27177219,27177319,0,0,1401,1501
31121,27175885,27177275,27177349,0,0,1390,1464
31122,27175886,27177319,27177393,0,0,1433,1507
31119,27175817,27177217,27177412,0,0,1400,1595
31123,27175886,27177349,27177444,0,0,1463,1558
31124,27175886,27177393,27177472,0,0,1507,1586
31125,27175886,27177412,27177486,0,0,1526,1600
31126,27175887,27177444,27177529,0,0,1557,1642
31127,27175887,27177472,27177547,0,0,1585,1660
30269,27084296,27115673,27177554,0,0,31377,93258
31128,27175887,27177486,27177572,0,0,1599,1685
31129,27175887,27177529,27177605,0,0,1642,1718
31130,27175887,27177547,27177623,0,0,1660,1736
31131,27176320,27177572,27177701,0,0,1252,1381
31132,27176321,27177605,27177750,0,0,1284,1429
31133,27176321,27177623,27177768,0,0,1302,1447
31134,27176321,27177701,27177846,0,0,1380,1525
31135,27176321,27177750,27177921,0,0,1429,1600
31136,27176321,27177768,27177939,0,0,1447,1618
31137,27176321,27177846,27178017,0,0,1525,1696
31139,27176322,27177939,27178063,0,0,1617,1741
31140,27176322,27178017,27178141,0,0,1695,1819
31141,27176322,27178063,27178203,0,0,1741,1881
31138,27176321,27177921,27178248,0,0,1600,1927
31142,27176322,27178141,27178297,0,0,1819,1975
31143,27176322,27178203,27178333,0,0,1881,2011
31144,27176322,27178248,27178378,0,0,1926,2056
31145,27176322,27178297,27178453,0,0,1975,2131
31146,27176323,27178333,27178470,0,0,2010,2147
31147,27176323,27178378,27178510,0,0,2055,2187
31148,27176323,27178453,27178581,0,0,2130,2258
31149,27176323,27178470,27178598,0,0,2147,2275
31150,27176323,27178510,27178654,0,0,2187,2331
31151,27176323,27178581,27178725,0,0,2258,2402
31152,27176324,27178598,27178737,0,0,2274,2413
31153,27176324,27178654,27178791,0,0,2330,2467
31154,27176324,27178725,27178877,0,0,2401,2553
31155,27176324,27178737,27178889,0,0,2413,2565
31156,27176324,27178791,27178922,0,0,2467,2598
31161,27176781,27178922,27178979,0,0,2141,2198
31158,27176324,27178889,27179021,0,0,2565,2697
31162,27176782,27178979,27179057,0,0,2197,2275
31163,27176782,27179021,27179099,0,0,2239,2317
31164,27176782,27179057,27179136,0,0,2275,2354
31157,27176324,27178877,27179173,0,0,2553,2849
31166,27176783,27179136,27179178,0,0,2353,2395
31165,27176782,27179099,27179200,0,0,2317,2418
31167,27176783,27179173,27179227,0,0,2390,2444
31168,27176783,27179178,27179301,0,0,2395,2518
31169,27176783,27179200,27179302,0,0,2417,2519
31172,27177037,27179301,27179354,0,0,2264,2317
31173,27177037,27179302,27179366,0,0,2265,2329
31170,27176783,27179227,27179388,0,0,2444,2605
31174,27177037,27179354,27179434,0,0,2317,2397
31175,27177038,27179366,27179438,0,0,2328,2400
31178,27177039,27179438,27179476,0,0,2399,2437
31176,27177038,27179388,27179505,0,0,2350,2467
31179,27177039,27179476,27179540,0,0,2437,2501
31180,27177039,27179505,27179563,0,0,2466,2524
31181,27177039,27179540,27179619,0,0,2501,2580
31182,27177041,27179563,27179621,0,0,2522,2580
31177,27177038,27179434,27179669,0,0,2396,2631
31183,27177041,27179619,27179672,0,0,2578,2631
31184,27177041,27179621,27179696,0,0,2580,2655
31185,27177041,27179669,27179723,0,0,2628,2682
31186,27177041,27179672,27179768,0,0,2631,2727
31187,27177041,27179696,27179814,0,0,2655,2773
31189,27177042,27179768,27179816,0,0,2726,2774
30280,27084300,27132096,27179854,0,0,47796,95554
31190,27177042,27179814,27179878,0,0,2772,2836
31191,27177042,27179816,27179896,0,0,2774,2854
31188,27177041,27179723,27179915,0,0,2682,2874
31192,27177043,27179878,27179931,0,0,2835,2888
31193,27177043,27179896,27179954,0,0,2853,2911
31194,27177043,27179915,27179989,0,0,2872,2946
31195,27177043,27179931,27180016,0,0,2888,2973
31197,27177044,27179989,27180037,0,0,2945,2993
31198,27177044,27180016,27180064,0,0,2972,3020
31200,27177044,27180064,27180128,0,0,3020,3084
31196,27177043,27179954,27180151,0,0,2911,3108
31199,27177044,27180037,27180154,0,0,2993,3110
31201,27177044,27180128,27180208,0,0,3084,3164
31202,27177045,27180151,27180215,0,0,3106,3170
31203,27177045,27180154,27180218,0,0,3109,3173
31204,27177045,27180208,27180277,0,0,3163,3232
31205,27177061,27180215,27180290,0,0,3154,3229
31206,27177062,27180218,27180309,0,0,3156,3247
30276,27084299,27131964,27180317,0,0,47665,96018
31207,27177062,27180277,27180336,0,0,3215,3274
31210,27177063,27180336,27180390,0,0,3273,3327
31208,27177062,27180290,27180408,0,0,3228,3346
31209,27177062,27180309,27180461,0,0,3247,3399
31211,27177063,27180390,27180477,0,0,3327,3414
31215,27177648,27180408,27180545,0,0,2760,2897
30900,27162948,27162948,27180556,0,0,0,17608
31216,27177649,27180461,27180598,0,0,2812,2949
30283,27084301,27132429,27180601,0,0,48128,96300
31217,27177649,27180477,27180614,0,0,2828,2965
30287,27084302,27132557,27180640,0,0,48255,96338
31218,27177649,27180545,27180682,0,0,2896,3033
30298,27084350,27133418,27180707,0,0,49068,96357
31219,27177649,27180598,27180735,0,0,2949,3086
31220,27177650,27180614,27180751,0,0,2964,3101
31221,27177650,27180682,27180840,0,0,3032,3190
31222,27177650,27180735,27180875,0,0,3085,3225
30299,27084351,27133567,27180907,0,0,49216,96556
31224,27177651,27180840,27180980,0,0,3189,3329
31223,27177650,27180751,27181040,0,0,3101,3390
31225,27177651,27180875,27181075,0,0,3224,3424
30300,27084351,27133676,27181090,0,0,49325,96739
31226,27177651,27180980,27181164,0,0,3329,3513
31227,27177651,27181040,27181208,0,0,3389,3557
31228,27177652,27181075,27181243,0,0,3423,3591
31229,27177652,27181164,27181329,0,0,3512,3677
31230,27177652,27181208,27181357,0,0,3556,3705
30277,27084299,27132037,27181446,0,0,47738,97147
31232,27177653,27181329,27181461,0,0,3676,3808
31231,27177652,27181243,27181484,0,0,3591,3832
31233,27177653,27181357,27181489,0,0,3704,3836
31234,27177653,27181461,27181614,0,0,3808,3961
31236,27177653,27181489,27181621,0,0,3836,3968
31235,27177653,27181484,27181637,0,0,3831,3984
30278,27084299,27132057,27181697,0,0,47758,97398
30281,27084300,27132284,27181706,0,0,47984,97406
31238,27177654,27181621,27181753,0,0,3967,4099
31239,27177654,27181637,27181769,0,0,3983,4115
31237,27177653,27181614,27181872,0,0,3961,4219
31240,27177654,27181753,27181879,0,0,4099,4225
31241,27177654,27181769,27181912,0,0,4115,4258
30286,27084301,27132524,27181937,0,0,48223,97636
30303,27084352,27134099,27181960,0,0,49747,97608
31242,27177654,27181872,27181994,0,0,4218,4340
31243,27177654,27181879,27182022,0,0,4225,4368
31244,27177655,27181912,27182037,0,0,4257,4382
30282,27084300,27132373,27182057,0,0,48073,97757
31245,27177655,27181994,27182136,0,0,4339,4481
31246,27177655,27182022,27182159,0,0,4367,4504
31247,27177655,27182037,27182169,0,0,4382,4514
31248,27177655,27182136,27182267,0,0,4481,4612
31249,27177655,27182159,27182290,0,0,4504,4635
31251,27177656,27182267,27182398,0,0,4611,4742
31252,27177656,27182290,27182416,0,0,4634,4760
30284,27084301,27132468,27182430,0,0,48167,98129
31250,27177655,27182169,27182432,0,0,4514,4777
30272,27084298,27131397,27182489,0,0,47099,98191
31253,27177656,27182398,27182524,0,0,4742,4868
31254,27177656,27182416,27182542,0,0,4760,4886
31255,27177656,27182432,27182563,0,0,4776,4907
30301,27084351,27133962,27182599,0,0,49611,98248
30304,27084352,27134638,27182645,0,0,50286,98293
31256,27177656,27182524,27182655,0,0,4868,4999
31257,27177656,27182542,27182673,0,0,4886,5017
31258,27177657,27182563,27182694,0,0,4906,5037
31259,27177657,27182655,27182784,0,0,4998,5127
31260,27177657,27182673,27182801,0,0,5016,5144
31261,27177657,27182694,27182822,0,0,5037,5165
30285,27084301,27132483,27182851,0,0,48182,98550
31262,27177657,27182784,27182907,0,0,5127,5250
31263,27177657,27182801,27182924,0,0,5144,5267
31265,27177658,27182907,27183046,0,0,5249,5388
31266,27177658,27182924,27183058,0,0,5266,5400
31264,27177657,27182822,27183084,0,0,5165,5427
31267,27177658,27183046,27183180,0,0,5388,5522
31268,27177658,27183058,27183192,0,0,5400,5534
31269,27177658,27183084,27183218,0,0,5426,5560
31270,27177658,27183180,27183303,0,0,5522,5645
31271,27177659,27183192,27183320,0,0,5533,5661
31272,27177659,27183218,27183346,0,0,5559,5687
31273,27177660,27183303,27183431,0,0,5643,5771
31274,27177660,27183320,27183459,0,0,5660,5799
30302,27084351,27133976,27183470,0,0,49625,99119
31275,27177660,27183346,27183504,0,0,5686,5844
31277,27177661,27183459,27183585,0,0,5798,5924
31276,27177660,27183431,27183599,0,0,5771,5939
31278,27177661,27183504,27183609,0,0,5843,5948
31279,27177661,27183585,27183700,0,0,5924,6039
31281,27177662,27183609,27183708,0,0,5947,6046
31282,27177662,27183700,27183761,0,0,6038,6099
31283,27177662,27183708,27183765,0,0,6046,6103
31284,27177662,27183761,27183818,0,0,6099,6156
31285,27177663,27183765,27183843,0,0,6102,6180
31280,27177661,27183599,27183871,0,0,5938,6210
31286,27177663,27183818,27183886,0,0,6155,6223
30307,27084353,27135766,27183898,0,0,51413,99545
30305,27084352,27135482,27183900,0,0,51130,99548
31287,27177663,27183843,27183911,0,0,6180,6248
31288,27177663,27183871,27183939,0,0,6208,6276
31289,27177664,27183886,27183954,0,0,6222,6290
31290,27177664,27183911,27183974,0,0,6247,6310
31291,27177664,27183939,27184002,0,0,6275,6338
31292,27177664,27183954,27184022,0,0,6290,6358
31293,27177664,27183974,27184047,0,0,6310,6383
30306,27084352,27135559,27184050,0,0,51207,99698
31294,27177664,27184002,27184075,0,0,6338,6411
31295,27177665,27184022,27184095,0,0,6357,6430
31296,27177665,27184047,27184120,0,0,6382,6455
31297,27177665,27184075,27184148,0,0,6410,6483
31298,27177665,27184095,27184168,0,0,6430,6503
31299,27177665,27184120,27184193,0,0,6455,6528
31300,27177665,27184148,27184216,0,0,6483,6551
31302,27177666,27184193,27184261,0,0,6527,6595
31303,27177666,27184216,27184284,0,0,6550,6618
30288,27084302,27132619,27184316,0,0,48317,100014
31304,27177666,27184261,27184329,0,0,6595,6663
31301,27177665,27184168,27184351,0,0,6503,6686
31305,27177666,27184284,27184352,0,0,6618,6686
31306,27177666,27184329,27184397,0,0,6663,6731
31307,27177666,27184351,27184419,0,0,6685,6753
31308,27177667,27184352,27184420,0,0,6685,6753
31309,27177667,27184397,27184465,0,0,6730,6798
31310,27177667,27184419,27184487,0,0,6752,6820
31311,27177667,27184420,27184488,0,0,6753,6821
31312,27177667,27184465,27184533,0,0,6798,6866
30308,27084353,27136231,27184544,0,0,51878,100191
31313,27177667,27184487,27184555,0,0,6820,6888
31314,27177667,27184488,27184561,0,0,6821,6894
31315,27177667,27184533,27184590,0,0,6866,6923
31316,27177668,27184555,27184633,0,0,6887,6965
31317,27177668,27184561,27184639,0,0,6893,6971
31318,27177668,27184590,27184642,0,0,6922,6974
31319,27177668,27184633,27184711,0,0,6965,7043
31320,27177668,27184639,27184717,0,0,6971,7049
31322,27177669,27184711,27184779,0,0,7042,7110
31323,27177669,27184717,27184785,0,0,7048,7116
31321,27177668,27184642,27184830,0,0,6974,7162
31324,27177669,27184779,27184847,0,0,7110,7178
31325,27177669,27184785,27184853,0,0,7116,7184
31326,27177669,27184830,27184898,0,0,7161,7229
31328,27177676,27184847,27184915,0,0,7171,7239
31329,27177676,27184853,27184921,0,0,7177,7245
31330,27177676,27184898,27184966,0,0,7222,7290
31331,27177677,27184915,27184983,0,0,7238,7306
31332,27177677,27184921,27184989,0,0,7244,7312
31333,27177677,27184966,27185034,0,0,7289,7357
31334,27177678,27184983,27185051,0,0,7305,7373
31335,27177678,27184989,27185062,0,0,7311,7384
31336,27177678,27185034,27185107,0,0,7356,7429
31338,27177679,27185062,27185114,0,0,7383,7435
31337,27177678,27185051,27185129,0,0,7373,7451
30184,27012359,27012359,27185159,0,0,0,172800
31339,27177679,27185107,27185164,0,0,7428,7485
31340,27177680,27185114,27185171,0,0,7434,7491
30185,27012373,27012373,27185173,0,0,0,172800
31341,27177680,27185129,27185212,0,0,7449,7532
31342,27177680,27185164,27185216,0,0,7484,7536
31343,27177680,27185171,27185244,0,0,7491,7564
31345,27177681,27185216,27185289,0,0,7535,7608
30309,27084353,27136731,27185311,0,0,52378,100958
31346,27177681,27185244,27185312,0,0,7563,7631
31347,27177681,27185289,27185357,0,0,7608,7676
31348,27177681,27185312,27185380,0,0,7631,7699
31344,27177680,27185212,27185401,0,0,7532,7721
31349,27177681,27185357,27185410,0,0,7676,7729
31350,27177681,27185380,27185449,0,0,7699,7768
31351,27177681,27185401,27185465,0,0,7720,7784
31352,27180119,27185410,27185466,0,0,5291,5347
31353,27180119,27185449,27185521,0,0,5330,5402
31354,27180119,27185465,27185537,0,0,5346,5418
31355,27180120,27185466,27185538,0,0,5346,5418
31356,27180120,27185521,27185579,0,0,5401,5459
31357,27180120,27185537,27185590,0,0,5417,5470
31359,27180121,27185579,27185643,0,0,5458,5522
31360,27180121,27185590,27185654,0,0,5469,5533
31362,27180345,27185654,27185708,0,0,5309,5363
31358,27180120,27185538,27185723,0,0,5418,5603
31361,27180121,27185643,27185746,0,0,5522,5625
31363,27180351,27185708,27185762,0,0,5357,5411
31364,27180351,27185723,27185793,0,0,5372,5442
31365,27180352,27185746,27185816,0,0,5394,5464
31366,27180352,27185762,27185827,0,0,5410,5475
31367,27180352,27185793,27185857,0,0,5441,5505
31369,27180353,27185827,27185886,0,0,5474,5533
31370,27180353,27185857,27185927,0,0,5504,5574
31371,27180353,27185886,27185946,0,0,5533,5593
31372,27180585,27185927,27185979,0,0,5342,5394
31368,27180352,27185816,27186000,0,0,5464,5648
31373,27180585,27185946,27186014,0,0,5361,5429
31374,27180586,27185979,27186047,0,0,5393,5461
31375,27180586,27186000,27186089,0,0,5414,5503
31376,27180586,27186014,27186103,0,0,5428,5517
31377,27180586,27186047,27186103,0,0,5461,5517
30310,27084353,27137034,27186130,0,0,52681,101777
31378,27180586,27186089,27186151,0,0,5503,5565
31380,27180587,27186103,27186165,0,0,5516,5578
31381,27180587,27186151,27186203,0,0,5564,5616
31382,27181562,27186165,27186219,0,0,4603,4657
31383,27181562,27186203,27186274,0,0,4641,4712
31384,27181562,27186219,27186290,0,0,4657,4728
31379,27180586,27186103,27186295,0,0,5517,5709
31385,27181562,27186274,27186345,0,0,4712,4783
31387,27181562,27186295,27186349,0,0,4733,4787
31386,27181562,27186290,27186387,0,0,4728,4825
30311,27084354,27137743,27186396,0,0,53389,102042
31389,27181593,27186349,27186403,0,0,4756,4810
31390,27181594,27186387,27186452,0,0,4793,4858
31391,27181594,27186403,27186468,0,0,4809,4874
31392,27181766,27186452,27186508,0,0,4686,4742
31388,27181562,27186345,27186537,0,0,4783,4975
31393,27181766,27186468,27186540,0,0,4702,4774
31394,27181766,27186508,27186580,0,0,4742,4814
31395,27181766,27186537,27186609,0,0,4771,4843
31396,27181766,27186540,27186638,0,0,4774,4872
31398,27181797,27186609,27186663,0,0,4812,4866
31399,27181798,27186638,27186692,0,0,4840,4894
30274,27084298,27131902,27186695,0,0,47604,102397
31400,27181798,27186663,27186729,0,0,4865,4931
31401,27181798,27186692,27186758,0,0,4894,4960
31402,27181948,27186729,27186782,0,0,4781,4834
31397,27181766,27186580,27186793,0,0,4814,5027
31403,27181948,27186758,27186822,0,0,4810,4874
31404,27181948,27186782,27186857,0,0,4834,4909
31405,27181948,27186793,27186868,0,0,4845,4920
31406,27182094,27186822,27186886,0,0,4728,4792
31407,27182094,27186857,27186921,0,0,4763,4827
31408,27182094,27186868,27186932,0,0,4774,4838
30312,27084354,27137756,27186961,0,0,53402,102607
31409,27182094,27186886,27186961,0,0,4792,4867
31410,27182215,27186921,27186977,0,0,4706,4762
31411,27182215,27186932,27187000,0,0,4717,4785
31412,27182215,27186961,27187029,0,0,4746,4814
31414,27182311,27187000,27187045,0,0,4689,4734
31413,27182215,27186977,27187056,0,0,4762,4841
31415,27182311,27187029,27187074,0,0,4718,4763
31416,27182311,27187045,27187090,0,0,4734,4779
31417,27182311,27187056,27187113,0,0,4745,4802
31418,27182429,27187074,27187139,0,0,4645,4710
31419,27182435,27187090,27187149,0,0,4655,4714
31420,27182435,27187113,27187172,0,0,4678,4737
31421,27182435,27187139,27187209,0,0,4704,4774
31422,27182537,27187149,27187214,0,0,4612,4677
31423,27182543,27187172,27187231,0,0,4629,4688
31424,27182543,27187209,27187268,0,0,4666,4725
31425,27182543,27187214,27187284,0,0,4671,4741
31426,27182646,27187231,27187285,0,0,4585,4639
31427,27182652,27187268,27187316,0,0,4616,4664
31428,27182652,27187284,27187332,0,0,4632,4680
31429,27182652,27187285,27187350,0,0,4633,4698
31430,27182728,27187316,27187379,0,0,4588,4651
31431,27182729,27187332,27187395,0,0,4603,4666
30289,27084302,27132841,27187430,0,0,48539,103128
30315,27084355,27140047,27187434,0,0,55692,103079
31432,27182729,27187350,27187434,0,0,4621,4705
31433,27182729,27187379,27187463,0,0,4650,4734
31434,27182729,27187395,27187479,0,0,4666,4750
31435,27182730,27187434,27187481,0,0,4704,4751
31436,27182730,27187463,27187526,0,0,4733,4796
31437,27182730,27187479,27187537,0,0,4749,4807
31439,27182731,27187526,27187584,0,0,4795,4853
31440,27182731,27187537,27187616,0,0,4806,4885
31441,27182731,27187584,27187653,0,0,4853,4922
31438,27182730,27187481,27187691,0,0,4751,4961
30295,27084303,27133255,27187697,0,0,48952,103394
31442,27182731,27187616,27187700,0,0,4885,4969
31443,27182732,27187653,27187721,0,0,4921,4989
31444,27182732,27187691,27187759,0,0,4959,5027
31445,27182732,27187700,27187762,0,0,4968,5030
31446,27182732,27187721,27187799,0,0,4989,5067
31447,27182733,27187759,27187821,0,0,5026,5088
31448,27182733,27187762,27187852,0,0,5029,5119
31450,27182733,27187821,27187880,0,0,5088,5147
31449,27182733,27187799,27187889,0,0,5066,5156
31451,27182733,27187852,27187911,0,0,5119,5178
31452,27182733,27187880,27187939,0,0,5147,5206
31454,27182770,27187911,27187963,0,0,5141,5193
31455,27182770,27187939,27187991,0,0,5169,5221
31456,27182770,27187963,27188015,0,0,5193,5245
31458,27183368,27187991,27188056,0,0,4623,4688
31453,27182734,27187889,27188069,0,0,5155,5335
31459,27183374,27188015,27188079,0,0,4641,4705
31460,27183374,27188056,27188120,0,0,4682,4746
31461,27183375,27188069,27188133,0,0,4694,4758
30313,27084354,27138690,27188134,0,0,54336,103780
31462,27183375,27188079,27188169,0,0,4704,4794
31463,27183375,27188120,27188174,0,0,4745,4799
30273,27084298,27131836,27188175,0,0,47538,103877
31465,27183376,27188169,27188222,0,0,4793,4846
31466,27183376,27188174,27188239,0,0,4798,4863
31467,27183376,27188222,27188287,0,0,4846,4911
31464,27183375,27188133,27188326,0,0,4758,4951
31472,27183885,27188239,27188328,0,0,4354,4443
31473,27183885,27188287,27188392,0,0,4402,4507
31475,27183886,27188328,27188433,0,0,4442,4547
31474,27183885,27188326,27188442,0,0,4441,4557
31476,27183886,27188392,27188483,0,0,4506,4597
31477,27183886,27188433,27188545,0,0,4547,4659
31478,27183886,27188442,27188554,0,0,4556,4668
31479,27183886,27188483,27188595,0,0,4597,4709
31482,27183958,27188595,27188670,0,0,4637,4712
31481,27183887,27188554,27188678,0,0,4667,4791
31494,27184013,27188678,27188751,0,0,4665,4738
30314,27084354,27138768,27188753,0,0,54414,104399
31485,27183959,27188670,27188765,0,0,4711,4806
31480,27183886,27188545,27188768,0,0,4659,4882
31506,27184042,27188765,27188837,0,0,4723,4795
31498,27184014,27188751,27188858,0,0,4737,4844
31509,27184043,27188768,27188866,0,0,4725,4823
31522,27184941,27188837,27188947,0,0,3896,4006
31523,27184941,27188858,27188987,0,0,3917,4046
31524,27184942,27188866,27188995,0,0,3924,4053
31525,27184942,27188947,27189076,0,0,4005,4134
31528,27184975,27189076,27189110,0,0,4101,4135
31526,27184942,27188987,27189116,0,0,4045,4174
31529,27185183,27189110,27189175,0,0,3927,3992
31530,27185210,27189116,27189218,0,0,3906,4008
31527,27184942,27188995,27189224,0,0,4053,4282
31531,27185330,27189175,27189288,0,0,3845,3958
30294,27084303,27133173,27189524,0,0,48870,105221
31534,27185852,27189224,27190053,0,0,3372,4201
31535,27185960,27189288,27190118,0,0,3328,4158
31532,27185563,27189218,27190337,0,0,3655,4774
31537,27187157,27190118,27190352,0,0,2961,3195
31536,27186693,27190053,27190530,0,0,3360,3837
31539,27187211,27190352,27190531,0,0,3141,3320
31538,27187195,27190337,27190532,0,0,3142,3337
31542,27187372,27190532,27190655,0,0,3160,3283
31541,27187253,27190531,27190667,0,0,3278,3414
31540,27187228,27190530,27190682,0,0,3302,3454
30316,27084355,27141453,27190720,0,0,57098,106365
31544,27187440,27190667,27190725,0,0,3227,3285
31543,27187402,27190655,27190740,0,0,3253,3338
31545,27187479,27190682,27190740,0,0,3203,3261
30291,27084302,27132987,27191077,0,0,48685,106775
31551,27190879,27190879,27191112,0,0,0,233
30290,27084302,27132849,27191168,0,0,48547,106866
30296,27084303,27133257,27192054,0,0,48954,107751
30275,27084298,27131939,27192164,0,0,47641,107866
30317,27084355,27141568,27192315,0,0,57213,107960
30279,27084299,27132079,27192426,0,0,47780,108127
30293,27084303,27133132,27193150,0,0,48829,108847
30292,27084302,27133063,27193437,0,0,48761,109135
30325,27084357,27145951,27194187,0,0,61594,109830
30318,27084355,27142323,27194292,0,0,57968,109937
30321,27084356,27143675,27194925,0,0,59319,110569
30320,27084356,27142539,27195015,0,0,58183,110659
30322,27084356,27144041,27198504,0,0,59685,114148
30319,27084355,27142434,27199646,0,0,58079,115291
31546,27187635,27190725,27199725,0,0,3090,12090
31547,27187699,27190740,27199740,0,0,3041,12041
31548,27187708,27190740,27199740,0,0,3032,12032
30323,27084356,27144138,27199815,0,0,59782,115459
31553,27196885,27199740,27199860,0,0,2855,2975
31554,27197097,27199860,27200017,0,0,2763,2920
31555,27197098,27200017,27200136,0,0,2919,3038
31556,27197098,27200136,27200272,0,0,3038,3174
31557,27197098,27200272,27200408,0,0,3174,3310
31558,27197098,27200408,27200565,0,0,3310,3467
31559,27197098,27200565,27200679,0,0,3467,3581
31560,27197098,27200679,27200961,0,0,3581,3863
31561,27197099,27200961,27201086,0,0,3862,3987
31562,27197099,27201086,27201211,0,0,3987,4112
31563,27197099,27201211,27201336,0,0,4112,4237
31564,27197099,27201336,27201461,0,0,4237,4362
31565,27197099,27201461,27201576,0,0,4362,4477
30324,27084356,27145379,27201647,0,0,61023,117291
31566,27197099,27201576,27201690,0,0,4477,4591
31567,27197099,27201690,27201821,0,0,4591,4722
31568,27197100,27201821,27201947,0,0,4721,4847
31569,27197100,27201947,27202073,0,0,4847,4973
30271,27084297,27115694,27202094,0,0,31397,117797
31570,27197100,27202073,27202198,0,0,4973,5098
31571,27197100,27202198,27202312,0,0,5098,5212
31572,27197100,27202312,27202426,0,0,5212,5326
31573,27197100,27202426,27202682,0,0,5326,5582
31574,27197101,27202682,27202796,0,0,5581,5695
31575,27197101,27202796,27202926,0,0,5695,5825
31576,27197101,27202926,27203045,0,0,5825,5944
31577,27197101,27203045,27203164,0,0,5944,6063
31578,27197101,27203164,27203282,0,0,6063,6181
31579,27197101,27203282,27203400,0,0,6181,6299
31580,27197101,27203400,27203518,0,0,6299,6417
31581,27197102,27203518,27203634,0,0,6416,6532
31582,27197102,27203634,27203750,0,0,6532,6648
31583,27197102,27203750,27203867,0,0,6648,6765
31584,27197102,27203867,27203985,0,0,6765,6883
31585,27197102,27203985,27204103,0,0,6883,7001
31586,27197102,27204103,27204355,0,0,7001,7253
31587,27197103,27204355,27204475,0,0,7252,7372
31588,27197103,27204475,27204595,0,0,7372,7492
31589,27197103,27204595,27204714,0,0,7492,7611
31590,27197103,27204714,27204843,0,0,7611,7740
31591,27197103,27204843,27204972,0,0,7740,7869
31592,27197103,27204972,27205096,0,0,7869,7993
31593,27197103,27205096,27205341,0,0,7993,8238
31594,27197135,27205341,27205465,0,0,8206,8330
31595,27197135,27205465,27205589,0,0,8330,8454
31596,27197135,27205589,27205704,0,0,8454,8569
31597,27197135,27205704,27205820,0,0,8569,8685
31598,27197135,27205820,27205941,0,0,8685,8806
31599,27197136,27205941,27206062,0,0,8805,8926
31600,27197136,27206062,27206183,0,0,8926,9047
31601,27197136,27206183,27206302,0,0,9047,9166
31602,27197136,27206302,27206420,0,0,9166,9284
31603,27197137,27206420,27206540,0,0,9283,9403
31604,27197137,27206540,27206660,0,0,9403,9523
31605,27197137,27206660,27206780,0,0,9523,9643
31606,27197137,27206780,27207029,0,0,9643,9892
31607,27197138,27207029,27207149,0,0,9891,10011
31608,27197138,27207149,27207269,0,0,10011,10131
30326,27084357,27159333,27207343,0,0,74976,122986
31609,27197138,27207269,27207387,0,0,10131,10249
31610,27197139,27207387,27207505,0,0,10248,10366
31611,27197139,27207505,27207623,0,0,10366,10484
31612,27197139,27207623,27207741,0,0,10484,10602
30328,27084357,27159536,27207755,0,0,75179,123398
31613,27197139,27207741,27207859,0,0,10602,10720
31614,27197140,27207859,27207976,0,0,10719,10836
31615,27197140,27207976,27208089,0,0,10836,10949
30327,27084357,27159351,27208156,0,0,74994,123799
31616,27197140,27208089,27208235,0,0,10949,11095
31617,27197140,27208235,27208349,0,0,11095,11209
30331,27084358,27159685,27208409,0,0,75327,124051
30334,27084358,27160585,27208443,0,0,76227,124085
31618,27197140,27208349,27208468,0,0,11209,11328
31619,27197140,27208468,27208716,0,0,11328,11576
31549,27187715,27199725,27208725,0,0,12010,21010
31550,27187729,27199740,27208740,0,0,12011,21011
31620,27197141,27208716,27208836,0,0,11575,11695
31621,27197141,27208725,27208844,0,0,11584,11703
30332,27084358,27159837,27208850,0,0,75479,124492
31622,27197141,27208740,27208879,0,0,11599,11738
31624,27197141,27208844,27208962,0,0,11703,11821
31623,27197141,27208836,27208975,0,0,11695,11834
31625,27197141,27208879,27209002,0,0,11738,11861
31627,27197142,27208975,27209098,0,0,11833,11956
31628,27197142,27209002,27209141,0,0,11860,11999
31626,27197141,27208962,27209212,0,0,11821,12071
31629,27197142,27209098,27209237,0,0,11956,12095
31630,27197142,27209141,27209280,0,0,11999,12138
30335,27084359,27160779,27209292,0,0,76420,124933
31631,27197142,27209212,27209351,0,0,12070,12209
30333,27084358,27159864,27209359,0,0,75506,125001
31632,27197142,27209237,27209370,0,0,12095,12228
31633,27197143,27209280,27209413,0,0,12137,12270
31634,27197143,27209351,27209484,0,0,12208,12341
31635,27197143,27209370,27209497,0,0,12227,12354
31636,27197143,27209413,27209530,0,0,12270,12387
31637,27197143,27209484,27209602,0,0,12341,12459
31638,27197143,27209497,27209631,0,0,12354,12488
31639,27197144,27209530,27209664,0,0,12386,12520
31640,27197144,27209602,27209736,0,0,12458,12592
31641,27197144,27209631,27209760,0,0,12487,12616
31642,27197144,27209664,27209793,0,0,12520,12649
31643,27197144,27209736,27209865,0,0,12592,12721
31645,27197145,27209793,27209907,0,0,12648,12762
31646,27197145,27209865,27209982,0,0,12720,12837
31644,27197144,27209760,27210005,0,0,12616,12861
31647,27197145,27209907,27210023,0,0,12762,12878
31648,27197145,27209982,27210109,0,0,12837,12964
31649,27197145,27210005,27210132,0,0,12860,12987
31650,27197145,27210023,27210150,0,0,12878,13005
31651,27197146,27210109,27210236,0,0,12963,13090
31652,27197147,27210132,27210259,0,0,12985,13112
31653,27197147,27210150,27210277,0,0,13003,13130
31654,27197147,27210236,27210351,0,0,13089,13204
31655,27197147,27210259,27210375,0,0,13112,13228
31656,27197147,27210277,27210393,0,0,13130,13246
31657,27197148,27210351,27210467,0,0,13203,13319
30336,27084359,27161128,27210470,0,0,76769,126111
31658,27197148,27210375,27210507,0,0,13227,13359
31659,27197148,27210393,27210525,0,0,13245,13377
31660,27197149,27210467,27210610,0,0,13318,13461
31661,27197149,27210507,27210650,0,0,13358,13501
31662,27197149,27210525,27210668,0,0,13376,13519
31663,27197149,27210610,27210727,0,0,13461,13578
31664,27197150,27210650,27210777,0,0,13500,13627
31665,27197150,27210668,27210784,0,0,13518,13634
31666,27197150,27210727,27210843,0,0,13577,13693
31668,27197151,27210784,27210900,0,0,13633,13749
31669,27197151,27210843,27210975,0,0,13692,13824
31670,27197151,27210900,27211032,0,0,13749,13881
31667,27197150,27210777,27211036,0,0,13627,13886
31671,27197151,27210975,27211128,0,0,13824,13977
31673,27197151,27211036,27211152,0,0,13885,14001
31672,27197151,27211032,27211185,0,0,13881,14034
31674,27197152,27211128,27211270,0,0,13976,14118
31675,27197152,27211152,27211294,0,0,14000,14142
31676,27197152,27211185,27211327,0,0,14033,14175
31677,27197152,27211270,27211412,0,0,14118,14260
31678,27197152,27211294,27211420,0,0,14142,14268
31679,27197152,27211327,27211485,0,0,14175,14333
31680,27197153,27211412,27211538,0,0,14259,14385
31681,27197153,27211420,27211551,0,0,14267,14398
31682,27197153,27211485,27211616,0,0,14332,14463
31683,27197153,27211538,27211648,0,0,14385,14495
31684,27197153,27211551,27211687,0,0,14398,14534
31685,27197153,27211616,27211752,0,0,14463,14599
31686,27197153,27211648,27211774,0,0,14495,14621
31687,27197154,27211687,27211813,0,0,14533,14659
31688,27197154,27211752,27211889,0,0,14598,14735
31689,27197154,27211774,27211891,0,0,14620,14737
31690,27197154,27211813,27211936,0,0,14659,14782
31691,27197154,27211889,27212007,0,0,14735,14853
31693,27197155,27211936,27212054,0,0,14781,14899
31694,27197155,27212007,27212126,0,0,14852,14971
31692,27197154,27211891,27212160,0,0,14737,15006
31695,27197155,27212054,27212173,0,0,14899,15018
31696,27197155,27212126,27212256,0,0,14971,15101
31697,27197155,27212160,27212286,0,0,15005,15131
31698,27200130,27212173,27212362,0,0,12043,12232
30329,27084357,27159549,27212409,0,0,75192,128052
31699,27200131,27212256,27212445,0,0,12125,12314
31702,27200436,27212362,27212556,0,0,11926,12120
31700,27200131,27212286,27212581,0,0,12155,12450
31703,27200436,27212445,27212655,0,0,12009,12219
30337,27084359,27161469,27212751,0,0,77110,128392
31704,27200436,27212556,27212766,0,0,12120,12330
31705,27200437,27212581,27212791,0,0,12144,12354
31706,27200437,27212655,27212891,0,0,12218,12454
31707,27200437,27212766,27213002,0,0,12329,12565
31708,27200437,27212791,27213027,0,0,12354,12590
31709,27200437,27212891,27213127,0,0,12454,12690
31710,27200437,27213002,27213238,0,0,12565,12801
31711,27200484,27213027,27213243,0,0,12543,12759
31712,27200484,27213127,27213343,0,0,12643,12859
31713,27200484,27213238,27213454,0,0,12754,12970
31714,27200485,27213243,27213459,0,0,12758,12974
31715,27200485,27213343,27213559,0,0,12858,13074
31716,27200485,27213454,27213645,0,0,12969,13160
31718,27200486,27213559,27213761,0,0,13073,13275
31717,27200485,27213459,27213840,0,0,12974,13355
31719,27200486,27213645,27213847,0,0,13159,13361
31720,27200486,27213761,27213963,0,0,13275,13477
31722,27200487,27213847,27214049,0,0,13360,13562
31721,27200486,27213840,27214063,0,0,13354,13577
31723,27200487,27213963,27214186,0,0,13476,13699
31724,27200487,27214049,27214272,0,0,13562,13785
31725,27200487,27214063,27214286,0,0,13576,13799
31726,27200488,27214186,27214403,0,0,13698,13915
31727,27200488,27214272,27214489,0,0,13784,14001
31728,27200488,27214286,27214503,0,0,13798,14015
31729,27200488,27214403,27214620,0,0,13915,14132
31731,27200489,27214503,27214700,0,0,14014,14211
31730,27200489,27214489,27214706,0,0,14000,14217
31732,27200489,27214620,27214808,0,0,14131,14319
31733,27200489,27214700,27214904,0,0,14211,14415
31734,27200489,27214706,27214926,0,0,14217,14437
31735,27200489,27214808,27215002,0,0,14319,14513
31736,27200490,27214904,27215098,0,0,14414,14608
31737,27200490,27214926,27215136,0,0,14436,14646
31738,27200490,27215002,27215212,0,0,14512,14722
31739,27200490,27215098,27215308,0,0,14608,14818
31740,27200490,27215136,27215341,0,0,14646,14851
31742,27200491,27215308,27215513,0,0,14817,15022
31743,27200491,27215341,27215546,0,0,14850,15055
31741,27200490,27215212,27215566,0,0,14722,15076
31744,27200491,27215513,27215745,0,0,15022,15254
31746,27200491,27215566,27215760,0,0,15075,15269
31745,27200491,27215546,27215778,0,0,15055,15287
31748,27200492,27215760,27215952,0,0,15268,15460
31747,27200491,27215745,27215953,0,0,15254,15462
31749,27200492,27215778,27215975,0,0,15286,15483
30330,27084357,27159612,27216099,0,0,75255,131742
31751,27200492,27215953,27216145,0,0,15461,15653
31750,27200492,27215952,27216165,0,0,15460,15673
31752,27200492,27215975,27216172,0,0,15483,15680
31753,27200492,27216145,27216342,0,0,15653,15850
31754,27200493,27216165,27216362,0,0,15672,15869
31755,27200493,27216172,27216369,0,0,15679,15876
31756,27200493,27216342,27216539,0,0,15849,16046
31758,27200493,27216369,27216560,0,0,15876,16067
31757,27200493,27216362,27216580,0,0,15869,16087
31759,27200493,27216539,27216751,0,0,16046,16258
31760,27200494,27216560,27216764,0,0,16066,16270
31761,27200494,27216580,27216774,0,0,16086,16280
31762,27200494,27216751,27216945,0,0,16257,16451
31763,27200494,27216764,27216969,0,0,16270,16475
31764,27200494,27216774,27216974,0,0,16280,16480
31766,27200526,27216969,27217169,0,0,16443,16643
31767,27200526,27216974,27217175,0,0,16448,16649
31765,27200494,27216945,27217286,0,0,16451,16792
31768,27200526,27217169,27217370,0,0,16643,16844
31769,27200526,27217175,27217387,0,0,16649,16861
31770,27200527,27217286,27217483,0,0,16759,16956
31771,27200527,27217370,27217578,0,0,16843,17051
31772,27200527,27217387,27217585,0,0,16860,17058
31773,27200527,27217483,27217681,0,0,16956,17154
31775,27202001,27217578,27217769,0,0,15577,15768
31776,27202001,27217585,27217776,0,0,15584,15775
31777,27202001,27217681,27217893,0,0,15680,15892
31778,27202001,27217769,27217981,0,0,15768,15980
31779,27202001,27217776,27217988,0,0,15775,15987
31780,27202002,27217893,27218193,0,0,15891,16191
31781,27202002,27217981,27218281,0,0,15979,16279
31782,27202003,27217988,27218288,0,0,15985,16285
30340,27084360,27161528,27218353,0,0,77168,133993
30341,27084360,27161528,27218449,0,0,77168,134089
31784,27202003,27218281,27218465,0,0,16278,16462
31785,27202003,27218288,27218488,0,0,16285,16485
31783,27202003,27218193,27218493,0,0,16190,16490
31786,27202003,27218465,27218660,0,0,16462,16657
31788,27202004,27218493,27218688,0,0,16489,16684
30346,27084413,27171228,27218766,0,0,86815,134353
31787,27202003,27218488,27218788,0,0,16485,16785
30348,27084415,27171228,27218818,0,0,86813,134403
31789,27202004,27218660,27218876,0,0,16656,16872
31790,27202004,27218688,27218878,0,0,16684,16874
31791,27202004,27218788,27219004,0,0,16784,17000
30347,27084414,27171228,27219089,0,0,86814,134675
31792,27202004,27218876,27219092,0,0,16872,17088
31793,27202004,27218878,27219094,0,0,16874,17090
31794,27202004,27219004,27219220,0,0,17000,17216
31795,27202005,27219092,27219288,0,0,17087,17283
31796,27202005,27219094,27219394,0,0,17089,17389
31797,27202082,27219220,27219432,0,0,17138,17350
31798,27202082,27219288,27219500,0,0,17206,17418
30338,27084359,27161528,27219552,0,0,77169,135193
31800,27202083,27219432,27219644,0,0,17349,17561
31799,27202082,27219394,27219694,0,0,17312,17612
31801,27202083,27219500,27219696,0,0,17417,17613
30297,27084303,27133373,27219773,0,0,49070,135470
31802,27202083,27219644,27219840,0,0,17561,17757
31803,27202083,27219694,27219890,0,0,17611,17807
31804,27202084,27219696,27219892,0,0,17612,17808
31806,27202085,27219890,27220102,0,0,17805,18017
31807,27202085,27219892,27220104,0,0,17807,18019
31805,27202084,27219840,27220140,0,0,17756,18056
31808,27202085,27220102,27220314,0,0,18017,18229
31809,27202085,27220104,27220316,0,0,18019,18231
30345,27084361,27171228,27220320,0,0,86867,135959
31810,27202086,27220140,27220346,0,0,18054,18260
31811,27202086,27220314,27220504,0,0,18228,18418
31812,27202086,27220316,27220527,0,0,18230,18441
31813,27202087,27220346,27220557,0,0,18259,18470
31814,27202087,27220504,27220699,0,0,18417,18612
31815,27202087,27220527,27220722,0,0,18440,18635
31816,27202087,27220557,27220752,0,0,18470,18665
31817,27202087,27220699,27220915,0,0,18612,18828
31818,27202087,27220722,27220917,0,0,18635,18830
31819,27202088,27220752,27220958,0,0,18664,18870
31820,27202088,27220915,27221121,0,0,18827,19033
31821,27202088,27220917,27221217,0,0,18829,19129
31822,27202088,27220958,27221258,0,0,18870,19170
31823,27202088,27221121,27221421,0,0,19033,19333
31825,27202089,27221258,27221452,0,0,19169,19363
30342,27084360,27162320,27221471,0,0,77960,137111
31824,27202088,27221217,27221517,0,0,19129,19429
31826,27202089,27221421,27221627,0,0,19332,19538
31827,27202089,27221452,27221669,0,0,19363,19580
31828,27202089,27221517,27221709,0,0,19428,19620
31829,27202089,27221627,27221830,0,0,19538,19741
31831,27202090,27221709,27221902,0,0,19619,19812
31830,27202089,27221669,27221969,0,0,19580,19880
31832,27202090,27221830,27222034,0,0,19740,19944
31833,27202090,27221902,27222096,0,0,19812,20006
30339,27084359,27161528,27222122,0,0,77169,137763
31834,27202090,27221969,27222169,0,0,19879,20079
31835,27202090,27222034,27222229,0,0,19944,20139
31836,27203295,27222096,27222286,0,0,18801,18991
31837,27203296,27222169,27222375,0,0,18873,19079
31838,27203296,27222229,27222435,0,0,18933,19139
31839,27203296,27222286,27222513,0,0,18990,19217
31840,27203296,27222375,27222602,0,0,19079,19306
31841,27203297,27222435,27222662,0,0,19138,19365
31842,27203297,27222513,27222740,0,0,19216,19443
31843,27203298,27222602,27222902,0,0,19304,19604
31844,27203299,27222662,27222962,0,0,19363,19663
30349,27084415,27175823,27223034,0,0,91408,138619
31845,27203299,27222740,27223040,0,0,19441,19741
31847,27203301,27222962,27223172,0,0,19661,19871
31846,27203299,27222902,27223202,0,0,19603,19903
31848,27203301,27223040,27223250,0,0,19739,19949
30350,27084415,27175823,27223323,0,0,91408,138908
31849,27203302,27223172,27223382,0,0,19870,20080
31850,27203302,27223202,27223423,0,0,19900,20121
31851,27203302,27223250,27223482,0,0,19948,20180
30351,27084415,27175823,27223557,0,0,91408,139142
31852,27203302,27223382,27223614,0,0,20080,20312
31853,27203302,27223423,27223655,0,0,20121,20353
31854,27203302,27223482,27223725,0,0,20180,20423
31855,27203384,27223614,27223857,0,0,20230,20473
31856,27203384,27223655,27223898,0,0,20271,20514
31857,27203384,27223725,27223989,0,0,20341,20605
31858,27203385,27223857,27224111,0,0,20472,20726
31859,27203385,27223898,27224163,0,0,20513,20778
31860,27203385,27223989,27224254,0,0,20604,20869
31861,27203385,27224111,27224376,0,0,20726,20991
31862,27203386,27224163,27224439,0,0,20777,21053
31863,27203386,27224254,27224530,0,0,20868,21144
30352,27084416,27177554,27224603,0,0,93138,140187
31864,27203386,27224376,27224663,0,0,20990,21277
31865,27203387,27224439,27224726,0,0,21052,21339
31866,27203387,27224530,27224828,0,0,21143,21441
31867,27203387,27224663,27224961,0,0,21276,21574
31868,27203387,27224726,27225024,0,0,21339,21637
31869,27203388,27224828,27225128,0,0,21440,21740
31870,27203388,27224961,27225261,0,0,21573,21873
31871,27203388,27225024,27225324,0,0,21636,21936
31872,27203388,27225128,27225337,0,0,21740,21949
31873,27203389,27225261,27225470,0,0,21872,22081
31874,27203389,27225324,27225533,0,0,21935,22144
31875,27203389,27225337,27225557,0,0,21948,22168
31876,27203389,27225470,27225690,0,0,22081,22301
31877,27203389,27225533,27225775,0,0,22144,22386
31878,27203389,27225557,27225799,0,0,22168,22410
31879,27203390,27225690,27225932,0,0,22300,22542
31880,27203390,27225775,27226017,0,0,22385,22627
31881,27203390,27225799,27226052,0,0,22409,22662
31884,27204353,27226052,27226102,0,0,21699,21749
31885,27204353,27226102,27226163,0,0,21749,21810
31882,27203390,27225932,27226185,0,0,22542,22795
31886,27204353,27226163,27226224,0,0,21810,21871
31883,27203390,27226017,27226270,0,0,22627,22880
31887,27204353,27226185,27226342,0,0,21832,21989
31889,27204440,27226270,27226382,0,0,21830,21942
31888,27204353,27226224,27226411,0,0,21871,22058
31890,27204440,27226342,27226470,0,0,21902,22030
31891,27204440,27226382,27226510,0,0,21942,22070
31893,27204441,27226470,27226583,0,0,22029,22142
31894,27204441,27226510,27226624,0,0,22069,22183
31892,27204440,27226411,27226662,0,0,21971,22222
31895,27204441,27226583,27226713,0,0,22142,22272
31896,27204441,27226624,27226732,0,0,22183,22291
31898,27204441,27226713,27226836,0,0,22272,22395
31899,27204442,27226732,27226855,0,0,22290,22413
31897,27204441,27226662,27226916,0,0,22221,22475
31900,27204442,27226836,27226949,0,0,22394,22507
30353,27084416,27179854,27226973,0,0,95438,142557
31901,27204442,27226855,27226973,0,0,22413,22531
30901,27163023,27226973,27227040,0,0,63950,64017
31902,27204442,27226916,27227045,0,0,22474,22603
31905,27204443,27226973,27227089,0,0,22530,22646
30989,27166225,27227040,27227117,0,0,60815,60892
31906,27204443,27227045,27227172,0,0,22602,22729
30990,27166295,27227117,27227194,0,0,60822,60899
31903,27204442,27226949,27227195,0,0,22507,22753
31907,27204443,27227089,27227205,0,0,22646,22762
31904,27204442,27226973,27227218,0,0,22531,22776
31909,27204443,27227195,27227252,0,0,22752,22809
30991,27166372,27227194,27227260,0,0,60822,60888
31908,27204443,27227172,27227277,0,0,22729,22834
31912,27204444,27227252,27227293,0,0,22808,22849
30992,27166446,27227260,27227330,0,0,60814,60884
30993,27166515,27227330,27227394,0,0,60815,60879
31911,27204443,27227218,27227399,0,0,22775,22956
31910,27204443,27227205,27227418,0,0,22762,22975
30994,27166581,27227394,27227469,0,0,60813,60888
30995,27166649,27227469,27227541,0,0,60820,60892
30996,27166727,27227541,27227609,0,0,60814,60882
30997,27166797,27227609,27227685,0,0,60812,60888
30998,27166865,27227685,27227754,0,0,60820,60889
30999,27167003,27227754,27227827,0,0,60751,60824
31075,27174918,27227827,27227901,0,0,52909,52983
31160,27176693,27227901,27228054,0,0,51208,51361
31171,27176914,27228054,27228604,0,0,51140,51690
31212,27177096,27228604,27228779,0,0,51508,51683
30356,27084417,27180640,27228960,0,0,96223,144543
30359,27084418,27181090,27229036,0,0,96672,144618
31327,27177675,27229036,27229109,0,0,51361,51434
31214,27177563,27228960,27229120,0,0,51397,51557
30355,27084417,27180601,27229287,0,0,96184,144870
31483,27183958,27228960,27229300,0,0,45002,45342
30357,27084417,27180707,27229322,0,0,96290,144905
31495,27184013,27229300,27229642,0,0,45287,45629
31486,27183959,27229322,27229936,0,0,45363,45977
31489,27183960,27229287,27230171,0,0,45327,46211
30358,27084417,27180907,27230405,0,0,96490,145988
31499,27184014,27229642,27230519,0,0,45628,46505
31507,27184042,27230171,27230522,0,0,46129,46480
31914,27212482,27230522,27230590,0,0,18040,18108
31915,27212597,27230590,27230663,0,0,17993,18066
30363,27084419,27181937,27230880,0,0,97518,146461
31490,27183960,27229936,27230912,0,0,45976,46952
31919,27222357,27227418,27230979,0,0,5061,8622
31500,27184014,27230405,27231024,0,0,46391,47010
31916,27214278,27230663,27231263,0,0,16385,16985
31514,27184044,27230519,27231402,0,0,46475,47358
30365,27084419,27182057,27231474,0,0,97638,147055
31920,27222357,27227901,27231493,0,0,5544,9136
31510,27184043,27230912,27231516,0,0,46869,47473
31469,27183510,27231474,27231571,0,0,47964,48061
30360,27084418,27181446,27231600,0,0,97028,147182
31471,27183854,27231571,27231633,0,0,47717,47779
31518,27184474,27231600,27231670,0,0,47126,47196
31519,27184543,27231633,27231705,0,0,47090,47162
31520,27184588,27231670,27231743,0,0,47082,47155
30369,27084420,27182645,27231750,0,0,98225,147330
31521,27184744,27231705,27231769,0,0,46961,47025
30366,27084419,27182430,27231779,0,0,98011,147360
31923,27227305,27229109,27231804,0,0,1804,4499
31503,27184026,27230880,27231845,0,0,46854,47819
30364,27084419,27181960,27231890,0,0,97541,147471
30374,27084421,27184050,27231970,0,0,99629,147549
31515,27184044,27231024,27231998,0,0,46980,47954
31924,27227306,27229322,27232005,0,0,2016,4699
30361,27084418,27181697,27232098,0,0,97279,147680
31213,27177513,27228779,27232123,0,0,51266,54610
30368,27084420,27182599,27232365,0,0,98179,147945
31921,27222358,27229036,27232657,0,0,6678,10299
31917,27216862,27227293,27232667,0,0,10431,15805
31487,27183959,27232098,27232712,0,0,48139,48753
31918,27216868,27227399,27232778,0,0,10531,15910
30379,27084422,27185173,27232906,0,0,100751,148484
31925,27227306,27230405,27233100,0,0,3099,5794
30375,27084421,27184316,27233280,0,0,99895,148859
31501,27184014,27232712,27233322,0,0,48698,49308
30362,27084418,27181706,27233364,0,0,97288,148946
31493,27183966,27232365,27233364,0,0,48399,49398
31926,27227306,27230880,27233659,0,0,3574,6353
30370,27084420,27182851,27233729,0,0,98431,149309
30377,27084421,27185159,27233896,0,0,100738,149475
31511,27184043,27233280,27233897,0,0,49237,49854
31504,27184026,27232906,27233903,0,0,48880,49877
31159,27176413,27233903,27233976,0,0,57490,57563
31009,27171604,27233896,27234011,0,0,62292,62407
30380,27084422,27185173,27234032,0,0,100751,149610
31516,27184044,27233322,27234308,0,0,49278,50264
30354,27084416,27180317,27234539,0,0,95901,150123
30382,27084422,27186130,27234552,0,0,101708,150130
31484,27183958,27233976,27234589,0,0,50018,50631
30383,27084422,27186396,27234616,0,0,101974,150194
30381,27084422,27185311,27234683,0,0,100889,150261
31496,27184013,27234589,27235211,0,0,50576,51198
30376,27084421,27184544,27235431,0,0,100123,151010
31491,27183960,27234552,27235559,0,0,50592,51599
30384,27084423,27186695,27236122,0,0,102272,151699
30367,27084419,27182489,27236393,0,0,98070,151974
30371,27084420,27183470,27237129,0,0,99050,152709
30394,27084457,27191077,27237761,0,0,106620,153304
31470,27183564,27229287,27237820,0,0,45723,54256
31502,27184014,27237129,27238137,0,0,53115,54123
30395,27084458,27191168,27238160,0,0,106710,153702
31913,27205183,27227277,27238409,0,0,22094,33226
30396,27084459,27192054,27239150,0,0,107595,154691
30372,27084420,27183898,27239423,0,0,99478,155003
31929,27239496,27239496,27239570,0,0,0,74
31508,27184042,27239150,27239769,0,0,55108,55727
30398,27084459,27192315,27239989,0,0,107856,155530
30399,27084459,27192426,27240033,0,0,107967,155574
30397,27084459,27192164,27240089,0,0,107705,155630
31930,27239931,27239931,27240165,0,0,0,234
30386,27084423,27187430,27240490,0,0,103007,156067
30400,27084460,27193150,27240498,0,0,108690,156038
30390,27084424,27188175,27240544,0,0,103751,156120
31512,27184043,27239769,27240774,0,0,55726,56731
30401,27084460,27193437,27240916,0,0,108977,156456
31931,27240883,27240883,27240956,0,0,0,73
30402,27084460,27194187,27242046,0,0,109727,157586
30373,27084420,27183900,27242395,0,0,99480,157975
30403,27084460,27194292,27242525,0,0,109832,158065
31932,27242655,27242655,27242957,0,0,0,302
30404,27084461,27194925,27243151,0,0,110464,158690
30385,27084423,27186961,27243197,0,0,102538,158774
30391,27084424,27188753,27243687,0,0,104329,159263
30405,27084461,27195015,27243958,0,0,110554,159497
30451,27091354,27243958,27244031,0,0,152604,152677
30817,27149520,27244031,27244105,0,0,94511,94585
30827,27153309,27244105,27244207,0,0,90796,90898
30392,27084424,27189524,27245956,0,0,105100,161532
30387,27084423,27187434,27246398,0,0,103011,161975
30389,27084424,27188134,27246437,0,0,103710,162013
31943,27246421,27246421,27246530,0,0,0,109
31944,27246561,27246561,27246620,0,0,0,59
31945,27246611,27246611,27246720,0,0,0,109
30406,27084461,27198504,27247542,0,0,114043,163081
31922,27223138,27231516,27247837,0,0,8378,24699
31946,27248428,27248428,27248537,0,0,0,109
31947,27248550,27248550,27248929,0,0,0,379
30899,27162611,27162611,27249011,0,0,0,86400
30408,27084462,27199815,27250427,0,0,115353,165965
31948,27248928,27248929,27250647,0,0,1,1719
30393,27084424,27190720,27250719,0,0,106296,166295
31950,27248929,27250427,27251601,0,0,1498,2672
31701,27200279,27231402,27251785,0,0,31123,51506
30343,27084360,27165580,27251980,0,0,81220,167620
31949,27248929,27250427,27251990,0,0,1498,3061
31951,27250021,27251980,27252047,0,0,1959,2026
31774,27201122,27233364,27252364,0,0,32242,51242
30409,27084462,27201647,27252631,0,0,117185,168169
30344,27084360,27166247,27252647,0,0,81887,168287
31952,27250682,27250682,27253348,0,0,0,2666
31953,27250688,27250688,27253372,0,0,0,2684
31954,27250689,27250689,27253384,0,0,0,2695
31955,27250689,27250689,27253399,0,0,0,2710
29812,26942818,26942818,27253843,0,0,0,311025
30411,27084463,27207343,27254893,0,0,122880,170430
31942,27246067,27246067,27254958,0,0,0,8891
31928,27239419,27239423,27255713,0,0,4,16294
31933,27243440,27243440,27255778,0,0,0,12338
30413,27084463,27208156,27255785,0,0,123693,171322
31961,27255653,27255713,27255817,0,0,60,164
31962,27255757,27255785,27255880,0,0,28,123
30412,27084463,27207755,27256902,0,0,123292,172439
31963,27255948,27256902,27256987,0,0,954,1039
31964,27256190,27256987,27257071,0,0,797,881
31965,27256562,27257071,27257271,0,0,509,709
31966,27256964,27257271,27257363,0,0,307,399
31967,27257312,27257363,27257458,0,0,51,146
30417,27084464,27209292,27257694,0,0,124828,173230
30414,27084463,27208409,27257730,0,0,123946,173267
31936,27244696,27244696,27257782,0,0,0,13086
31968,27258004,27258004,27258036,0,0,0,32
31937,27245007,27245007,27258079,0,0,0,13072
31969,27258004,27258036,27258079,0,0,32,75
30407,27084461,27199646,27258186,0,0,115185,173725
30415,27084463,27208443,27258409,0,0,123980,173946
31972,27258553,27258553,27259153,0,0,0,600
30418,27084464,27209359,27259214,0,0,124895,174750
31941,27246064,27246064,27259484,0,0,0,13420
30416,27084463,27208850,27259820,0,0,124387,175357
31959,27254801,27255880,27259841,0,0,1079,5040
31934,27243686,27243686,27259963,0,0,0,16277
30421,27084465,27212751,27260155,0,0,128286,175690
31973,27259904,27260155,27260254,0,0,251,350
31457,27182862,27229109,27260268,0,0,46247,77406
31974,27260029,27260254,27260558,0,0,225,529
30157,27001927,27001927,27261127,0,0,0,259200
31976,27260609,27261127,27261204,0,0,518,595
31978,27261281,27261281,27261355,0,0,0,74
31468,27183411,27229120,27261520,0,0,45709,78109
31979,27261622,27261622,27261682,0,0,0,60
31488,27183959,27261127,27261745,0,0,77168,77786
31533,27185847,27231743,27262032,0,0,45896,76185
30159,27002875,27002875,27262075,0,0,0,259200
30160,27002875,27002875,27262075,0,0,0,259200
30161,27002875,27002875,27262075,0,0,0,259200
30162,27002875,27002875,27262075,0,0,0,259200
30163,27002875,27002875,27262075,0,0,0,259200
31552,27191412,27240498,27262466,0,0,49086,71054
31497,27184013,27262032,27262656,0,0,78019,78643
31492,27183960,27261745,27262768,0,0,77785,78808
31505,27184026,27262075,27263103,0,0,78049,79077
31513,27184043,27262656,27263289,0,0,78613,79246
31987,27262903,27263103,27263335,0,0,200,432
31985,27262477,27263335,27263408,0,0,858,931
31970,27258054,27258079,27263434,0,0,25,5380
31971,27258054,27258186,27263558,0,0,132,5504
31991,27263464,27263558,27263596,0,0,94,132
31993,27263582,27263582,27263612,0,0,0,30
31992,27263519,27263596,27263629,0,0,77,110
31994,27263609,27263629,27263689,0,0,20,80
31517,27184044,27262768,27263775,0,0,78724,79731
31995,27263672,27263689,27263776,0,0,17,104
31997,27263830,27263830,27263899,0,0,0,69
31984,27262474,27263775,27264041,0,0,1301,1567
31998,27264002,27264002,27264088,0,0,0,86
31999,27264091,27264091,27264138,0,0,0,47
32000,27264136,27264136,27264172,0,0,0,36
30419,27084464,27210470,27264232,0,0,126006,179768
30422,27084465,27216099,27264258,0,0,131634,179793
32001,27264226,27264226,27264265,0,0,0,39
32002,27264299,27264299,27264346,0,0,0,47
32003,27264372,27264372,27264410,0,0,0,38
32004,27264445,27264445,27264485,0,0,0,40
30174,27005296,27005296,27264496,0,0,0,259200
30175,27005314,27005314,27264514,0,0,0,259200
30176,27005328,27005328,27264528,0,0,0,259200
30177,27005340,27005340,27264540,0,0,0,259200
30178,27005351,27005351,27264551,0,0,0,259200
32006,27264506,27264506,27264588,0,0,0,82
30179,27005517,27005517,27264717,0,0,0,259200
30180,27005529,27005529,27264729,0,0,0,259200
30181,27005541,27005541,27264741,0,0,0,259200
30182,27005554,27005554,27264754,0,0,0,259200
32008,27264732,27264732,27264804,0,0,0,72
30183,27005613,27005613,27264813,0,0,0,259200
32010,27264842,27264842,27264909,0,0,0,67
32011,27264900,27264900,27264949,0,0,0,49
32013,27264954,27264954,27265078,0,0,0,124
32009,27264832,27264832,27265158,0,0,0,326
32014,27264973,27264973,27265198,0,0,0,225
32017,27265203,27265203,27265242,0,0,0,39
32015,27265003,27265003,27265352,0,0,0,349
32018,27265304,27265304,27265352,0,0,0,48
31986,27262622,27262622,27265427,0,0,0,2805
32019,27265401,27265401,27265744,0,0,0,343
32022,27265699,27265699,27265896,0,0,0,197
32027,27265861,27265861,27265904,0,0,0,43
32020,27265580,27265580,27265915,0,0,0,335
32021,27265604,27265604,27265945,0,0,0,341
32029,27265942,27265942,27265981,0,0,0,39
32026,27265803,27265803,27265993,0,0,0,190
32025,27265785,27265785,27266032,0,0,0,247
32033,27266328,27266328,27266366,0,0,0,38
32032,27266216,27266216,27266422,0,0,0,206
32034,27266376,27266376,27266426,0,0,0,50
32035,27266461,27266461,27266492,0,0,0,31
32036,27266542,27266542,27266716,0,0,0,174
32051,27266662,27266662,27266716,0,0,0,54
32037,27266542,27266542,27266754,0,0,0,212
30423,27084465,27218353,27266830,0,0,133888,182365
32040,27266549,27266549,27266851,0,0,0,302
32038,27266542,27266542,27266875,0,0,0,333
32039,27266548,27266548,27266889,0,0,0,341
32041,27266549,27266549,27266890,0,0,0,341
32052,27266831,27266831,27266900,0,0,0,69
30427,27084466,27219089,27267013,0,0,134623,182547
32045,27266551,27266551,27267122,0,0,0,571
32043,27266550,27266550,27267144,0,0,0,594
32042,27266549,27266549,27267153,0,0,0,604
32046,27266551,27266551,27267154,0,0,0,603
32044,27266550,27266550,27267366,0,0,0,816
32053,27267441,27267441,27267509,0,0,0,68
32048,27266552,27266552,27267621,0,0,0,1069
32047,27266551,27266551,27267671,0,0,0,1120
32050,27266553,27266553,27267673,0,0,0,1120
32054,27267606,27267606,27267685,0,0,0,79
32007,27264612,27264612,27267704,0,0,0,3092
32056,27267607,27267607,27267721,0,0,0,114
32049,27266552,27266552,27267752,0,0,0,1200
32055,27267606,27267606,27267762,0,0,0,156
32057,27267607,27267607,27267763,0,0,0,156
32058,27267607,27267607,27267774,0,0,0,167
30420,27084464,27212409,27267928,0,0,127945,183464
30425,27084465,27218766,27268110,0,0,134301,183645
32063,27268317,27268317,27268464,0,0,0,147
30430,27084466,27220320,27268563,0,0,135854,184097
30424,27084465,27218449,27268634,0,0,133984,184169
30429,27084466,27219773,27268693,0,0,135307,184227
30428,27084466,27219552,27268711,0,0,135086,184245
32064,27269005,27269005,27269127,0,0,0,122
32065,27269087,27269087,27269152,0,0,0,65
32066,27269106,27269106,27269166,0,0,0,60
32069,27269199,27269199,27269354,0,0,0,155
32067,27269143,27269143,27269380,0,0,0,237
32070,27269447,27269447,27269497,0,0,0,50
30431,27084466,27221471,27269560,0,0,137005,185094
32072,27269649,27269649,27269692,0,0,0,43
32068,27269162,27269162,27269762,0,0,0,600
32073,27269671,27269671,27269837,0,0,0,166
32075,27269890,27269890,27269944,0,0,0,54
30426,27084465,27218818,27270073,0,0,134353,185608
32077,27269926,27269926,27270216,0,0,0,290
32062,27268282,27268282,27270592,0,0,0,2310
32059,27267905,27267905,27270622,0,0,0,2717
30744,27101852,27235211,27271057,0,0,133359,169205
30432,27084467,27222122,27271200,0,0,137655,186733
32082,27271215,27271215,27271366,0,0,0,151
32081,27271203,27271203,27271428,0,0,0,225
30378,27084421,27185159,27271559,0,0,100738,187138
32083,27271616,27271616,27271689,0,0,0,73
32060,27268019,27268019,27271705,0,0,0,3686
32084,27271757,27271757,27271819,0,0,0,62
31975,27260059,27260558,27272023,0,0,499,11964
32061,27268121,27268121,27272143,0,0,0,4022
32085,27272191,27272191,27272282,0,0,0,91
31990,27263100,27263775,27272608,0,0,675,9508
30186,27013688,27013688,27272888,0,0,0,259200
32087,27273450,27273450,27273504,0,0,0,54
30444,27088618,27261127,27273507,0,0,172509,184889
31957,27254718,27254718,27273683,0,0,0,18965
30388,27084423,27187697,27274097,0,0,103274,189674
31996,27263734,27263775,27274446,0,0,41,10712
32088,27274839,27274839,27274892,0,0,0,53
32089,27275191,27275191,27275243,0,0,0,52
31958,27254748,27254958,27275283,0,0,210,20535
32090,27275771,27275771,27275824,0,0,0,53
32091,27275811,27275811,27275876,0,0,0,65
31977,27260894,27261127,27277519,0,0,233,16625
30433,27084467,27223034,27277799,0,0,138567,193332
30434,27084467,27223323,27279541,0,0,138856,195074
30436,27084468,27224603,27281570,0,0,140135,197102
32093,27279190,27279190,27282755,0,0,0,3565
32094,27279190,27279190,27282804,0,0,0,3614
32095,27279190,27279190,27282970,0,0,0,3780
30435,27084467,27223557,27283971,0,0,139090,199504
31956,27254108,27254108,27284544,0,0,0,30436
32096,27284539,27284539,27284696,0,0,0,157
32098,27286777,27286777,27287141,0,0,0,364
31989,27262938,27263434,27288163,0,0,496,25225
30410,27084462,27202094,27288494,0,0,117632,204032
32099,27290982,27290982,27291066,0,0,0,84
32101,27291825,27291825,27292166,0,0,0,341
30807,27115813,27231845,27292445,0,0,116032,176632
32092,27277283,27277283,27293674,0,0,0,16391
32080,27270334,27270334,27294274,0,0,0,23940
32100,27291811,27291811,27294571,0,0,0,2760
31988,27262914,27263408,27295647,0,0,494,32733
32012,27264949,27264949,27295902,0,0,0,30953
30810,27117546,27264514,27296394,0,0,146968,178848
31938,27245294,27245294,27297218,0,0,0,51924
31940,27245612,27245612,27297554,0,0,0,51942
30809,27117516,27264496,27299744,0,0,146980,182228
32102,27293535,27293535,27300802,0,0,0,7267
32074,27269825,27269825,27308624,0,0,0,38799
32078,27269962,27269962,27308730,0,0,0,38768
32103,27293636,27293636,27309944,0,0,0,16308
32028,27265934,27265934,27311493,0,0,0,45559
32097,27284654,27284654,27315015,0,0,0,30361
32076,27269894,27269894,27317648,0,0,0,47754
30898,27161489,27234032,27318064,0,0,72543,156575
32079,27270178,27270178,27318097,0,0,0,47919
31012,27173421,27238137,27321982,0,0,64716,148561
30446,27089094,27242046,27321993,0,0,152952,232899
32110,27324179,27324179,27324274,0,0,0,95
32111,27324253,27324253,27324380,0,0,0,127
31011,27173382,27235559,27324443,0,0,62177,151061
32108,27323956,27323956,27324909,0,0,0,953
32109,27323992,27323992,27324963,0,0,0,971
32106,27309912,27309912,27326280,0,0,0,16368
32115,27326743,27326743,27326832,0,0,0,89
32116,27326832,27326832,27326924,0,0,0,92
32117,27326983,27326983,27327053,0,0,0,70
32118,27327119,27327119,27327338,0,0,0,219
32119,27327577,27327577,27327695,0,0,0,118
32120,27327752,27327752,27327859,0,0,0,107
32121,27327958,27327958,27328070,0,0,0,112
32005,27264477,27264477,27328902,0,0,0,64425
32122,27329013,27329013,27329118,0,0,0,105
32123,27329198,27329198,27329271,0,0,0,73
32125,27329396,27329396,27329471,0,0,0,75
32127,27329551,27329551,27329621,0,0,0,70
32128,27329654,27329654,27329727,0,0,0,73
32129,27329743,27329743,27329818,0,0,0,75
32126,27329488,27329488,27330088,0,0,0,600
32132,27330065,27330065,27330169,0,0,0,104
32133,27330095,27330095,27330212,0,0,0,117
32134,27330162,27330162,27330235,0,0,0,73
32135,27330207,27330207,27330274,0,0,0,67
32137,27330297,27330297,27330417,0,0,0,120
32130,27329843,27329843,27330443,0,0,0,600
32140,27330556,27330556,27330661,0,0,0,105
32139,27330552,27330552,27330680,0,0,0,128
32141,27330627,27330627,27330685,0,0,0,58
32142,27330663,27330663,27330771,0,0,0,108
32136,27330248,27330248,27330848,0,0,0,600
32143,27330762,27330762,27330879,0,0,0,117
32144,27331013,27331013,27331131,0,0,0,118
32147,27331252,27331252,27331307,0,0,0,55
32149,27331290,27331290,27331357,0,0,0,67
32148,27331287,27331287,27331388,0,0,0,101
32145,27331179,27331179,27331449,0,0,0,270
32152,27331504,27331504,27331559,0,0,0,55
32150,27331439,27331439,27331601,0,0,0,162
32153,27331541,27331541,27331617,0,0,0,76
32154,27331609,27331609,27331838,0,0,0,229
32151,27331458,27331458,27332058,0,0,0,600
32156,27332102,27332102,27332188,0,0,0,86
32159,27332306,27332306,27332418,0,0,0,112
32157,27332208,27332208,27332437,0,0,0,229
31939,27245521,27247837,27332671,0,0,2316,87150
32124,27329347,27329347,27332947,0,0,0,3600
32161,27333451,27333451,27333560,0,0,0,109
32162,27333642,27333642,27333729,0,0,0,87
32163,27334534,27334534,27334629,0,0,0,95
32174,27334714,27334714,27334772,0,0,0,58
32175,27334990,27334990,27335072,0,0,0,82
32176,27336160,27336160,27336252,0,0,0,92
32177,27336592,27336592,27336831,0,0,0,239
32178,27336978,27336978,27337064,0,0,0,86
32179,27337743,27337743,27337830,0,0,0,87
32181,27337905,27337905,27338109,0,0,0,204
32183,27338179,27338179,27338517,0,0,0,338
31960,27255336,27257730,27339529,0,0,2394,84193
32023,27265709,27265709,27341765,0,0,0,76056
32114,27326238,27326238,27342626,0,0,0,16388
32155,27331854,27331854,27342708,0,0,0,10854
32186,27339608,27339608,27342721,0,0,0,3113
32198,27341585,27341585,27343021,0,0,0,1436
32187,27340041,27340041,27343135,0,0,0,3094
32188,27340209,27340209,27343290,0,0,0,3081
32189,27340352,27340352,27343423,0,0,0,3071
32190,27340475,27340475,27343558,0,0,0,3083
32191,27340658,27340658,27343743,0,0,0,3085
32192,27341158,27341158,27344290,0,0,0,3132
32193,27341221,27341221,27344362,0,0,0,3141
32194,27341289,27341289,27344394,0,0,0,3105
32195,27341361,27341361,27344515,0,0,0,3154
32107,27314978,27314978,27344543,0,0,0,29565
32196,27341432,27341432,27344556,0,0,0,3124
32197,27341500,27341500,27344639,0,0,0,3139
32219,27344964,27344964,27345038,0,0,0,74
32225,27345455,27345455,27345575,0,0,0,120
32199,27342019,27342019,27346185,0,0,0,4166
32180,27337892,27337892,27346832,0,0,0,8940
32201,27343087,27343087,27347122,0,0,0,4035
32206,27343727,27343727,27347897,0,0,0,4170
32209,27343940,27343940,27348050,0,0,0,4110
32212,27344073,27344073,27348188,0,0,0,4115
32213,27344173,27344173,27348251,0,0,0,4078
32214,27344227,27344227,27348361,0,0,0,4134
32215,27344410,27344410,27348548,0,0,0,4138
32216,27344482,27344482,27348616,0,0,0,4134
32184,27339061,27339061,27350055,0,0,0,10994
30877,27160285,27244207,27351262,0,0,83922,190977
32232,27349111,27349111,27351279,0,0,0,2168
32235,27349112,27349112,27351307,0,0,0,2195
32233,27349111,27349111,27351317,0,0,0,2206
32236,27349112,27349112,27351329,0,0,0,2217
32234,27349111,27349111,27351348,0,0,0,2237
30808,27115847,27231970,27352418,0,0,116123,236571
32245,27351097,27351262,27353590,0,0,165,2493
32247,27353637,27353637,27353794,0,0,0,157
32244,27350965,27351262,27354029,0,0,297,3064
32238,27350047,27350047,27355151,0,0,0,5104
32239,27350166,27350166,27355234,0,0,0,5068
32202,27343181,27351262,27355363,0,0,8081,12182
32241,27350317,27351262,27356222,0,0,945,5905
32240,27350258,27351262,27356250,0,0,1004,5992
32258,27355796,27355796,27356755,0,0,0,959
32261,27355934,27355934,27357710,0,0,0,1776
32260,27355928,27355928,27357771,0,0,0,1843
32262,27355935,27355935,27357806,0,0,0,1871
32263,27355935,27355935,27358314,0,0,0,2379
32264,27355935,27355935,27358337,0,0,0,2402
32265,27355935,27355935,27358370,0,0,0,2435
31010,27172144,27252631,27358918,0,0,80487,186774
32275,27359541,27359541,27359766,0,0,0,225
32269,27358432,27358432,27359983,0,0,0,1551
32270,27358432,27358432,27359983,0,0,0,1551
32271,27358432,27358432,27359994,0,0,0,1562
32268,27358426,27358426,27360005,0,0,0,1579
32272,27358432,27358432,27360005,0,0,0,1573
32273,27358433,27358433,27360030,0,0,0,1597
32274,27358433,27358433,27360065,0,0,0,1632
32185,27339088,27339529,27361129,0,0,441,22041
32248,27353693,27353693,27362919,0,0,0,9226
32200,27342579,27342579,27363086,0,0,0,20507
32277,27362276,27362276,27363633,0,0,0,1357
32278,27362281,27362281,27363633,0,0,0,1352
32282,27362283,27362283,27363666,0,0,0,1383
32279,27362282,27362282,27363676,0,0,0,1394
32280,27362282,27362282,27363687,0,0,0,1405
32281,27362282,27362282,27363687,0,0,0,1405
32283,27362283,27362283,27363688,0,0,0,1405
32284,27362283,27362283,27363710,0,0,0,1427
32250,27354721,27354721,27363912,0,0,0,9191
32246,27353321,27358918,27363965,0,0,5597,10644
32249,27353836,27353836,27363986,0,0,0,10150
32251,27354802,27354802,27363992,0,0,0,9190
32252,27354878,27354878,27364099,0,0,0,9221
32253,27354941,27354941,27364147,0,0,0,9206
32254,27355072,27355072,27364254,0,0,0,9182
32286,27364441,27364441,27364667,0,0,0,226
32255,27355517,27355517,27365830,0,0,0,10313
32256,27355594,27355594,27365890,0,0,0,10296
32257,27355697,27355697,27365978,0,0,0,10281
32276,27359761,27363965,27366010,0,0,4204,6249
32131,27329863,27329863,27366217,0,0,0,36354
32259,27355893,27355893,27366218,0,0,0,10325
32138,27330360,27330360,27366623,0,0,0,36263
32146,27331201,27331201,27367458,0,0,0,36257
32287,27365246,27366010,27368057,0,0,764,2811
32266,27355971,27355971,27368060,0,0,0,12089
32158,27332216,27332216,27368228,0,0,0,36012
32290,27367595,27367595,27368799,0,0,0,1204
32291,27367595,27367595,27368811,0,0,0,1216
32289,27367594,27367594,27368821,0,0,0,1227
32292,27367595,27367595,27368822,0,0,0,1227
32294,27367596,27367596,27368823,0,0,0,1227
32288,27367588,27367588,27368831,0,0,0,1243
32295,27367596,27367596,27368834,0,0,0,1238
32296,27367596,27367596,27368845,0,0,0,1249
32293,27367595,27367595,27368855,0,0,0,1260
32160,27333319,27333319,27369748,0,0,0,36429
32297,27369271,27369271,27370398,0,0,0,1127
32299,27369278,27369278,27370400,0,0,0,1122
32307,27370185,27370185,27370410,0,0,0,225
32300,27369278,27369278,27370411,0,0,0,1133
32301,27369278,27369278,27370433,0,0,0,1155
32303,27369279,27369279,27370434,0,0,0,1155
32304,27369279,27369279,27370434,0,0,0,1155
32298,27369277,27369277,27370443,0,0,0,1166
32305,27369279,27369279,27370445,0,0,0,1166
32302,27369278,27369278,27370470,0,0,0,1192
32306,27369279,27369279,27370513,0,0,0,1234
31927,27238984,27263103,27370578,0,0,24119,131594
32310,27370637,27370637,27371660,0,0,0,1023
32308,27370630,27370630,27371669,0,0,0,1039
32309,27370636,27370636,27371670,0,0,0,1034
32311,27370637,27370637,27371671,0,0,0,1034
32314,27370638,27370638,27371694,0,0,0,1056
32312,27370637,27370637,27371705,0,0,0,1068
32315,27370638,27370638,27371706,0,0,0,1068
32316,27370638,27370638,27371706,0,0,0,1068
32313,27370637,27370637,27371716,0,0,0,1079
32318,27370639,27370639,27371718,0,0,0,1079
32317,27370638,27370638,27371770,0,0,0,1132
32320,27372417,27372417,27373319,0,0,0,902
32321,27372417,27372417,27373331,0,0,0,914
32324,27372418,27372418,27373350,0,0,0,932
32322,27372417,27372417,27373361,0,0,0,944
32325,27372418,27372418,27373362,0,0,0,944
32323,27372417,27372417,27373372,0,0,0,955
32326,27372418,27372418,27373373,0,0,0,955
32330,27372419,27372419,27373385,0,0,0,966
32331,27372419,27372419,27373385,0,0,0,966
32327,27372418,27372418,27373395,0,0,0,977
32328,27372418,27372418,27373406,0,0,0,988
32329,27372418,27372418,27373406,0,0,0,988
32217,27344501,27344501,27373704,0,0,0,29203
32332,27373774,27373774,27373919,0,0,0,145
32333,27373798,27373798,27374282,0,0,0,484
32337,27373799,27373799,27374294,0,0,0,495
32334,27373798,27373798,27374304,0,0,0,506
32335,27373798,27373798,27374304,0,0,0,506
32338,27373799,27373799,27374305,0,0,0,506
32182,27337972,27337972,27374308,0,0,0,36336
32336,27373798,27373798,27374315,0,0,0,517
32339,27373799,27373799,27374316,0,0,0,517
32340,27373799,27373799,27374327,0,0,0,528
32341,27373799,27373799,27374327,0,0,0,528
32343,27373800,27373800,27374328,0,0,0,528
32342,27373799,27373799,27374338,0,0,0,539
32344,27373800,27373800,27374350,0,0,0,550
32345,27373800,27373800,27374350,0,0,0,550
32346,27373800,27373800,27374361,0,0,0,561
32347,27373800,27373800,27374361,0,0,0,561
32348,27373800,27373800,27374361,0,0,0,561
32349,27373800,27373800,27374361,0,0,0,561
32350,27373801,27373801,27374362,0,0,0,561
32351,27373801,27373801,27374362,0,0,0,561
32352,27373801,27373801,27374362,0,0,0,561
32353,27373801,27373801,27374362,0,0,0,561
32354,27373801,27373919,27374363,0,0,118,562
32356,27374609,27374609,27374732,0,0,0,123
32357,27374609,27374609,27374732,0,0,0,123
32360,27374610,27374610,27374733,0,0,0,123
32361,27374610,27374610,27374733,0,0,0,123
32362,27374610,27374610,27374733,0,0,0,123
32366,27374611,27374611,27374734,0,0,0,123
32367,27374611,27374611,27374734,0,0,0,123
32355,27374608,27374608,27374742,0,0,0,134
32358,27374609,27374609,27374743,0,0,0,134
32359,27374609,27374609,27374743,0,0,0,134
32363,27374610,27374610,27374744,0,0,0,134
32364,27374610,27374610,27374744,0,0,0,134
32365,27374610,27374610,27374744,0,0,0,134
32368,27374611,27374611,27374745,0,0,0,134
32369,27374611,27374611,27374745,0,0,0,134
32370,27374611,27374611,27374745,0,0,0,134
32371,27374611,27374611,27374745,0,0,0,134
32372,27374612,27374612,27374746,0,0,0,134
32373,27374612,27374612,27374746,0,0,0,134
32243,27350565,27351262,27374834,0,0,697,24269
32374,27374612,27374612,27374876,0,0,0,264
32376,27375007,27375007,27375469,0,0,0,462
32377,27375013,27375013,27375501,0,0,0,488
32378,27375013,27375013,27375512,0,0,0,499
32379,27375013,27375013,27375512,0,0,0,499
32380,27375013,27375013,27375523,0,0,0,510
32381,27375014,27375014,27375524,0,0,0,510
32382,27375014,27375014,27375524,0,0,0,510
32383,27375014,27375014,27375535,0,0,0,521
32384,27375015,27375015,27375536,0,0,0,521
32385,27375015,27375015,27375547,0,0,0,532
32386,27375015,27375015,27375547,0,0,0,532
32387,27375015,27375015,27375558,0,0,0,543
32388,27375016,27375016,27375559,0,0,0,543
32400,27375551,27375559,27375634,0,0,8,83
32389,27375016,27375016,27375791,0,0,0,775
32390,27375016,27375016,27375813,0,0,0,797
32391,27375016,27375016,27375813,0,0,0,797
32392,27375017,27375469,27375959,0,0,452,942
32393,27375017,27375501,27376002,0,0,484,985
32396,27375018,27375523,27376024,0,0,505,1006
32397,27375018,27375524,27376025,0,0,506,1007
32398,27375018,27375524,27376036,0,0,506,1018
32399,27375018,27375535,27376047,0,0,517,1029
32242,27350478,27351262,27376219,0,0,784,25741
32394,27375017,27375512,27376298,0,0,495,1281
32395,27375017,27375512,27376298,0,0,495,1281
32403,27376619,27376619,27376943,0,0,0,324
32404,27376619,27376619,27376959,0,0,0,340
32402,27376613,27376613,27376970,0,0,0,357
32405,27376619,27376619,27376980,0,0,0,361
32406,27376620,27376620,27376981,0,0,0,361
32407,27376620,27376620,27376981,0,0,0,361
32408,27376621,27376621,27377050,0,0,0,429
32409,27376622,27376622,27377051,0,0,0,429
32410,27376622,27376622,27377051,0,0,0,429
32411,27376622,27376622,27377051,0,0,0,429
32412,27376623,27376623,27377052,0,0,0,429
32413,27376623,27376943,27377372,0,0,320,749
32421,27376625,27377051,27377383,0,0,426,758
32414,27376623,27376959,27377388,0,0,336,765
32422,27376625,27377051,27377394,0,0,426,769
32423,27376625,27377052,27377396,0,0,427,771
32415,27376623,27376970,27377587,0,0,347,964
32416,27376624,27376980,27377597,0,0,356,973
32417,27376624,27376981,27377609,0,0,357,985
32418,27376624,27376981,27377609,0,0,357,985
32419,27376624,27377050,27377689,0,0,426,1065
32420,27376624,27377051,27377690,0,0,427,1066
32424,27376625,27377372,27377716,0,0,747,1091
32425,27376625,27377383,27377727,0,0,758,1102
32426,27376625,27377388,27377728,0,0,763,1103
32427,27376625,27377394,27377734,0,0,769,1109
32428,27376626,27377396,27377747,0,0,770,1121
32429,27376626,27377587,27377949,0,0,961,1323
32430,27376626,27377597,27377959,0,0,971,1333
32431,27376626,27377609,27377971,0,0,983,1345
32285,27362836,27363086,27379390,0,0,250,16554
32433,27379218,27379218,27379476,0,0,0,258
32435,27379219,27379219,27379493,0,0,0,274
32434,27379218,27379218,27379508,0,0,0,290
32436,27379219,27379219,27379509,0,0,0,290
32437,27379219,27379219,27379509,0,0,0,290
32438,27379219,27379219,27379509,0,0,0,290
32439,27379219,27379219,27379540,0,0,0,321
32440,27379219,27379390,27379711,0,0,171,492
32441,27379219,27379390,27379711,0,0,171,492
32442,27379220,27379390,27379711,0,0,170,491
32443,27379220,27379390,27379711,0,0,170,491
32449,27379222,27379509,27379779,0,0,287,557
32444,27379220,27379476,27379797,0,0,256,577
32224,27345280,27345280,27379840,0,0,0,34560
32453,27379222,27379711,27379975,0,0,489,753
32452,27379222,27379711,27379991,0,0,489,769
32454,27379222,27379711,27380001,0,0,489,779
32445,27379221,27379493,27380021,0,0,272,800
32446,27379221,27379508,27380036,0,0,287,815
32447,27379221,27379509,27380063,0,0,288,842
32448,27379221,27379509,27380063,0,0,288,842
32455,27379222,27379779,27380069,0,0,557,847
32456,27379223,27379797,27380087,0,0,574,864
32450,27379222,27379540,27380094,0,0,318,872
32457,27379223,27379975,27380245,0,0,752,1022
32458,27379223,27379991,27380261,0,0,768,1038
32451,27379222,27379711,27380265,0,0,489,1043
32459,27379223,27380001,27380282,0,0,778,1059
31070,27174404,27264540,27380304,0,0,90136,205900
32460,27379223,27380021,27380313,0,0,798,1090
32461,27379223,27380036,27380328,0,0,813,1105
32463,27379346,27380063,27380330,0,0,717,984
32464,27379346,27380069,27380347,0,0,723,1001
32465,27379346,27380087,27380376,0,0,741,1030
32466,27379346,27380094,27380394,0,0,748,1048
32462,27379345,27380063,27380511,0,0,718,1166
32467,27379347,27380245,27380534,0,0,898,1187
32470,27379347,27380282,27380546,0,0,935,1199
32468,27379347,27380261,27380561,0,0,914,1214
32469,27379347,27380265,27380565,0,0,918,1218
32471,27379348,27380304,27380565,0,0,956,1217
32474,27379349,27380304,27380576,0,0,955,1227
32472,27379348,27380304,27380745,0,0,956,1397
32473,27379348,27380304,27380745,0,0,956,1397
32475,27380684,27380684,27380961,0,0,0,277
32476,27380685,27380685,27380962,0,0,0,277
32477,27380685,27380685,27380962,0,0,0,277
32478,27380685,27380685,27380962,0,0,0,277
32479,27380686,27380686,27381036,0,0,0,350
32480,27380686,27380686,27381036,0,0,0,350
32481,27380686,27380686,27381036,0,0,0,350
32482,27380687,27380687,27381037,0,0,0,350
32483,27380687,27380687,27381037,0,0,0,350
32484,27380687,27380687,27381037,0,0,0,350
32485,27380687,27380687,27381048,0,0,0,361
32486,27380687,27380687,27381048,0,0,0,361
32487,27380687,27380687,27381048,0,0,0,361
32488,27380687,27380687,27381059,0,0,0,372
32489,27380688,27380688,27381060,0,0,0,372
32223,27345229,27345229,27381063,0,0,0,35834
32490,27380688,27380688,27381071,0,0,0,383
32491,27380688,27380688,27381071,0,0,0,383
32492,27380688,27380688,27381082,0,0,0,394
32493,27380688,27380688,27381082,0,0,0,394
32494,27380688,27380688,27381093,0,0,0,405
32495,27380689,27380689,27381105,0,0,0,416
32496,27380689,27380689,27381105,0,0,0,416
32497,27380689,27380689,27381105,0,0,0,416
32498,27380689,27380689,27381116,0,0,0,427
32499,27380689,27380745,27381172,0,0,56,483
32500,27380689,27380745,27381183,0,0,56,494
32515,27380891,27381060,27381201,0,0,169,310
32508,27380889,27381037,27381321,0,0,148,432
32509,27380889,27381037,27381321,0,0,148,432
32510,27380889,27381037,27381332,0,0,148,443
32511,27380890,27381048,27381343,0,0,158,453
32512,27380890,27381048,27381354,0,0,158,464
32513,27380890,27381048,27381354,0,0,158,464
32518,27380892,27381082,27381360,0,0,190,468
32519,27380892,27381082,27381360,0,0,190,468
32520,27380892,27381093,27381371,0,0,201,479
32523,27380893,27381105,27381374,0,0,212,481
32514,27380890,27381059,27381376,0,0,169,486
32516,27380891,27381071,27381388,0,0,180,497
32522,27380893,27381105,27381394,0,0,212,501
32524,27380893,27381116,27381396,0,0,223,503
32502,27380690,27380962,27381400,0,0,272,710
32501,27380689,27380961,27381410,0,0,272,721
32503,27380690,27380962,27381411,0,0,272,721
32504,27380690,27380962,27381422,0,0,272,732
32525,27380893,27381172,27381452,0,0,279,559
32526,27380894,27381183,27381474,0,0,289,580
32527,27380894,27381201,27381492,0,0,307,598
32505,27380690,27381036,27381496,0,0,346,806
32506,27380690,27381036,27381507,0,0,346,817
32507,27380690,27381036,27381507,0,0,346,817
32517,27380891,27381071,27381560,0,0,180,669
32521,27380892,27381105,27381605,0,0,213,713
32528,27380894,27381321,27381623,0,0,427,729
32530,27381626,27381626,27381892,0,0,0,266
32531,27381632,27381632,27381898,0,0,0,266
32532,27381633,27381633,27381915,0,0,0,282
32533,27381633,27381633,27381915,0,0,0,282
32534,27381633,27381633,27381915,0,0,0,282
32535,27381633,27381633,27381941,0,0,0,308
32536,27381634,27381634,27381942,0,0,0,308
32537,27381634,27381634,27381942,0,0,0,308
32538,27381634,27381634,27381942,0,0,0,308
32539,27381634,27381634,27381942,0,0,0,308
32540,27381637,27381637,27382029,0,0,0,392
32541,27381637,27381892,27382284,0,0,255,647
32542,27381637,27381898,27382290,0,0,261,653
32543,27381637,27381915,27382307,0,0,278,670
32544,27381637,27381915,27382307,0,0,278,670
32545,27381637,27381915,27382307,0,0,278,670
32546,27381638,27381941,27382333,0,0,303,695
32547,27381638,27381942,27382334,0,0,304,696
32548,27381638,27381942,27382334,0,0,304,696
32549,27381638,27381942,27382334,0,0,304,696
32550,27381638,27381942,27382361,0,0,304,723
32551,27381638,27382029,27382448,0,0,391,810
32222,27345192,27345192,27382488,0,0,0,37296
32560,27381640,27382334,27382598,0,0,694,958
32561,27381640,27382361,27382626,0,0,721,986
32552,27381638,27382284,27382703,0,0,646,1065
32553,27381639,27382290,27382709,0,0,651,1070
32562,27381640,27382448,27382723,0,0,808,1083
32554,27381639,27382307,27382737,0,0,668,1098
32555,27381639,27382307,27382737,0,0,668,1098
32556,27381639,27382307,27382737,0,0,668,1098
32557,27381639,27382333,27382945,0,0,694,1306
32558,27381639,27382334,27382946,0,0,695,1307
32559,27381639,27382334,27382957,0,0,695,1318
32566,27381641,27382709,27382984,0,0,1068,1343
32568,27381641,27382737,27383008,0,0,1096,1367
32569,27381641,27382737,27383008,0,0,1096,1367
32567,27381641,27382723,27383009,0,0,1082,1368
32570,27381641,27382737,27383019,0,0,1096,1378
32221,27345085,27345085,27383115,0,0,0,38030
32563,27381640,27382598,27383221,0,0,958,1581
32573,27381642,27382957,27383235,0,0,1315,1593
32571,27381641,27382945,27383238,0,0,1304,1597
32572,27381642,27382946,27383239,0,0,1304,1597
32564,27381640,27382626,27383249,0,0,986,1609
32574,27381642,27382984,27383262,0,0,1342,1620
32575,27381642,27383008,27383286,0,0,1366,1644
32576,27381642,27383008,27383297,0,0,1366,1655
32577,27381642,27383009,27383309,0,0,1367,1667
32578,27381642,27383019,27383319,0,0,1377,1677
32565,27381640,27382703,27383326,0,0,1063,1686
32579,27381840,27383115,27383415,0,0,1275,1575
32580,27381840,27383221,27383496,0,0,1381,1656
32581,27381841,27383235,27383510,0,0,1394,1669
32587,27382647,27383297,27383518,0,0,650,871
32582,27381841,27383238,27383524,0,0,1397,1683
32588,27382647,27383309,27383530,0,0,662,883
32583,27382646,27383239,27383603,0,0,593,957
32584,27382646,27383249,27383613,0,0,603,967
32401,27376245,27376245,27383705,0,0,0,7460
32585,27382646,27383262,27383725,0,0,616,1079
32593,27382648,27383510,27383731,0,0,862,1083
32594,27382648,27383518,27383739,0,0,870,1091
32595,27382648,27383524,27383745,0,0,876,1097
32586,27382646,27383286,27383749,0,0,640,1103
32596,27382648,27383530,27383762,0,0,882,1114
32589,27382647,27383319,27383782,0,0,672,1135
32590,27382647,27383326,27383800,0,0,679,1153
32597,27382648,27383603,27383846,0,0,955,1198
32598,27382648,27383613,27383856,0,0,965,1208
32591,27382647,27383415,27383889,0,0,768,1242
32604,27382649,27383725,27383924,0,0,1076,1275
32605,27382650,27383731,27383941,0,0,1081,1291
32599,27382649,27383705,27383948,0,0,1056,1299
32606,27382650,27383739,27383949,0,0,1089,1299
32600,27382649,27383705,27383959,0,0,1056,1310
32601,27382649,27383705,27383959,0,0,1056,1310
32602,27382649,27383705,27383959,0,0,1056,1310
32607,27382650,27383745,27383966,0,0,1095,1316
32592,27382647,27383496,27383970,0,0,849,1323
32603,27382649,27383705,27383970,0,0,1056,1321
32608,27382650,27383749,27383970,0,0,1099,1320
32609,27382650,27383762,27383983,0,0,1112,1333
32610,27382650,27383782,27384003,0,0,1132,1353
32611,27382650,27383800,27384043,0,0,1150,1393
32612,27382651,27383846,27384089,0,0,1195,1438
32613,27382651,27383856,27384099,0,0,1205,1448
32614,27382651,27383889,27384143,0,0,1238,1492
32616,27382651,27383941,27384156,0,0,1290,1505
32617,27382651,27383948,27384163,0,0,1297,1512
32618,27382784,27383949,27384164,0,0,1165,1380
32615,27382651,27383924,27384178,0,0,1273,1527
32619,27382784,27383959,27384185,0,0,1175,1401
32622,27382785,27383966,27384203,0,0,1181,1418
32620,27382784,27383959,27384207,0,0,1175,1423
32623,27382785,27383970,27384207,0,0,1185,1422
32621,27382784,27383959,27384218,0,0,1175,1434
32624,27382785,27383970,27384218,0,0,1185,1433
32625,27382786,27383970,27384218,0,0,1184,1432
32626,27382786,27383983,27384231,0,0,1197,1445
32627,27382786,27384003,27384251,0,0,1217,1465
32220,27345017,27345017,27385836,0,0,0,40819
32529,27381345,27381410,27391493,0,0,65,10148
32218,27344897,27344897,27391644,0,0,0,46747
32432,27379100,27379100,27395446,0,0,0,16346
29815,26943147,26943147,27405262,0,0,0,462115
32375,27374806,27374806,27405367,0,0,0,30561
30450,27090291,27261127,27407440,0,0,170836,317149
32104,27295621,27295621,27411388,0,0,0,115767
32105,27295712,27295712,27411497,0,0,0,115785
32628,27395407,27395407,27411738,0,0,0,16331
32319,27370698,27391493,27412026,0,0,20795,41328
32031,27266034,27266034,27416620,0,0,0,150586
31046,27173929,27259841,27416944,0,0,85912,243015
32630,27413889,27413889,27418303,0,0,0,4414
32632,27418321,27418321,27418380,0,0,0,59
32634,27418399,27418399,27418476,0,0,0,77
32633,27418363,27418363,27418549,0,0,0,186
32636,27418553,27418553,27418872,0,0,0,319
32638,27418833,27418833,27418966,0,0,0,133
32635,27418446,27418446,27419356,0,0,0,910
32637,27418666,27418666,27419954,0,0,0,1288
32640,27420855,27420855,27420982,0,0,0,127
32641,27421155,27421155,27421290,0,0,0,135
32642,27421585,27421585,27421715,0,0,0,130
32643,27422152,27422152,27422280,0,0,0,128
32644,27422340,27422340,27422463,0,0,0,123
32645,27422780,27422780,27422908,0,0,0,128
32639,27419965,27419965,27423260,0,0,0,3295
32646,27423202,27423202,27423329,0,0,0,127
32647,27423322,27423322,27423449,0,0,0,127
32024,27265724,27265724,27424124,0,0,0,158400
32030,27265992,27265992,27424392,0,0,0,158400
32648,27425448,27425448,27425573,0,0,0,125
32629,27411697,27411697,27428012,0,0,0,16315
32652,27428258,27428258,27428473,0,0,0,215
32653,27428258,27428258,27428473,0,0,0,215
32654,27428258,27428258,27428473,0,0,0,215
32655,27428259,27428259,27428474,0,0,0,215
32674,27428268,27428268,27428481,0,0,0,213
32675,27428268,27428268,27428481,0,0,0,213
32676,27428268,27428268,27428481,0,0,0,213
32677,27428268,27428268,27428481,0,0,0,213
32651,27428252,27428252,27428484,0,0,0,232
32668,27428267,27428267,27428501,0,0,0,234
32669,27428267,27428267,27428501,0,0,0,234
32670,27428267,27428267,27428501,0,0,0,234
32671,27428267,27428267,27428501,0,0,0,234
32672,27428268,27428268,27428502,0,0,0,234
32673,27428268,27428268,27428528,0,0,0,260
32689,27428476,27428476,27428554,0,0,0,78
32656,27428263,27428263,27428671,0,0,0,408
32657,27428264,27428264,27428672,0,0,0,408
32658,27428264,27428264,27428672,0,0,0,408
32659,27428265,27428265,27428673,0,0,0,408
32660,27428265,27428265,27428673,0,0,0,408
32682,27428474,27428474,27428673,0,0,0,199
32697,27428478,27428478,27428678,0,0,0,200
32692,27428476,27428476,27428679,0,0,0,203
32702,27428479,27428479,27428681,0,0,0,202
32703,27428479,27428479,27428681,0,0,0,202
32681,27428473,27428473,27428683,0,0,0,210
32696,27428477,27428477,27428688,0,0,0,211
32698,27428478,27428478,27428689,0,0,0,211
32693,27428477,27428477,27428691,0,0,0,214
32694,27428477,27428477,27428691,0,0,0,214
32704,27428479,27428479,27428692,0,0,0,213
32683,27428474,27428474,27428695,0,0,0,221
32685,27428475,27428475,27428696,0,0,0,221
32678,27428473,27428473,27428697,0,0,0,224
32679,27428473,27428473,27428697,0,0,0,224
32699,27428478,27428478,27428700,0,0,0,222
32700,27428478,27428478,27428700,0,0,0,222
32701,27428478,27428478,27428700,0,0,0,222
32695,27428477,27428477,27428702,0,0,0,225
32684,27428474,27428474,27428706,0,0,0,232
32686,27428475,27428475,27428707,0,0,0,232
32687,27428475,27428475,27428707,0,0,0,232
32680,27428473,27428473,27428708,0,0,0,235
32688,27428475,27428475,27428718,0,0,0,243
32690,27428476,27428476,27428719,0,0,0,243
32691,27428476,27428476,27428730,0,0,0,254
32661,27428265,27428265,27428788,0,0,0,523
32662,27428265,27428265,27428799,0,0,0,534
32663,27428265,27428265,27428799,0,0,0,534
32664,27428266,27428266,27428800,0,0,0,534
32665,27428266,27428266,27428811,0,0,0,545
32666,27428266,27428266,27428822,0,0,0,556
32667,27428266,27428266,27428822,0,0,0,556
32721,27429095,27429095,27429308,0,0,0,213
32722,27429095,27429095,27429319,0,0,0,224
32711,27429094,27429094,27429320,0,0,0,226
32712,27429094,27429094,27429320,0,0,0,226
32713,27429094,27429094,27429320,0,0,0,226
32714,27429094,27429094,27429320,0,0,0,226
32715,27429094,27429094,27429320,0,0,0,226
32717,27429095,27429095,27429321,0,0,0,226
32723,27429095,27429095,27429330,0,0,0,235
32718,27429095,27429095,27429332,0,0,0,237
32719,27429095,27429095,27429343,0,0,0,248
32720,27429095,27429095,27429343,0,0,0,248
32736,27429327,27429327,27429536,0,0,0,209
32724,27429323,27429323,27429547,0,0,0,224
32737,27429327,27429327,27429547,0,0,0,220
32738,27429327,27429327,27429547,0,0,0,220
32725,27429324,27429324,27429548,0,0,0,224
32726,27429324,27429324,27429548,0,0,0,224
32739,27429328,27429328,27429548,0,0,0,220
32727,27429324,27429324,27429559,0,0,0,235
32740,27429328,27429328,27429559,0,0,0,231
32741,27429328,27429328,27429559,0,0,0,231
32742,27429328,27429328,27429570,0,0,0,242
32743,27429328,27429328,27429570,0,0,0,242
32744,27429328,27429328,27429570,0,0,0,242
32728,27429325,27429325,27429571,0,0,0,246
32729,27429325,27429325,27429571,0,0,0,246
32730,27429325,27429325,27429582,0,0,0,257
32731,27429325,27429325,27429582,0,0,0,257
32745,27429329,27429329,27429582,0,0,0,253
32746,27429329,27429329,27429582,0,0,0,253
32747,27429329,27429329,27429593,0,0,0,264
32732,27429326,27429326,27429594,0,0,0,268
32733,27429326,27429326,27429594,0,0,0,268
32748,27429329,27429329,27429604,0,0,0,275
32734,27429326,27429326,27429605,0,0,0,279
32735,27429326,27429326,27429605,0,0,0,279
32705,27429093,27429093,27429634,0,0,0,541
32706,27429093,27429093,27429645,0,0,0,552
32707,27429093,27429093,27429656,0,0,0,563
32708,27429093,27429093,27429656,0,0,0,563
32709,27429093,27429093,27429656,0,0,0,563
32710,27429093,27429093,27429667,0,0,0,574
32716,27429094,27429094,27429679,0,0,0,585
32749,27429985,27429985,27430115,0,0,0,130
32750,27430542,27430542,27430670,0,0,0,128
32112,27325220,27325220,27431036,0,0,0,105816
32751,27430918,27430918,27431049,0,0,0,131
32753,27431274,27431274,27431413,0,0,0,139
32754,27432217,27432217,27432383,0,0,0,166
32113,27325252,27325252,27432900,0,0,0,107648
32755,27433081,27433081,27433210,0,0,0,129
32756,27433518,27433518,27433684,0,0,0,166
32757,27433849,27433849,27434069,0,0,0,220
32231,27346009,27350055,27435068,0,0,4046,89059
32631,27418204,27418204,27436867,0,0,0,18663
32758,27435185,27435185,27438409,0,0,0,3224
32649,27426794,27426794,27441626,0,0,0,14832
32764,27445513,27445513,27446497,0,0,0,984
32765,27445946,27445946,27446925,0,0,0,979
32650,27427974,27427974,27448279,0,0,0,20305
32774,27450731,27450731,27450915,0,0,0,184
32775,27450731,27450731,27450915,0,0,0,184
32776,27450731,27450731,27450915,0,0,0,184
32777,27450731,27450731,27450915,0,0,0,184
32778,27450731,27450731,27450915,0,0,0,184
32779,27450731,27450731,27450915,0,0,0,184
32780,27450986,27450986,27451170,0,0,0,184
32781,27450986,27450986,27451170,0,0,0,184
32782,27450987,27450987,27451171,0,0,0,184
32783,27450987,27450987,27451171,0,0,0,184
32784,27450987,27450987,27451171,0,0,0,184
32785,27450987,27450987,27451171,0,0,0,184
32786,27450988,27450988,27451172,0,0,0,184
32787,27450988,27450988,27451172,0,0,0,184
32788,27450988,27450988,27451172,0,0,0,184
32789,27450988,27450988,27451172,0,0,0,184
32790,27450989,27450989,27451173,0,0,0,184
32791,27450989,27450989,27451173,0,0,0,184
32792,27450989,27450989,27451173,0,0,0,184
32793,27450989,27450989,27451173,0,0,0,184
32794,27450990,27450990,27451174,0,0,0,184
32795,27450990,27450990,27451174,0,0,0,184
32796,27450990,27450990,27451174,0,0,0,184
32797,27450990,27450990,27451174,0,0,0,184
32798,27450991,27450991,27451175,0,0,0,184
32799,27450991,27450991,27451175,0,0,0,184
32800,27450991,27450991,27451175,0,0,0,184
32801,27450991,27450991,27451175,0,0,0,184
32802,27450991,27450991,27451175,0,0,0,184
32769,27450730,27450730,27451179,0,0,0,449
32770,27450730,27450730,27451179,0,0,0,449
32771,27450730,27450730,27451179,0,0,0,449
32772,27450730,27450730,27451179,0,0,0,449
32773,27450731,27450731,27451180,0,0,0,449
32803,27450992,27450992,27451188,0,0,0,196
32804,27450992,27450992,27451188,0,0,0,196
32805,27450992,27450992,27451188,0,0,0,196
32806,27450992,27450992,27451199,0,0,0,207
32807,27450992,27450992,27451199,0,0,0,207
32840,27451408,27451408,27451495,0,0,0,87
32838,27451408,27451408,27451587,0,0,0,179
32839,27451408,27451408,27451587,0,0,0,179
32827,27451406,27451406,27451612,0,0,0,206
32828,27451406,27451406,27451612,0,0,0,206
32829,27451406,27451406,27451623,0,0,0,217
32830,27451406,27451406,27451623,0,0,0,217
32831,27451407,27451407,27451635,0,0,0,228
32832,27451407,27451407,27451635,0,0,0,228
32833,27451407,27451407,27451635,0,0,0,228
32834,27451407,27451407,27451646,0,0,0,239
32835,27451407,27451407,27451657,0,0,0,250
32836,27451407,27451407,27451657,0,0,0,250
32837,27451407,27451407,27451657,0,0,0,250
32841,27451408,27451408,27451669,0,0,0,261
32842,27451408,27451408,27451680,0,0,0,272
32843,27451408,27451408,27451680,0,0,0,272
32844,27451611,27451611,27451725,0,0,0,114
32808,27451403,27451403,27451795,0,0,0,392
32809,27451403,27451403,27451795,0,0,0,392
32810,27451403,27451403,27451795,0,0,0,392
32811,27451403,27451403,27451795,0,0,0,392
32812,27451404,27451404,27451796,0,0,0,392
32813,27451404,27451404,27451796,0,0,0,392
32814,27451404,27451404,27451796,0,0,0,392
32815,27451404,27451404,27451796,0,0,0,392
32816,27451404,27451404,27451796,0,0,0,392
32817,27451404,27451404,27451796,0,0,0,392
32818,27451404,27451404,27451796,0,0,0,392
32819,27451405,27451405,27451797,0,0,0,392
32820,27451405,27451405,27451797,0,0,0,392
32821,27451405,27451405,27451797,0,0,0,392
32822,27451405,27451405,27451797,0,0,0,392
32823,27451405,27451405,27451797,0,0,0,392
32858,27451615,27451615,27451818,0,0,0,203
32859,27451615,27451615,27451818,0,0,0,203
32824,27451405,27451405,27451824,0,0,0,419
32845,27451611,27451611,27451824,0,0,0,213
32846,27451611,27451611,27451824,0,0,0,213
32825,27451406,27451406,27451825,0,0,0,419
32826,27451406,27451406,27451825,0,0,0,419
32860,27451615,27451615,27451829,0,0,0,214
32847,27451612,27451612,27451836,0,0,0,224
32848,27451612,27451612,27451847,0,0,0,235
32849,27451612,27451612,27451847,0,0,0,235
32850,27451612,27451612,27451847,0,0,0,235
32851,27451613,27451613,27451859,0,0,0,246
32852,27451613,27451613,27451859,0,0,0,246
32853,27451613,27451613,27451870,0,0,0,257
32854,27451614,27451614,27451882,0,0,0,268
32855,27451614,27451614,27451882,0,0,0,268
32856,27451614,27451614,27451882,0,0,0,268
32857,27451614,27451614,27451882,0,0,0,268
32878,27452564,27452564,27452770,0,0,0,206
32879,27452564,27452564,27452781,0,0,0,217
32893,27452816,27452816,27452913,0,0,0,97
32894,27452816,27452816,27452913,0,0,0,97
32885,27452814,27452814,27453008,0,0,0,194
32861,27452561,27452561,27453013,0,0,0,452
32862,27452561,27452561,27453013,0,0,0,452
32863,27452562,27452562,27453014,0,0,0,452
32864,27452562,27452562,27453014,0,0,0,452
32865,27452562,27452562,27453014,0,0,0,452
32866,27452562,27452562,27453014,0,0,0,452
32867,27452562,27452562,27453014,0,0,0,452
32868,27452562,27452562,27453014,0,0,0,452
32869,27452562,27452562,27453014,0,0,0,452
32870,27452563,27452563,27453015,0,0,0,452
32871,27452563,27452563,27453015,0,0,0,452
32872,27452563,27452563,27453015,0,0,0,452
32873,27452563,27452563,27453015,0,0,0,452
32874,27452563,27452563,27453015,0,0,0,452
32875,27452563,27452563,27453015,0,0,0,452
32876,27452564,27452564,27453016,0,0,0,452
32877,27452564,27452564,27453016,0,0,0,452
32895,27452816,27452816,27453024,0,0,0,208
32896,27452817,27452817,27453036,0,0,0,219
32897,27452817,27452817,27453036,0,0,0,219
32880,27452812,27452812,27453040,0,0,0,228
32881,27452812,27452812,27453040,0,0,0,228
32898,27452817,27452817,27453047,0,0,0,230
32899,27452817,27452817,27453047,0,0,0,230
32900,27452817,27452817,27453047,0,0,0,230
32882,27452813,27452813,27453052,0,0,0,239
32883,27452813,27452813,27453052,0,0,0,239
32884,27452813,27452813,27453052,0,0,0,239
32886,27452814,27452814,27453053,0,0,0,239
32901,27452817,27452817,27453058,0,0,0,241
32902,27452818,27452818,27453059,0,0,0,241
32887,27452814,27452814,27453064,0,0,0,250
32888,27452814,27452814,27453064,0,0,0,250
32903,27452818,27452818,27453070,0,0,0,252
32904,27452818,27452818,27453070,0,0,0,252
32889,27452815,27452815,27453076,0,0,0,261
32905,27452818,27452818,27453081,0,0,0,263
32890,27452815,27452815,27453087,0,0,0,272
32906,27452819,27452819,27453093,0,0,0,274
32907,27452819,27452819,27453093,0,0,0,274
32908,27452819,27452819,27453093,0,0,0,274
32891,27452815,27452815,27453098,0,0,0,283
32892,27452815,27452815,27453098,0,0,0,283
32909,27452819,27452819,27453104,0,0,0,285
32928,27453823,27453823,27454029,0,0,0,206
32929,27453823,27453823,27454029,0,0,0,206
32930,27453823,27453823,27454040,0,0,0,217
32931,27453823,27453823,27454040,0,0,0,217
32932,27453823,27453823,27454051,0,0,0,228
32937,27454074,27454074,27454166,0,0,0,92
32938,27454076,27454076,27454190,0,0,0,114
32939,27454076,27454076,27454190,0,0,0,114
32940,27454076,27454076,27454190,0,0,0,114
32941,27454076,27454076,27454190,0,0,0,114
32935,27454074,27454074,27454258,0,0,0,184
32936,27454074,27454074,27454258,0,0,0,184
32910,27453820,27453820,27454262,0,0,0,442
32911,27453820,27453820,27454262,0,0,0,442
32912,27453820,27453820,27454262,0,0,0,442
32913,27453820,27453820,27454262,0,0,0,442
32914,27453821,27453821,27454263,0,0,0,442
32915,27453821,27453821,27454263,0,0,0,442
32916,27453821,27453821,27454263,0,0,0,442
32917,27453821,27453821,27454263,0,0,0,442
32918,27453821,27453821,27454263,0,0,0,442
32919,27453821,27453821,27454263,0,0,0,442
32920,27453822,27453822,27454264,0,0,0,442
32921,27453822,27453822,27454264,0,0,0,442
32922,27453822,27453822,27454264,0,0,0,442
32923,27453822,27453822,27454264,0,0,0,442
32924,27453822,27453822,27454264,0,0,0,442
32925,27453822,27453822,27454264,0,0,0,442
32926,27453822,27453822,27454264,0,0,0,442
32927,27453823,27453823,27454265,0,0,0,442
32933,27454071,27454071,27454299,0,0,0,228
32934,27454071,27454071,27454299,0,0,0,228
32961,27454320,27454320,27454526,0,0,0,206
32990,27454581,27454581,27454663,0,0,0,82
32991,27454581,27454581,27454663,0,0,0,82
32976,27454578,27454578,27454675,0,0,0,97
32979,27454579,27454579,27454676,0,0,0,97
32985,27454580,27454580,27454704,0,0,0,124
32986,27454580,27454580,27454704,0,0,0,124
32962,27454574,27454574,27454753,0,0,0,179
32963,27454574,27454574,27454753,0,0,0,179
32969,27454576,27454576,27454755,0,0,0,179
32942,27454317,27454317,27454760,0,0,0,443
32943,27454317,27454317,27454760,0,0,0,443
32944,27454317,27454317,27454760,0,0,0,443
32945,27454318,27454318,27454761,0,0,0,443
32946,27454318,27454318,27454761,0,0,0,443
32947,27454318,27454318,27454761,0,0,0,443
32948,27454318,27454318,27454761,0,0,0,443
32949,27454318,27454318,27454761,0,0,0,443
32950,27454318,27454318,27454761,0,0,0,443
32951,27454319,27454319,27454762,0,0,0,443
32952,27454319,27454319,27454762,0,0,0,443
32953,27454319,27454319,27454762,0,0,0,443
32954,27454319,27454319,27454762,0,0,0,443
32955,27454319,27454319,27454762,0,0,0,443
32956,27454319,27454319,27454762,0,0,0,443
32957,27454320,27454320,27454763,0,0,0,443
32958,27454320,27454320,27454763,0,0,0,443
32959,27454320,27454320,27454763,0,0,0,443
32960,27454320,27454320,27454763,0,0,0,443
32975,27454577,27454577,27454778,0,0,0,201
32977,27454578,27454578,27454779,0,0,0,201
32964,27454574,27454574,27454780,0,0,0,206
32994,27454581,27454581,27454784,0,0,0,203
32978,27454578,27454578,27454790,0,0,0,212
32965,27454575,27454575,27454792,0,0,0,217
32980,27454579,27454579,27454802,0,0,0,223
32981,27454579,27454579,27454802,0,0,0,223
32982,27454579,27454579,27454802,0,0,0,223
32966,27454575,27454575,27454803,0,0,0,228
32983,27454579,27454579,27454813,0,0,0,234
32967,27454575,27454575,27454814,0,0,0,239
32968,27454575,27454575,27454814,0,0,0,239
32970,27454576,27454576,27454815,0,0,0,239
32984,27454579,27454579,27454824,0,0,0,245
32971,27454576,27454576,27454826,0,0,0,250
32972,27454577,27454577,27454827,0,0,0,250
32973,27454577,27454577,27454827,0,0,0,250
32987,27454580,27454580,27454836,0,0,0,256
32974,27454577,27454577,27454838,0,0,0,261
32988,27454580,27454580,27454847,0,0,0,267
32989,27454580,27454580,27454847,0,0,0,267
32992,27454581,27454581,27454859,0,0,0,278
32993,27454581,27454581,27454859,0,0,0,278
33010,27455300,27455300,27455496,0,0,0,196
33011,27455300,27455300,27455508,0,0,0,208
33012,27455300,27455300,27455508,0,0,0,208
33013,27455300,27455300,27455519,0,0,0,219
33040,27455555,27455555,27455708,0,0,0,153
33025,27455552,27455552,27455749,0,0,0,197
32995,27455297,27455297,27455751,0,0,0,454
32996,27455297,27455297,27455751,0,0,0,454
32997,27455297,27455297,27455751,0,0,0,454
32998,27455298,27455298,27455752,0,0,0,454
32999,27455298,27455298,27455752,0,0,0,454
33000,27455298,27455298,27455752,0,0,0,454
33001,27455298,27455298,27455752,0,0,0,454
33002,27455298,27455298,27455752,0,0,0,454
33003,27455298,27455298,27455752,0,0,0,454
33004,27455299,27455299,27455753,0,0,0,454
33005,27455299,27455299,27455753,0,0,0,454
33006,27455299,27455299,27455753,0,0,0,454
33007,27455299,27455299,27455753,0,0,0,454
33008,27455300,27455300,27455754,0,0,0,454
33009,27455300,27455300,27455754,0,0,0,454
33026,27455552,27455552,27455760,0,0,0,208
33027,27455552,27455552,27455760,0,0,0,208
33014,27455548,27455548,27455767,0,0,0,219
33028,27455552,27455552,27455771,0,0,0,219
33029,27455553,27455553,27455772,0,0,0,219
33015,27455549,27455549,27455779,0,0,0,230
33016,27455549,27455549,27455779,0,0,0,230
33017,27455549,27455549,27455779,0,0,0,230
33030,27455553,27455553,27455783,0,0,0,230
33031,27455553,27455553,27455783,0,0,0,230
33018,27455550,27455550,27455791,0,0,0,241
33019,27455550,27455550,27455791,0,0,0,241
33032,27455553,27455553,27455794,0,0,0,241
33033,27455553,27455553,27455794,0,0,0,241
33034,27455554,27455554,27455795,0,0,0,241
33020,27455550,27455550,27455802,0,0,0,252
33021,27455550,27455550,27455802,0,0,0,252
33035,27455554,27455554,27455806,0,0,0,252
33036,27455554,27455554,27455806,0,0,0,252
33037,27455554,27455554,27455806,0,0,0,252
33022,27455551,27455551,27455814,0,0,0,263
33038,27455554,27455554,27455817,0,0,0,263
33039,27455554,27455554,27455817,0,0,0,263
33023,27455551,27455551,27455825,0,0,0,274
33024,27455551,27455551,27455825,0,0,0,274
33041,27455555,27455555,27455829,0,0,0,274
33042,27455555,27455555,27455840,0,0,0,285
33043,27455555,27455555,27455840,0,0,0,285
32763,27436882,27436882,27456090,0,0,0,19208
33060,27456535,27456535,27456736,0,0,0,201
33061,27456535,27456535,27456736,0,0,0,201
33062,27456535,27456535,27456747,0,0,0,212
33063,27456535,27456535,27456747,0,0,0,212
33064,27456536,27456536,27456759,0,0,0,223
33065,27456536,27456536,27456770,0,0,0,234
33066,27456536,27456536,27456770,0,0,0,234
33044,27456531,27456531,27456877,0,0,0,346
33045,27456531,27456531,27456877,0,0,0,346
33046,27456532,27456532,27456878,0,0,0,346
33047,27456532,27456532,27456878,0,0,0,346
33048,27456533,27456533,27456879,0,0,0,346
33049,27456533,27456533,27456879,0,0,0,346
33050,27456533,27456533,27456879,0,0,0,346
33051,27456533,27456533,27456879,0,0,0,346
33052,27456533,27456533,27456879,0,0,0,346
33053,27456534,27456534,27456880,0,0,0,346
33054,27456534,27456534,27456880,0,0,0,346
33055,27456534,27456534,27456880,0,0,0,346
33056,27456534,27456534,27456880,0,0,0,346
33057,27456534,27456534,27456880,0,0,0,346
33058,27456534,27456534,27456880,0,0,0,346
33059,27456535,27456535,27456881,0,0,0,346
33100,27457087,27457087,27457189,0,0,0,102
33101,27457087,27457087,27457189,0,0,0,102
33102,27457087,27457087,27457201,0,0,0,114
33103,27457087,27457087,27457201,0,0,0,114
33093,27457086,27457086,27457236,0,0,0,150
33094,27457086,27457086,27457236,0,0,0,150
33082,27457084,27457084,27457289,0,0,0,205
33083,27457084,27457084,27457289,0,0,0,205
33084,27457084,27457084,27457289,0,0,0,205
33085,27457084,27457084,27457289,0,0,0,205
33086,27457084,27457084,27457289,0,0,0,205
33087,27457084,27457084,27457289,0,0,0,205
33088,27457085,27457085,27457290,0,0,0,205
33089,27457085,27457085,27457290,0,0,0,205
33090,27457085,27457085,27457290,0,0,0,205
33091,27457085,27457085,27457290,0,0,0,205
33095,27457086,27457086,27457291,0,0,0,205
33096,27457086,27457086,27457291,0,0,0,205
33097,27457086,27457086,27457291,0,0,0,205
33098,27457087,27457087,27457292,0,0,0,205
33099,27457087,27457087,27457292,0,0,0,205
33092,27457085,27457085,27457302,0,0,0,217
33104,27457251,27457251,27457353,0,0,0,102
33105,27457251,27457251,27457353,0,0,0,102
33106,27457251,27457251,27457365,0,0,0,114
33067,27457081,27457081,27457405,0,0,0,324
33068,27457081,27457081,27457405,0,0,0,324
33069,27457081,27457081,27457405,0,0,0,324
33070,27457082,27457082,27457406,0,0,0,324
33071,27457082,27457082,27457406,0,0,0,324
33072,27457082,27457082,27457406,0,0,0,324
33073,27457082,27457082,27457406,0,0,0,324
33074,27457082,27457082,27457406,0,0,0,324
33075,27457082,27457082,27457406,0,0,0,324
33076,27457083,27457083,27457418,0,0,0,335
33077,27457083,27457083,27457418,0,0,0,335
33078,27457083,27457083,27457418,0,0,0,335
33079,27457083,27457083,27457429,0,0,0,346
33080,27457083,27457083,27457440,0,0,0,357
33081,27457083,27457083,27457440,0,0,0,357
33114,27457819,27457819,27458003,0,0,0,184
33115,27457820,27457820,27458004,0,0,0,184
33116,27457820,27457820,27458004,0,0,0,184
33117,27457820,27457820,27458004,0,0,0,184
33118,27457820,27457820,27458004,0,0,0,184
33119,27457821,27457821,27458005,0,0,0,184
33120,27457821,27457821,27458005,0,0,0,184
33121,27457821,27457821,27458005,0,0,0,184
33122,27457822,27457822,27458006,0,0,0,184
33123,27457822,27457822,27458006,0,0,0,184
33124,27457822,27457822,27458006,0,0,0,184
33125,27457822,27457822,27458006,0,0,0,184
33126,27457823,27457823,27458007,0,0,0,184
33127,27457823,27457823,27458007,0,0,0,184
33128,27457823,27457823,27458007,0,0,0,184
33129,27457823,27457823,27458007,0,0,0,184
33130,27457824,27457824,27458008,0,0,0,184
33131,27457824,27457824,27458008,0,0,0,184
33132,27457824,27457824,27458008,0,0,0,184
33133,27457824,27457824,27458008,0,0,0,184
33134,27457824,27457824,27458008,0,0,0,184
33135,27457824,27457824,27458008,0,0,0,184
33136,27457825,27457825,27458009,0,0,0,184
33137,27457825,27457825,27458009,0,0,0,184
33138,27457825,27457825,27458009,0,0,0,184
33139,27457825,27457825,27458009,0,0,0,184
33140,27457825,27457825,27458009,0,0,0,184
33107,27457566,27457566,27458013,0,0,0,447
33108,27457566,27457566,27458013,0,0,0,447
33109,27457566,27457566,27458013,0,0,0,447
33110,27457566,27457566,27458013,0,0,0,447
33111,27457566,27457566,27458013,0,0,0,447
33112,27457566,27457566,27458013,0,0,0,447
33113,27457566,27457566,27458013,0,0,0,447
33141,27457825,27457825,27458021,0,0,0,196
33142,27457826,27457826,27458022,0,0,0,196
33143,27457826,27457826,27458033,0,0,0,207
33144,27457826,27457826,27458033,0,0,0,207
33145,27457826,27457826,27458044,0,0,0,218
33146,27457826,27457826,27458044,0,0,0,218
33147,27457826,27457826,27458044,0,0,0,218
33154,27460885,27460885,27461114,0,0,0,229
33155,27460886,27460886,27461115,0,0,0,229
33156,27460886,27460886,27461115,0,0,0,229
33157,27460886,27460886,27461115,0,0,0,229
33158,27460886,27460886,27461115,0,0,0,229
33159,27460887,27460887,27461116,0,0,0,229
33160,27460887,27460887,27461116,0,0,0,229
33161,27460887,27460887,27461116,0,0,0,229
33162,27460887,27460887,27461116,0,0,0,229
33163,27460888,27460888,27461117,0,0,0,229
33164,27460888,27460888,27461117,0,0,0,229
33165,27460888,27460888,27461117,0,0,0,229
33166,27460888,27460888,27461117,0,0,0,229
33167,27460889,27460889,27461118,0,0,0,229
33168,27460889,27460889,27461118,0,0,0,229
33169,27460889,27460889,27461118,0,0,0,229
33170,27460889,27460889,27461118,0,0,0,229
33171,27460890,27460890,27461119,0,0,0,229
33172,27460890,27460890,27461119,0,0,0,229
33173,27460890,27460890,27461119,0,0,0,229
33174,27460890,27460890,27461119,0,0,0,229
33175,27460890,27460890,27461119,0,0,0,229
33176,27460891,27460891,27461120,0,0,0,229
33177,27460891,27460891,27461120,0,0,0,229
33178,27460891,27460891,27461120,0,0,0,229
33179,27460891,27460891,27461120,0,0,0,229
33180,27460891,27460891,27461120,0,0,0,229
33181,27460891,27460891,27461120,0,0,0,229
33182,27460892,27460892,27461121,0,0,0,229
33183,27460892,27460892,27461121,0,0,0,229
33184,27460892,27460892,27461121,0,0,0,229
33185,27460892,27460892,27461121,0,0,0,229
33186,27460892,27460892,27461121,0,0,0,229
33187,27460892,27460892,27461121,0,0,0,229
33188,27460893,27460893,27461122,0,0,0,229
33189,27460893,27460893,27461122,0,0,0,229
33148,27460677,27460677,27461124,0,0,0,447
33149,27460677,27460677,27461124,0,0,0,447
33150,27460677,27460677,27461124,0,0,0,447
33151,27460677,27460677,27461124,0,0,0,447
33152,27460677,27460677,27461124,0,0,0,447
33153,27460677,27460677,27461124,0,0,0,447
33190,27460893,27460893,27461134,0,0,0,241
33191,27460893,27460893,27461134,0,0,0,241
33192,27460893,27460893,27461145,0,0,0,252
33193,27460893,27460893,27461145,0,0,0,252
33194,27460893,27460893,27461156,0,0,0,263
33195,27460894,27460894,27461157,0,0,0,263
33196,27460894,27460894,27461168,0,0,0,274
33197,27462029,27462029,27462151,0,0,0,122
33198,27462029,27462029,27462151,0,0,0,122
33199,27462029,27462029,27462151,0,0,0,122
33200,27462029,27462029,27462151,0,0,0,122
33201,27462030,27462030,27462152,0,0,0,122
33202,27462030,27462030,27462168,0,0,0,138
33203,27462030,27462030,27462168,0,0,0,138
33204,27462030,27462030,27462168,0,0,0,138
33205,27462030,27462030,27462168,0,0,0,138
33206,27462030,27462030,27462168,0,0,0,138
33207,27462031,27462031,27462169,0,0,0,138
33208,27462031,27462031,27462169,0,0,0,138
33209,27462031,27462031,27462169,0,0,0,138
33210,27462031,27462031,27462169,0,0,0,138
33211,27462031,27462031,27462169,0,0,0,138
33212,27462031,27462031,27462169,0,0,0,138
33213,27462032,27462032,27462170,0,0,0,138
33214,27462032,27462032,27462170,0,0,0,138
33215,27462032,27462032,27462170,0,0,0,138
33216,27462032,27462032,27462170,0,0,0,138
33217,27462032,27462032,27462170,0,0,0,138
33218,27462032,27462032,27462196,0,0,0,164
33235,27462327,27462327,27462523,0,0,0,196
33236,27462327,27462327,27462523,0,0,0,196
33237,27462327,27462327,27462535,0,0,0,208
33238,27462327,27462327,27462546,0,0,0,219
33239,27462327,27462327,27462546,0,0,0,219
33240,27462327,27462327,27462557,0,0,0,230
33257,27462580,27462580,27462683,0,0,0,103
33258,27462580,27462580,27462683,0,0,0,103
33219,27462324,27462324,27462778,0,0,0,454
33220,27462324,27462324,27462778,0,0,0,454
33221,27462324,27462324,27462778,0,0,0,454
33222,27462324,27462324,27462778,0,0,0,454
33223,27462325,27462325,27462779,0,0,0,454
33224,27462325,27462325,27462779,0,0,0,454
33225,27462325,27462325,27462779,0,0,0,454
33226,27462325,27462325,27462779,0,0,0,454
33227,27462325,27462325,27462779,0,0,0,454
33228,27462325,27462325,27462779,0,0,0,454
33229,27462326,27462326,27462780,0,0,0,454
33230,27462326,27462326,27462780,0,0,0,454
33231,27462326,27462326,27462780,0,0,0,454
33232,27462326,27462326,27462780,0,0,0,454
33233,27462326,27462326,27462780,0,0,0,454
33234,27462326,27462326,27462780,0,0,0,454
33251,27462578,27462578,27462781,0,0,0,203
33252,27462578,27462578,27462792,0,0,0,214
33253,27462579,27462579,27462793,0,0,0,214
33254,27462579,27462579,27462793,0,0,0,214
33255,27462579,27462579,27462793,0,0,0,214
33256,27462579,27462579,27462804,0,0,0,225
33259,27462580,27462580,27462805,0,0,0,225
33241,27462575,27462575,27462816,0,0,0,241
33242,27462576,27462576,27462817,0,0,0,241
33243,27462576,27462576,27462817,0,0,0,241
33244,27462576,27462576,27462828,0,0,0,252
33245,27462577,27462577,27462829,0,0,0,252
33246,27462577,27462577,27462829,0,0,0,252
33260,27462580,27462580,27462838,0,0,0,258
33261,27462581,27462581,27462839,0,0,0,258
33262,27462581,27462581,27462839,0,0,0,258
33247,27462577,27462577,27462840,0,0,0,263
33249,27462578,27462578,27462841,0,0,0,263
33250,27462578,27462578,27462841,0,0,0,263
33263,27462581,27462581,27462850,0,0,0,269
33264,27462581,27462581,27462850,0,0,0,269
33265,27462581,27462581,27462850,0,0,0,269
33248,27462577,27462577,27462851,0,0,0,274
33266,27462582,27462582,27462862,0,0,0,280
33285,27462974,27462974,27463181,0,0,0,207
33286,27462974,27462974,27463192,0,0,0,218
33287,27462974,27462974,27463203,0,0,0,229
33301,27463227,27463227,27463335,0,0,0,108
33302,27463227,27463227,27463335,0,0,0,108
33305,27463228,27463228,27463336,0,0,0,108
33310,27463229,27463229,27463360,0,0,0,131
33311,27463229,27463229,27463360,0,0,0,131
33315,27463230,27463230,27463383,0,0,0,153
33288,27463223,27463223,27463418,0,0,0,195
33294,27463225,27463225,27463420,0,0,0,195
33295,27463225,27463225,27463420,0,0,0,195
33298,27463226,27463226,27463423,0,0,0,197
33267,27462971,27462971,27463425,0,0,0,454
33268,27462971,27462971,27463425,0,0,0,454
33269,27462971,27462971,27463425,0,0,0,454
33270,27462971,27462971,27463425,0,0,0,454
33271,27462971,27462971,27463425,0,0,0,454
33272,27462972,27462972,27463426,0,0,0,454
33273,27462972,27462972,27463426,0,0,0,454
33274,27462972,27462972,27463426,0,0,0,454
33275,27462972,27462972,27463426,0,0,0,454
33276,27462972,27462972,27463426,0,0,0,454
33277,27462972,27462972,27463426,0,0,0,454
33278,27462973,27462973,27463427,0,0,0,454
33279,27462973,27462973,27463427,0,0,0,454
33280,27462973,27462973,27463427,0,0,0,454
33281,27462973,27462973,27463427,0,0,0,454
33282,27462974,27462974,27463428,0,0,0,454
33283,27462974,27462974,27463428,0,0,0,454
33299,27463226,27463226,27463434,0,0,0,208
33300,27463226,27463226,27463434,0,0,0,208
33284,27462974,27462974,27463440,0,0,0,466
33303,27463227,27463227,27463446,0,0,0,219
33289,27463223,27463223,27463452,0,0,0,229
33304,27463227,27463227,27463457,0,0,0,230
33290,27463224,27463224,27463464,0,0,0,240
33306,27463228,27463228,27463469,0,0,0,241
33291,27463224,27463224,27463475,0,0,0,251
33292,27463224,27463224,27463475,0,0,0,251
33293,27463224,27463224,27463475,0,0,0,251
33307,27463228,27463228,27463480,0,0,0,252
33308,27463228,27463228,27463480,0,0,0,252
33309,27463228,27463228,27463480,0,0,0,252
33296,27463225,27463225,27463487,0,0,0,262
33297,27463226,27463226,27463499,0,0,0,273
33312,27463229,27463229,27463503,0,0,0,274
33313,27463229,27463229,27463514,0,0,0,285
33314,27463229,27463229,27463514,0,0,0,285
33316,27463230,27463230,27463515,0,0,0,285
33349,27463863,27463863,27463955,0,0,0,92
33350,27463863,27463863,27463955,0,0,0,92
33355,27463864,27463864,27463956,0,0,0,92
33356,27463864,27463864,27463956,0,0,0,92
33357,27463864,27463864,27463956,0,0,0,92
33351,27463863,27463863,27463977,0,0,0,114
33352,27463863,27463863,27463977,0,0,0,114
33358,27463864,27463864,27463978,0,0,0,114
33359,27463864,27463864,27463978,0,0,0,114
33360,27463864,27463864,27463989,0,0,0,125
33367,27464003,27464003,27464058,0,0,0,55
33368,27464003,27464003,27464069,0,0,0,66
33353,27463863,27463863,27464102,0,0,0,239
33361,27464001,27464001,27464115,0,0,0,114
33362,27464002,27464002,27464116,0,0,0,114
33363,27464002,27464002,27464116,0,0,0,114
33364,27464002,27464002,27464127,0,0,0,125
33365,27464002,27464002,27464127,0,0,0,125
33366,27464003,27464003,27464139,0,0,0,136
33317,27463857,27463857,27464188,0,0,0,331
33318,27463857,27463857,27464188,0,0,0,331
33319,27463857,27463857,27464188,0,0,0,331
33320,27463857,27463857,27464188,0,0,0,331
33321,27463858,27463858,27464189,0,0,0,331
33322,27463858,27463858,27464189,0,0,0,331
33323,27463858,27463858,27464189,0,0,0,331
33324,27463858,27463858,27464189,0,0,0,331
33325,27463859,27463859,27464190,0,0,0,331
33326,27463859,27463859,27464190,0,0,0,331
33327,27463859,27463859,27464190,0,0,0,331
33328,27463859,27463859,27464190,0,0,0,331
33329,27463859,27463859,27464190,0,0,0,331
33330,27463860,27463860,27464191,0,0,0,331
33331,27463860,27463860,27464191,0,0,0,331
33332,27463860,27463860,27464191,0,0,0,331
33333,27463860,27463860,27464191,0,0,0,331
33334,27463860,27463860,27464213,0,0,0,353
32768,27448016,27448016,27464226,0,0,0,16210
33335,27463860,27463860,27464460,0,0,0,600
33336,27463861,27463861,27464461,0,0,0,600
33337,27463861,27463861,27464461,0,0,0,600
33338,27463861,27463861,27464461,0,0,0,600
33339,27463861,27463861,27464461,0,0,0,600
33340,27463861,27463861,27464461,0,0,0,600
33341,27463861,27463861,27464461,0,0,0,600
33342,27463862,27463862,27464462,0,0,0,600
33343,27463862,27463862,27464462,0,0,0,600
33344,27463862,27463862,27464462,0,0,0,600
33345,27463862,27463862,27464462,0,0,0,600
33346,27463862,27463862,27464462,0,0,0,600
33347,27463862,27463862,27464462,0,0,0,600
33348,27463862,27463862,27464462,0,0,0,600
33354,27463863,27463863,27464463,0,0,0,600
33389,27464686,27464686,27464893,0,0,0,207
33390,27464686,27464686,27464893,0,0,0,207
33391,27464686,27464686,27464904,0,0,0,218
33392,27464687,27464687,27464905,0,0,0,218
33393,27464687,27464687,27464916,0,0,0,229
33394,27464687,27464687,27464916,0,0,0,229
33395,27464687,27464687,27464916,0,0,0,229
33396,27464687,27464687,27464916,0,0,0,229
33397,27464687,27464687,27464927,0,0,0,240
33398,27464687,27464687,27464938,0,0,0,251
33411,27464914,27464914,27465045,0,0,0,131
33370,27464683,27464683,27465096,0,0,0,413
33371,27464683,27464683,27465096,0,0,0,413
33372,27464683,27464683,27465096,0,0,0,413
33373,27464683,27464683,27465096,0,0,0,413
33374,27464684,27464684,27465097,0,0,0,413
33375,27464684,27464684,27465097,0,0,0,413
33376,27464684,27464684,27465097,0,0,0,413
33377,27464684,27464684,27465097,0,0,0,413
33378,27464684,27464684,27465097,0,0,0,413
33379,27464684,27464684,27465097,0,0,0,413
33380,27464685,27464685,27465098,0,0,0,413
33381,27464685,27464685,27465098,0,0,0,413
33382,27464685,27464685,27465098,0,0,0,413
33383,27464685,27464685,27465098,0,0,0,413
33384,27464685,27464685,27465098,0,0,0,413
33385,27464685,27464685,27465098,0,0,0,413
33386,27464686,27464686,27465099,0,0,0,413
33387,27464686,27464686,27465099,0,0,0,413
33388,27464686,27464686,27465099,0,0,0,413
33420,27464916,27464916,27465108,0,0,0,192
33421,27464916,27464916,27465119,0,0,0,203
33404,27464912,27464912,27465120,0,0,0,208
33405,27464912,27464912,27465120,0,0,0,208
33406,27464912,27464912,27465120,0,0,0,208
33422,27464916,27464916,27465130,0,0,0,214
33407,27464913,27464913,27465132,0,0,0,219
33408,27464913,27464913,27465132,0,0,0,219
33409,27464913,27464913,27465143,0,0,0,230
33410,27464913,27464913,27465143,0,0,0,230
33412,27464914,27464914,27465155,0,0,0,241
33399,27464910,27464910,27465161,0,0,0,251
33413,27464914,27464914,27465166,0,0,0,252
33414,27464915,27464915,27465167,0,0,0,252
33415,27464915,27464915,27465167,0,0,0,252
33400,27464911,27464911,27465173,0,0,0,262
33401,27464911,27464911,27465173,0,0,0,262
33402,27464911,27464911,27465173,0,0,0,262
33403,27464912,27464912,27465174,0,0,0,262
33416,27464915,27464915,27465178,0,0,0,263
33417,27464915,27464915,27465178,0,0,0,263
33418,27464915,27464915,27465189,0,0,0,274
33419,27464916,27464916,27465190,0,0,0,274
32267,27356817,27361129,27466110,0,0,4312,109293
33447,27466666,27466666,27466782,0,0,0,116
33433,27466663,27466663,27466843,0,0,0,180
33430,27466662,27466662,27466864,0,0,0,202
33448,27466666,27466666,27466870,0,0,0,204
33449,27466666,27466666,27466870,0,0,0,204
33431,27466662,27466662,27466875,0,0,0,213
33432,27466662,27466662,27466875,0,0,0,213
33450,27466666,27466666,27466881,0,0,0,215
33434,27466663,27466663,27466887,0,0,0,224
33451,27466666,27466666,27466892,0,0,0,226
33452,27466667,27466667,27466893,0,0,0,226
33435,27466663,27466663,27466898,0,0,0,235
33453,27466667,27466667,27466904,0,0,0,237
33454,27466667,27466667,27466904,0,0,0,237
33436,27466664,27466664,27466910,0,0,0,246
33437,27466664,27466664,27466910,0,0,0,246
33455,27466667,27466667,27466915,0,0,0,248
33456,27466667,27466667,27466915,0,0,0,248
33438,27466664,27466664,27466921,0,0,0,257
33439,27466664,27466664,27466921,0,0,0,257
33440,27466664,27466664,27466932,0,0,0,268
33441,27466664,27466664,27466932,0,0,0,268
33442,27466665,27466665,27466933,0,0,0,268
33443,27466665,27466665,27466944,0,0,0,279
33444,27466665,27466665,27466955,0,0,0,290
33445,27466665,27466665,27466955,0,0,0,290
33446,27466665,27466665,27466955,0,0,0,290
33423,27466658,27466658,27466956,0,0,0,298
33424,27466659,27466659,27466957,0,0,0,298
33425,27466659,27466659,27466957,0,0,0,298
33426,27466660,27466660,27466958,0,0,0,298
33427,27466661,27466661,27466959,0,0,0,298
33428,27466662,27466662,27466960,0,0,0,298
33429,27466662,27466662,27466971,0,0,0,309
33457,27466775,27466775,27467023,0,0,0,248
33458,27466775,27466775,27467034,0,0,0,259
32016,27265082,27265082,27479708,0,0,0,214626
33369,27464185,27464185,27480228,0,0,0,16043
33459,27480194,27480194,27496154,0,0,0,15960
32230,27345723,27345723,27497814,0,0,0,152091
33461,27497724,27497724,27498671,0,0,0,947
32210,27343958,27343958,27502358,0,0,0,158400
32211,27344014,27344014,27502414,0,0,0,158400
33460,27496112,27496112,27512110,0,0,0,15998
32203,27343615,27343615,27516415,0,0,0,172800
32204,27343657,27343657,27516457,0,0,0,172800
32205,27343721,27343721,27516521,0,0,0,172800
32207,27343754,27343754,27516554,0,0,0,172800
32208,27343833,27343833,27516633,0,0,0,172800
32226,27345528,27345528,27518328,0,0,0,172800
32227,27345566,27345566,27518366,0,0,0,172800
32228,27345621,27345621,27518421,0,0,0,172800
32229,27345676,27345676,27518476,0,0,0,172800
32752,27430976,27430976,27520152,0,0,0,89176
31980,27262458,27262466,27521666,0,0,8,259208
31981,27262458,27262466,27521666,0,0,8,259208
31982,27262458,27262466,27521666,0,0,8,259208
31983,27262473,27262473,27521673,0,0,0,259200
31935,27243875,27263289,27522489,0,0,19414,278614
33465,27522286,27522286,27523116,0,0,0,830
33463,27512067,27512067,27527979,0,0,0,15912
32237,27349618,27355363,27528163,0,0,5745,178545
32071,27269516,27269516,27528716,0,0,0,259200
30806,27111570,27231769,27529548,0,0,120199,417978
32086,27273075,27273075,27532275,0,0,0,259200
32759,27435264,27435264,27541075,0,0,0,105811
33470,27527219,27527219,27543394,0,0,0,16175
33471,27527937,27527937,27543788,0,0,0,15851
32761,27435293,27435293,27551081,0,0,0,115788
32760,27435286,27435286,27551094,0,0,0,115808
32762,27435301,27435301,27551105,0,0,0,115804
32766,27447233,27447233,27554174,0,0,0,106941
32767,27447263,27447263,27554388,0,0,0,107125
33476,27558209,27558209,27558416,0,0,0,207
33477,27558216,27558216,27558429,0,0,0,213
33474,27543350,27543350,27559413,0,0,0,16063
33475,27543785,27543785,27559640,0,0,0,15855
33478,27558444,27558444,27560623,0,0,0,2179
33479,27558464,27558464,27560702,0,0,0,2238
33480,27559366,27559366,27575237,0,0,0,15871
33481,27559597,27559597,27575588,0,0,0,15991
33482,27575203,27575203,27591201,0,0,0,15998
32164,27334566,27334566,27593766,0,0,0,259200
32165,27334581,27334581,27593781,0,0,0,259200
32166,27334587,27334587,27593787,0,0,0,259200
32167,27334599,27334599,27593799,0,0,0,259200
32168,27334606,27334606,27593806,0,0,0,259200
32169,27334614,27334614,27593814,0,0,0,259200
32170,27334619,27334619,27593819,0,0,0,259200
32171,27334625,27334625,27593825,0,0,0,259200
33464,27520117,27520117,27605728,0,0,0,85611
33462,27499075,27499075,27606794,0,0,0,107719
33486,27591157,27591157,27607103,0,0,0,15946
33490,27622954,27622954,27623038,0,0,0,84
33489,27607061,27607061,27623205,0,0,0,16144
32172,27334631,27370578,27629778,0,0,35947,295147
33493,27630525,27630525,27630589,0,0,0,64
33494,27632159,27632159,27632233,0,0,0,74
33495,27632529,27632529,27633153,0,0,0,624
33496,27633298,27633298,27633935,0,0,0,637
33492,27624275,27624275,27634447,0,0,0,10172
33497,27633888,27633888,27634515,0,0,0,627
33498,27634475,27634475,27635124,0,0,0,649
33499,27635076,27635076,27635371,0,0,0,295
33501,27635734,27635734,27636397,0,0,0,663
33487,27601778,27601778,27637778,0,0,0,36000
33491,27623165,27623165,27639365,0,0,0,16200
32173,27334644,27380304,27639504,0,0,45660,304860
33500,27635104,27635104,27644825,0,0,0,9721
33503,27639333,27639333,27655596,0,0,0,16263
33504,27655554,27655554,27671823,0,0,0,16269
33507,27682097,27682097,27682460,0,0,0,363
33508,27683024,27683024,27683657,0,0,0,633
33509,27683803,27683803,27683848,0,0,0,45
33505,27671781,27671781,27688161,0,0,0,16380
33522,27688295,27688295,27688941,0,0,0,646
33484,27590981,27590981,27689493,0,0,0,98512
33523,27688891,27688891,27689537,0,0,0,646
33524,27689626,27689626,27690274,0,0,0,648
33488,27605683,27605683,27690788,0,0,0,85105
33525,27690231,27690231,27690877,0,0,0,646
33510,27683812,27683812,27691057,0,0,0,7245
33512,27683882,27683882,27691070,0,0,0,7188
33511,27683871,27683871,27691076,0,0,0,7205
33513,27683893,27683893,27691076,0,0,0,7183
33516,27683930,27683930,27691076,0,0,0,7146
33517,27683935,27683935,27691081,0,0,0,7146
33518,27683951,27683951,27691087,0,0,0,7136
33520,27683972,27683972,27691087,0,0,0,7115
33515,27683914,27683914,27691109,0,0,0,7195
33519,27683955,27683955,27691113,0,0,0,7158
33514,27683901,27683901,27691128,0,0,0,7227
33529,27691194,27691194,27693327,0,0,0,2133
33527,27691130,27691130,27693409,0,0,0,2279
33532,27691251,27691251,27693468,0,0,0,2217
33535,27691299,27691299,27693521,0,0,0,2222
33528,27691168,27691168,27693525,0,0,0,2357
33531,27691235,27691235,27693543,0,0,0,2308
33533,27691268,27691268,27693567,0,0,0,2299
33534,27691283,27691283,27693577,0,0,0,2294
33530,27691215,27691215,27693584,0,0,0,2369
33536,27691317,27691317,27693632,0,0,0,2315
33537,27691339,27691339,27697929,0,0,0,6590
33539,27697271,27697271,27702575,0,0,0,5304
33521,27688127,27688127,27704482,0,0,0,16355
33543,27705074,27705074,27705480,0,0,0,406
33538,27697253,27697253,27705820,0,0,0,8567
33544,27705433,27705433,27705832,0,0,0,399
33485,27591082,27591082,27706845,0,0,0,115763
33541,27697841,27697841,27708052,0,0,0,10211
33540,27697835,27697835,27708973,0,0,0,11138
33542,27704439,27704439,27720801,0,0,0,16362
33545,27720761,27720761,27737022,0,0,0,16261
33546,27736980,27736980,27753344,0,0,0,16364
33502,27638901,27638901,27754651,0,0,0,115750
33548,27761031,27761031,27762334,0,0,0,1303
33549,27763089,27763089,27763689,0,0,0,600
33551,27765614,27765614,27765710,0,0,0,96
33552,27765693,27765693,27765813,0,0,0,120
33554,27766493,27766493,27766613,0,0,0,120
33556,27768031,27768031,27768092,0,0,0,61
33557,27768071,27768071,27768140,0,0,0,69
33555,27766600,27766600,27768400,0,0,0,1800
33547,27753303,27753303,27769663,0,0,0,16360
33560,27770668,27770668,27770876,0,0,0,208
33561,27770908,27770908,27771048,0,0,0,140
33506,27674371,27674371,27771174,0,0,0,96803
33562,27771095,27771095,27772206,0,0,0,1111
33563,27772313,27772313,27772502,0,0,0,189
33567,27772622,27772622,27772758,0,0,0,136
33571,27773216,27773216,27773362,0,0,0,146
33572,27773220,27773220,27773377,0,0,0,157
33574,27773228,27773228,27773498,0,0,0,270
33570,27773199,27773199,27773529,0,0,0,330
33573,27773224,27773224,27773605,0,0,0,381
33569,27773193,27773193,27773652,0,0,0,459
33568,27773189,27773189,27773958,0,0,0,769
33576,27774851,27774851,27775585,0,0,0,734
33575,27773669,27773669,27776189,0,0,0,2520
33526,27690751,27690751,27776366,0,0,0,85615
33581,27776534,27776534,27776634,0,0,0,100
33582,27776624,27776624,27776700,0,0,0,76
33577,27775716,27775716,27777005,0,0,0,1289
33580,27776531,27776531,27777471,0,0,0,940
33579,27776491,27776491,27778261,0,0,0,1770
33583,27777066,27777066,27778866,0,0,0,1800
33584,27778265,27778265,27779050,0,0,0,785
33587,27779235,27779235,27779344,0,0,0,109
33585,27778968,27778968,27779473,0,0,0,505
33588,27779513,27779513,27779826,0,0,0,313
33590,27779662,27779662,27779837,0,0,0,175
33586,27779191,27779191,27779905,0,0,0,714
33591,27779843,27779843,27780449,0,0,0,606
33592,27779855,27779855,27780450,0,0,0,595
33595,27780430,27780430,27780573,0,0,0,143
33596,27780450,27780450,27780740,0,0,0,290
33598,27780719,27780719,27780857,0,0,0,138
33594,27780356,27780356,27781079,0,0,0,723
33593,27780305,27780305,27781092,0,0,0,787
33599,27780870,27780870,27781279,0,0,0,409
33600,27781303,27781303,27781441,0,0,0,138
33601,27781313,27781313,27781451,0,0,0,138
33602,27781323,27781323,27781461,0,0,0,138
33604,27781432,27781432,27781574,0,0,0,142
33603,27781323,27781323,27781624,0,0,0,301
33466,27522614,27522614,27781814,0,0,0,259200
33467,27522614,27522614,27781814,0,0,0,259200
33468,27522614,27522614,27781814,0,0,0,259200
33605,27781799,27781799,27781924,0,0,0,125
33469,27522811,27522811,27782011,0,0,0,259200
33606,27782206,27782206,27782348,0,0,0,142
33609,27782927,27782927,27783084,0,0,0,157
33610,27783071,27783071,27783146,0,0,0,75
33615,27783308,27783308,27783391,0,0,0,83
33616,27783367,27783367,27784078,0,0,0,711
33619,27784575,27784575,27784721,0,0,0,146
33618,27783838,27783838,27784889,0,0,0,1051
33620,27784972,27784972,27785079,0,0,0,107
33621,27785061,27785061,27785195,0,0,0,134
33622,27785288,27785288,27785668,0,0,0,380
33623,27785617,27785617,27785680,0,0,0,63
33624,27785646,27785646,27785722,0,0,0,76
33625,27785812,27785812,27785927,0,0,0,115
33558,27769616,27769616,27785969,0,0,0,16353
33627,27786119,27786119,27786244,0,0,0,125
33628,27786473,27786473,27786610,0,0,0,137
33629,27786583,27786583,27786729,0,0,0,146
33472,27530104,27530104,27789304,0,0,0,259200
33631,27789755,27789755,27789813,0,0,0,58
33632,27789925,27789925,27789965,0,0,0,40
33473,27532409,27532409,27791609,0,0,0,259200
33607,27782604,27782604,27793390,0,0,0,10786
33626,27785925,27785925,27802238,0,0,0,16313
33483,27588882,27588882,27804300,0,0,0,215418
33550,27764100,27764100,27818450,0,0,0,54350
33634,27802201,27802201,27818550,0,0,0,16349
33642,27824624,27824624,27825641,0,0,0,1017
33641,27824602,27824602,27825653,0,0,0,1051
33636,27824327,27824327,27826094,0,0,0,1767
33637,27824514,27824514,27827793,0,0,0,3279
33638,27824543,27824543,27827928,0,0,0,3385
33640,27824562,27824562,27828944,0,0,0,4382
33639,27824554,27824554,27829050,0,0,0,4496
33635,27818507,27818507,27834880,0,0,0,16373
33644,27839962,27839962,27840071,0,0,0,109
33608,27782607,27782607,27841193,0,0,0,58586
33647,27845567,27845567,27845690,0,0,0,123
33646,27844445,27844445,27845826,0,0,0,1381
33650,27847449,27847449,27847583,0,0,0,134
33651,27847823,27847823,27847959,0,0,0,136
33652,27848324,27848324,27848459,0,0,0,135
33654,27848857,27848857,27849003,0,0,0,146
33655,27849190,27849190,27849325,0,0,0,135
33643,27834837,27834837,27851045,0,0,0,16208
33565,27772374,27772374,27852226,0,0,0,79852
33653,27848429,27848429,27852254,0,0,0,3825
33564,27772364,27772364,27855205,0,0,0,82841
33661,27855268,27855268,27856190,0,0,0,922
33660,27855260,27855260,27856287,0,0,0,1027
33662,27856480,27856480,27856593,0,0,0,113
33659,27854327,27854327,27856738,0,0,0,2411
33663,27856627,27856627,27856987,0,0,0,360
33664,27856874,27856874,27857105,0,0,0,231
33665,27856971,27856971,27857134,0,0,0,163
33658,27854313,27854313,27857735,0,0,0,3422
33657,27854304,27854304,27857811,0,0,0,3507
33666,27857287,27857287,27858314,0,0,0,1027
33667,27857845,27857845,27858523,0,0,0,678
33668,27857922,27857922,27858700,0,0,0,778
33566,27772385,27772385,27858785,0,0,0,86400
33672,27859996,27859996,27860159,0,0,0,163
33559,27769648,27769648,27860400,0,0,0,90752
33673,27860319,27860319,27860481,0,0,0,162
33674,27860526,27860526,27860635,0,0,0,109
33675,27860797,27860797,27860878,0,0,0,81
33649,27845833,27845833,27861238,0,0,0,15405
33677,27861600,27861600,27861855,0,0,0,255
33578,27776320,27776320,27862717,0,0,0,86397
33678,27861921,27861921,27863686,0,0,0,1765
33682,27862969,27862969,27865096,0,0,0,2127
33681,27862960,27862960,27865202,0,0,0,2242
33684,27862978,27862978,27865488,0,0,0,2510
33648,27845716,27845716,27865672,0,0,0,19956
33685,27863215,27863215,27866204,0,0,0,2989
33680,27862953,27862953,27866247,0,0,0,3294
33617,27783537,27783537,27866337,0,0,0,82800
33656,27850995,27850995,27867253,0,0,0,16258
33686,27863734,27863734,27867501,0,0,0,3767
33683,27862975,27862975,27868950,0,0,0,5975
33692,27870948,27870948,27871021,0,0,0,73
33676,27860888,27860888,27871688,0,0,0,10800
33695,27871890,27871890,27871975,0,0,0,85
33691,27870803,27870803,27872522,0,0,0,1719
33696,27872096,27872096,27874181,0,0,0,2085
33697,27874171,27874171,27874295,0,0,0,124
33669,27859927,27859927,27876080,0,0,0,16153
33671,27859972,27859972,27876083,0,0,0,16111
33670,27859937,27859937,27876085,0,0,0,16148
33589,27779588,27779588,27877474,0,0,0,97886
33704,27882083,27882083,27882200,0,0,0,117
33701,27876985,27876985,27882929,0,0,0,5944
33694,27871582,27871582,27883200,0,0,0,11618
33705,27883088,27883088,27883248,0,0,0,160
33687,27867216,27867216,27883431,0,0,0,16215
33709,27885730,27885730,27885852,0,0,0,122
33710,27885815,27885815,27885932,0,0,0,117
33713,27885833,27885833,27886604,0,0,0,771
33712,27885824,27885824,27886733,0,0,0,909
33711,27885820,27885820,27887547,0,0,0,1727
33703,27881586,27881586,27889908,0,0,0,8322
33700,27876050,27876050,27892106,0,0,0,16056
33698,27876043,27876043,27892122,0,0,0,16079
33699,27876043,27876043,27892133,0,0,0,16090
33708,27883726,27883726,27899292,0,0,0,15566
33707,27883391,27883391,27899420,0,0,0,16029
33645,27841155,27841155,27899849,0,0,0,58694
33693,27871015,27871015,27904229,0,0,0,33214
33714,27892068,27892068,27907887,0,0,0,15819
33716,27892087,27892087,27907913,0,0,0,15826
33715,27892080,27892080,27908011,0,0,0,15931
33717,27899379,27899379,27915342,0,0,0,15963
33553,27765828,27765828,27920807,0,0,0,154979
33719,27907851,27907851,27923806,0,0,0,15955
33720,27907873,27907873,27923859,0,0,0,15986
33721,27907977,27907977,27924037,0,0,0,16060
33690,27869663,27869663,27927799,0,0,0,58136
33722,27915296,27915296,27931342,0,0,0,16046
33728,27934084,27934084,27934193,0,0,0,109
33633,27789968,27789968,27936101,0,0,0,146133
33731,27937708,27937708,27937823,0,0,0,115
33732,27937878,27937878,27937994,0,0,0,116
33689,27868990,27868990,27939106,0,0,0,70116
33734,27939303,27939303,27939469,0,0,0,166
33735,27939398,27939398,27939552,0,0,0,154
33724,27923809,27923809,27939745,0,0,0,15936
33723,27923759,27923759,27939778,0,0,0,16019
33736,27939453,27939453,27939953,0,0,0,500
33725,27923991,27923991,27939969,0,0,0,15978
33741,27940253,27940253,27940384,0,0,0,131
33740,27940145,27940145,27940675,0,0,0,530
33729,27936076,27936076,27941104,0,0,0,5028
33743,27941015,27941015,27941114,0,0,0,99
33742,27940707,27940707,27941820,0,0,0,1113
33744,27942267,27942267,27942352,0,0,0,85
33745,27942318,27942318,27942398,0,0,0,80
33748,27942319,27942319,27942433,0,0,0,114
33746,27942318,27942318,27942445,0,0,0,127
33747,27942318,27942318,27942445,0,0,0,127
33749,27942319,27942319,27942446,0,0,0,127
33768,27942439,27942439,27942508,0,0,0,69
33766,27942439,27942439,27942525,0,0,0,86
33767,27942439,27942439,27942536,0,0,0,97
33760,27942429,27942429,27942552,0,0,0,123
33763,27942434,27942434,27942568,0,0,0,134
33770,27942442,27942508,27942597,0,0,66,155
33769,27942439,27942508,27942600,0,0,69,161
33771,27942442,27942536,27942625,0,0,94,183
33773,27943304,27943304,27943433,0,0,0,129
33750,27942319,27942319,27943519,0,0,0,1200
33751,27942319,27942319,27943519,0,0,0,1200
33752,27942320,27942320,27943520,0,0,0,1200
33753,27942320,27942320,27943520,0,0,0,1200
33754,27942320,27942320,27943520,0,0,0,1200
33755,27942320,27942320,27943520,0,0,0,1200
33756,27942320,27942320,27943520,0,0,0,1200
33757,27942320,27942320,27943520,0,0,0,1200
33758,27942321,27942321,27943521,0,0,0,1200
33759,27942321,27942321,27943521,0,0,0,1200
33772,27942828,27942828,27943578,0,0,0,750
33761,27942429,27942429,27943629,0,0,0,1200
33762,27942430,27942430,27943630,0,0,0,1200
33764,27942435,27942435,27943635,0,0,0,1200
33765,27942435,27942435,27943635,0,0,0,1200
33730,27936133,27936133,27945192,0,0,0,9059
33774,27946916,27946916,27947063,0,0,0,147
33775,27947091,27947091,27947179,0,0,0,88
33726,27931309,27931309,27947296,0,0,0,15987
33679,27862678,27862678,27947394,0,0,0,84716
33778,27947545,27947545,27947722,0,0,0,177
33781,27947553,27947553,27948164,0,0,0,611
33780,27947550,27947550,27948420,0,0,0,870
33779,27947548,27947548,27948978,0,0,0,1430
33792,27950832,27950832,27950906,0,0,0,74
33782,27950825,27950825,27950913,0,0,0,88
33785,27950827,27950827,27950925,0,0,0,98
33791,27950831,27950831,27950929,0,0,0,98
33783,27950826,27950826,27951407,0,0,0,581
33793,27950832,27950832,27951413,0,0,0,581
33784,27950826,27950826,27951430,0,0,0,604
33786,27950827,27950827,27951431,0,0,0,604
33787,27950827,27950827,27951431,0,0,0,604
33788,27950827,27950827,27951431,0,0,0,604
33789,27950828,27950828,27951432,0,0,0,604
33790,27950828,27950828,27951432,0,0,0,604
33794,27950832,27950832,27951436,0,0,0,604
33795,27950832,27950832,27951436,0,0,0,604
33796,27950832,27950832,27951436,0,0,0,604
33797,27950832,27950832,27951436,0,0,0,604
33798,27950832,27950832,27951436,0,0,0,604
33799,27950833,27950833,27951437,0,0,0,604
33810,27951615,27951615,27951680,0,0,0,65
33801,27951607,27951607,27951695,0,0,0,88
33800,27951483,27951483,27951696,0,0,0,213
33802,27951608,27951608,27951707,0,0,0,99
33812,27951615,27951615,27951713,0,0,0,98
33811,27951615,27951615,27951714,0,0,0,99
33814,27951616,27951616,27951886,0,0,0,270
33815,27951616,27951616,27951917,0,0,0,301
33813,27951615,27951615,27951927,0,0,0,312
33816,27951616,27951616,27951928,0,0,0,312
33817,27951616,27951616,27951928,0,0,0,312
33818,27951616,27951616,27951939,0,0,0,323
33819,27951962,27951962,27952022,0,0,0,60
33803,27951608,27951608,27952055,0,0,0,447
33805,27951609,27951609,27952090,0,0,0,481
33806,27951609,27951609,27952143,0,0,0,534
33807,27951609,27951609,27952156,0,0,0,547
33804,27951608,27951608,27952166,0,0,0,558
33808,27951609,27951609,27952167,0,0,0,558
33809,27951609,27951609,27952167,0,0,0,558
33820,27953265,27953265,27953345,0,0,0,80
33821,27953265,27953265,27953388,0,0,0,123
33822,27953265,27953265,27953388,0,0,0,123
33825,27953266,27953266,27953389,0,0,0,123
33826,27953266,27953266,27953389,0,0,0,123
33827,27953266,27953266,27953400,0,0,0,134
33823,27953265,27953265,27953410,0,0,0,145
33828,27953266,27953266,27953411,0,0,0,145
33835,27953279,27953279,27953411,0,0,0,132
33824,27953265,27953265,27953433,0,0,0,168
33840,27953281,27953281,27953531,0,0,0,250
33829,27953266,27953266,27953539,0,0,0,273
33832,27953279,27953279,27953544,0,0,0,265
33833,27953279,27953279,27953544,0,0,0,265
33834,27953279,27953279,27953544,0,0,0,265
33836,27953280,27953280,27953545,0,0,0,265
33837,27953280,27953280,27953545,0,0,0,265
33841,27953281,27953281,27953546,0,0,0,265
33842,27953282,27953282,27953547,0,0,0,265
33843,27953282,27953282,27953547,0,0,0,265
33830,27953266,27953266,27953554,0,0,0,288
33831,27953266,27953266,27953554,0,0,0,288
33844,27953282,27953282,27953559,0,0,0,277
33839,27953280,27953410,27953565,0,0,130,285
33845,27953282,27953410,27953565,0,0,128,283
33838,27953280,27953400,27953677,0,0,120,397
33848,27953914,27953914,27954218,0,0,0,304
33847,27953913,27953913,27954259,0,0,0,346
33849,27953914,27953914,27954260,0,0,0,346
33852,27953915,27953915,27954261,0,0,0,346
33853,27953915,27953915,27954261,0,0,0,346
33850,27953914,27953914,27954271,0,0,0,357
33851,27953914,27953914,27954271,0,0,0,357
33854,27953915,27953915,27954284,0,0,0,369
33846,27953912,27953912,27954292,0,0,0,380
33864,27954130,27954260,27954336,0,0,130,206
33865,27954332,27954332,27954405,0,0,0,73
33856,27953964,27953964,27954537,0,0,0,573
33860,27953965,27953965,27954572,0,0,0,607
33857,27953964,27953964,27954582,0,0,0,618
33858,27953964,27953964,27954582,0,0,0,618
33861,27953965,27953965,27954583,0,0,0,618
33859,27953964,27953964,27954594,0,0,0,630
33862,27953965,27953965,27954594,0,0,0,629
33863,27953965,27953965,27954605,0,0,0,640
33855,27953963,27953963,27954619,0,0,0,656
33727,27933539,27933539,27954843,0,0,0,21304
33866,27955231,27955231,27955303,0,0,0,72
33867,27955245,27955245,27955400,0,0,0,155
33869,27955328,27955328,27955473,0,0,0,145
33870,27955328,27955328,27955516,0,0,0,188
33873,27955329,27955329,27955517,0,0,0,188
33874,27955329,27955329,27955517,0,0,0,188
33871,27955328,27955328,27955527,0,0,0,199
33875,27955329,27955329,27955528,0,0,0,199
33872,27955328,27955328,27955538,0,0,0,210
33876,27955329,27955329,27955539,0,0,0,210
33868,27955327,27955327,27955561,0,0,0,234
33877,27955333,27955333,27955597,0,0,0,264
33878,27955333,27955333,27955628,0,0,0,295
33881,27955334,27955334,27955629,0,0,0,295
33880,27955333,27955333,27955638,0,0,0,305
33882,27955334,27955334,27955641,0,0,0,307
33883,27955334,27955334,27955641,0,0,0,307
33884,27955334,27955334,27955652,0,0,0,318
33885,27955334,27955334,27955652,0,0,0,318
33879,27955333,27955333,27955674,0,0,0,341
33887,27955351,27955351,27955821,0,0,0,470
33737,27939704,27939704,27955849,0,0,0,16145
33889,27955351,27955351,27955865,0,0,0,514
33738,27939743,27939743,27955886,0,0,0,16143
33891,27955352,27955473,27955987,0,0,121,635
33888,27955351,27955516,27956030,0,0,165,679
33892,27955352,27955517,27956031,0,0,165,679
33898,27955967,27955967,27956047,0,0,0,80
33893,27955352,27955528,27956053,0,0,176,701
33894,27955352,27955538,27956064,0,0,186,712
33890,27955351,27955561,27956081,0,0,210,730
33739,27939931,27939931,27956083,0,0,0,16152
33886,27955338,27955538,27956083,0,0,200,745
33899,27956029,27956029,27956176,0,0,0,147
33901,27956162,27956162,27956218,0,0,0,56
33910,27956173,27956173,27956222,0,0,0,49
33919,27956189,27956189,27956233,0,0,0,44
33923,27956191,27956191,27956235,0,0,0,44
33902,27956162,27956162,27956240,0,0,0,78
33903,27956162,27956162,27956240,0,0,0,78
33904,27956162,27956162,27956240,0,0,0,78
33905,27956162,27956162,27956240,0,0,0,78
33906,27956162,27956162,27956240,0,0,0,78
33908,27956163,27956163,27956241,0,0,0,78
33909,27956163,27956163,27956241,0,0,0,78
33917,27956174,27956174,27956248,0,0,0,74
33907,27956162,27956162,27956252,0,0,0,90
33911,27956173,27956173,27956257,0,0,0,84
33914,27956174,27956174,27956258,0,0,0,84
33915,27956174,27956174,27956258,0,0,0,84
33918,27956175,27956175,27956259,0,0,0,84
33913,27956173,27956173,27956264,0,0,0,91
33916,27956174,27956174,27956265,0,0,0,91
33912,27956173,27956173,27956269,0,0,0,96
33920,27956190,27956190,27956270,0,0,0,80
33924,27956191,27956191,27956271,0,0,0,80
33921,27956190,27956235,27956315,0,0,45,125
33931,27956195,27956240,27956315,0,0,45,120
33930,27956194,27956240,27956315,0,0,46,121
33932,27956195,27956241,27956316,0,0,46,121
33925,27956191,27956240,27956320,0,0,49,129
33927,27956194,27956240,27956320,0,0,46,126
33933,27956197,27956248,27956322,0,0,51,125
33935,27956197,27956248,27956328,0,0,51,131
33922,27956190,27956240,27956331,0,0,50,141
33926,27956191,27956240,27956331,0,0,49,140
33928,27956194,27956240,27956331,0,0,46,137
33929,27956194,27956240,27956331,0,0,46,137
33934,27956197,27956252,27956336,0,0,55,139
33936,27956197,27956269,27956349,0,0,72,152
33938,27957657,27957657,27957735,0,0,0,78
33939,27957754,27957754,27957861,0,0,0,107
33943,27957761,27957761,27957876,0,0,0,115
33940,27957760,27957760,27957898,0,0,0,138
33944,27957761,27957761,27957899,0,0,0,138
33941,27957760,27957760,27957909,0,0,0,149
33946,27957762,27957762,27957911,0,0,0,149
33970,27957767,27957861,27957930,0,0,94,163
33964,27957766,27957766,27957932,0,0,0,166
33945,27957761,27957761,27957939,0,0,0,178
33947,27957762,27957762,27957940,0,0,0,178
33948,27957762,27957762,27957951,0,0,0,189
33942,27957760,27957760,27957973,0,0,0,213
33950,27957763,27957763,27957976,0,0,0,213
33954,27957764,27957764,27957977,0,0,0,213
33953,27957763,27957763,27957985,0,0,0,222
33951,27957763,27957763,27957988,0,0,0,225
33955,27957764,27957764,27957989,0,0,0,225
33957,27957764,27957764,27957992,0,0,0,228
33952,27957763,27957763,27958002,0,0,0,239
33978,27957768,27957876,27958003,0,0,108,235
33979,27957768,27957876,27958003,0,0,108,235
33977,27957768,27957909,27958036,0,0,141,268
33983,27957769,27957899,27958037,0,0,130,268
33949,27957762,27957762,27958043,0,0,0,281
33980,27957768,27957939,27958054,0,0,171,286
33973,27957767,27957876,27958075,0,0,109,308
33965,27957766,27957876,27958077,0,0,110,311
33956,27957764,27957764,27958079,0,0,0,315
33966,27957766,27957876,27958089,0,0,110,323
33971,27957767,27957876,27958089,0,0,109,322
33972,27957767,27957876,27958089,0,0,109,322
33959,27957765,27957765,27958126,0,0,0,361
33981,27957768,27958002,27958137,0,0,234,369
33976,27957767,27958043,27958192,0,0,276,425
33974,27957767,27957992,27958204,0,0,225,437
33968,27957766,27957973,27958208,0,0,207,442
33967,27957766,27957876,27958225,0,0,110,459
33958,27957765,27957876,27958237,0,0,111,472
33960,27957765,27957876,27958248,0,0,111,483
33961,27957765,27957876,27958259,0,0,111,494
33962,27957765,27957876,27958273,0,0,111,508
33975,27957767,27958192,27958297,0,0,425,530
33982,27957768,27958208,27958299,0,0,440,531
33969,27957766,27957951,27958326,0,0,185,560
33963,27957765,27957985,27958347,0,0,220,582
33718,27899806,27899806,27958369,0,0,0,58563
33986,27958746,27958746,27958890,0,0,0,144
33688,27868987,27868987,27958932,0,0,0,89945
33984,27957815,27958299,27959499,0,0,484,1684
33895,27955699,27955699,27960849,0,0,0,5150
34002,27962765,27962765,27963025,0,0,0,260
34003,27962766,27962766,27963026,0,0,0,260
34004,27962768,27962768,27963028,0,0,0,260
34001,27962763,27962763,27963034,0,0,0,271
33776,27947245,27947245,27963140,0,0,0,15895
34010,27963235,27963235,27963980,0,0,0,745
33987,27960839,27960839,27966011,0,0,0,5172
33988,27961041,27961041,27966095,0,0,0,5054
33989,27961118,27961118,27966251,0,0,0,5133
33990,27961173,27961173,27966271,0,0,0,5098
33991,27961652,27961652,27966773,0,0,0,5121
34012,27966883,27966883,27966941,0,0,0,58
34028,27968791,27968791,27968855,0,0,0,64
34038,27971208,27971208,27971542,0,0,0,334
34039,27971713,27971713,27971848,0,0,0,135
33896,27955809,27955809,27972023,0,0,0,16214
33897,27955836,27955836,27972027,0,0,0,16191
34042,27971987,27971987,27972112,0,0,0,125
33900,27956042,27956042,27972254,0,0,0,16212
33702,27877432,27877432,27974892,0,0,0,97460
34005,27963000,27963000,27977184,0,0,0,14184
34007,27963031,27963031,27977204,0,0,0,14173
34008,27963048,27963048,27977399,0,0,0,14351
34006,27963012,27963012,27977519,0,0,0,14507
34011,27963238,27963238,27978401,0,0,0,15163
33937,27956292,27956292,27978591,0,0,0,22299
34009,27963107,27963107,27978937,0,0,0,15830
33597,27780631,27780631,27980029,0,0,0,199398
33992,27961749,27961749,27980443,0,0,0,18694
33993,27961939,27961939,27980723,0,0,0,18784
33999,27962561,27962561,27981117,0,0,0,18556
33998,27962501,27962501,27981202,0,0,0,18701
34000,27962722,27962722,27981401,0,0,0,18679
34014,27967195,27967195,27985137,0,0,0,17942
34013,27967150,27967150,27985140,0,0,0,17990
34015,27967257,27967257,27985234,0,0,0,17977
34016,27967598,27967598,27985525,0,0,0,17927
34017,27967717,27967717,27985814,0,0,0,18097
34018,27967911,27967911,27985962,0,0,0,18051
34026,27968739,27968739,27986730,0,0,0,17991
34031,27968853,27968853,27986876,0,0,0,18023
34033,27968924,27968924,27986937,0,0,0,18013
34040,27971981,27971981,27988291,0,0,0,16310
34041,27971984,27971984,27988296,0,0,0,16312
34043,27972222,27972222,27988489,0,0,0,16267
34034,27968987,27968987,27991632,0,0,0,22645
34030,27968826,27968826,27991876,0,0,0,23050
34035,27969012,27969012,27992300,0,0,0,23288
34025,27968730,27968730,27992704,0,0,0,23974
34036,27969038,27969038,27992795,0,0,0,23757
34023,27968688,27968688,27993308,0,0,0,24620
34019,27968566,27968566,27993868,0,0,0,25302
34021,27968625,27968625,27994084,0,0,0,25459
34027,27968765,27968765,27994181,0,0,0,25416
34020,27968609,27968609,27994316,0,0,0,25707
34022,27968649,27968649,27994654,0,0,0,26005
33996,27962396,27962396,27994774,0,0,0,32378
33994,27962374,27962374,27994838,0,0,0,32464
34046,27978891,27978891,27994907,0,0,0,16016
33995,27962386,27962386,27995077,0,0,0,32691
33997,27962405,27962405,27996297,0,0,0,33892
34047,27988250,27988250,28004483,0,0,0,16233
34048,27988262,27988262,28004548,0,0,0,16286
34024,27968715,27968715,28004715,0,0,0,36000
34049,27988447,27988447,28004737,0,0,0,16290
34029,27968816,27968816,28004816,0,0,0,36000
34032,27968859,27968859,28004859,0,0,0,36000
34037,27969070,27969070,28005070,0,0,0,36000
34050,27990343,27990343,28016638,0,0,0,26295
33985,27958322,27958322,28016938,0,0,0,58616
34064,28004440,28004440,28020764,0,0,0,16324
34065,28004499,28004499,28020812,0,0,0,16313
34066,28004694,28004694,28021041,0,0,0,16347
34071,28021080,28021080,28021150,0,0,0,70
34070,28021067,28021067,28021169,0,0,0,102
33706,27883360,27883360,28021821,0,0,0,138461
34072,28021976,28021976,28022030,0,0,0,54
34073,28022262,28022262,28022378,0,0,0,116
34074,28022629,28022629,28022675,0,0,0,46
34075,28022663,28022663,28022717,0,0,0,54
34076,28022690,28022690,28022722,0,0,0,32
34077,28022773,28022773,28022811,0,0,0,38
34078,28022852,28022852,28022911,0,0,0,59
34080,28022894,28022894,28022980,0,0,0,86
34079,28022875,28022875,28022988,0,0,0,113
34083,28023914,28023914,28024202,0,0,0,288
34084,28024029,28024029,28024202,0,0,0,173
34082,28023770,28023770,28024205,0,0,0,435
34085,28024067,28024067,28024205,0,0,0,138
34092,28025087,28025087,28025187,0,0,0,100
34088,28024295,28024295,28025201,0,0,0,906
34091,28025072,28025072,28025205,0,0,0,133
34089,28024311,28024311,28025206,0,0,0,895
34093,28025107,28025107,28025207,0,0,0,100
34090,28025064,28025064,28025208,0,0,0,144
34086,28024246,28024246,28025210,0,0,0,964
34087,28024283,28024283,28025212,0,0,0,929
34094,28025142,28025142,28025222,0,0,0,80
34100,28025316,28025316,28025390,0,0,0,74
34105,28026137,28026137,28026197,0,0,0,60
34106,28026493,28026493,28026553,0,0,0,60
34126,28027279,28027279,28027485,0,0,0,206
34127,28027279,28027279,28027485,0,0,0,206
34128,28027279,28027279,28027496,0,0,0,217
34129,28027279,28027279,28027507,0,0,0,228
34130,28027279,28027279,28027518,0,0,0,239
34151,28027535,28027535,28027676,0,0,0,141
34152,28027535,28027535,28027676,0,0,0,141
34131,28027529,28027529,28027718,0,0,0,189
34107,28027276,28027276,28027725,0,0,0,449
34108,28027276,28027276,28027725,0,0,0,449
34109,28027276,28027276,28027725,0,0,0,449
34110,28027276,28027276,28027725,0,0,0,449
34111,28027276,28027276,28027725,0,0,0,449
34112,28027276,28027276,28027725,0,0,0,449
34113,28027277,28027277,28027726,0,0,0,449
34114,28027277,28027277,28027726,0,0,0,449
34115,28027277,28027277,28027726,0,0,0,449
34116,28027277,28027277,28027726,0,0,0,449
34117,28027277,28027277,28027726,0,0,0,449
34118,28027277,28027277,28027726,0,0,0,449
34119,28027277,28027277,28027726,0,0,0,449
34120,28027278,28027278,28027727,0,0,0,449
34121,28027278,28027278,28027727,0,0,0,449
34122,28027278,28027278,28027727,0,0,0,449
34123,28027278,28027278,28027727,0,0,0,449
34124,28027278,28027278,28027727,0,0,0,449
34125,28027278,28027278,28027727,0,0,0,449
34139,28027531,28027531,28027738,0,0,0,207
34140,28027532,28027532,28027739,0,0,0,207
34157,28027536,28027536,28027740,0,0,0,204
34142,28027533,28027533,28027751,0,0,0,218
34143,28027533,28027533,28027751,0,0,0,218
34141,28027532,28027532,28027761,0,0,0,229
34144,28027533,28027533,28027762,0,0,0,229
34145,28027533,28027533,28027762,0,0,0,229
34146,28027534,28027534,28027774,0,0,0,240
34147,28027534,28027534,28027774,0,0,0,240
34148,28027534,28027534,28027774,0,0,0,240
34132,28027529,28027529,28027779,0,0,0,250
34133,28027530,28027530,28027780,0,0,0,250
34134,28027530,28027530,28027780,0,0,0,250
34135,28027530,28027530,28027791,0,0,0,261
34136,28027530,28027530,28027791,0,0,0,261
34149,28027534,28027534,28027796,0,0,0,262
34150,28027534,28027534,28027796,0,0,0,262
34153,28027535,28027535,28027797,0,0,0,262
34154,28027535,28027535,28027797,0,0,0,262
34137,28027531,28027531,28027803,0,0,0,272
34138,28027531,28027531,28027803,0,0,0,272
34155,28027535,28027535,28027819,0,0,0,284
34156,28027535,28027535,28027830,0,0,0,295
34158,28028565,28028565,28028604,0,0,0,39
34051,27990405,27990405,28028988,0,0,0,38583
34160,28029167,28029167,28029214,0,0,0,47
34095,28025178,28025178,28029637,0,0,0,4459
34097,28025183,28025183,28029663,0,0,0,4480
34165,28029943,28029943,28030035,0,0,0,92
34166,28030102,28030102,28030173,0,0,0,71
34169,28030270,28030270,28030365,0,0,0,95
34202,28030425,28030425,28030529,0,0,0,104
34203,28030425,28030425,28030529,0,0,0,104
34204,28030425,28030425,28030529,0,0,0,104
34171,28030419,28030419,28030776,0,0,0,357
34172,28030420,28030420,28030777,0,0,0,357
34173,28030420,28030420,28030777,0,0,0,357
34174,28030420,28030420,28030777,0,0,0,357
34175,28030420,28030420,28030777,0,0,0,357
34176,28030420,28030420,28030777,0,0,0,357
34177,28030420,28030420,28030777,0,0,0,357
34178,28030421,28030421,28030778,0,0,0,357
34179,28030421,28030421,28030778,0,0,0,357
34180,28030421,28030421,28030778,0,0,0,357
34181,28030421,28030421,28030778,0,0,0,357
34182,28030421,28030421,28030778,0,0,0,357
34183,28030421,28030421,28030778,0,0,0,357
34184,28030422,28030422,28030779,0,0,0,357
34185,28030422,28030422,28030779,0,0,0,357
34186,28030422,28030422,28030779,0,0,0,357
34187,28030422,28030422,28030779,0,0,0,357
34188,28030422,28030422,28030779,0,0,0,357
34209,28030680,28030680,28030784,0,0,0,104
34210,28030680,28030680,28030784,0,0,0,104
34211,28030680,28030680,28030784,0,0,0,104
34213,28030681,28030681,28030785,0,0,0,104
34214,28030681,28030681,28030785,0,0,0,104
34215,28030681,28030681,28030785,0,0,0,104
34216,28030681,28030681,28030785,0,0,0,104
34217,28030682,28030682,28030786,0,0,0,104
34189,28030422,28030422,28030791,0,0,0,369
34190,28030422,28030422,28030791,0,0,0,369
34195,28030424,28030424,28030793,0,0,0,369
34218,28030682,28030682,28030797,0,0,0,115
34219,28030682,28030682,28030797,0,0,0,115
34220,28030682,28030682,28030797,0,0,0,115
34221,28030683,28030683,28030798,0,0,0,115
34191,28030423,28030423,28030803,0,0,0,380
34192,28030423,28030423,28030803,0,0,0,380
34193,28030423,28030423,28030803,0,0,0,380
34194,28030423,28030423,28030803,0,0,0,380
34196,28030424,28030424,28030804,0,0,0,380
34197,28030424,28030424,28030804,0,0,0,380
34198,28030424,28030424,28030804,0,0,0,380
34199,28030424,28030424,28030804,0,0,0,380
34200,28030424,28030424,28030804,0,0,0,380
34201,28030424,28030424,28030804,0,0,0,380
34205,28030425,28030425,28030805,0,0,0,380
34206,28030425,28030425,28030805,0,0,0,380
34207,28030425,28030425,28030805,0,0,0,380
34208,28030425,28030425,28030805,0,0,0,380
34212,28030680,28030680,28030982,0,0,0,302
34222,28030772,28030772,28031165,0,0,0,393
34224,28030965,28030965,28031290,0,0,0,325
34225,28031170,28031170,28031332,0,0,0,162
34227,28031415,28031415,28031857,0,0,0,442
34228,28031415,28031415,28031857,0,0,0,442
34229,28031415,28031415,28031857,0,0,0,442
34230,28031415,28031415,28031857,0,0,0,442
34231,28031415,28031415,28031857,0,0,0,442
34232,28031415,28031415,28031857,0,0,0,442
34233,28031416,28031416,28031858,0,0,0,442
34234,28031416,28031416,28031858,0,0,0,442
34235,28031416,28031416,28031858,0,0,0,442
34236,28031416,28031416,28031858,0,0,0,442
34237,28031666,28031666,28032047,0,0,0,381
34238,28032094,28032094,28032345,0,0,0,251
34239,28032094,28032094,28032345,0,0,0,251
34240,28032094,28032094,28032345,0,0,0,251
34241,28032094,28032094,28032345,0,0,0,251
34242,28032094,28032094,28032345,0,0,0,251
34243,28032116,28032116,28032367,0,0,0,251
34245,28032239,28032239,28032367,0,0,0,128
34244,28032117,28032117,28032368,0,0,0,251
34246,28032240,28032240,28032368,0,0,0,128
34247,28032240,28032240,28032368,0,0,0,128
34248,28032240,28032240,28032368,0,0,0,128
34249,28032245,28032245,28032373,0,0,0,128
34250,28032246,28032246,28032374,0,0,0,128
34251,28032246,28032246,28032374,0,0,0,128
34252,28032246,28032246,28032374,0,0,0,128
34253,28032246,28032246,28032374,0,0,0,128
34254,28032246,28032246,28032374,0,0,0,128
34255,28032246,28032246,28032374,0,0,0,128
34256,28032247,28032247,28032375,0,0,0,128
34257,28032247,28032247,28032375,0,0,0,128
34258,28032247,28032247,28032375,0,0,0,128
34259,28032247,28032247,28032375,0,0,0,128
34260,28032247,28032247,28032375,0,0,0,128
34261,28032247,28032247,28032392,0,0,0,145
34262,28032248,28032248,28032393,0,0,0,145
34263,28032248,28032248,28032393,0,0,0,145
34264,28032248,28032248,28032404,0,0,0,156
34265,28032248,28032248,28032404,0,0,0,156
34266,28032248,28032248,28032415,0,0,0,167
34267,28032248,28032248,28032415,0,0,0,167
34268,28032367,28032367,28032417,0,0,0,50
34272,28032624,28032624,28032684,0,0,0,60
34271,28032590,28032590,28032752,0,0,0,162
34281,28033665,28033665,28033798,0,0,0,133
34282,28033665,28033665,28033798,0,0,0,133
34283,28033666,28033666,28033799,0,0,0,133
34284,28033666,28033666,28033799,0,0,0,133
34285,28033666,28033666,28033799,0,0,0,133
34286,28033666,28033666,28033799,0,0,0,133
34287,28033667,28033667,28033800,0,0,0,133
34288,28033667,28033667,28033800,0,0,0,133
34289,28033667,28033667,28033800,0,0,0,133
34290,28033667,28033667,28033800,0,0,0,133
34291,28033668,28033668,28033801,0,0,0,133
34292,28033668,28033668,28033801,0,0,0,133
34293,28033668,28033668,28033801,0,0,0,133
34294,28033668,28033668,28033801,0,0,0,133
34295,28033669,28033669,28033802,0,0,0,133
34296,28033669,28033669,28033802,0,0,0,133
34273,28033517,28033517,28033803,0,0,0,286
34274,28033517,28033517,28033803,0,0,0,286
34275,28033517,28033517,28033803,0,0,0,286
34276,28033517,28033517,28033803,0,0,0,286
34277,28033518,28033518,28033804,0,0,0,286
34278,28033518,28033518,28033804,0,0,0,286
34279,28033518,28033518,28033804,0,0,0,286
34280,28033518,28033518,28033804,0,0,0,286
34297,28033669,28033669,28033819,0,0,0,150
34298,28033670,28033670,28033820,0,0,0,150
34299,28033670,28033670,28033820,0,0,0,150
34300,28033670,28033670,28033820,0,0,0,150
34301,28033670,28033670,28033820,0,0,0,150
34302,28033670,28033670,28033820,0,0,0,150
34303,28033670,28033670,28033820,0,0,0,150
34304,28033671,28033671,28033821,0,0,0,150
34305,28033798,28033798,28033859,0,0,0,61
34321,28034231,28034231,28034443,0,0,0,212
34322,28034231,28034231,28034443,0,0,0,212
34323,28034231,28034231,28034443,0,0,0,212
34324,28034231,28034231,28034454,0,0,0,223
34325,28034231,28034231,28034454,0,0,0,223
34326,28034232,28034232,28034466,0,0,0,234
34327,28034232,28034232,28034466,0,0,0,234
34328,28034232,28034232,28034466,0,0,0,234
34329,28034232,28034232,28034477,0,0,0,245
34330,28034232,28034232,28034488,0,0,0,256
34331,28034232,28034232,28034488,0,0,0,256
34336,28034451,28034451,28034559,0,0,0,108
34337,28034451,28034451,28034559,0,0,0,108
34343,28034453,28034453,28034573,0,0,0,120
34347,28034454,28034454,28034607,0,0,0,153
34348,28034454,28034454,28034607,0,0,0,153
34332,28034450,28034450,28034650,0,0,0,200
34335,28034451,28034451,28034651,0,0,0,200
34306,28034228,28034228,28034656,0,0,0,428
34307,28034228,28034228,28034656,0,0,0,428
34308,28034228,28034228,28034656,0,0,0,428
34309,28034229,28034229,28034657,0,0,0,428
34310,28034229,28034229,28034657,0,0,0,428
34311,28034229,28034229,28034657,0,0,0,428
34312,28034229,28034229,28034657,0,0,0,428
34313,28034229,28034229,28034657,0,0,0,428
34314,28034229,28034229,28034657,0,0,0,428
34315,28034230,28034230,28034658,0,0,0,428
34316,28034230,28034230,28034658,0,0,0,428
34317,28034230,28034230,28034658,0,0,0,428
34318,28034230,28034230,28034658,0,0,0,428
34319,28034231,28034231,28034659,0,0,0,428
34320,28034231,28034231,28034659,0,0,0,428
34339,28034452,28034452,28034671,0,0,0,219
34340,28034452,28034452,28034671,0,0,0,219
34341,28034452,28034452,28034671,0,0,0,219
34342,28034452,28034452,28034682,0,0,0,230
34344,28034453,28034453,28034683,0,0,0,230
34345,28034453,28034453,28034694,0,0,0,241
34346,28034453,28034453,28034705,0,0,0,252
34333,28034450,28034450,28034706,0,0,0,256
34349,28034454,28034454,28034706,0,0,0,252
34334,28034450,28034450,28034717,0,0,0,267
34338,28034451,28034451,28034718,0,0,0,267
34350,28034454,28034454,28034728,0,0,0,274
34351,28034455,28034455,28034729,0,0,0,274
34352,28034455,28034455,28034729,0,0,0,274
33777,27947353,27947353,28034766,0,0,0,87413
34354,28034893,28034893,28035166,0,0,0,273
34355,28034893,28034893,28035166,0,0,0,273
34356,28034893,28034893,28035166,0,0,0,273
34357,28034893,28034893,28035166,0,0,0,273
34358,28034893,28034893,28035166,0,0,0,273
34359,28034893,28034893,28035166,0,0,0,273
34360,28034894,28034894,28035167,0,0,0,273
34361,28034894,28034894,28035167,0,0,0,273
34362,28034894,28034894,28035167,0,0,0,273
34363,28034894,28034894,28035167,0,0,0,273
34364,28034894,28034894,28035167,0,0,0,273
34368,28035103,28035103,28035316,0,0,0,213
34369,28035104,28035104,28035317,0,0,0,213
34370,28035104,28035104,28035317,0,0,0,213
34371,28035104,28035104,28035317,0,0,0,213
34383,28035109,28035109,28035318,0,0,0,209
34384,28035112,28035112,28035321,0,0,0,209
34372,28035105,28035105,28035339,0,0,0,234
34373,28035105,28035105,28035339,0,0,0,234
34374,28035105,28035105,28035350,0,0,0,245
34375,28035106,28035106,28035351,0,0,0,245
34376,28035106,28035106,28035351,0,0,0,245
34377,28035106,28035106,28035373,0,0,0,267
34378,28035106,28035106,28035373,0,0,0,267
34379,28035107,28035107,28035374,0,0,0,267
34380,28035107,28035107,28035374,0,0,0,267
34365,28035102,28035102,28035375,0,0,0,273
34385,28035200,28035200,28035375,0,0,0,175
34386,28035200,28035200,28035375,0,0,0,175
34387,28035200,28035200,28035375,0,0,0,175
34381,28035107,28035107,28035385,0,0,0,278
34366,28035103,28035103,28035388,0,0,0,285
34367,28035103,28035103,28035388,0,0,0,285
34382,28035107,28035107,28035396,0,0,0,289
34389,28035202,28035202,28035411,0,0,0,209
34394,28035314,28035314,28035414,0,0,0,100
34390,28035204,28035204,28035424,0,0,0,220
34391,28035207,28035207,28035427,0,0,0,220
34388,28035200,28035200,28035431,0,0,0,231
34392,28035209,28035209,28035440,0,0,0,231
34393,28035313,28035313,28035555,0,0,0,242
34395,28035317,28035317,28035559,0,0,0,242
34396,28035392,28035392,28035593,0,0,0,201
34397,28035395,28035395,28035596,0,0,0,201
34398,28035397,28035397,28035609,0,0,0,212
34399,28035413,28035413,28035621,0,0,0,208
34400,28035416,28035416,28035624,0,0,0,208
34159,28029153,28029153,28035768,0,0,0,6615
34401,28035728,28035728,28035777,0,0,0,49
34269,28032367,28032367,28035802,0,0,0,3435
34402,28035822,28035822,28036122,0,0,0,300
34403,28035822,28035822,28036122,0,0,0,300
34404,28035822,28035822,28036122,0,0,0,300
34405,28035823,28035823,28036123,0,0,0,300
34406,28035823,28035823,28036123,0,0,0,300
34407,28035823,28035823,28036123,0,0,0,300
34408,28035823,28035823,28036123,0,0,0,300
34409,28035823,28035823,28036123,0,0,0,300
34410,28035823,28035823,28036123,0,0,0,300
34434,28036037,28036037,28036145,0,0,0,108
34439,28036038,28036038,28036146,0,0,0,108
34443,28036039,28036039,28036147,0,0,0,108
34436,28036037,28036037,28036162,0,0,0,125
34437,28036037,28036037,28036162,0,0,0,125
34438,28036037,28036037,28036162,0,0,0,125
34440,28036038,28036038,28036163,0,0,0,125
34441,28036038,28036038,28036163,0,0,0,125
34442,28036038,28036038,28036163,0,0,0,125
34444,28036039,28036039,28036164,0,0,0,125
34445,28036039,28036039,28036164,0,0,0,125
34446,28036039,28036039,28036164,0,0,0,125
34447,28036039,28036039,28036164,0,0,0,125
34448,28036040,28036040,28036165,0,0,0,125
34449,28036040,28036040,28036165,0,0,0,125
34450,28036040,28036040,28036165,0,0,0,125
34451,28036040,28036040,28036165,0,0,0,125
34452,28036040,28036040,28036165,0,0,0,125
34453,28036040,28036040,28036165,0,0,0,125
34411,28036031,28036031,28036272,0,0,0,241
34412,28036031,28036031,28036272,0,0,0,241
34413,28036031,28036031,28036272,0,0,0,241
34414,28036032,28036032,28036273,0,0,0,241
34415,28036032,28036032,28036273,0,0,0,241
34416,28036032,28036032,28036273,0,0,0,241
34417,28036032,28036032,28036273,0,0,0,241
34418,28036033,28036033,28036274,0,0,0,241
34419,28036033,28036033,28036274,0,0,0,241
34420,28036033,28036033,28036274,0,0,0,241
34422,28036034,28036034,28036275,0,0,0,241
34421,28036033,28036033,28036291,0,0,0,258
34423,28036034,28036034,28036292,0,0,0,258
34424,28036034,28036034,28036292,0,0,0,258
34425,28036035,28036035,28036293,0,0,0,258
34426,28036035,28036035,28036293,0,0,0,258
34427,28036035,28036035,28036293,0,0,0,258
34428,28036035,28036035,28036293,0,0,0,258
34429,28036036,28036036,28036294,0,0,0,258
34430,28036036,28036036,28036294,0,0,0,258
34431,28036036,28036036,28036294,0,0,0,258
34432,28036036,28036036,28036294,0,0,0,258
34433,28036036,28036036,28036294,0,0,0,258
34435,28036037,28036037,28036295,0,0,0,258
34062,27991576,27991576,28036326,0,0,0,44750
34454,28036344,28036344,28036587,0,0,0,243
34455,28036344,28036344,28036587,0,0,0,243
34456,28036344,28036344,28036587,0,0,0,243
34457,28036344,28036344,28036587,0,0,0,243
34475,28036598,28036598,28036749,0,0,0,151
34469,28036596,28036596,28036802,0,0,0,206
34470,28036596,28036596,28036802,0,0,0,206
34471,28036596,28036596,28036802,0,0,0,206
34483,28036599,28036599,28036805,0,0,0,206
34484,28036599,28036599,28036805,0,0,0,206
34472,28036596,28036596,28036813,0,0,0,217
34485,28036600,28036600,28036817,0,0,0,217
34486,28036600,28036600,28036817,0,0,0,217
34487,28036602,28036602,28036819,0,0,0,217
34473,28036597,28036597,28036825,0,0,0,228
34458,28036593,28036593,28036836,0,0,0,243
34459,28036593,28036593,28036836,0,0,0,243
34460,28036593,28036593,28036836,0,0,0,243
34461,28036593,28036593,28036836,0,0,0,243
34474,28036597,28036597,28036836,0,0,0,239
34463,28036594,28036594,28036837,0,0,0,243
34464,28036594,28036594,28036848,0,0,0,254
34476,28036598,28036598,28036848,0,0,0,250
34477,28036598,28036598,28036848,0,0,0,250
34478,28036598,28036598,28036848,0,0,0,250
34465,28036594,28036594,28036859,0,0,0,265
34466,28036595,28036595,28036860,0,0,0,265
34479,28036599,28036599,28036860,0,0,0,261
34467,28036595,28036595,28036871,0,0,0,276
34468,28036595,28036595,28036871,0,0,0,276
34480,28036599,28036599,28036871,0,0,0,272
34481,28036599,28036599,28036871,0,0,0,272
34482,28036599,28036599,28036882,0,0,0,283
34462,28036593,28036593,28036902,0,0,0,309
34488,28036685,28036685,28036913,0,0,0,228
34489,28036778,28036778,28037006,0,0,0,228
34490,28036780,28036780,28037019,0,0,0,239
34491,28036782,28036782,28037032,0,0,0,250
34492,28036971,28036971,28037053,0,0,0,82
34068,28020721,28020721,28037067,0,0,0,16346
34069,28020775,28020775,28037079,0,0,0,16304
34495,28037120,28037120,28037192,0,0,0,72
34517,28037504,28037504,28037674,0,0,0,170
34508,28037501,28037501,28037715,0,0,0,214
34509,28037502,28037502,28037716,0,0,0,214
34510,28037502,28037502,28037727,0,0,0,225
34511,28037502,28037502,28037727,0,0,0,225
34512,28037502,28037502,28037738,0,0,0,236
34513,28037503,28037503,28037739,0,0,0,236
34514,28037503,28037503,28037750,0,0,0,247
34515,28037503,28037503,28037750,0,0,0,247
34516,28037503,28037503,28037750,0,0,0,247
34518,28037504,28037504,28037762,0,0,0,258
34497,28037498,28037498,28037766,0,0,0,268
34498,28037499,28037499,28037767,0,0,0,268
34499,28037499,28037499,28037767,0,0,0,268
34500,28037499,28037499,28037767,0,0,0,268
34501,28037499,28037499,28037767,0,0,0,268
34502,28037500,28037500,28037768,0,0,0,268
34503,28037500,28037500,28037768,0,0,0,268
34504,28037500,28037500,28037768,0,0,0,268
34519,28037504,28037504,28037773,0,0,0,269
34520,28037504,28037504,28037773,0,0,0,269
34525,28037595,28037595,28037782,0,0,0,187
34521,28037504,28037504,28037784,0,0,0,280
34522,28037504,28037504,28037784,0,0,0,280
34505,28037501,28037501,28037786,0,0,0,285
34506,28037501,28037501,28037786,0,0,0,285
34523,28037505,28037505,28037796,0,0,0,291
34524,28037507,28037507,28037798,0,0,0,291
34507,28037501,28037501,28037801,0,0,0,300
34528,28037600,28037600,28037806,0,0,0,206
34529,28037602,28037602,28037819,0,0,0,217
34530,28037604,28037604,28037821,0,0,0,217
34526,28037595,28037595,28037895,0,0,0,300
34527,28037597,28037597,28037897,0,0,0,300
34531,28037713,28037713,28037930,0,0,0,217
34532,28037716,28037716,28037933,0,0,0,217
34533,28037718,28037718,28037946,0,0,0,228
34535,28037723,28037723,28037951,0,0,0,228
34534,28037721,28037721,28037960,0,0,0,239
34536,28037765,28037765,28037963,0,0,0,198
34537,28037784,28037784,28037997,0,0,0,213
34538,28037786,28037786,28037999,0,0,0,213
34539,28037789,28037789,28038002,0,0,0,213
34544,28038945,28038945,28038992,0,0,0,47
34567,28039168,28039168,28039337,0,0,0,169
34545,28039087,28039087,28039387,0,0,0,300
34546,28039087,28039087,28039387,0,0,0,300
34547,28039087,28039087,28039387,0,0,0,300
34548,28039088,28039088,28039388,0,0,0,300
34549,28039088,28039088,28039388,0,0,0,300
34550,28039088,28039088,28039388,0,0,0,300
34551,28039088,28039088,28039388,0,0,0,300
34552,28039089,28039089,28039389,0,0,0,300
34553,28039167,28039167,28039396,0,0,0,229
34554,28039167,28039167,28039396,0,0,0,229
34555,28039167,28039167,28039396,0,0,0,229
34559,28039168,28039168,28039397,0,0,0,229
34560,28039168,28039168,28039397,0,0,0,229
34561,28039168,28039168,28039397,0,0,0,229
34562,28039168,28039168,28039397,0,0,0,229
34563,28039168,28039168,28039397,0,0,0,229
34568,28039169,28039169,28039398,0,0,0,229
34569,28039169,28039169,28039398,0,0,0,229
34570,28039169,28039169,28039398,0,0,0,229
34571,28039169,28039169,28039398,0,0,0,229
34572,28039170,28039170,28039399,0,0,0,229
34573,28039170,28039170,28039399,0,0,0,229
34574,28039170,28039170,28039399,0,0,0,229
34575,28039170,28039170,28039399,0,0,0,229
34576,28039171,28039171,28039400,0,0,0,229
34577,28039171,28039171,28039400,0,0,0,229
34578,28039171,28039171,28039400,0,0,0,229
34579,28039171,28039171,28039400,0,0,0,229
34580,28039172,28039172,28039401,0,0,0,229
34581,28039172,28039172,28039401,0,0,0,229
34582,28039172,28039172,28039401,0,0,0,229
34583,28039172,28039172,28039401,0,0,0,229
34584,28039172,28039172,28039401,0,0,0,229
34585,28039172,28039172,28039401,0,0,0,229
34586,28039173,28039173,28039402,0,0,0,229
34587,28039173,28039173,28039402,0,0,0,229
34588,28039173,28039173,28039402,0,0,0,229
34589,28039173,28039173,28039402,0,0,0,229
34590,28039173,28039173,28039402,0,0,0,229
34591,28039173,28039173,28039425,0,0,0,252
34592,28039174,28039174,28039426,0,0,0,252
34593,28039174,28039174,28039426,0,0,0,252
34594,28039174,28039174,28039426,0,0,0,252
34595,28039174,28039174,28039426,0,0,0,252
34596,28039174,28039174,28039426,0,0,0,252
34597,28039174,28039174,28039426,0,0,0,252
34598,28039174,28039174,28039426,0,0,0,252
34599,28039175,28039175,28039427,0,0,0,252
34600,28039175,28039175,28039427,0,0,0,252
34601,28039175,28039175,28039427,0,0,0,252
34602,28039396,28039396,28039463,0,0,0,67
34564,28039168,28039168,28039497,0,0,0,329
34556,28039167,28039167,28039507,0,0,0,340
34565,28039168,28039168,28039519,0,0,0,351
34557,28039167,28039167,28039540,0,0,0,373
34603,28039396,28039396,28039596,0,0,0,200
34566,28039168,28039168,28039630,0,0,0,462
34604,28039645,28039645,28039778,0,0,0,133
34605,28039808,28039808,28040108,0,0,0,300
34606,28039808,28039808,28040108,0,0,0,300
34607,28039808,28039808,28040108,0,0,0,300
34608,28039808,28039808,28040108,0,0,0,300
34609,28039808,28039808,28040108,0,0,0,300
34610,28039808,28039808,28040108,0,0,0,300
34611,28039809,28039809,28040109,0,0,0,300
34612,28039809,28039809,28040109,0,0,0,300
34613,28039809,28039809,28040109,0,0,0,300
34614,28039809,28039809,28040109,0,0,0,300
34615,28039809,28039809,28040109,0,0,0,300
34616,28039810,28039810,28040110,0,0,0,300
34617,28039810,28039810,28040110,0,0,0,300
34618,28040064,28040064,28040265,0,0,0,201
34632,28040067,28040067,28040265,0,0,0,198
34621,28040065,28040065,28040266,0,0,0,201
34625,28040066,28040066,28040267,0,0,0,201
34633,28040068,28040068,28040277,0,0,0,209
34634,28040068,28040068,28040277,0,0,0,209
34635,28040068,28040068,28040288,0,0,0,220
34636,28040068,28040068,28040288,0,0,0,220
34622,28040065,28040065,28040294,0,0,0,229
34637,28040069,28040069,28040300,0,0,0,231
34638,28040069,28040069,28040300,0,0,0,231
34541,28037979,28037979,28040304,0,0,0,2325
34619,28040064,28040064,28040304,0,0,0,240
34639,28040069,28040069,28040311,0,0,0,242
34640,28040069,28040069,28040311,0,0,0,242
34641,28040069,28040069,28040311,0,0,0,242
34623,28040065,28040065,28040316,0,0,0,251
34642,28040070,28040070,28040323,0,0,0,253
34624,28040065,28040065,28040327,0,0,0,262
34626,28040066,28040066,28040328,0,0,0,262
34643,28040070,28040070,28040334,0,0,0,264
34644,28040070,28040070,28040334,0,0,0,264
34645,28040070,28040070,28040334,0,0,0,264
34627,28040066,28040066,28040339,0,0,0,273
34628,28040066,28040066,28040339,0,0,0,273
34646,28040070,28040070,28040345,0,0,0,275
34629,28040067,28040067,28040351,0,0,0,284
34630,28040067,28040067,28040351,0,0,0,284
34647,28040070,28040070,28040356,0,0,0,286
34631,28040067,28040067,28040362,0,0,0,295
34558,28039167,28039167,28040367,0,0,0,1200
34620,28040064,28040064,28040661,0,0,0,597
34649,28040513,28040513,28040661,0,0,0,148
34650,28040755,28040755,28040895,0,0,0,140
34651,28040960,28040960,28041010,0,0,0,50
34652,28040966,28040966,28041041,0,0,0,75
34653,28040966,28040966,28041041,0,0,0,75
34659,28040968,28040968,28041043,0,0,0,75
34658,28040967,28040967,28041051,0,0,0,84
34654,28040966,28040966,28041052,0,0,0,86
34655,28040967,28040967,28041053,0,0,0,86
34656,28040967,28040967,28041053,0,0,0,86
34657,28040967,28040967,28041053,0,0,0,86
34660,28041344,28041344,28041428,0,0,0,84
34661,28041642,28041642,28041720,0,0,0,78
34662,28041997,28041997,28042096,0,0,0,99
33611,27783094,27783094,28042294,0,0,0,259200
33612,27783094,27783094,28042294,0,0,0,259200
33613,27783094,27783094,28042294,0,0,0,259200
34664,28042230,28042230,28042323,0,0,0,93
34663,28042043,28042043,28042411,0,0,0,368
33614,27783233,27783233,28042433,0,0,0,259200
34665,28042490,28042490,28042745,0,0,0,255
34667,28042860,28042860,28043267,0,0,0,407
34668,28043260,28043260,28043474,0,0,0,214
34669,28043735,28043735,28043773,0,0,0,38
34164,28029671,28029671,28043977,0,0,0,14306
34670,28043953,28043953,28043998,0,0,0,45
34688,28044338,28044338,28044534,0,0,0,196
34689,28044338,28044338,28044557,0,0,0,219
34690,28044338,28044338,28044557,0,0,0,219
34691,28044338,28044338,28044568,0,0,0,230
34671,28044335,28044335,28044635,0,0,0,300
34672,28044335,28044335,28044635,0,0,0,300
34673,28044335,28044335,28044635,0,0,0,300
34674,28044335,28044335,28044635,0,0,0,300
34675,28044335,28044335,28044635,0,0,0,300
34676,28044335,28044335,28044635,0,0,0,300
34677,28044336,28044336,28044636,0,0,0,300
34678,28044336,28044336,28044636,0,0,0,300
34679,28044336,28044336,28044636,0,0,0,300
34680,28044336,28044336,28044636,0,0,0,300
34681,28044336,28044336,28044636,0,0,0,300
34683,28044337,28044337,28044637,0,0,0,300
34684,28044337,28044337,28044637,0,0,0,300
34685,28044337,28044337,28044637,0,0,0,300
34686,28044337,28044337,28044637,0,0,0,300
34687,28044338,28044338,28044638,0,0,0,300
34710,28044597,28044597,28044767,0,0,0,170
34715,28044598,28044598,28044768,0,0,0,170
34716,28044598,28044598,28044768,0,0,0,170
34717,28044598,28044598,28044768,0,0,0,170
34718,28044598,28044598,28044779,0,0,0,181
34719,28044598,28044598,28044779,0,0,0,181
34702,28044595,28044595,28044798,0,0,0,203
34703,28044595,28044595,28044798,0,0,0,203
34704,28044595,28044595,28044820,0,0,0,225
34705,28044595,28044595,28044820,0,0,0,225
34706,28044596,28044596,28044821,0,0,0,225
34707,28044596,28044596,28044821,0,0,0,225
34708,28044596,28044596,28044832,0,0,0,236
34709,28044596,28044596,28044832,0,0,0,236
34692,28044592,28044592,28044833,0,0,0,241
34693,28044592,28044592,28044833,0,0,0,241
34694,28044592,28044592,28044833,0,0,0,241
34711,28044597,28044597,28044844,0,0,0,247
34712,28044597,28044597,28044844,0,0,0,247
34695,28044593,28044593,28044845,0,0,0,252
34696,28044593,28044593,28044845,0,0,0,252
34713,28044597,28044597,28044855,0,0,0,258
34714,28044597,28044597,28044855,0,0,0,258
34697,28044593,28044593,28044856,0,0,0,263
34698,28044594,28044594,28044857,0,0,0,263
34699,28044594,28044594,28044868,0,0,0,274
34700,28044594,28044594,28044868,0,0,0,274
34701,28044594,28044594,28044879,0,0,0,285
34543,28038012,28038012,28044943,0,0,0,6931
34720,28044849,28044849,28044959,0,0,0,110
34052,27990463,27990463,28044976,0,0,0,54513
34721,28045057,28045057,28045357,0,0,0,300
34722,28045058,28045058,28045358,0,0,0,300
34723,28045058,28045058,28045358,0,0,0,300
34724,28045058,28045058,28045358,0,0,0,300
34725,28045058,28045058,28045358,0,0,0,300
34726,28045058,28045058,28045358,0,0,0,300
34727,28045058,28045058,28045358,0,0,0,300
34728,28045059,28045059,28045359,0,0,0,300
34729,28045059,28045059,28045359,0,0,0,300
34730,28045059,28045059,28045359,0,0,0,300
34731,28045059,28045059,28045359,0,0,0,300
34732,28045059,28045059,28045359,0,0,0,300
34733,28045059,28045059,28045359,0,0,0,300
34734,28045060,28045060,28045360,0,0,0,300
34735,28045060,28045060,28045360,0,0,0,300
34736,28045060,28045060,28045360,0,0,0,300
34737,28045060,28045060,28045360,0,0,0,300
34738,28045060,28045060,28045360,0,0,0,300
34739,28045060,28045060,28045360,0,0,0,300
34740,28045061,28045061,28045361,0,0,0,300
34741,28045061,28045061,28045361,0,0,0,300
34742,28045061,28045061,28045361,0,0,0,300
34743,28045061,28045061,28045361,0,0,0,300
34744,28045061,28045061,28045361,0,0,0,300
34745,28045061,28045061,28045361,0,0,0,300
34746,28045062,28045062,28045362,0,0,0,300
34747,28045062,28045062,28045362,0,0,0,300
34748,28045062,28045062,28045362,0,0,0,300
34749,28045062,28045062,28045362,0,0,0,300
34750,28045062,28045062,28045362,0,0,0,300
34751,28045062,28045062,28045362,0,0,0,300
34752,28045063,28045063,28045363,0,0,0,300
34753,28045063,28045063,28045363,0,0,0,300
34754,28045063,28045063,28045363,0,0,0,300
34755,28045063,28045063,28045363,0,0,0,300
34756,28045063,28045063,28045363,0,0,0,300
34757,28045063,28045063,28045363,0,0,0,300
34758,28045063,28045063,28045363,0,0,0,300
34759,28045256,28045256,28045556,0,0,0,300
34760,28045256,28045256,28045556,0,0,0,300
34761,28045257,28045257,28045557,0,0,0,300
34762,28045257,28045257,28045557,0,0,0,300
34763,28045257,28045257,28045557,0,0,0,300
34764,28045258,28045258,28045558,0,0,0,300
34765,28045258,28045258,28045558,0,0,0,300
34766,28045258,28045258,28045558,0,0,0,300
34767,28045258,28045258,28045558,0,0,0,300
34768,28045259,28045259,28045559,0,0,0,300
34769,28045259,28045259,28045559,0,0,0,300
34770,28045259,28045259,28045559,0,0,0,300
34771,28045259,28045259,28045559,0,0,0,300
34772,28045260,28045260,28045560,0,0,0,300
34773,28045260,28045260,28045560,0,0,0,300
34774,28045260,28045260,28045560,0,0,0,300
34775,28045694,28045694,28045809,0,0,0,115
34776,28045695,28045695,28045909,0,0,0,214
34777,28045697,28045697,28045911,0,0,0,214
34778,28045716,28045716,28045920,0,0,0,204
34779,28045938,28045938,28046111,0,0,0,173
34781,28046269,28046269,28046384,0,0,0,115
34648,28040286,28040286,28047098,0,0,0,6812
34783,28047619,28047619,28047672,0,0,0,53
34790,28047627,28047627,28047686,0,0,0,59
34786,28047626,28047626,28047707,0,0,0,81
34791,28047627,28047627,28047708,0,0,0,81
34789,28047626,28047626,28047712,0,0,0,86
34784,28047625,28047625,28047717,0,0,0,92
34785,28047625,28047625,28047717,0,0,0,92
34787,28047626,28047626,28047718,0,0,0,92
34788,28047626,28047626,28047718,0,0,0,92
34792,28047627,28047627,28047719,0,0,0,92
34794,28047628,28047628,28047720,0,0,0,92
34795,28047628,28047628,28047720,0,0,0,92
34796,28047628,28047628,28047720,0,0,0,92
34799,28047629,28047629,28047721,0,0,0,92
34800,28047629,28047629,28047734,0,0,0,105
34798,28047629,28047712,28047804,0,0,83,175
34793,28047627,28047712,28047810,0,0,85,183
34797,28047628,28047718,28047815,0,0,90,187
34801,28047718,28047815,28047904,0,0,97,186
34780,28046143,28046143,28048026,0,0,0,1883
34168,28030236,28030236,28048268,0,0,0,18032
34167,28030114,28030114,28048279,0,0,0,18165
33630,27789748,27789748,28048948,0,0,0,259200
34802,28048963,28048963,28049040,0,0,0,77
34804,28049011,28049011,28049102,0,0,0,91
34803,28048982,28048982,28049106,0,0,0,124
34807,28049696,28049696,28049811,0,0,0,115
34081,28023594,28023594,28049878,0,0,0,26284
34808,28050053,28050053,28050172,0,0,0,119
34809,28050234,28050234,28050349,0,0,0,115
34810,28050426,28050426,28050530,0,0,0,104
34811,28050670,28050670,28050785,0,0,0,115
34822,28050904,28050904,28051110,0,0,0,206
34823,28050905,28050905,28051111,0,0,0,206
34824,28050905,28050905,28051123,0,0,0,218
34825,28050905,28050905,28051134,0,0,0,229
34826,28050905,28050905,28051134,0,0,0,229
34827,28050905,28050905,28051134,0,0,0,229
34828,28050905,28050905,28051145,0,0,0,240
34829,28050905,28050905,28051145,0,0,0,240
34848,28051160,28051160,28051367,0,0,0,207
34849,28051160,28051160,28051367,0,0,0,207
34812,28050902,28050902,28051368,0,0,0,466
34834,28051156,28051156,28051368,0,0,0,212
34813,28050903,28050903,28051369,0,0,0,466
34814,28050903,28050903,28051369,0,0,0,466
34815,28050903,28050903,28051369,0,0,0,466
34816,28050903,28050903,28051369,0,0,0,466
34835,28051157,28051157,28051369,0,0,0,212
34817,28050904,28050904,28051370,0,0,0,466
34818,28050904,28050904,28051370,0,0,0,466
34819,28050904,28050904,28051370,0,0,0,466
34820,28050904,28050904,28051370,0,0,0,466
34821,28050904,28050904,28051370,0,0,0,466
34850,28051160,28051160,28051378,0,0,0,218
34851,28051160,28051160,28051378,0,0,0,218
34852,28051161,28051161,28051379,0,0,0,218
34836,28051157,28051157,28051380,0,0,0,223
34853,28051161,28051161,28051390,0,0,0,229
34854,28051161,28051161,28051390,0,0,0,229
34837,28051157,28051157,28051391,0,0,0,234
34838,28051157,28051157,28051391,0,0,0,234
34855,28051161,28051161,28051401,0,0,0,240
34839,28051158,28051158,28051403,0,0,0,245
34840,28051158,28051158,28051403,0,0,0,245
34841,28051158,28051158,28051403,0,0,0,245
34842,28051158,28051158,28051403,0,0,0,245
34830,28051155,28051155,28051406,0,0,0,251
34831,28051155,28051155,28051406,0,0,0,251
34843,28051159,28051159,28051415,0,0,0,256
34832,28051156,28051156,28051418,0,0,0,262
34833,28051156,28051156,28051418,0,0,0,262
34844,28051159,28051159,28051426,0,0,0,267
34845,28051159,28051159,28051426,0,0,0,267
34846,28051160,28051160,28051427,0,0,0,267
34847,28051160,28051160,28051438,0,0,0,278
34540,28037966,28037966,28051497,0,0,0,13531
34542,28037995,28037995,28051560,0,0,0,13565
34887,28051838,28051838,28051912,0,0,0,74
34874,28051835,28051835,28052039,0,0,0,204
34875,28051835,28051835,28052039,0,0,0,204
34892,28051838,28051838,28052049,0,0,0,211
34876,28051836,28051836,28052051,0,0,0,215
34877,28051836,28051836,28052051,0,0,0,215
34878,28051836,28051836,28052067,0,0,0,231
34879,28051836,28051836,28052067,0,0,0,231
34880,28051836,28051836,28052067,0,0,0,231
34881,28051837,28051837,28052079,0,0,0,242
34882,28051837,28051837,28052079,0,0,0,242
34857,28051832,28051832,28052084,0,0,0,252
34858,28051832,28051832,28052084,0,0,0,252
34859,28051832,28051832,28052084,0,0,0,252
34860,28051833,28051833,28052085,0,0,0,252
34861,28051833,28051833,28052085,0,0,0,252
34862,28051833,28051833,28052085,0,0,0,252
34863,28051833,28051833,28052085,0,0,0,252
34864,28051833,28051833,28052085,0,0,0,252
34865,28051834,28051834,28052086,0,0,0,252
34866,28051834,28051834,28052086,0,0,0,252
34867,28051834,28051834,28052086,0,0,0,252
34883,28051837,28051837,28052090,0,0,0,253
34884,28051837,28051837,28052101,0,0,0,264
34885,28051837,28051837,28052101,0,0,0,264
34886,28051837,28051837,28052101,0,0,0,264
34888,28051838,28051838,28052102,0,0,0,264
34868,28051834,28051834,28052103,0,0,0,269
34869,28051834,28051834,28052103,0,0,0,269
34870,28051834,28051834,28052103,0,0,0,269
34889,28051838,28051838,28052113,0,0,0,275
34871,28051835,28051835,28052115,0,0,0,280
34872,28051835,28051835,28052115,0,0,0,280
34890,28051838,28051838,28052124,0,0,0,286
34891,28051838,28051838,28052124,0,0,0,286
34873,28051835,28051835,28052126,0,0,0,291
34893,28051915,28051915,28052137,0,0,0,222
34895,28051916,28051916,28052138,0,0,0,222
34896,28051916,28051916,28052154,0,0,0,238
34897,28051916,28051916,28052154,0,0,0,238
34898,28051916,28051916,28052154,0,0,0,238
34894,28051915,28051915,28052164,0,0,0,249
34899,28052110,28052110,28052167,0,0,0,57
34901,28052229,28052229,28052278,0,0,0,49
34900,28052170,28052170,28052373,0,0,0,203
34902,28052336,28052336,28052374,0,0,0,38
34938,28052780,28052780,28052871,0,0,0,91
34918,28052776,28052776,28052975,0,0,0,199
34936,28052779,28052779,28052980,0,0,0,201
34919,28052776,28052776,28052986,0,0,0,210
34920,28052776,28052776,28052986,0,0,0,210
34937,28052779,28052779,28052991,0,0,0,212
34939,28052780,28052780,28052992,0,0,0,212
34921,28052776,28052776,28052997,0,0,0,221
34922,28052776,28052776,28053008,0,0,0,232
34923,28052777,28052777,28053009,0,0,0,232
34924,28052777,28052777,28053009,0,0,0,232
34940,28052780,28052780,28053014,0,0,0,234
34941,28052780,28052780,28053014,0,0,0,234
34925,28052777,28052777,28053020,0,0,0,243
34942,28052780,28052780,28053025,0,0,0,245
34943,28052781,28052781,28053026,0,0,0,245
34926,28052777,28052777,28053031,0,0,0,254
34927,28052778,28052778,28053032,0,0,0,254
34928,28052778,28052778,28053032,0,0,0,254
34903,28052771,28052771,28053033,0,0,0,262
34904,28052772,28052772,28053034,0,0,0,262
34905,28052772,28052772,28053034,0,0,0,262
34906,28052772,28052772,28053034,0,0,0,262
34907,28052773,28052773,28053035,0,0,0,262
34908,28052773,28052773,28053035,0,0,0,262
34909,28052773,28052773,28053035,0,0,0,262
34910,28052774,28052774,28053036,0,0,0,262
34911,28052774,28052774,28053036,0,0,0,262
34912,28052774,28052774,28053036,0,0,0,262
34913,28052774,28052774,28053036,0,0,0,262
34929,28052778,28052778,28053043,0,0,0,265
34914,28052775,28052775,28053049,0,0,0,274
34915,28052775,28052775,28053049,0,0,0,274
34930,28052778,28052778,28053054,0,0,0,276
34932,28052779,28052779,28053055,0,0,0,276
34916,28052775,28052775,28053060,0,0,0,285
34931,28052778,28052778,28053065,0,0,0,287
34933,28052779,28052779,28053066,0,0,0,287
34917,28052775,28052775,28053071,0,0,0,296
34934,28052779,28052779,28053077,0,0,0,298
34935,28052779,28052779,28053077,0,0,0,298
34944,28053063,28053063,28053120,0,0,0,57
34494,28037033,28037033,28053357,0,0,0,16324
34098,28025187,28025187,28053426,0,0,0,28239
34493,28037025,28037025,28053448,0,0,0,16423
34972,28053804,28053804,28053999,0,0,0,195
34962,28053802,28053802,28054014,0,0,0,212
34963,28053802,28053802,28054014,0,0,0,212
34964,28053802,28053802,28054025,0,0,0,223
34965,28053802,28053802,28054025,0,0,0,223
34966,28053802,28053802,28054036,0,0,0,234
34967,28053803,28053803,28054037,0,0,0,234
34968,28053803,28053803,28054037,0,0,0,234
34969,28053803,28053803,28054048,0,0,0,245
34970,28053803,28053803,28054048,0,0,0,245
34971,28053803,28053803,28054069,0,0,0,266
34973,28053804,28053804,28054070,0,0,0,266
34974,28053804,28053804,28054070,0,0,0,266
34982,28053882,28053882,28054073,0,0,0,191
34975,28053804,28053804,28054081,0,0,0,277
34976,28053804,28053804,28054081,0,0,0,277
34947,28053799,28053799,28054092,0,0,0,293
34948,28053799,28053799,28054092,0,0,0,293
34949,28053799,28053799,28054092,0,0,0,293
34950,28053799,28053799,28054092,0,0,0,293
34951,28053799,28053799,28054092,0,0,0,293
34952,28053800,28053800,28054093,0,0,0,293
34953,28053800,28053800,28054093,0,0,0,293
34954,28053800,28053800,28054093,0,0,0,293
34955,28053800,28053800,28054093,0,0,0,293
34956,28053801,28053801,28054094,0,0,0,293
34957,28053801,28053801,28054094,0,0,0,293
34958,28053801,28053801,28054094,0,0,0,293
34959,28053801,28053801,28054094,0,0,0,293
34960,28053801,28053801,28054094,0,0,0,293
34961,28053802,28053802,28054095,0,0,0,293
34983,28053883,28053883,28054096,0,0,0,213
34984,28053883,28053883,28054096,0,0,0,213
34985,28053883,28053883,28054096,0,0,0,213
34987,28053884,28053884,28054097,0,0,0,213
34986,28053883,28053883,28054107,0,0,0,224
34988,28053884,28053884,28054119,0,0,0,235
34989,28053884,28053884,28054119,0,0,0,235
34990,28053884,28053884,28054130,0,0,0,246
34991,28053885,28053885,28054131,0,0,0,246
34992,28053885,28053885,28054131,0,0,0,246
34993,28053885,28053885,28054142,0,0,0,257
34994,28053886,28053886,28054154,0,0,0,268
34995,28053886,28053886,28054154,0,0,0,268
34979,28053882,28053882,28054159,0,0,0,277
34977,28053881,28053881,28054160,0,0,0,279
34980,28053882,28053882,28054170,0,0,0,288
34981,28053882,28053882,28054181,0,0,0,299
34996,28054174,28054174,28054245,0,0,0,71
34997,28054230,28054230,28054328,0,0,0,98
34998,28054230,28054230,28054438,0,0,0,208
35035,28054823,28054823,28054913,0,0,0,90
34999,28054727,28054727,28054984,0,0,0,257
35000,28054727,28054727,28054984,0,0,0,257
35001,28054727,28054727,28054984,0,0,0,257
35002,28054727,28054727,28054984,0,0,0,257
35003,28054728,28054728,28054985,0,0,0,257
35004,28054728,28054728,28054985,0,0,0,257
35005,28054728,28054728,28054985,0,0,0,257
35006,28054728,28054728,28054985,0,0,0,257
35007,28054728,28054728,28054985,0,0,0,257
35008,28054729,28054729,28054986,0,0,0,257
35009,28054729,28054729,28054997,0,0,0,268
35010,28054729,28054729,28054997,0,0,0,268
35011,28054729,28054729,28054997,0,0,0,268
35012,28054729,28054729,28054997,0,0,0,268
35018,28054818,28054818,28055022,0,0,0,204
35019,28054818,28054818,28055033,0,0,0,215
35034,28054822,28054822,28055033,0,0,0,211
35020,28054819,28054819,28055034,0,0,0,215
35021,28054819,28054819,28055034,0,0,0,215
35036,28054823,28054823,28055034,0,0,0,211
35037,28054823,28054823,28055034,0,0,0,211
35022,28054819,28054819,28055045,0,0,0,226
35023,28054819,28054819,28055045,0,0,0,226
35038,28054823,28054823,28055045,0,0,0,222
35039,28054823,28054823,28055045,0,0,0,222
35024,28054820,28054820,28055046,0,0,0,226
35015,28054817,28054817,28055050,0,0,0,233
35025,28054820,28054820,28055057,0,0,0,237
35040,28054826,28054826,28055059,0,0,0,233
35026,28054820,28054820,28055068,0,0,0,248
35027,28054820,28054820,28055068,0,0,0,248
35028,28054821,28054821,28055080,0,0,0,259
35029,28054821,28054821,28055080,0,0,0,259
35013,28054817,28054817,28055085,0,0,0,268
35030,28054821,28054821,28055091,0,0,0,270
35031,28054822,28054822,28055092,0,0,0,270
35032,28054822,28054822,28055092,0,0,0,270
35014,28054817,28054817,28055102,0,0,0,285
35016,28054818,28054818,28055103,0,0,0,285
35017,28054818,28054818,28055103,0,0,0,285
35033,28054822,28054822,28055114,0,0,0,292
35041,28054910,28054910,28055154,0,0,0,244
35042,28054912,28054912,28055156,0,0,0,244
35043,28055181,28055181,28055385,0,0,0,204
35077,28055843,28055843,28056045,0,0,0,202
35062,28055839,28055839,28056056,0,0,0,217
35063,28055839,28055839,28056056,0,0,0,217
35064,28055839,28055839,28056056,0,0,0,217
35078,28055843,28055843,28056056,0,0,0,213
35079,28055843,28055843,28056056,0,0,0,213
35044,28055759,28055759,28056057,0,0,0,298
35045,28055759,28055759,28056057,0,0,0,298
35046,28055759,28055759,28056057,0,0,0,298
35047,28055759,28055759,28056057,0,0,0,298
35048,28055759,28055759,28056057,0,0,0,298
35065,28055840,28055840,28056057,0,0,0,217
35066,28055840,28055840,28056057,0,0,0,217
35080,28055844,28055844,28056057,0,0,0,213
35081,28055844,28055844,28056057,0,0,0,213
35049,28055760,28055760,28056058,0,0,0,298
35050,28055760,28055760,28056058,0,0,0,298
35051,28055760,28055760,28056058,0,0,0,298
35052,28055760,28055760,28056058,0,0,0,298
35053,28055760,28055760,28056058,0,0,0,298
35054,28055760,28055760,28056058,0,0,0,298
35055,28055761,28055761,28056059,0,0,0,298
35056,28055761,28055761,28056059,0,0,0,298
35057,28055761,28055761,28056059,0,0,0,298
35058,28055761,28055761,28056059,0,0,0,298
35059,28055761,28055761,28056059,0,0,0,298
35067,28055840,28055840,28056068,0,0,0,228
35082,28055844,28055844,28056068,0,0,0,224
35083,28055844,28055844,28056079,0,0,0,235
35068,28055841,28055841,28056080,0,0,0,239
35084,28055845,28055845,28056080,0,0,0,235
35085,28055845,28055845,28056080,0,0,0,235
35069,28055841,28055841,28056091,0,0,0,250
35070,28055841,28055841,28056091,0,0,0,250
35086,28055845,28055845,28056091,0,0,0,246
35071,28055842,28055842,28056092,0,0,0,250
35087,28055845,28055845,28056102,0,0,0,257
35088,28055845,28055845,28056102,0,0,0,257
35072,28055842,28055842,28056103,0,0,0,261
35073,28055842,28055842,28056103,0,0,0,261
35074,28055842,28055842,28056103,0,0,0,261
35089,28055846,28055846,28056103,0,0,0,257
35075,28055843,28055843,28056104,0,0,0,261
35090,28055846,28055846,28056125,0,0,0,279
35091,28055846,28055846,28056125,0,0,0,279
35092,28055846,28055846,28056125,0,0,0,279
35076,28055843,28055843,28056126,0,0,0,283
35060,28055838,28055838,28056128,0,0,0,290
35061,28055839,28055839,28056137,0,0,0,298
35093,28055936,28055936,28056145,0,0,0,209
35094,28055938,28055938,28056228,0,0,0,290
35095,28056134,28056134,28056343,0,0,0,209
34162,28029625,28029625,28057964,0,0,0,28339
34496,28037497,28037497,28059180,0,0,0,21683
34163,28029647,28029647,28060708,0,0,0,31061
34782,28047525,28047525,28062759,0,0,0,15234
34806,28049301,28049301,28064223,0,0,0,14922
34682,28044336,28044336,28064629,0,0,0,20293
34945,28053320,28053320,28069566,0,0,0,16246
34946,28053401,28053401,28069696,0,0,0,16295
34226,28031292,28031292,28069734,0,0,0,38442
34978,28053881,28053881,28070269,0,0,0,16388
34099,28025272,28025272,28071591,0,0,0,46319
34101,28025382,28025382,28071945,0,0,0,46563
34045,27974860,27974860,28072098,0,0,0,97238
34102,28025413,28025413,28072765,0,0,0,47352
34103,28025455,28025455,28073055,0,0,0,47600
34067,28016898,28016898,28075348,0,0,0,58450
34104,28025477,28025477,28075650,0,0,0,50173
35097,28064180,28064180,28079042,0,0,0,14862
35098,28069533,28069533,28085884,0,0,0,16351
35099,28069651,28069651,28085946,0,0,0,16295
35100,28070231,28070231,28086547,0,0,0,16316
35103,28079004,28079004,28093678,0,0,0,14674
35104,28085837,28085837,28102177,0,0,0,16340
35105,28085912,28085912,28102347,0,0,0,16435
35106,28086511,28086511,28102892,0,0,0,16381
34096,28025180,28025180,28107623,0,0,0,82443
35107,28093632,28093632,28108488,0,0,0,14856
33733,27938451,27938451,28109556,0,0,0,171105
34161,28029592,28029592,28111900,0,0,0,82308
35108,28102133,28102133,28118411,0,0,0,16278
35109,28102304,28102304,28118579,0,0,0,16275
35110,28102849,28102849,28119190,0,0,0,16341
34353,28034730,28034730,28121781,0,0,0,87051
35111,28108446,28108446,28123267,0,0,0,14821
35102,28075316,28075316,28134001,0,0,0,58685
35112,28118375,28118375,28134667,0,0,0,16292
35113,28118538,28118538,28134847,0,0,0,16309
35139,28135243,28135243,28135397,0,0,0,154
35140,28135244,28135244,28135398,0,0,0,154
35141,28135244,28135244,28135398,0,0,0,154
35142,28135244,28135244,28135398,0,0,0,154
35143,28135244,28135244,28135398,0,0,0,154
35144,28135244,28135244,28135398,0,0,0,154
35146,28135245,28135245,28135416,0,0,0,171
35145,28135244,28135244,28135426,0,0,0,182
35147,28135245,28135245,28135427,0,0,0,182
35148,28135245,28135245,28135427,0,0,0,182
35149,28135245,28135245,28135438,0,0,0,193
35150,28135245,28135245,28135438,0,0,0,193
35151,28135245,28135245,28135438,0,0,0,193
35152,28135246,28135246,28135450,0,0,0,204
35153,28135246,28135246,28135450,0,0,0,204
35154,28135246,28135246,28135450,0,0,0,204
35155,28135246,28135246,28135461,0,0,0,215
35156,28135246,28135246,28135483,0,0,0,237
35157,28135246,28135246,28135494,0,0,0,248
35117,28135238,28135238,28135556,0,0,0,318
35118,28135239,28135239,28135557,0,0,0,318
35119,28135239,28135239,28135557,0,0,0,318
35120,28135240,28135240,28135558,0,0,0,318
35121,28135240,28135240,28135558,0,0,0,318
35122,28135240,28135240,28135558,0,0,0,318
35123,28135240,28135240,28135558,0,0,0,318
35124,28135241,28135241,28135559,0,0,0,318
35125,28135241,28135241,28135559,0,0,0,318
35126,28135241,28135241,28135559,0,0,0,318
35127,28135241,28135241,28135559,0,0,0,318
35128,28135242,28135242,28135560,0,0,0,318
35129,28135242,28135242,28135560,0,0,0,318
35130,28135242,28135242,28135560,0,0,0,318
35131,28135242,28135242,28135560,0,0,0,318
35132,28135242,28135242,28135560,0,0,0,318
35133,28135242,28135242,28135560,0,0,0,318
35134,28135243,28135243,28135561,0,0,0,318
35135,28135243,28135243,28135561,0,0,0,318
35136,28135243,28135243,28135561,0,0,0,318
35137,28135243,28135243,28135561,0,0,0,318
35138,28135243,28135243,28135561,0,0,0,318
35160,28135385,28135385,28135611,0,0,0,226
35158,28135384,28135384,28135621,0,0,0,237
35161,28135385,28135385,28135633,0,0,0,248
35162,28135385,28135385,28135633,0,0,0,248
35159,28135384,28135384,28135643,0,0,0,259
35163,28135385,28135385,28135644,0,0,0,259
35164,28135388,28135388,28135647,0,0,0,259
35165,28135391,28135391,28135650,0,0,0,259
35166,28135548,28135548,28135818,0,0,0,270
35167,28135702,28135702,28135829,0,0,0,127
34059,27991088,27991088,28136478,0,0,0,145390
35115,28123223,28123223,28138198,0,0,0,14975
35188,28141366,28141366,28141560,0,0,0,194
35189,28141366,28141366,28141571,0,0,0,205
35190,28141366,28141366,28141571,0,0,0,205
35191,28141366,28141366,28141582,0,0,0,216
35192,28141366,28141366,28141582,0,0,0,216
35193,28141366,28141366,28141593,0,0,0,227
35194,28141366,28141366,28141593,0,0,0,227
35169,28141356,28141356,28141594,0,0,0,238
35170,28141363,28141363,28141605,0,0,0,242
35171,28141363,28141363,28141605,0,0,0,242
35172,28141363,28141363,28141605,0,0,0,242
35173,28141363,28141363,28141605,0,0,0,242
35174,28141364,28141364,28141606,0,0,0,242
35175,28141364,28141364,28141606,0,0,0,242
35176,28141364,28141364,28141606,0,0,0,242
35177,28141364,28141364,28141606,0,0,0,242
35178,28141364,28141364,28141606,0,0,0,242
35179,28141364,28141364,28141606,0,0,0,242
35180,28141364,28141364,28141617,0,0,0,253
35181,28141365,28141365,28141629,0,0,0,264
35182,28141365,28141365,28141629,0,0,0,264
35183,28141365,28141365,28141629,0,0,0,264
35184,28141365,28141365,28141640,0,0,0,275
35185,28141365,28141365,28141640,0,0,0,275
35186,28141365,28141365,28141651,0,0,0,286
35187,28141365,28141365,28141651,0,0,0,286
35195,28141504,28141504,28141676,0,0,0,172
35204,28141506,28141506,28141696,0,0,0,190
35205,28141507,28141507,28141708,0,0,0,201
35206,28141507,28141507,28141719,0,0,0,212
35207,28141507,28141507,28141719,0,0,0,212
35208,28141507,28141507,28141719,0,0,0,212
35196,28141504,28141504,28141738,0,0,0,234
35209,28141508,28141508,28141742,0,0,0,234
35197,28141505,28141505,28141743,0,0,0,238
35198,28141505,28141505,28141754,0,0,0,249
35199,28141505,28141505,28141754,0,0,0,249
35200,28141505,28141505,28141765,0,0,0,260
35201,28141506,28141506,28141766,0,0,0,260
35202,28141506,28141506,28141788,0,0,0,282
35203,28141506,28141506,28141788,0,0,0,282
35211,28146670,28146670,28146942,0,0,0,272
35212,28146670,28146670,28146942,0,0,0,272
35213,28146671,28146671,28146943,0,0,0,272
35214,28146671,28146671,28146943,0,0,0,272
35215,28146671,28146671,28146943,0,0,0,272
35216,28146672,28146672,28146944,0,0,0,272
35217,28146672,28146672,28146944,0,0,0,272
35218,28146672,28146672,28146944,0,0,0,272
35219,28146672,28146672,28146944,0,0,0,272
35220,28146673,28146673,28146945,0,0,0,272
35221,28146673,28146673,28146945,0,0,0,272
35222,28146673,28146673,28146945,0,0,0,272
35223,28146673,28146673,28146945,0,0,0,272
35224,28146673,28146673,28146945,0,0,0,272
35225,28146673,28146673,28146945,0,0,0,272
35244,28146786,28146786,28146990,0,0,0,204
35245,28146787,28146787,28146991,0,0,0,204
35229,28146783,28146783,28146997,0,0,0,214
35230,28146784,28146784,28146998,0,0,0,214
35231,28146784,28146784,28146998,0,0,0,214
35232,28146784,28146784,28146998,0,0,0,214
35246,28146787,28146787,28147002,0,0,0,215
35247,28146787,28146787,28147002,0,0,0,215
35248,28146787,28146787,28147013,0,0,0,226
35233,28146784,28146784,28147020,0,0,0,236
35234,28146785,28146785,28147021,0,0,0,236
35235,28146785,28146785,28147021,0,0,0,236
35236,28146785,28146785,28147021,0,0,0,236
35249,28146787,28146787,28147024,0,0,0,237
35250,28146787,28146787,28147024,0,0,0,237
35251,28146787,28146787,28147024,0,0,0,237
35252,28146788,28146788,28147025,0,0,0,237
35237,28146785,28146785,28147032,0,0,0,247
35238,28146785,28146785,28147043,0,0,0,258
35239,28146786,28146786,28147044,0,0,0,258
35240,28146786,28146786,28147044,0,0,0,258
35253,28146788,28146788,28147047,0,0,0,259
35254,28146788,28146788,28147047,0,0,0,259
35255,28146788,28146788,28147047,0,0,0,259
35241,28146786,28146786,28147055,0,0,0,269
35242,28146786,28146786,28147055,0,0,0,269
35226,28146780,28146780,28147064,0,0,0,284
35227,28146781,28146781,28147065,0,0,0,284
35228,28146782,28146782,28147066,0,0,0,284
35243,28146786,28146786,28147066,0,0,0,280
35256,28146883,28146883,28147142,0,0,0,259
34053,27990720,27990720,28149120,0,0,0,158400
34054,27990760,27990760,28149160,0,0,0,158400
34055,27990868,27990868,28149268,0,0,0,158400
34056,27990894,27990894,28149294,0,0,0,158400
34057,27990945,27990945,28149345,0,0,0,158400
34058,27991029,27991029,28149429,0,0,0,158400
34060,27991158,27991158,28149558,0,0,0,158400
34061,27991335,27991335,28149735,0,0,0,158400
34063,27991722,27991722,28150122,0,0,0,158400
35275,28151924,28151924,28152116,0,0,0,192
35276,28151924,28151924,28152127,0,0,0,203
35277,28151924,28151924,28152138,0,0,0,214
35278,28151924,28151924,28152138,0,0,0,214
35279,28151924,28151924,28152138,0,0,0,214
35280,28151924,28151924,28152149,0,0,0,225
35281,28151924,28151924,28152149,0,0,0,225
35282,28151925,28151925,28152161,0,0,0,236
35283,28151925,28151925,28152172,0,0,0,247
35284,28151925,28151925,28152172,0,0,0,247
35258,28151921,28151921,28152177,0,0,0,256
35259,28151921,28151921,28152177,0,0,0,256
35260,28151921,28151921,28152177,0,0,0,256
35261,28151921,28151921,28152177,0,0,0,256
35262,28151921,28151921,28152177,0,0,0,256
35263,28151922,28151922,28152178,0,0,0,256
35264,28151922,28151922,28152178,0,0,0,256
35265,28151922,28151922,28152178,0,0,0,256
35266,28151922,28151922,28152178,0,0,0,256
35267,28151922,28151922,28152178,0,0,0,256
35268,28151922,28151922,28152178,0,0,0,256
35285,28151925,28151925,28152183,0,0,0,258
35286,28151925,28151925,28152183,0,0,0,258
35287,28151926,28151926,28152184,0,0,0,258
35269,28151923,28151923,28152190,0,0,0,267
35270,28151923,28151923,28152190,0,0,0,267
35271,28151923,28151923,28152190,0,0,0,267
35288,28151926,28151926,28152195,0,0,0,269
35293,28151994,28151994,28152199,0,0,0,205
35294,28151994,28151994,28152199,0,0,0,205
35272,28151923,28151923,28152201,0,0,0,278
35273,28151923,28151923,28152201,0,0,0,278
35289,28151926,28151926,28152206,0,0,0,280
35290,28151926,28151926,28152206,0,0,0,280
35291,28151926,28151926,28152206,0,0,0,280
35295,28151994,28151994,28152210,0,0,0,216
35296,28151995,28151995,28152211,0,0,0,216
35274,28151923,28151923,28152212,0,0,0,289
35297,28151995,28151995,28152222,0,0,0,227
35298,28151995,28151995,28152222,0,0,0,227
35299,28151995,28151995,28152233,0,0,0,238
35300,28151996,28151996,28152234,0,0,0,238
35292,28151993,28151993,28152242,0,0,0,249
35301,28152274,28152274,28152523,0,0,0,249
35168,28138161,28138161,28153150,0,0,0,14989
35303,28154825,28154825,28154958,0,0,0,133
35210,28146663,28146663,28157914,0,0,0,11251
35302,28153107,28153107,28168132,0,0,0,15025
35257,28151916,28151916,28168280,0,0,0,16364
35101,28072061,28072061,28170187,0,0,0,98126
35304,28155014,28155014,28171370,0,0,0,16356
35305,28155126,28155126,28171433,0,0,0,16307
35311,28173657,28173657,28173704,0,0,0,47
35306,28168091,28168091,28183111,0,0,0,15020
35307,28168247,28168247,28184572,0,0,0,16325
35309,28171328,28171328,28187711,0,0,0,16383
35310,28171389,28171389,28187786,0,0,0,16397
35312,28173723,28173723,28189103,0,0,0,15380
35116,28133960,28133960,28192650,0,0,0,58690
35313,28183065,28183065,28198146,0,0,0,15081
35319,28200350,28200350,28200390,0,0,0,40
35320,28200510,28200510,28200662,0,0,0,152
35314,28184531,28184531,28200722,0,0,0,16191
35321,28200652,28200652,28200828,0,0,0,176
35323,28201040,28201040,28201812,0,0,0,772
34170,28030414,28030414,28203214,0,0,0,172800
35324,28203477,28203477,28203586,0,0,0,109
35315,28187668,28187668,28203954,0,0,0,16286
35316,28187746,28187746,28203975,0,0,0,16229
35327,28205410,28205410,28205593,0,0,0,183
35114,28121747,28121747,28207949,0,0,0,86202
35318,28198103,28198103,28213209,0,0,0,15106
35322,28200681,28200681,28216876,0,0,0,16195
34666,28042632,28042632,28218365,0,0,0,175733
35325,28203904,28203904,28220095,0,0,0,16191
35326,28203933,28203933,28220154,0,0,0,16221
35368,28221175,28221175,28221370,0,0,0,195
35369,28221175,28221175,28221381,0,0,0,206
35370,28221175,28221175,28221381,0,0,0,206
35371,28221175,28221175,28221381,0,0,0,206
35372,28221175,28221175,28221392,0,0,0,217
35373,28221175,28221175,28221403,0,0,0,228
35334,28221167,28221167,28221474,0,0,0,307
35335,28221169,28221169,28221476,0,0,0,307
35336,28221169,28221169,28221476,0,0,0,307
35337,28221169,28221169,28221476,0,0,0,307
35338,28221170,28221170,28221477,0,0,0,307
35339,28221170,28221170,28221477,0,0,0,307
35340,28221170,28221170,28221477,0,0,0,307
35341,28221170,28221170,28221477,0,0,0,307
35342,28221170,28221170,28221477,0,0,0,307
35343,28221170,28221170,28221493,0,0,0,323
35344,28221171,28221171,28221494,0,0,0,323
35345,28221171,28221171,28221494,0,0,0,323
35346,28221171,28221171,28221505,0,0,0,334
35347,28221171,28221171,28221516,0,0,0,345
35348,28221171,28221171,28221516,0,0,0,345
35349,28221172,28221172,28221528,0,0,0,356
35350,28221172,28221172,28221528,0,0,0,356
35351,28221172,28221172,28221539,0,0,0,367
35352,28221172,28221172,28221539,0,0,0,367
35353,28221172,28221172,28221550,0,0,0,378
35354,28221172,28221172,28221561,0,0,0,389
35355,28221173,28221173,28221562,0,0,0,389
35356,28221173,28221173,28221562,0,0,0,389
35357,28221173,28221173,28221573,0,0,0,400
35358,28221173,28221173,28221573,0,0,0,400
35359,28221173,28221173,28221584,0,0,0,411
35360,28221173,28221173,28221584,0,0,0,411
35361,28221174,28221174,28221585,0,0,0,411
35362,28221174,28221174,28221596,0,0,0,422
35363,28221174,28221174,28221596,0,0,0,422
35364,28221174,28221174,28221607,0,0,0,433
35365,28221174,28221174,28221607,0,0,0,433
35366,28221174,28221174,28221607,0,0,0,433
35367,28221174,28221174,28221618,0,0,0,444
35374,28221425,28221425,28221653,0,0,0,228
35331,28218557,28218557,28222279,0,0,0,3722
35375,28221472,28221472,28226960,0,0,0,5488
35329,28213169,28213169,28228223,0,0,0,15054
34044,27972626,27972626,28231826,0,0,0,259200
35330,28216842,28216842,28232934,0,0,0,16092
35332,28220054,28220054,28236264,0,0,0,16210
35333,28220101,28220101,28236280,0,0,0,16179
35382,28237239,28237239,28237565,0,0,0,326
35379,28235282,28235282,28238247,0,0,0,2965
35377,28232813,28232813,28241452,0,0,0,8639
35383,28237618,28237618,28243172,0,0,0,5554
35376,28228183,28228183,28243191,0,0,0,15008
35378,28232891,28232891,28248884,0,0,0,15993
35317,28192619,28192619,28251167,0,0,0,58548
35386,28251493,28251493,28251553,0,0,0,60
35381,28236249,28236249,28252252,0,0,0,16003
35380,28236227,28236227,28252263,0,0,0,16036
35384,28243151,28243151,28258202,0,0,0,15051
35387,28251571,28251571,28262391,0,0,0,10820
35385,28248844,28248844,28264908,0,0,0,16064
35308,28170143,28170143,28267834,0,0,0,97691
35388,28252201,28252201,28268151,0,0,0,15950
35389,28252229,28252229,28268226,0,0,0,15997
35390,28258156,28258156,28273240,0,0,0,15084
34223,28030901,28030901,28276412,0,0,0,245511
35396,28278233,28278233,28278306,0,0,0,73
35391,28264871,28264871,28280768,0,0,0,15897
35416,28281175,28281175,28281380,0,0,0,205
35417,28281176,28281176,28281381,0,0,0,205
35418,28281176,28281176,28281381,0,0,0,205
35419,28281176,28281176,28281392,0,0,0,216
35420,28281176,28281176,28281403,0,0,0,227
35421,28281176,28281176,28281403,0,0,0,227
35422,28281176,28281176,28281403,0,0,0,227
35399,28281173,28281173,28281414,0,0,0,241
35400,28281173,28281173,28281414,0,0,0,241
35401,28281173,28281173,28281414,0,0,0,241
35402,28281173,28281173,28281414,0,0,0,241
35403,28281173,28281173,28281414,0,0,0,241
35404,28281173,28281173,28281414,0,0,0,241
35405,28281174,28281174,28281415,0,0,0,241
35406,28281174,28281174,28281415,0,0,0,241
35407,28281174,28281174,28281415,0,0,0,241
35423,28281177,28281177,28281415,0,0,0,238
35424,28281177,28281177,28281415,0,0,0,238
35408,28281174,28281174,28281426,0,0,0,252
35409,28281174,28281174,28281426,0,0,0,252
35425,28281177,28281177,28281426,0,0,0,249
35426,28281177,28281177,28281437,0,0,0,260
35427,28281177,28281177,28281437,0,0,0,260
35410,28281174,28281174,28281448,0,0,0,274
35411,28281175,28281175,28281449,0,0,0,274
35412,28281175,28281175,28281449,0,0,0,274
35413,28281175,28281175,28281449,0,0,0,274
35433,28281251,28281251,28281452,0,0,0,201
35434,28281251,28281251,28281452,0,0,0,201
35414,28281175,28281175,28281460,0,0,0,285
35436,28281252,28281252,28281464,0,0,0,212
35437,28281252,28281252,28281464,0,0,0,212
35415,28281175,28281175,28281471,0,0,0,296
35435,28281251,28281251,28281474,0,0,0,223
35429,28281249,28281249,28281483,0,0,0,234
35438,28281255,28281255,28281489,0,0,0,234
35428,28281249,28281249,28281509,0,0,0,260
35430,28281250,28281250,28281521,0,0,0,271
35431,28281250,28281250,28281521,0,0,0,271
35432,28281250,28281250,28281532,0,0,0,282
35393,28268111,28268111,28284117,0,0,0,16006
35394,28268180,28268180,28284181,0,0,0,16001
35096,28062757,28062757,28284719,0,0,0,221962
35442,28286339,28286339,28286478,0,0,0,139
35444,28287131,28287131,28287939,0,0,0,808
35395,28273192,28273192,28288236,0,0,0,15044
34270,28032392,28032392,28291592,0,0,0,259200
35328,28207906,28207906,28294285,0,0,0,86379
35443,28286436,28286436,28294957,0,0,0,8521
35450,28296104,28296104,28296162,0,0,0,58
35398,28280725,28280725,28296585,0,0,0,15860
35446,28288205,28288205,28298655,0,0,0,10450
35490,28299554,28299554,28299764,0,0,0,210
35491,28299554,28299554,28299764,0,0,0,210
35492,28299555,28299555,28299765,0,0,0,210
35474,28299552,28299552,28299766,0,0,0,214
35475,28299552,28299552,28299766,0,0,0,214
35476,28299552,28299552,28299766,0,0,0,214
35493,28299555,28299555,28299776,0,0,0,221
35494,28299555,28299555,28299776,0,0,0,221
35495,28299555,28299555,28299776,0,0,0,221
35477,28299552,28299552,28299777,0,0,0,225
35478,28299552,28299552,28299777,0,0,0,225
35496,28299555,28299555,28299787,0,0,0,232
35497,28299555,28299555,28299787,0,0,0,232
35480,28299553,28299553,28299789,0,0,0,236
35481,28299553,28299553,28299789,0,0,0,236
35482,28299553,28299553,28299789,0,0,0,236
35498,28299555,28299555,28299798,0,0,0,243
35479,28299552,28299552,28299799,0,0,0,247
35483,28299553,28299553,28299800,0,0,0,247
35459,28299548,28299548,28299804,0,0,0,256
35460,28299548,28299548,28299804,0,0,0,256
35461,28299548,28299548,28299804,0,0,0,256
35462,28299549,28299549,28299805,0,0,0,256
35463,28299549,28299549,28299805,0,0,0,256
35464,28299549,28299549,28299805,0,0,0,256
35465,28299550,28299550,28299806,0,0,0,256
35466,28299550,28299550,28299806,0,0,0,256
35467,28299550,28299550,28299806,0,0,0,256
35468,28299550,28299550,28299806,0,0,0,256
35499,28299556,28299556,28299810,0,0,0,254
35500,28299556,28299556,28299810,0,0,0,254
35484,28299553,28299553,28299811,0,0,0,258
35469,28299551,28299551,28299819,0,0,0,268
35470,28299551,28299551,28299819,0,0,0,268
35471,28299551,28299551,28299819,0,0,0,268
35472,28299551,28299551,28299819,0,0,0,268
35485,28299553,28299553,28299822,0,0,0,269
35486,28299553,28299553,28299822,0,0,0,269
35487,28299554,28299554,28299823,0,0,0,269
35473,28299551,28299551,28299830,0,0,0,279
35488,28299554,28299554,28299834,0,0,0,280
35489,28299554,28299554,28299834,0,0,0,280
35501,28299628,28299628,28299893,0,0,0,265
35457,28299546,28299546,28299894,0,0,0,348
35458,28299548,28299548,28299896,0,0,0,348
35502,28299631,28299631,28299896,0,0,0,265
35439,28284078,28284078,28300042,0,0,0,15964
35440,28284141,28284141,28300085,0,0,0,15944
35505,28300549,28300549,28300856,0,0,0,307
35506,28300549,28300549,28300856,0,0,0,307
35507,28300549,28300549,28300856,0,0,0,307
35508,28300550,28300550,28300857,0,0,0,307
35509,28300550,28300550,28300857,0,0,0,307
35510,28300550,28300550,28300857,0,0,0,307
35511,28300550,28300550,28300857,0,0,0,307
35512,28300550,28300550,28300857,0,0,0,307
35519,28300664,28300664,28300864,0,0,0,200
35520,28300664,28300664,28300875,0,0,0,211
35521,28300664,28300664,28300875,0,0,0,211
35538,28300668,28300668,28300876,0,0,0,208
35539,28300668,28300668,28300876,0,0,0,208
35540,28300668,28300668,28300876,0,0,0,208
35541,28300668,28300668,28300876,0,0,0,208
35522,28300665,28300665,28300887,0,0,0,222
35523,28300665,28300665,28300887,0,0,0,222
35524,28300665,28300665,28300887,0,0,0,222
35525,28300665,28300665,28300898,0,0,0,233
35542,28300668,28300668,28300898,0,0,0,230
35526,28300666,28300666,28300899,0,0,0,233
35543,28300669,28300669,28300899,0,0,0,230
35544,28300669,28300669,28300899,0,0,0,230
35527,28300666,28300666,28300910,0,0,0,244
35528,28300666,28300666,28300910,0,0,0,244
35545,28300669,28300669,28300910,0,0,0,241
35529,28300666,28300666,28300921,0,0,0,255
35546,28300669,28300669,28300921,0,0,0,252
35547,28300669,28300669,28300921,0,0,0,252
35548,28300669,28300669,28300921,0,0,0,252
35530,28300667,28300667,28300922,0,0,0,255
35531,28300667,28300667,28300922,0,0,0,255
35549,28300670,28300670,28300922,0,0,0,252
35532,28300667,28300667,28300933,0,0,0,266
35550,28300670,28300670,28300933,0,0,0,263
35533,28300667,28300667,28300944,0,0,0,277
35551,28300670,28300670,28300944,0,0,0,274
35534,28300667,28300667,28300955,0,0,0,288
35535,28300667,28300667,28300955,0,0,0,288
35536,28300668,28300668,28300956,0,0,0,288
35537,28300668,28300668,28300967,0,0,0,299
35513,28300662,28300662,28300969,0,0,0,307
35515,28300663,28300663,28300970,0,0,0,307
35516,28300663,28300663,28300970,0,0,0,307
35517,28300663,28300663,28300970,0,0,0,307
35518,28300664,28300664,28300971,0,0,0,307
35553,28300990,28300990,28301264,0,0,0,274
35579,28301789,28301789,28301932,0,0,0,143
35580,28301789,28301789,28301932,0,0,0,143
35581,28301789,28301789,28301932,0,0,0,143
35582,28301789,28301789,28301932,0,0,0,143
35584,28301790,28301790,28301960,0,0,0,170
35585,28301790,28301790,28301960,0,0,0,170
35586,28301790,28301790,28301960,0,0,0,170
35587,28301790,28301790,28301960,0,0,0,170
35583,28301789,28301789,28301970,0,0,0,181
35588,28301790,28301790,28301971,0,0,0,181
35589,28301790,28301790,28301971,0,0,0,181
35590,28301790,28301790,28301982,0,0,0,192
35554,28301780,28301780,28301983,0,0,0,203
35594,28301883,28301883,28302009,0,0,0,126
35556,28301785,28301785,28302056,0,0,0,271
35557,28301786,28301786,28302057,0,0,0,271
35558,28301786,28301786,28302057,0,0,0,271
35559,28301786,28301786,28302057,0,0,0,271
35560,28301786,28301786,28302057,0,0,0,271
35561,28301786,28301786,28302057,0,0,0,271
35562,28301786,28301786,28302057,0,0,0,271
35563,28301786,28301786,28302057,0,0,0,271
35564,28301787,28301787,28302058,0,0,0,271
35565,28301787,28301787,28302058,0,0,0,271
35566,28301787,28301787,28302058,0,0,0,271
35567,28301787,28301787,28302058,0,0,0,271
35568,28301787,28301787,28302058,0,0,0,271
35569,28301787,28301787,28302058,0,0,0,271
35570,28301787,28301787,28302058,0,0,0,271
35571,28301788,28301788,28302059,0,0,0,271
35572,28301788,28301788,28302059,0,0,0,271
35573,28301788,28301788,28302059,0,0,0,271
35574,28301788,28301788,28302059,0,0,0,271
35575,28301788,28301788,28302059,0,0,0,271
35576,28301788,28301788,28302059,0,0,0,271
35577,28301789,28301789,28302060,0,0,0,271
35578,28301789,28301789,28302060,0,0,0,271
35591,28301883,28301883,28302086,0,0,0,203
35592,28301883,28301883,28302086,0,0,0,203
35593,28301883,28301883,28302086,0,0,0,203
35595,28301884,28301884,28302098,0,0,0,214
35596,28301884,28301884,28302109,0,0,0,225
35597,28301884,28301884,28302109,0,0,0,225
35598,28301884,28301884,28302120,0,0,0,236
35599,28301885,28301885,28302121,0,0,0,236
35600,28301885,28301885,28302121,0,0,0,236
35601,28301885,28301885,28302132,0,0,0,247
35602,28301885,28301885,28302132,0,0,0,247
35603,28301886,28301886,28302144,0,0,0,258
35604,28301886,28301886,28302144,0,0,0,258
35555,28301783,28301783,28302182,0,0,0,399
35605,28302137,28302137,28302274,0,0,0,137
35606,28302386,28302386,28302523,0,0,0,137
35445,28288204,28288204,28303232,0,0,0,15028
35607,28302386,28302386,28303249,0,0,0,863
35630,28303542,28303542,28303770,0,0,0,228
35636,28303549,28303549,28303777,0,0,0,228
35638,28303550,28303550,28303778,0,0,0,228
35639,28303550,28303550,28303778,0,0,0,228
35640,28303551,28303551,28303779,0,0,0,228
35626,28303532,28303532,28303780,0,0,0,248
35627,28303532,28303532,28303780,0,0,0,248
35628,28303533,28303533,28303781,0,0,0,248
35629,28303533,28303533,28303781,0,0,0,248
35647,28303553,28303553,28303781,0,0,0,228
35648,28303553,28303553,28303781,0,0,0,228
35631,28303543,28303543,28303782,0,0,0,239
35655,28303555,28303555,28303783,0,0,0,228
35659,28303556,28303556,28303784,0,0,0,228
35660,28303556,28303556,28303784,0,0,0,228
35661,28303556,28303556,28303784,0,0,0,228
35663,28303557,28303557,28303785,0,0,0,228
35664,28303557,28303557,28303785,0,0,0,228
35632,28303547,28303547,28303786,0,0,0,239
35633,28303547,28303547,28303786,0,0,0,239
35634,28303548,28303548,28303787,0,0,0,239
35635,28303548,28303548,28303787,0,0,0,239
35637,28303549,28303549,28303788,0,0,0,239
35668,28303560,28303560,28303788,0,0,0,228
35641,28303551,28303551,28303790,0,0,0,239
35642,28303551,28303551,28303790,0,0,0,239
35643,28303551,28303551,28303790,0,0,0,239
35644,28303551,28303551,28303790,0,0,0,239
35645,28303552,28303552,28303791,0,0,0,239
35646,28303552,28303552,28303791,0,0,0,239
35649,28303553,28303553,28303792,0,0,0,239
35650,28303553,28303553,28303792,0,0,0,239
35651,28303553,28303553,28303792,0,0,0,239
35652,28303554,28303554,28303793,0,0,0,239
35653,28303554,28303554,28303793,0,0,0,239
35654,28303554,28303554,28303793,0,0,0,239
35656,28303555,28303555,28303794,0,0,0,239
35657,28303555,28303555,28303794,0,0,0,239
35658,28303555,28303555,28303794,0,0,0,239
35662,28303556,28303556,28303795,0,0,0,239
35665,28303558,28303558,28303797,0,0,0,239
35666,28303559,28303559,28303798,0,0,0,239
35667,28303559,28303559,28303798,0,0,0,239
35669,28303560,28303560,28303799,0,0,0,239
35612,28303260,28303260,28303878,0,0,0,618
35620,28303530,28303530,28303880,0,0,0,350
35621,28303530,28303530,28303880,0,0,0,350
35622,28303530,28303530,28303880,0,0,0,350
35623,28303531,28303531,28303881,0,0,0,350
35624,28303531,28303531,28303881,0,0,0,350
35625,28303531,28303531,28303881,0,0,0,350
35613,28303260,28303260,28303894,0,0,0,634
35614,28303261,28303261,28303895,0,0,0,634
35615,28303267,28303267,28304184,0,0,0,917
35616,28303268,28303268,28304185,0,0,0,917
35617,28303269,28303269,28304186,0,0,0,917
35618,28303269,28303269,28304186,0,0,0,917
35717,28304806,28304806,28304875,0,0,0,69
35679,28304563,28304563,28305120,0,0,0,557
35683,28304563,28304563,28305126,0,0,0,563
35680,28304563,28304563,28305131,0,0,0,568
35681,28304563,28304563,28305131,0,0,0,568
35682,28304563,28304563,28305131,0,0,0,568
35670,28304523,28304523,28305133,0,0,0,610
35685,28304564,28304564,28305143,0,0,0,579
35671,28304523,28304523,28305149,0,0,0,626
35672,28304523,28304523,28305149,0,0,0,626
35687,28304564,28304564,28305149,0,0,0,585
35688,28304564,28304564,28305149,0,0,0,585
35689,28304564,28304564,28305149,0,0,0,585
35684,28304563,28304563,28305163,0,0,0,600
35686,28304564,28304564,28305164,0,0,0,600
35673,28304523,28304523,28305170,0,0,0,647
35674,28304523,28304523,28305170,0,0,0,647
35676,28304554,28304554,28305181,0,0,0,627
35677,28304555,28304555,28305182,0,0,0,627
35678,28304555,28304555,28305182,0,0,0,627
35675,28304523,28304523,28305191,0,0,0,668
35693,28304795,28304795,28305358,0,0,0,563
35694,28304795,28304795,28305358,0,0,0,563
35710,28304798,28304798,28305363,0,0,0,565
35698,28304796,28304796,28305365,0,0,0,569
35701,28304796,28304796,28305365,0,0,0,569
35711,28304805,28304805,28305369,0,0,0,564
35691,28304788,28304788,28305373,0,0,0,585
35743,28304815,28304815,28305375,0,0,0,560
35705,28304797,28304797,28305377,0,0,0,580
35706,28304797,28304797,28305377,0,0,0,580
35696,28304795,28304795,28305380,0,0,0,585
35712,28304805,28304805,28305380,0,0,0,575
35697,28304796,28304796,28305381,0,0,0,585
35700,28304796,28304796,28305381,0,0,0,585
35713,28304805,28304805,28305381,0,0,0,576
35722,28304806,28304806,28305382,0,0,0,576
35723,28304806,28304806,28305382,0,0,0,576
35724,28304807,28304807,28305383,0,0,0,576
35730,28304808,28304808,28305383,0,0,0,575
35695,28304795,28304795,28305385,0,0,0,590
35699,28304796,28304796,28305386,0,0,0,590
35702,28304796,28304796,28305386,0,0,0,590
35752,28304816,28304816,28305386,0,0,0,570
35774,28304821,28304821,28305386,0,0,0,565
35704,28304797,28304797,28305387,0,0,0,590
35719,28304806,28304806,28305387,0,0,0,581
35720,28304806,28304806,28305387,0,0,0,581
35725,28304807,28304807,28305387,0,0,0,580
35754,28304817,28304817,28305387,0,0,0,570
35756,28304817,28304817,28305389,0,0,0,572
35758,28304817,28304817,28305392,0,0,0,575
35690,28304787,28304787,28305393,0,0,0,606
35746,28304815,28304815,28305393,0,0,0,578
35747,28304815,28304815,28305393,0,0,0,578
35748,28304816,28304816,28305394,0,0,0,578
35757,28304817,28304817,28305395,0,0,0,578
35781,28304823,28304823,28305396,0,0,0,573
35716,28304805,28304805,28305397,0,0,0,592
35775,28304821,28304821,28305397,0,0,0,576
35776,28304821,28304821,28305397,0,0,0,576
35745,28304815,28304815,28305398,0,0,0,583
35735,28304810,28304810,28305399,0,0,0,589
35736,28304811,28304811,28305400,0,0,0,589
35737,28304812,28304812,28305401,0,0,0,589
35738,28304812,28304812,28305401,0,0,0,589
35749,28304816,28304816,28305401,0,0,0,585
35751,28304816,28304816,28305402,0,0,0,586
35718,28304806,28304806,28305403,0,0,0,597
35721,28304806,28304806,28305403,0,0,0,597
35726,28304807,28304807,28305403,0,0,0,596
35744,28304815,28304815,28305403,0,0,0,588
35707,28304797,28304797,28305404,0,0,0,607
35708,28304797,28304797,28305404,0,0,0,607
35709,28304797,28304797,28305404,0,0,0,607
35759,28304817,28304817,28305404,0,0,0,587
35763,28304818,28304818,28305406,0,0,0,588
35764,28304818,28304818,28305406,0,0,0,588
35703,28304796,28304796,28305407,0,0,0,611
35782,28304823,28304823,28305407,0,0,0,584
35783,28304823,28304823,28305407,0,0,0,584
35753,28304816,28304816,28305408,0,0,0,592
35769,28304819,28304819,28305410,0,0,0,591
35770,28304819,28304819,28305410,0,0,0,591
35750,28304816,28304816,28305412,0,0,0,596
35715,28304805,28304805,28305413,0,0,0,608
35731,28304808,28304808,28305414,0,0,0,606
35732,28304808,28304808,28305414,0,0,0,606
35733,28304808,28304808,28305414,0,0,0,606
35765,28304819,28304819,28305418,0,0,0,599
35766,28304819,28304819,28305418,0,0,0,599
35767,28304819,28304819,28305418,0,0,0,599
35727,28304807,28304807,28305419,0,0,0,612
35728,28304807,28304807,28305419,0,0,0,612
35729,28304807,28304807,28305419,0,0,0,612
35777,28304821,28304821,28305419,0,0,0,598
35785,28304824,28304824,28305419,0,0,0,595
35755,28304817,28304817,28305420,0,0,0,603
35778,28304822,28304822,28305420,0,0,0,598
35779,28304822,28304822,28305420,0,0,0,598
35771,28304819,28304819,28305421,0,0,0,602
35772,28304820,28304820,28305422,0,0,0,602
35773,28304820,28304820,28305422,0,0,0,602
35714,28304805,28304805,28305429,0,0,0,624
35768,28304819,28304819,28305429,0,0,0,610
35784,28304823,28304823,28305429,0,0,0,606
35762,28304818,28304818,28305432,0,0,0,614
35734,28304810,28304810,28305441,0,0,0,631
35761,28304818,28304818,28305441,0,0,0,623
35786,28304824,28304824,28305441,0,0,0,617
35787,28304824,28304824,28305441,0,0,0,617
35780,28304822,28304822,28305442,0,0,0,620
35739,28304814,28304814,28305445,0,0,0,631
35740,28304814,28304814,28305445,0,0,0,631
35741,28304815,28304815,28305446,0,0,0,631
35742,28304815,28304815,28305446,0,0,0,631
35760,28304817,28304817,28305451,0,0,0,634
35692,28304795,28304795,28305455,0,0,0,660
35456,28298857,28298857,28306084,0,0,0,7227
35610,28303077,28303077,28306354,0,0,0,3277
35788,28306437,28306437,28307024,0,0,0,587
35789,28306557,28306557,28307133,0,0,0,576
35790,28307148,28307148,28307735,0,0,0,587
35791,28307184,28307184,28307782,0,0,0,598
34805,28049231,28049231,28308431,0,0,0,259200
35802,28308801,28308801,28309093,0,0,0,292
35793,28308786,28308786,28309133,0,0,0,347
35794,28308792,28308792,28309138,0,0,0,346
35805,28308802,28308802,28309152,0,0,0,350
35795,28308792,28308792,28309154,0,0,0,362
35796,28308792,28308792,28309154,0,0,0,362
35797,28308793,28308793,28309155,0,0,0,362
35806,28308802,28308802,28309158,0,0,0,356
35804,28308802,28308802,28309168,0,0,0,366
35809,28308802,28308802,28309168,0,0,0,366
35807,28308802,28308802,28309174,0,0,0,372
35808,28308802,28308802,28309174,0,0,0,372
35803,28308802,28308802,28309179,0,0,0,377
35798,28308793,28308793,28309182,0,0,0,389
35799,28308793,28308793,28309182,0,0,0,389
35800,28308793,28308793,28309182,0,0,0,389
35801,28308794,28308794,28309183,0,0,0,389
35933,28309094,28309094,28309194,0,0,0,100
36143,28309161,28309161,28309255,0,0,0,94
35819,28309053,28309053,28309397,0,0,0,344
35828,28309061,28309061,28309416,0,0,0,355
35810,28309051,28309051,28309417,0,0,0,366
35811,28309051,28309051,28309417,0,0,0,366
35812,28309051,28309051,28309417,0,0,0,366
35813,28309052,28309052,28309417,0,0,0,365
35814,28309052,28309052,28309417,0,0,0,365
35833,28309062,28309062,28309418,0,0,0,356
35834,28309062,28309062,28309418,0,0,0,356
35835,28309063,28309063,28309419,0,0,0,356
35842,28309065,28309065,28309431,0,0,0,366
35843,28309065,28309065,28309431,0,0,0,366
35844,28309066,28309066,28309432,0,0,0,366
35874,28309078,28309078,28309433,0,0,0,355
35820,28309053,28309053,28309434,0,0,0,381
35859,28309072,28309072,28309434,0,0,0,362
35821,28309054,28309054,28309435,0,0,0,381
35822,28309054,28309054,28309435,0,0,0,381
35823,28309054,28309054,28309435,0,0,0,381
35824,28309055,28309055,28309436,0,0,0,381
35825,28309060,28309060,28309436,0,0,0,376
35838,28309064,28309064,28309436,0,0,0,372
35839,28309064,28309064,28309436,0,0,0,372
35840,28309064,28309064,28309436,0,0,0,372
35827,28309061,28309061,28309437,0,0,0,376
35829,28309061,28309061,28309437,0,0,0,376
35830,28309061,28309061,28309437,0,0,0,376
35831,28309061,28309061,28309437,0,0,0,376
35841,28309065,28309065,28309437,0,0,0,372
35815,28309052,28309052,28309438,0,0,0,386
35816,28309052,28309052,28309438,0,0,0,386
35832,28309061,28309061,28309438,0,0,0,377
35817,28309053,28309053,28309439,0,0,0,386
35818,28309053,28309053,28309439,0,0,0,386
35862,28309074,28309074,28309445,0,0,0,371
35863,28309075,28309075,28309446,0,0,0,371
35917,28309090,28309090,28309448,0,0,0,358
35947,28309103,28309103,28309449,0,0,0,346
35836,28309063,28309063,28309451,0,0,0,388
35837,28309063,28309063,28309451,0,0,0,388
35903,28309085,28309085,28309451,0,0,0,366
35904,28309085,28309085,28309451,0,0,0,366
35905,28309085,28309085,28309451,0,0,0,366
35939,28309101,28309101,28309453,0,0,0,352
35940,28309101,28309101,28309453,0,0,0,352
35857,28309072,28309072,28309455,0,0,0,383
35858,28309072,28309072,28309455,0,0,0,383
35864,28309075,28309075,28309456,0,0,0,381
35865,28309075,28309075,28309456,0,0,0,381
35866,28309075,28309075,28309456,0,0,0,381
35826,28309060,28309060,28309457,0,0,0,397
35853,28309069,28309069,28309457,0,0,0,388
35854,28309069,28309069,28309457,0,0,0,388
35855,28309069,28309069,28309457,0,0,0,388
35867,28309076,28309076,28309457,0,0,0,381
35868,28309076,28309076,28309457,0,0,0,381
35869,28309076,28309076,28309457,0,0,0,381
35870,28309076,28309076,28309457,0,0,0,381
35845,28309066,28309066,28309458,0,0,0,392
35846,28309066,28309066,28309458,0,0,0,392
35847,28309066,28309066,28309458,0,0,0,392
35871,28309077,28309077,28309458,0,0,0,381
35872,28309077,28309077,28309458,0,0,0,381
35873,28309077,28309077,28309458,0,0,0,381
35893,28309082,28309082,28309458,0,0,0,376
35894,28309082,28309082,28309458,0,0,0,376
35907,28309086,28309086,28309458,0,0,0,372
35908,28309086,28309086,28309458,0,0,0,372
35909,28309086,28309086,28309458,0,0,0,372
35895,28309083,28309083,28309459,0,0,0,376
35896,28309083,28309083,28309459,0,0,0,376
35880,28309079,28309079,28309460,0,0,0,381
35881,28309079,28309079,28309460,0,0,0,381
35882,28309079,28309079,28309460,0,0,0,381
35883,28309079,28309079,28309460,0,0,0,381
35884,28309079,28309079,28309460,0,0,0,381
35885,28309079,28309079,28309460,0,0,0,381
35897,28309083,28309083,28309460,0,0,0,377
35898,28309083,28309083,28309460,0,0,0,377
35899,28309083,28309083,28309460,0,0,0,377
35900,28309083,28309083,28309460,0,0,0,377
35911,28309087,28309087,28309460,0,0,0,373
35912,28309087,28309087,28309460,0,0,0,373
35913,28309087,28309087,28309460,0,0,0,373
35886,28309080,28309080,28309461,0,0,0,381
35887,28309080,28309080,28309461,0,0,0,381
35888,28309080,28309080,28309461,0,0,0,381
35889,28309080,28309080,28309461,0,0,0,381
35890,28309080,28309080,28309461,0,0,0,381
35891,28309081,28309081,28309462,0,0,0,381
35892,28309081,28309081,28309462,0,0,0,381
35875,28309078,28309078,28309464,0,0,0,386
35876,28309078,28309078,28309464,0,0,0,386
35877,28309078,28309078,28309464,0,0,0,386
35878,28309078,28309078,28309464,0,0,0,386
35879,28309078,28309078,28309464,0,0,0,386
35856,28309072,28309072,28309471,0,0,0,399
35931,28309093,28309093,28309471,0,0,0,378
35932,28309093,28309093,28309471,0,0,0,378
35934,28309094,28309094,28309472,0,0,0,378
35935,28309094,28309094,28309472,0,0,0,378
35922,28309090,28309090,28309473,0,0,0,383
35923,28309091,28309091,28309474,0,0,0,383
35924,28309091,28309091,28309474,0,0,0,383
35925,28309091,28309091,28309474,0,0,0,383
35926,28309091,28309091,28309474,0,0,0,383
35927,28309091,28309091,28309474,0,0,0,383
35928,28309091,28309091,28309474,0,0,0,383
35929,28309092,28309092,28309475,0,0,0,383
35953,28309105,28309105,28309476,0,0,0,371
35954,28309105,28309105,28309476,0,0,0,371
35955,28309105,28309105,28309476,0,0,0,371
35860,28309074,28309074,28309477,0,0,0,403
35861,28309074,28309074,28309477,0,0,0,403
35936,28309094,28309094,28309477,0,0,0,383
35937,28309094,28309094,28309477,0,0,0,383
35918,28309090,28309090,28309479,0,0,0,389
35919,28309090,28309090,28309479,0,0,0,389
35920,28309090,28309090,28309479,0,0,0,389
35921,28309090,28309090,28309479,0,0,0,389
35944,28309102,28309102,28309480,0,0,0,378
35945,28309103,28309103,28309481,0,0,0,378
35946,28309103,28309103,28309481,0,0,0,378
35949,28309104,28309104,28309481,0,0,0,377
35950,28309104,28309104,28309481,0,0,0,377
35951,28309104,28309104,28309481,0,0,0,377
35938,28309100,28309100,28309483,0,0,0,383
35914,28309089,28309089,28309484,0,0,0,395
35915,28309089,28309089,28309484,0,0,0,395
35916,28309089,28309089,28309484,0,0,0,395
36019,28309121,28309121,28309484,0,0,0,363
36024,28309122,28309122,28309485,0,0,0,363
35848,28309068,28309068,28309486,0,0,0,418
35849,28309068,28309068,28309486,0,0,0,418
35850,28309068,28309068,28309486,0,0,0,418
35851,28309068,28309068,28309486,0,0,0,418
35981,28309110,28309110,28309486,0,0,0,376
35982,28309110,28309110,28309486,0,0,0,376
35983,28309110,28309110,28309486,0,0,0,376
35852,28309069,28309069,28309487,0,0,0,418
35959,28309106,28309106,28309487,0,0,0,381
35960,28309106,28309106,28309487,0,0,0,381
35961,28309106,28309106,28309487,0,0,0,381
35962,28309106,28309106,28309487,0,0,0,381
36011,28309119,28309119,28309487,0,0,0,368
36012,28309119,28309119,28309487,0,0,0,368
35906,28309085,28309085,28309488,0,0,0,403
35986,28309112,28309112,28309488,0,0,0,376
35987,28309112,28309112,28309488,0,0,0,376
35988,28309112,28309112,28309488,0,0,0,376
35991,28309113,28309113,28309489,0,0,0,376
35992,28309113,28309113,28309489,0,0,0,376
35910,28309086,28309086,28309490,0,0,0,404
35941,28309101,28309101,28309490,0,0,0,389
35993,28309114,28309114,28309490,0,0,0,376
35942,28309102,28309102,28309491,0,0,0,389
35943,28309102,28309102,28309491,0,0,0,389
36006,28309118,28309118,28309491,0,0,0,373
36007,28309118,28309118,28309491,0,0,0,373
35901,28309084,28309084,28309492,0,0,0,408
35902,28309084,28309084,28309492,0,0,0,408
36009,28309119,28309119,28309492,0,0,0,373
35963,28309107,28309107,28309493,0,0,0,386
35964,28309107,28309107,28309493,0,0,0,386
35965,28309107,28309107,28309493,0,0,0,386
35966,28309107,28309107,28309493,0,0,0,386
35967,28309107,28309107,28309493,0,0,0,386
36014,28309120,28309120,28309493,0,0,0,373
36015,28309120,28309120,28309493,0,0,0,373
35968,28309108,28309108,28309494,0,0,0,386
35969,28309108,28309108,28309494,0,0,0,386
35970,28309108,28309108,28309494,0,0,0,386
35971,28309108,28309108,28309494,0,0,0,386
35972,28309108,28309108,28309494,0,0,0,386
35973,28309108,28309108,28309494,0,0,0,386
35974,28309108,28309108,28309494,0,0,0,386
36002,28309117,28309117,28309494,0,0,0,377
35975,28309109,28309109,28309495,0,0,0,386
35976,28309109,28309109,28309495,0,0,0,386
35977,28309109,28309109,28309495,0,0,0,386
36003,28309118,28309118,28309495,0,0,0,377
36004,28309118,28309118,28309495,0,0,0,377
36005,28309118,28309118,28309495,0,0,0,377
35979,28309110,28309110,28309496,0,0,0,386
36075,28309141,28309141,28309500,0,0,0,359
35994,28309114,28309114,28309501,0,0,0,387
35995,28309114,28309114,28309501,0,0,0,387
35996,28309115,28309115,28309502,0,0,0,387
35997,28309115,28309115,28309502,0,0,0,387
35998,28309115,28309115,28309502,0,0,0,387
35999,28309116,28309116,28309503,0,0,0,387
36000,28309116,28309116,28309503,0,0,0,387
36001,28309116,28309116,28309503,0,0,0,387
35956,28309105,28309105,28309507,0,0,0,402
35958,28309106,28309106,28309508,0,0,0,402
36032,28309126,28309126,28309510,0,0,0,384
36033,28309126,28309126,28309510,0,0,0,384
36034,28309127,28309127,28309511,0,0,0,384
36035,28309127,28309127,28309511,0,0,0,384
36037,28309127,28309127,28309511,0,0,0,384
36038,28309127,28309127,28309511,0,0,0,384
35948,28309103,28309103,28309512,0,0,0,409
35952,28309104,28309104,28309512,0,0,0,408
36039,28309128,28309128,28309512,0,0,0,384
36028,28309123,28309123,28309513,0,0,0,390
36046,28309129,28309129,28309513,0,0,0,384
36047,28309129,28309129,28309513,0,0,0,384
36048,28309129,28309129,28309513,0,0,0,384
36050,28309130,28309130,28309513,0,0,0,383
36051,28309130,28309130,28309513,0,0,0,383
36052,28309130,28309130,28309513,0,0,0,383
36029,28309124,28309124,28309514,0,0,0,390
36030,28309124,28309124,28309514,0,0,0,390
36020,28309121,28309121,28309516,0,0,0,395
36021,28309121,28309121,28309516,0,0,0,395
36022,28309121,28309121,28309516,0,0,0,395
36023,28309121,28309121,28309516,0,0,0,395
35930,28309092,28309092,28309517,0,0,0,425
36040,28309128,28309128,28309517,0,0,0,389
36041,28309128,28309128,28309517,0,0,0,389
36042,28309128,28309128,28309517,0,0,0,389
36010,28309119,28309119,28309518,0,0,0,399
36013,28309119,28309119,28309518,0,0,0,399
36025,28309123,28309123,28309518,0,0,0,395
36026,28309123,28309123,28309518,0,0,0,395
36027,28309123,28309123,28309518,0,0,0,395
36044,28309129,28309129,28309518,0,0,0,389
36045,28309129,28309129,28309518,0,0,0,389
36053,28309130,28309130,28309518,0,0,0,388
36054,28309130,28309130,28309518,0,0,0,388
36060,28309131,28309131,28309518,0,0,0,387
36055,28309131,28309131,28309519,0,0,0,388
36056,28309131,28309131,28309519,0,0,0,388
36057,28309131,28309131,28309519,0,0,0,388
36058,28309131,28309131,28309519,0,0,0,388
36059,28309131,28309131,28309519,0,0,0,388
36061,28309132,28309132,28309519,0,0,0,387
36062,28309132,28309132,28309519,0,0,0,387
36063,28309132,28309132,28309519,0,0,0,387
36064,28309132,28309132,28309519,0,0,0,387
36065,28309132,28309132,28309519,0,0,0,387
36066,28309132,28309132,28309519,0,0,0,387
36067,28309138,28309138,28309519,0,0,0,381
36016,28309120,28309120,28309520,0,0,0,400
36017,28309120,28309120,28309520,0,0,0,400
36018,28309120,28309120,28309520,0,0,0,400
36069,28309139,28309139,28309520,0,0,0,381
36070,28309139,28309139,28309520,0,0,0,381
36071,28309139,28309139,28309520,0,0,0,381
36081,28309142,28309142,28309522,0,0,0,380
36082,28309142,28309142,28309522,0,0,0,380
36083,28309143,28309143,28309523,0,0,0,380
36085,28309143,28309143,28309523,0,0,0,380
35984,28309111,28309111,28309524,0,0,0,413
35985,28309111,28309111,28309524,0,0,0,413
36087,28309144,28309144,28309524,0,0,0,380
36088,28309144,28309144,28309524,0,0,0,380
36089,28309144,28309144,28309524,0,0,0,380
36072,28309140,28309140,28309525,0,0,0,385
36073,28309140,28309140,28309525,0,0,0,385
36074,28309140,28309140,28309525,0,0,0,385
36090,28309144,28309144,28309525,0,0,0,381
36091,28309144,28309144,28309525,0,0,0,381
36095,28309145,28309145,28309525,0,0,0,380
36096,28309145,28309145,28309525,0,0,0,380
36097,28309145,28309145,28309525,0,0,0,380
36098,28309145,28309145,28309525,0,0,0,380
36128,28309158,28309158,28309525,0,0,0,367
35989,28309113,28309113,28309526,0,0,0,413
35990,28309113,28309113,28309526,0,0,0,413
36093,28309145,28309145,28309526,0,0,0,381
36094,28309145,28309145,28309526,0,0,0,381
36102,28309146,28309146,28309526,0,0,0,380
36103,28309146,28309146,28309526,0,0,0,380
36130,28309158,28309158,28309526,0,0,0,368
36139,28309160,28309160,28309526,0,0,0,366
35978,28309109,28309109,28309527,0,0,0,418
36105,28309147,28309147,28309527,0,0,0,380
36106,28309147,28309147,28309527,0,0,0,380
35957,28309105,28309105,28309528,0,0,0,423
35980,28309110,28309110,28309528,0,0,0,418
36107,28309147,28309147,28309528,0,0,0,381
36110,28309148,28309148,28309529,0,0,0,381
36111,28309148,28309148,28309529,0,0,0,381
36112,28309148,28309148,28309529,0,0,0,381
36134,28309159,28309159,28309529,0,0,0,370
36135,28309159,28309159,28309529,0,0,0,370
36152,28309162,28309162,28309529,0,0,0,367
36076,28309141,28309141,28309531,0,0,0,390
36077,28309141,28309141,28309531,0,0,0,390
36078,28309141,28309141,28309531,0,0,0,390
36099,28309146,28309146,28309531,0,0,0,385
36100,28309146,28309146,28309531,0,0,0,385
36101,28309146,28309146,28309531,0,0,0,385
36156,28309163,28309163,28309531,0,0,0,368
36157,28309163,28309163,28309531,0,0,0,368
36079,28309142,28309142,28309532,0,0,0,390
36122,28309156,28309156,28309532,0,0,0,376
36123,28309156,28309156,28309532,0,0,0,376
36114,28309148,28309148,28309533,0,0,0,385
36115,28309148,28309148,28309533,0,0,0,385
36126,28309157,28309157,28309535,0,0,0,378
36145,28309161,28309161,28309535,0,0,0,374
36146,28309161,28309161,28309535,0,0,0,374
36129,28309158,28309158,28309536,0,0,0,378
36131,28309158,28309158,28309537,0,0,0,379
36140,28309160,28309160,28309537,0,0,0,377
36141,28309160,28309160,28309537,0,0,0,377
36132,28309159,28309159,28309538,0,0,0,379
36116,28309154,28309154,28309539,0,0,0,385
36160,28309164,28309164,28309539,0,0,0,375
36136,28309159,28309159,28309540,0,0,0,381
36153,28309162,28309162,28309540,0,0,0,378
36137,28309160,28309160,28309541,0,0,0,381
36154,28309163,28309163,28309541,0,0,0,378
36036,28309127,28309127,28309542,0,0,0,415
36124,28309156,28309156,28309543,0,0,0,387
36049,28309129,28309129,28309544,0,0,0,415
36125,28309157,28309157,28309544,0,0,0,387
36117,28309155,28309155,28309545,0,0,0,390
36118,28309155,28309155,28309545,0,0,0,390
36119,28309155,28309155,28309545,0,0,0,390
36120,28309155,28309155,28309545,0,0,0,390
36121,28309156,28309156,28309546,0,0,0,390
36147,28309161,28309161,28309546,0,0,0,385
36031,28309126,28309126,28309547,0,0,0,421
36148,28309162,28309162,28309547,0,0,0,385
36142,28309160,28309160,28309548,0,0,0,388
36133,28309159,28309159,28309549,0,0,0,390
36161,28309164,28309164,28309550,0,0,0,386
36068,28309139,28309139,28309552,0,0,0,413
36138,28309160,28309160,28309552,0,0,0,392
36155,28309163,28309163,28309552,0,0,0,389
36008,28309118,28309118,28309553,0,0,0,435
36158,28309163,28309163,28309553,0,0,0,390
36043,28309128,28309128,28309554,0,0,0,426
36084,28309143,28309143,28309554,0,0,0,411
36108,28309147,28309147,28309554,0,0,0,407
36109,28309147,28309147,28309554,0,0,0,407
36149,28309162,28309162,28309555,0,0,0,393
36150,28309162,28309162,28309555,0,0,0,393
36151,28309162,28309162,28309555,0,0,0,393
36086,28309143,28309143,28309560,0,0,0,417
36144,28309161,28309161,28309560,0,0,0,399
36159,28309163,28309163,28309560,0,0,0,397
36092,28309144,28309144,28309561,0,0,0,417
36080,28309142,28309142,28309564,0,0,0,422
36113,28309148,28309148,28309565,0,0,0,417
36127,28309157,28309157,28309568,0,0,0,411
36104,28309146,28309146,28309589,0,0,0,443
36162,28309181,28309181,28309611,0,0,0,430
36163,28309639,28309639,28310025,0,0,0,386
36164,28309717,28309717,28310067,0,0,0,350
34856,28051454,28051454,28310654,0,0,0,259200
36166,28310319,28310319,28310691,0,0,0,372
36167,28310763,28310763,28311146,0,0,0,383
36168,28311346,28311346,28311719,0,0,0,373
36171,28311588,28311588,28311719,0,0,0,131
36172,28311630,28311630,28311719,0,0,0,89
36169,28311392,28311392,28311728,0,0,0,336
35453,28296543,28296543,28312331,0,0,0,15788
36177,28312460,28312460,28312843,0,0,0,383
35455,28298672,28298672,28313298,0,0,0,14626
36178,28313825,28313825,28313880,0,0,0,55
36179,28313859,28313859,28314048,0,0,0,189
35503,28299995,28299995,28315817,0,0,0,15822
35504,28300037,28300037,28315868,0,0,0,15831
35611,28303196,28303196,28318235,0,0,0,15039
36174,28311752,28311752,28326598,0,0,0,14846
35452,28296166,28296166,28327940,0,0,0,31774
35451,28296137,28296137,28328127,0,0,0,31990
36176,28312263,28312263,28328273,0,0,0,16010
35449,28295195,28295195,28329240,0,0,0,34045
36181,28315821,28315821,28331556,0,0,0,15735
36180,28315778,28315778,28331585,0,0,0,15807
36182,28318191,28318191,28333241,0,0,0,15050
36175,28311810,28311810,28340432,0,0,0,28622
36183,28331525,28331525,28347537,0,0,0,16012
36184,28331544,28331544,28347580,0,0,0,16036
36185,28333205,28333205,28348200,0,0,0,14995
35397,28278466,28278466,28349513,0,0,0,71047
35454,28298464,28298464,28353856,0,0,0,55392
36186,28348162,28348162,28363088,0,0,0,14926
36190,28365865,28365865,28365905,0,0,0,40
35392,28267793,28267793,28365990,0,0,0,98197
36188,28365631,28365631,28366530,0,0,0,899
36189,28365790,28365790,28366555,0,0,0,765
36191,28365932,28365932,28366690,0,0,0,758
36193,28366765,28366765,28366806,0,0,0,41
36194,28366932,28366932,28366979,0,0,0,47
36173,28311729,28311729,28367183,0,0,0,55454
36195,28367672,28367672,28367748,0,0,0,76
36196,28367705,28367705,28367782,0,0,0,77
36165,28309782,28309782,28368455,0,0,0,58673
36198,28368498,28368498,28368538,0,0,0,40
36199,28368671,28368671,28368710,0,0,0,39
36200,28368727,28368727,28368776,0,0,0,49
36204,28369765,28369765,28369807,0,0,0,42
36205,28369777,28369777,28369815,0,0,0,38
36206,28370004,28370004,28370043,0,0,0,39
36207,28370086,28370086,28370125,0,0,0,39
36203,28369756,28369756,28370183,0,0,0,427
36208,28370105,28370105,28370185,0,0,0,80
36210,28370268,28370268,28370371,0,0,0,103
36211,28370358,28370358,28370480,0,0,0,122
36214,28370482,28370482,28370535,0,0,0,53
36215,28370521,28370521,28370589,0,0,0,68
36202,28369289,28369289,28370765,0,0,0,1476
36236,28371066,28371066,28371125,0,0,0,59
36218,28370806,28370806,28371147,0,0,0,341
36217,28370800,28370800,28371158,0,0,0,358
36219,28370806,28370806,28371168,0,0,0,362
36221,28370807,28370807,28371169,0,0,0,362
36229,28370816,28370816,28371170,0,0,0,354
36230,28370816,28370816,28371171,0,0,0,355
36231,28370816,28370816,28371171,0,0,0,355
36226,28370815,28370815,28371174,0,0,0,359
36235,28370816,28370816,28371186,0,0,0,370
36220,28370806,28370806,28371189,0,0,0,383
36222,28370807,28370807,28371190,0,0,0,383
36223,28370807,28370807,28371190,0,0,0,383
36227,28370815,28370815,28371190,0,0,0,375
36224,28370808,28370808,28371191,0,0,0,383
36225,28370808,28370808,28371191,0,0,0,383
36228,28370815,28370815,28371191,0,0,0,376
36232,28370816,28370816,28371197,0,0,0,381
36233,28370816,28370816,28371197,0,0,0,381
36234,28370816,28370816,28371197,0,0,0,381
36393,28371137,28371137,28371243,0,0,0,106
36350,28371126,28371126,28371257,0,0,0,131
36518,28371196,28371196,28371326,0,0,0,130
36519,28371196,28371196,28371326,0,0,0,130
36515,28371195,28371195,28371362,0,0,0,167
36516,28371195,28371195,28371362,0,0,0,167
36517,28371195,28371195,28371362,0,0,0,167
36521,28371332,28371332,28371420,0,0,0,88
36260,28371075,28371075,28371425,0,0,0,350
36261,28371075,28371075,28371425,0,0,0,350
36251,28371071,28371071,28371426,0,0,0,355
36252,28371071,28371071,28371426,0,0,0,355
36253,28371071,28371071,28371426,0,0,0,355
36239,28371066,28371066,28371436,0,0,0,370
36240,28371067,28371067,28371437,0,0,0,370
36241,28371067,28371067,28371437,0,0,0,370
36263,28371076,28371076,28371437,0,0,0,361
36264,28371076,28371076,28371437,0,0,0,361
36265,28371076,28371076,28371437,0,0,0,361
36244,28371068,28371068,28371438,0,0,0,370
36245,28371068,28371068,28371438,0,0,0,370
36272,28371093,28371093,28371438,0,0,0,345
36246,28371069,28371069,28371439,0,0,0,370
36247,28371069,28371069,28371439,0,0,0,370
36248,28371070,28371070,28371440,0,0,0,370
36266,28371076,28371076,28371442,0,0,0,366
36267,28371076,28371076,28371442,0,0,0,366
36268,28371076,28371076,28371442,0,0,0,366
36269,28371076,28371076,28371442,0,0,0,366
36258,28371075,28371075,28371447,0,0,0,372
36259,28371075,28371075,28371447,0,0,0,372
36277,28371094,28371094,28371455,0,0,0,361
36254,28371071,28371071,28371458,0,0,0,387
36255,28371071,28371071,28371458,0,0,0,387
36270,28371092,28371092,28371458,0,0,0,366
36256,28371072,28371072,28371459,0,0,0,387
36271,28371093,28371093,28371459,0,0,0,366
36297,28371103,28371103,28371459,0,0,0,356
36298,28371103,28371103,28371459,0,0,0,356
36520,28371330,28371330,28371460,0,0,0,130
36262,28371075,28371075,28371462,0,0,0,387
36257,28371075,28371075,28371463,0,0,0,388
36273,28371093,28371093,28371465,0,0,0,372
36274,28371093,28371093,28371465,0,0,0,372
36275,28371094,28371094,28371466,0,0,0,372
36281,28371095,28371095,28371466,0,0,0,371
36282,28371095,28371095,28371466,0,0,0,371
36283,28371096,28371096,28371467,0,0,0,371
36284,28371096,28371096,28371467,0,0,0,371
36308,28371106,28371106,28371468,0,0,0,362
36242,28371068,28371068,28371469,0,0,0,401
36243,28371068,28371068,28371469,0,0,0,401
36300,28371104,28371104,28371471,0,0,0,367
36301,28371104,28371104,28371471,0,0,0,367
36285,28371096,28371096,28371473,0,0,0,377
36286,28371096,28371096,28371473,0,0,0,377
36287,28371097,28371097,28371474,0,0,0,377
36288,28371097,28371097,28371474,0,0,0,377
36289,28371097,28371097,28371474,0,0,0,377
36249,28371070,28371070,28371477,0,0,0,407
36279,28371095,28371095,28371477,0,0,0,382
36280,28371095,28371095,28371477,0,0,0,382
36324,28371115,28371115,28371481,0,0,0,366
36302,28371104,28371104,28371482,0,0,0,378
36303,28371105,28371105,28371483,0,0,0,378
36304,28371105,28371105,28371483,0,0,0,378
36305,28371105,28371105,28371483,0,0,0,378
36290,28371102,28371102,28371485,0,0,0,383
36291,28371102,28371102,28371485,0,0,0,383
36292,28371102,28371102,28371485,0,0,0,383
36293,28371102,28371102,28371485,0,0,0,383
36294,28371102,28371102,28371485,0,0,0,383
36295,28371102,28371102,28371485,0,0,0,383
36296,28371102,28371102,28371485,0,0,0,383
36321,28371114,28371114,28371486,0,0,0,372
36326,28371115,28371115,28371486,0,0,0,371
36328,28371116,28371116,28371487,0,0,0,371
36329,28371116,28371116,28371487,0,0,0,371
36348,28371125,28371125,28371487,0,0,0,362
36330,28371117,28371117,28371488,0,0,0,371
36351,28371126,28371126,28371488,0,0,0,362
36523,28371402,28371402,28371490,0,0,0,88
36316,28371113,28371113,28371491,0,0,0,378
36317,28371113,28371113,28371491,0,0,0,378
36318,28371113,28371113,28371491,0,0,0,378
36363,28371129,28371129,28371491,0,0,0,362
36276,28371094,28371094,28371492,0,0,0,398
36331,28371117,28371117,28371493,0,0,0,376
36332,28371117,28371117,28371493,0,0,0,376
36333,28371117,28371117,28371493,0,0,0,376
36312,28371112,28371112,28371494,0,0,0,382
36313,28371112,28371112,28371494,0,0,0,382
36314,28371112,28371112,28371494,0,0,0,382
36354,28371127,28371127,28371494,0,0,0,367
36356,28371127,28371127,28371494,0,0,0,367
36357,28371127,28371127,28371494,0,0,0,367
36237,28371066,28371066,28371495,0,0,0,429
36238,28371066,28371066,28371495,0,0,0,429
36309,28371107,28371107,28371495,0,0,0,388
36310,28371107,28371107,28371495,0,0,0,388
36311,28371107,28371107,28371495,0,0,0,388
36334,28371118,28371118,28371495,0,0,0,377
36337,28371119,28371119,28371496,0,0,0,377
36338,28371119,28371119,28371496,0,0,0,377
36278,28371094,28371094,28371497,0,0,0,403
36299,28371104,28371104,28371497,0,0,0,393
36366,28371130,28371130,28371498,0,0,0,368
36375,28371131,28371131,28371498,0,0,0,367
36376,28371132,28371132,28371499,0,0,0,367
36369,28371130,28371130,28371502,0,0,0,372
36370,28371131,28371131,28371503,0,0,0,372
36371,28371131,28371131,28371503,0,0,0,372
36306,28371106,28371106,28371505,0,0,0,399
36307,28371106,28371106,28371505,0,0,0,399
36341,28371123,28371123,28371506,0,0,0,383
36342,28371123,28371123,28371506,0,0,0,383
36325,28371115,28371115,28371507,0,0,0,392
36343,28371124,28371124,28371507,0,0,0,383
36327,28371116,28371116,28371508,0,0,0,392
36250,28371070,28371070,28371509,0,0,0,439
36406,28371140,28371140,28371510,0,0,0,370
36409,28371141,28371141,28371511,0,0,0,370
36322,28371114,28371114,28371512,0,0,0,398
36323,28371115,28371115,28371513,0,0,0,398
36349,28371125,28371125,28371513,0,0,0,388
36355,28371127,28371127,28371515,0,0,0,388
36399,28371138,28371138,28371515,0,0,0,377
36402,28371139,28371139,28371515,0,0,0,376
36403,28371139,28371139,28371515,0,0,0,376
36410,28371141,28371141,28371516,0,0,0,375
36411,28371141,28371141,28371516,0,0,0,375
36412,28371141,28371141,28371516,0,0,0,375
36447,28371153,28371153,28371516,0,0,0,363
36344,28371124,28371124,28371517,0,0,0,393
36360,28371128,28371128,28371517,0,0,0,389
36361,28371128,28371128,28371517,0,0,0,389
36415,28371142,28371142,28371517,0,0,0,375
36416,28371142,28371142,28371517,0,0,0,375
36362,28371129,28371129,28371518,0,0,0,389
36352,28371126,28371126,28371519,0,0,0,393
36315,28371112,28371112,28371521,0,0,0,409
36335,28371118,28371118,28371521,0,0,0,403
36336,28371118,28371118,28371521,0,0,0,403
36358,28371128,28371128,28371521,0,0,0,393
36359,28371128,28371128,28371521,0,0,0,393
36319,28371113,28371113,28371522,0,0,0,409
36320,28371113,28371113,28371522,0,0,0,409
36364,28371129,28371129,28371523,0,0,0,394
36365,28371130,28371130,28371524,0,0,0,394
36397,28371138,28371138,28371525,0,0,0,387
36382,28371134,28371134,28371526,0,0,0,392
36383,28371134,28371134,28371526,0,0,0,392
36384,28371134,28371134,28371526,0,0,0,392
36385,28371134,28371134,28371526,0,0,0,392
36386,28371134,28371134,28371526,0,0,0,392
36387,28371135,28371135,28371527,0,0,0,392
36388,28371135,28371135,28371527,0,0,0,392
36389,28371135,28371135,28371527,0,0,0,392
36390,28371135,28371135,28371527,0,0,0,392
36391,28371135,28371135,28371527,0,0,0,392
36440,28371150,28371150,28371527,0,0,0,377
36441,28371150,28371150,28371527,0,0,0,377
36392,28371136,28371136,28371528,0,0,0,392
36442,28371151,28371151,28371528,0,0,0,377
36367,28371130,28371130,28371529,0,0,0,399
36368,28371130,28371130,28371529,0,0,0,399
36394,28371137,28371137,28371529,0,0,0,392
36395,28371137,28371137,28371529,0,0,0,392
36433,28371148,28371148,28371529,0,0,0,381
36437,28371149,28371149,28371531,0,0,0,382
36438,28371149,28371149,28371531,0,0,0,382
36435,28371148,28371148,28371535,0,0,0,387
36377,28371133,28371133,28371536,0,0,0,403
36378,28371133,28371133,28371536,0,0,0,403
36379,28371133,28371133,28371536,0,0,0,403
36380,28371133,28371133,28371536,0,0,0,403
36436,28371149,28371149,28371536,0,0,0,387
36381,28371134,28371134,28371537,0,0,0,403
36426,28371146,28371146,28371538,0,0,0,392
36427,28371146,28371146,28371538,0,0,0,392
36428,28371146,28371146,28371538,0,0,0,392
36372,28371131,28371131,28371540,0,0,0,409
36373,28371131,28371131,28371540,0,0,0,409
36374,28371131,28371131,28371540,0,0,0,409
36396,28371137,28371137,28371540,0,0,0,403
36398,28371138,28371138,28371541,0,0,0,403
36404,28371139,28371139,28371541,0,0,0,402
36401,28371139,28371139,28371542,0,0,0,403
36405,28371140,28371140,28371542,0,0,0,402
36345,28371124,28371124,28371543,0,0,0,419
36346,28371124,28371124,28371543,0,0,0,419
36347,28371124,28371124,28371543,0,0,0,419
36429,28371146,28371146,28371543,0,0,0,397
36452,28371154,28371154,28371543,0,0,0,389
36430,28371147,28371147,28371544,0,0,0,397
36431,28371147,28371147,28371544,0,0,0,397
36453,28371155,28371155,28371544,0,0,0,389
36454,28371155,28371155,28371544,0,0,0,389
36432,28371148,28371148,28371545,0,0,0,397
36434,28371148,28371148,28371545,0,0,0,397
36470,28371172,28371172,28371545,0,0,0,373
36471,28371172,28371172,28371545,0,0,0,373
36407,28371140,28371140,28371546,0,0,0,406
36408,28371140,28371140,28371546,0,0,0,406
36443,28371152,28371152,28371546,0,0,0,394
36444,28371152,28371152,28371546,0,0,0,394
36445,28371152,28371152,28371546,0,0,0,394
36422,28371145,28371145,28371547,0,0,0,402
36423,28371145,28371145,28371547,0,0,0,402
36446,28371153,28371153,28371547,0,0,0,394
36424,28371146,28371146,28371548,0,0,0,402
36478,28371174,28371174,28371551,0,0,0,377
36479,28371174,28371174,28371551,0,0,0,377
36339,28371123,28371123,28371553,0,0,0,430
36340,28371123,28371123,28371553,0,0,0,430
36413,28371141,28371141,28371553,0,0,0,412
36439,28371150,28371150,28371553,0,0,0,403
36448,28371153,28371153,28371553,0,0,0,400
36449,28371153,28371153,28371553,0,0,0,400
36450,28371153,28371153,28371553,0,0,0,400
36457,28371168,28371168,28371553,0,0,0,385
36414,28371142,28371142,28371554,0,0,0,412
36451,28371154,28371154,28371554,0,0,0,400
36458,28371169,28371169,28371554,0,0,0,385
36459,28371169,28371169,28371554,0,0,0,385
36460,28371169,28371169,28371554,0,0,0,385
36464,28371170,28371170,28371554,0,0,0,384
36417,28371143,28371143,28371555,0,0,0,412
36418,28371143,28371143,28371555,0,0,0,412
36419,28371143,28371143,28371555,0,0,0,412
36461,28371170,28371170,28371555,0,0,0,385
36466,28371171,28371171,28371555,0,0,0,384
36467,28371171,28371171,28371555,0,0,0,384
36420,28371144,28371144,28371556,0,0,0,412
36421,28371144,28371144,28371556,0,0,0,412
36462,28371170,28371170,28371559,0,0,0,389
36481,28371175,28371175,28371563,0,0,0,388
36482,28371175,28371175,28371563,0,0,0,388
36488,28371178,28371178,28371564,0,0,0,386
36489,28371178,28371178,28371564,0,0,0,386
36490,28371178,28371178,28371564,0,0,0,386
36491,28371178,28371178,28371564,0,0,0,386
36353,28371126,28371126,28371566,0,0,0,440
36400,28371138,28371138,28371567,0,0,0,429
36499,28371191,28371191,28371568,0,0,0,377
36500,28371191,28371191,28371568,0,0,0,377
36495,28371190,28371190,28371571,0,0,0,381
36496,28371190,28371190,28371571,0,0,0,381
36497,28371190,28371190,28371571,0,0,0,381
36455,28371157,28371157,28371573,0,0,0,416
36456,28371157,28371157,28371573,0,0,0,416
36502,28371191,28371191,28371573,0,0,0,382
36505,28371192,28371192,28371574,0,0,0,382
36506,28371192,28371192,28371574,0,0,0,382
36425,28371146,28371146,28371575,0,0,0,429
36463,28371170,28371170,28371575,0,0,0,405
36507,28371193,28371193,28371575,0,0,0,382
36465,28371171,28371171,28371576,0,0,0,405
36472,28371172,28371172,28371576,0,0,0,404
36473,28371173,28371173,28371577,0,0,0,404
36474,28371173,28371173,28371577,0,0,0,404
36468,28371171,28371171,28371581,0,0,0,410
36469,28371172,28371172,28371582,0,0,0,410
36508,28371193,28371193,28371586,0,0,0,393
36509,28371193,28371193,28371586,0,0,0,393
36510,28371194,28371194,28371587,0,0,0,393
36512,28371194,28371194,28371588,0,0,0,394
36513,28371194,28371194,28371588,0,0,0,394
36514,28371194,28371194,28371588,0,0,0,394
36480,28371175,28371175,28371594,0,0,0,419
36503,28371192,28371192,28371595,0,0,0,403
36504,28371192,28371192,28371595,0,0,0,403
36498,28371190,28371190,28371598,0,0,0,408
36501,28371191,28371191,28371599,0,0,0,408
36492,28371178,28371178,28371601,0,0,0,423
36475,28371173,28371173,28371603,0,0,0,430
36476,28371173,28371173,28371603,0,0,0,430
36477,28371173,28371173,28371603,0,0,0,430
36493,28371189,28371189,28371612,0,0,0,423
36511,28371194,28371194,28371619,0,0,0,425
36483,28371176,28371176,28371620,0,0,0,444
36484,28371177,28371177,28371621,0,0,0,444
36485,28371177,28371177,28371621,0,0,0,444
36486,28371177,28371177,28371621,0,0,0,444
36487,28371177,28371177,28371621,0,0,0,444
36525,28372164,28372164,28372252,0,0,0,88
36522,28371333,28371333,28372379,0,0,0,1046
36524,28371685,28371685,28372684,0,0,0,999
36526,28372413,28372413,28372837,0,0,0,424
36528,28372945,28372945,28373007,0,0,0,62
36527,28372899,28372899,28373261,0,0,0,362
36529,28373281,28373281,28373343,0,0,0,62
36530,28374057,28374057,28374147,0,0,0,90
36531,28374216,28374216,28374348,0,0,0,132
36532,28374608,28374608,28374707,0,0,0,99
36533,28374611,28374611,28374710,0,0,0,99
36534,28374613,28374613,28374712,0,0,0,99
36535,28374629,28374629,28374728,0,0,0,99
36536,28374632,28374632,28374731,0,0,0,99
36537,28374634,28374634,28374733,0,0,0,99
36538,28374637,28374637,28374736,0,0,0,99
36540,28374691,28374691,28374755,0,0,0,64
36541,28374693,28374693,28374757,0,0,0,64
36539,28374639,28374639,28374765,0,0,0,126
36545,28374728,28374728,28374786,0,0,0,58
36542,28374696,28374696,28374791,0,0,0,95
36543,28374698,28374698,28374793,0,0,0,95
36544,28374701,28374701,28374796,0,0,0,95
36546,28374730,28374730,28374825,0,0,0,95
36548,28374757,28374757,28374825,0,0,0,68
36549,28374759,28374759,28374827,0,0,0,68
36547,28374733,28374733,28374828,0,0,0,95
36550,28374762,28374762,28374830,0,0,0,68
36552,28374787,28374787,28374861,0,0,0,74
36553,28374789,28374789,28374863,0,0,0,74
36554,28374791,28374791,28374865,0,0,0,74
36555,28374794,28374794,28374868,0,0,0,74
36551,28374764,28374764,28374869,0,0,0,105
36557,28374823,28374823,28374892,0,0,0,69
36558,28374825,28374825,28374894,0,0,0,69
36559,28374827,28374827,28374896,0,0,0,69
36556,28374796,28374796,28374902,0,0,0,106
36562,28374862,28374862,28374931,0,0,0,69
36563,28374864,28374864,28374933,0,0,0,69
36560,28374830,28374830,28374936,0,0,0,106
36565,28374867,28374867,28374936,0,0,0,69
36561,28374832,28374832,28374938,0,0,0,106
36567,28374892,28374892,28374960,0,0,0,68
36568,28374894,28374894,28374962,0,0,0,68
36569,28374896,28374896,28374964,0,0,0,68
36566,28374869,28374869,28374969,0,0,0,100
36572,28374929,28374929,28374991,0,0,0,62
36573,28374931,28374931,28374993,0,0,0,62
36570,28374899,28374899,28374998,0,0,0,99
36571,28374901,28374901,28375000,0,0,0,99
36576,28374963,28374963,28375031,0,0,0,68
36574,28374933,28374933,28375032,0,0,0,99
36577,28374965,28374965,28375033,0,0,0,68
36575,28374936,28374936,28375035,0,0,0,99
36578,28374967,28374967,28375035,0,0,0,68
36580,28374991,28374991,28375065,0,0,0,74
36581,28374994,28374994,28375068,0,0,0,74
36582,28374996,28374996,28375070,0,0,0,74
36583,28374998,28374998,28375072,0,0,0,74
36579,28374969,28374969,28375074,0,0,0,105
36585,28375028,28375028,28375097,0,0,0,69
36586,28375030,28375030,28375099,0,0,0,69
36587,28375032,28375032,28375101,0,0,0,69
36584,28375001,28375001,28375107,0,0,0,106
36590,28375067,28375067,28375136,0,0,0,69
36591,28375069,28375069,28375138,0,0,0,69
36588,28375035,28375035,28375141,0,0,0,106
36592,28375072,28375072,28375141,0,0,0,69
36589,28375037,28375037,28375143,0,0,0,106
36594,28375097,28375097,28375166,0,0,0,69
36595,28375099,28375099,28375168,0,0,0,69
36596,28375101,28375101,28375170,0,0,0,69
36593,28375074,28375074,28375175,0,0,0,101
36599,28375134,28375134,28375197,0,0,0,63
36600,28375136,28375136,28375199,0,0,0,63
36601,28375138,28375138,28375201,0,0,0,63
36597,28375104,28375104,28375204,0,0,0,100
36598,28375106,28375106,28375206,0,0,0,100
36603,28375168,28375168,28375236,0,0,0,68
36604,28375170,28375170,28375238,0,0,0,68
36602,28375141,28375141,28375241,0,0,0,100
36605,28375173,28375173,28375241,0,0,0,68
36607,28375197,28375197,28375271,0,0,0,74
36608,28375200,28375200,28375274,0,0,0,74
36564,28374864,28374864,28375275,0,0,0,411
36609,28375202,28375202,28375276,0,0,0,74
36610,28375204,28375204,28375278,0,0,0,74
36606,28375175,28375175,28375280,0,0,0,105
36612,28375234,28375234,28375303,0,0,0,69
36613,28375236,28375236,28375305,0,0,0,69
36614,28375238,28375238,28375307,0,0,0,69
36611,28375207,28375207,28375313,0,0,0,106
36617,28375244,28375244,28375313,0,0,0,69
36618,28375273,28375273,28375342,0,0,0,69
36619,28375275,28375275,28375344,0,0,0,69
36615,28375241,28375241,28375347,0,0,0,106
36620,28375278,28375278,28375347,0,0,0,69
36616,28375243,28375243,28375349,0,0,0,106
36622,28375303,28375303,28375372,0,0,0,69
36623,28375305,28375305,28375374,0,0,0,69
36624,28375307,28375307,28375376,0,0,0,69
36621,28375280,28375280,28375381,0,0,0,101
36626,28375312,28375312,28375381,0,0,0,69
36627,28375340,28375340,28375403,0,0,0,63
36629,28375342,28375342,28375405,0,0,0,63
36625,28375310,28375310,28375410,0,0,0,100
36632,28375374,28375374,28375441,0,0,0,67
36630,28375344,28375344,28375443,0,0,0,99
36633,28375376,28375376,28375443,0,0,0,67
36631,28375347,28375347,28375446,0,0,0,99
36636,28375403,28375403,28375476,0,0,0,73
36637,28375406,28375406,28375479,0,0,0,73
36638,28375408,28375408,28375481,0,0,0,73
36634,28375379,28375379,28375483,0,0,0,104
36639,28375410,28375410,28375483,0,0,0,73
36635,28375381,28375381,28375485,0,0,0,104
36628,28375340,28375340,28375508,0,0,0,168
36641,28375440,28375440,28375509,0,0,0,69
36642,28375442,28375442,28375511,0,0,0,69
36643,28375444,28375444,28375513,0,0,0,69
36640,28375413,28375413,28375518,0,0,0,105
36646,28375478,28375478,28375547,0,0,0,69
36647,28375480,28375480,28375549,0,0,0,69
36648,28375483,28375483,28375552,0,0,0,69
36644,28375447,28375447,28375553,0,0,0,106
36645,28375449,28375449,28375555,0,0,0,106
36650,28375508,28375508,28375577,0,0,0,69
36651,28375510,28375510,28375579,0,0,0,69
36652,28375512,28375512,28375581,0,0,0,69
36649,28375485,28375485,28375586,0,0,0,101
36655,28375545,28375545,28375609,0,0,0,64
36653,28375515,28375515,28375616,0,0,0,101
36654,28375517,28375517,28375618,0,0,0,101
36657,28375547,28375547,28375648,0,0,0,101
36661,28375579,28375579,28375648,0,0,0,69
36658,28375549,28375549,28375650,0,0,0,101
36662,28375581,28375581,28375650,0,0,0,69
36659,28375552,28375552,28375653,0,0,0,101
36666,28375609,28375609,28375683,0,0,0,74
36668,28375611,28375611,28375685,0,0,0,74
36669,28375613,28375613,28375687,0,0,0,74
36663,28375584,28375584,28375690,0,0,0,106
36670,28375616,28375616,28375690,0,0,0,74
36664,28375586,28375586,28375692,0,0,0,106
36673,28375646,28375646,28375715,0,0,0,69
36675,28375648,28375648,28375717,0,0,0,69
36672,28375618,28375618,28375724,0,0,0,106
36681,28375685,28375685,28375753,0,0,0,68
36676,28375650,28375650,28375755,0,0,0,105
36682,28375687,28375687,28375755,0,0,0,68
36677,28375653,28375653,28375758,0,0,0,105
36683,28375690,28375690,28375758,0,0,0,68
36678,28375655,28375655,28375760,0,0,0,105
36685,28375715,28375715,28375783,0,0,0,68
36686,28375717,28375717,28375785,0,0,0,68
36687,28375719,28375719,28375787,0,0,0,68
36684,28375692,28375692,28375792,0,0,0,100
36690,28375751,28375751,28375814,0,0,0,63
36691,28375754,28375754,28375817,0,0,0,63
36688,28375722,28375722,28375821,0,0,0,99
36689,28375724,28375724,28375823,0,0,0,99
36694,28375785,28375785,28375853,0,0,0,68
36695,28375787,28375787,28375855,0,0,0,68
36692,28375756,28375756,28375856,0,0,0,100
36696,28375789,28375789,28375857,0,0,0,68
36693,28375758,28375758,28375858,0,0,0,100
36698,28375814,28375814,28375888,0,0,0,74
36699,28375817,28375817,28375891,0,0,0,74
36700,28375819,28375819,28375893,0,0,0,74
36701,28375821,28375821,28375895,0,0,0,74
36697,28375792,28375792,28375897,0,0,0,105
36703,28375851,28375851,28375920,0,0,0,69
36704,28375853,28375853,28375922,0,0,0,69
36705,28375855,28375855,28375924,0,0,0,69
36702,28375824,28375824,28375930,0,0,0,106
36708,28375890,28375890,28375959,0,0,0,69
36709,28375892,28375892,28375961,0,0,0,69
36710,28375894,28375894,28375963,0,0,0,69
36706,28375858,28375858,28375964,0,0,0,106
36707,28375860,28375860,28375966,0,0,0,106
36712,28375920,28375920,28375989,0,0,0,69
36713,28375922,28375922,28375991,0,0,0,69
36714,28375924,28375924,28375993,0,0,0,69
36711,28375897,28375897,28375998,0,0,0,101
36717,28375957,28375957,28376020,0,0,0,63
36718,28375959,28375959,28376022,0,0,0,63
36715,28375927,28375927,28376027,0,0,0,100
36716,28375929,28375929,28376029,0,0,0,100
36660,28375577,28375577,28376057,0,0,0,480
36721,28375991,28375991,28376059,0,0,0,68
36719,28375961,28375961,28376061,0,0,0,100
36722,28375993,28375993,28376061,0,0,0,68
36723,28375995,28375995,28376063,0,0,0,68
36720,28375964,28375964,28376064,0,0,0,100
36656,28375545,28375545,28376094,0,0,0,549
36725,28376020,28376020,28376094,0,0,0,74
36726,28376023,28376023,28376097,0,0,0,74
36727,28376025,28376025,28376099,0,0,0,74
36728,28376027,28376027,28376101,0,0,0,74
36724,28375998,28375998,28376103,0,0,0,105
36729,28376030,28376030,28376104,0,0,0,74
36730,28376057,28376057,28376126,0,0,0,69
36731,28376059,28376059,28376128,0,0,0,69
36732,28376061,28376061,28376130,0,0,0,69
36733,28376064,28376064,28376133,0,0,0,69
36735,28376096,28376096,28376164,0,0,0,68
36736,28376098,28376098,28376166,0,0,0,68
36737,28376101,28376101,28376169,0,0,0,68
36734,28376066,28376066,28376171,0,0,0,105
36739,28376126,28376126,28376193,0,0,0,67
36740,28376128,28376128,28376195,0,0,0,67
36741,28376130,28376130,28376197,0,0,0,67
36738,28376103,28376103,28376202,0,0,0,99
36744,28376163,28376163,28376225,0,0,0,62
36745,28376165,28376165,28376227,0,0,0,62
36742,28376133,28376133,28376231,0,0,0,98
36743,28376135,28376135,28376233,0,0,0,98
36748,28376196,28376196,28376264,0,0,0,68
36746,28376167,28376167,28376266,0,0,0,99
36749,28376198,28376198,28376266,0,0,0,68
36750,28376200,28376200,28376268,0,0,0,68
36747,28376170,28376170,28376269,0,0,0,99
36752,28376224,28376224,28376298,0,0,0,74
36753,28376227,28376227,28376301,0,0,0,74
36754,28376229,28376229,28376303,0,0,0,74
36755,28376231,28376231,28376305,0,0,0,74
36751,28376202,28376202,28376307,0,0,0,105
36665,28375587,28375587,28376308,0,0,0,721
36757,28376261,28376261,28376330,0,0,0,69
36758,28376263,28376263,28376332,0,0,0,69
36759,28376265,28376265,28376334,0,0,0,69
36756,28376234,28376234,28376340,0,0,0,106
36762,28376300,28376300,28376369,0,0,0,69
36763,28376302,28376302,28376371,0,0,0,69
36760,28376268,28376268,28376374,0,0,0,106
36764,28376305,28376305,28376374,0,0,0,69
36761,28376270,28376270,28376376,0,0,0,106
36680,28375683,28375683,28376399,0,0,0,716
36766,28376330,28376330,28376399,0,0,0,69
36767,28376332,28376332,28376401,0,0,0,69
36768,28376334,28376334,28376403,0,0,0,69
36765,28376307,28376307,28376408,0,0,0,101
36771,28376367,28376367,28376430,0,0,0,63
36772,28376369,28376369,28376432,0,0,0,63
36769,28376337,28376337,28376437,0,0,0,100
36770,28376339,28376339,28376439,0,0,0,100
36775,28376401,28376401,28376469,0,0,0,68
36773,28376371,28376371,28376471,0,0,0,100
36776,28376403,28376403,28376471,0,0,0,68
36777,28376405,28376405,28376473,0,0,0,68
36774,28376374,28376374,28376474,0,0,0,100
36779,28376430,28376430,28376504,0,0,0,74
36780,28376433,28376433,28376507,0,0,0,74
36781,28376435,28376435,28376509,0,0,0,74
36782,28376438,28376438,28376512,0,0,0,74
36778,28376408,28376408,28376513,0,0,0,105
36784,28376467,28376467,28376536,0,0,0,69
36785,28376469,28376469,28376538,0,0,0,69
36786,28376471,28376471,28376540,0,0,0,69
36783,28376440,28376440,28376546,0,0,0,106
36789,28376506,28376506,28376574,0,0,0,68
36790,28376508,28376508,28376576,0,0,0,68
36787,28376474,28376474,28376579,0,0,0,105
36791,28376511,28376511,28376579,0,0,0,68
36788,28376476,28376476,28376581,0,0,0,105
36792,28376513,28376513,28376581,0,0,0,68
36793,28376536,28376536,28376604,0,0,0,68
36794,28376538,28376538,28376606,0,0,0,68
36795,28376540,28376540,28376608,0,0,0,68
36798,28376573,28376573,28376636,0,0,0,63
36799,28376575,28376575,28376638,0,0,0,63
36796,28376543,28376543,28376642,0,0,0,99
36797,28376545,28376545,28376644,0,0,0,99
36802,28376606,28376606,28376674,0,0,0,68
36803,28376608,28376608,28376676,0,0,0,68
36800,28376577,28376577,28376677,0,0,0,100
36804,28376611,28376611,28376679,0,0,0,68
36801,28376580,28376580,28376680,0,0,0,100
36667,28375609,28375609,28376709,0,0,0,1100
36806,28376635,28376635,28376709,0,0,0,74
36807,28376638,28376638,28376712,0,0,0,74
36808,28376640,28376640,28376714,0,0,0,74
36805,28376613,28376613,28376718,0,0,0,105
36679,28375656,28375656,28376719,0,0,0,1063
36810,28376645,28376645,28376719,0,0,0,74
36811,28376672,28376672,28376741,0,0,0,69
36812,28376674,28376674,28376743,0,0,0,69
36813,28376676,28376676,28376745,0,0,0,69
36809,28376642,28376642,28376748,0,0,0,106
36816,28376711,28376711,28376780,0,0,0,69
36817,28376713,28376713,28376782,0,0,0,69
36814,28376679,28376679,28376785,0,0,0,106
36818,28376716,28376716,28376785,0,0,0,69
36815,28376681,28376681,28376787,0,0,0,106
36820,28376741,28376741,28376810,0,0,0,69
36821,28376743,28376743,28376812,0,0,0,69
36822,28376745,28376745,28376814,0,0,0,69
36819,28376718,28376718,28376819,0,0,0,101
36825,28376778,28376778,28376841,0,0,0,63
36826,28376780,28376780,28376843,0,0,0,63
36823,28376748,28376748,28376848,0,0,0,100
36824,28376750,28376750,28376850,0,0,0,100
36829,28376812,28376812,28376880,0,0,0,68
36827,28376782,28376782,28376882,0,0,0,100
36830,28376814,28376814,28376882,0,0,0,68
36831,28376816,28376816,28376884,0,0,0,68
36828,28376785,28376785,28376885,0,0,0,100
36833,28376841,28376841,28376915,0,0,0,74
36834,28376844,28376844,28376918,0,0,0,74
36835,28376846,28376846,28376920,0,0,0,74
36836,28376849,28376849,28376923,0,0,0,74
36832,28376819,28376819,28376924,0,0,0,105
36838,28376878,28376878,28376947,0,0,0,69
36839,28376880,28376880,28376949,0,0,0,69
36840,28376882,28376882,28376951,0,0,0,69
36837,28376851,28376851,28376957,0,0,0,106
36843,28376917,28376917,28376986,0,0,0,69
36844,28376919,28376919,28376988,0,0,0,69
36841,28376885,28376885,28376991,0,0,0,106
36845,28376922,28376922,28376991,0,0,0,69
36842,28376887,28376887,28376993,0,0,0,106
36847,28376947,28376947,28377016,0,0,0,69
36848,28376949,28376949,28377018,0,0,0,69
36849,28376952,28376952,28377021,0,0,0,69
36846,28376924,28376924,28377025,0,0,0,101
36852,28376984,28376984,28377047,0,0,0,63
36853,28376986,28376986,28377049,0,0,0,63
36854,28376988,28376988,28377051,0,0,0,63
36850,28376954,28376954,28377054,0,0,0,100
36851,28376956,28376956,28377056,0,0,0,100
36856,28377018,28377018,28377086,0,0,0,68
36857,28377020,28377020,28377088,0,0,0,68
36858,28377022,28377022,28377090,0,0,0,68
36855,28376991,28376991,28377091,0,0,0,100
36859,28377025,28377025,28377093,0,0,0,68
36860,28377047,28377047,28377121,0,0,0,74
36861,28377050,28377050,28377124,0,0,0,74
36862,28377052,28377052,28377126,0,0,0,74
36863,28377054,28377054,28377128,0,0,0,74
36865,28377084,28377084,28377153,0,0,0,69
36866,28377086,28377086,28377155,0,0,0,69
36867,28377088,28377088,28377157,0,0,0,69
36864,28377057,28377057,28377163,0,0,0,106
36870,28377123,28377123,28377192,0,0,0,69
36871,28377125,28377125,28377194,0,0,0,69
36868,28377091,28377091,28377197,0,0,0,106
36872,28377128,28377128,28377197,0,0,0,69
36869,28377093,28377093,28377199,0,0,0,106
36874,28377153,28377153,28377222,0,0,0,69
36875,28377155,28377155,28377224,0,0,0,69
36876,28377157,28377157,28377226,0,0,0,69
36873,28377130,28377130,28377231,0,0,0,101
36879,28377190,28377190,28377253,0,0,0,63
36880,28377192,28377192,28377255,0,0,0,63
36877,28377160,28377160,28377260,0,0,0,100
36878,28377162,28377162,28377262,0,0,0,100
36884,28377224,28377224,28377292,0,0,0,68
36881,28377194,28377194,28377294,0,0,0,100
36885,28377226,28377226,28377294,0,0,0,68
36882,28377197,28377197,28377297,0,0,0,100
36886,28377229,28377229,28377297,0,0,0,68
36671,28375617,28375617,28377298,0,0,0,1681
36674,28375646,28375646,28377327,0,0,0,1681
36888,28377254,28377254,28377328,0,0,0,74
36889,28377256,28377256,28377330,0,0,0,74
36890,28377258,28377258,28377332,0,0,0,74
36891,28377261,28377261,28377335,0,0,0,74
36887,28377231,28377231,28377336,0,0,0,105
36893,28377290,28377290,28377359,0,0,0,69
36894,28377292,28377292,28377361,0,0,0,69
36895,28377294,28377294,28377363,0,0,0,69
36892,28377263,28377263,28377369,0,0,0,106
36898,28377329,28377329,28377398,0,0,0,69
36899,28377331,28377331,28377400,0,0,0,69
36896,28377297,28377297,28377403,0,0,0,106
36897,28377299,28377299,28377405,0,0,0,106
36902,28377359,28377359,28377427,0,0,0,68
36903,28377361,28377361,28377429,0,0,0,68
36904,28377363,28377363,28377431,0,0,0,68
36900,28377334,28377334,28377434,0,0,0,100
36901,28377336,28377336,28377436,0,0,0,100
36907,28377396,28377396,28377459,0,0,0,63
36908,28377398,28377398,28377461,0,0,0,63
36905,28377366,28377366,28377466,0,0,0,100
36906,28377368,28377368,28377468,0,0,0,100
36911,28377430,28377430,28377499,0,0,0,69
36909,28377400,28377400,28377500,0,0,0,100
36912,28377432,28377432,28377501,0,0,0,69
36910,28377403,28377403,28377503,0,0,0,100
36913,28377434,28377434,28377503,0,0,0,69
36915,28377459,28377459,28377533,0,0,0,74
36916,28377461,28377461,28377535,0,0,0,74
36917,28377463,28377463,28377537,0,0,0,74
36918,28377466,28377466,28377540,0,0,0,74
36914,28377437,28377437,28377543,0,0,0,106
36920,28377496,28377496,28377565,0,0,0,69
36921,28377498,28377498,28377567,0,0,0,69
36922,28377500,28377500,28377569,0,0,0,69
36919,28377468,28377468,28377574,0,0,0,106
36925,28377535,28377535,28377604,0,0,0,69
36926,28377537,28377537,28377606,0,0,0,69
36923,28377503,28377503,28377609,0,0,0,106
36927,28377540,28377540,28377609,0,0,0,69
36924,28377505,28377505,28377611,0,0,0,106
36929,28377565,28377565,28377634,0,0,0,69
36930,28377567,28377567,28377636,0,0,0,69
36931,28377569,28377569,28377638,0,0,0,69
36928,28377542,28377542,28377643,0,0,0,101
36934,28377602,28377602,28377665,0,0,0,63
36935,28377604,28377604,28377667,0,0,0,63
36932,28377572,28377572,28377672,0,0,0,100
36933,28377574,28377574,28377674,0,0,0,100
36938,28377636,28377636,28377704,0,0,0,68
36936,28377606,28377606,28377706,0,0,0,100
36939,28377638,28377638,28377706,0,0,0,68
36937,28377609,28377609,28377709,0,0,0,100
36940,28377641,28377641,28377709,0,0,0,68
36942,28377665,28377665,28377739,0,0,0,74
36943,28377668,28377668,28377742,0,0,0,74
36944,28377670,28377670,28377744,0,0,0,74
36945,28377672,28377672,28377746,0,0,0,74
36941,28377643,28377643,28377748,0,0,0,105
36947,28377702,28377702,28377771,0,0,0,69
36948,28377704,28377704,28377773,0,0,0,69
36949,28377706,28377706,28377775,0,0,0,69
36950,28377709,28377709,28377778,0,0,0,69
36946,28377675,28377675,28377781,0,0,0,106
36952,28377741,28377741,28377810,0,0,0,69
36953,28377743,28377743,28377812,0,0,0,69
36954,28377746,28377746,28377815,0,0,0,69
36951,28377711,28377711,28377817,0,0,0,106
36955,28377748,28377748,28377817,0,0,0,69
36956,28377771,28377771,28377840,0,0,0,69
36957,28377773,28377773,28377842,0,0,0,69
36958,28377775,28377775,28377844,0,0,0,69
36961,28377808,28377808,28377871,0,0,0,63
36962,28377810,28377810,28377873,0,0,0,63
36959,28377778,28377778,28377878,0,0,0,100
36960,28377780,28377780,28377880,0,0,0,100
36965,28377842,28377842,28377910,0,0,0,68
36963,28377812,28377812,28377912,0,0,0,100
36966,28377844,28377844,28377912,0,0,0,68
36964,28377815,28377815,28377915,0,0,0,100
36967,28377847,28377847,28377915,0,0,0,68
36969,28377872,28377872,28377946,0,0,0,74
36970,28377874,28377874,28377948,0,0,0,74
36971,28377876,28377876,28377950,0,0,0,74
36972,28377879,28377879,28377953,0,0,0,74
36968,28377849,28377849,28377954,0,0,0,105
36974,28377908,28377908,28377977,0,0,0,69
36975,28377910,28377910,28377979,0,0,0,69
36976,28377912,28377912,28377981,0,0,0,69
36187,28363046,28363046,28377987,0,0,0,14941
36973,28377881,28377881,28377987,0,0,0,106
36980,28377947,28377947,28378016,0,0,0,69
36981,28377949,28377949,28378018,0,0,0,69
36977,28377915,28377915,28378021,0,0,0,106
36982,28377952,28377952,28378021,0,0,0,69
36978,28377917,28377917,28378023,0,0,0,106
36983,28377954,28377954,28378055,0,0,0,101
36984,28377977,28377977,28378077,0,0,0,100
36989,28378014,28378014,28378077,0,0,0,63
36985,28377979,28377979,28378079,0,0,0,100
36990,28378016,28378016,28378079,0,0,0,63
36986,28377981,28377981,28378081,0,0,0,100
36987,28377984,28377984,28378084,0,0,0,100
36988,28377986,28377986,28378086,0,0,0,100
36993,28378048,28378048,28378116,0,0,0,68
36994,28378050,28378050,28378118,0,0,0,68
36991,28378019,28378019,28378119,0,0,0,100
36995,28378052,28378052,28378120,0,0,0,68
36992,28378021,28378021,28378121,0,0,0,100
36997,28378077,28378077,28378151,0,0,0,74
36998,28378080,28378080,28378154,0,0,0,74
36999,28378082,28378082,28378156,0,0,0,74
37000,28378085,28378085,28378159,0,0,0,74
36996,28378055,28378055,28378160,0,0,0,105
37002,28378114,28378114,28378183,0,0,0,69
37003,28378116,28378116,28378185,0,0,0,69
37004,28378118,28378118,28378187,0,0,0,69
37001,28378087,28378087,28378193,0,0,0,106
37007,28378153,28378153,28378222,0,0,0,69
37008,28378155,28378155,28378224,0,0,0,69
37005,28378121,28378121,28378227,0,0,0,106
37009,28378158,28378158,28378227,0,0,0,69
37006,28378123,28378123,28378229,0,0,0,106
37011,28378183,28378183,28378252,0,0,0,69
37012,28378185,28378185,28378254,0,0,0,69
37013,28378187,28378187,28378256,0,0,0,69
37010,28378160,28378160,28378261,0,0,0,101
37016,28378220,28378220,28378284,0,0,0,64
37017,28378222,28378222,28378286,0,0,0,64
37014,28378190,28378190,28378291,0,0,0,101
37015,28378192,28378192,28378293,0,0,0,101
37020,28378254,28378254,28378323,0,0,0,69
37018,28378224,28378224,28378325,0,0,0,101
37021,28378256,28378256,28378325,0,0,0,69
37019,28378227,28378227,28378328,0,0,0,101
37022,28378259,28378259,28378328,0,0,0,69
37024,28378284,28378284,28378358,0,0,0,74
37025,28378286,28378286,28378360,0,0,0,74
37026,28378288,28378288,28378362,0,0,0,74
37027,28378291,28378291,28378365,0,0,0,74
37023,28378261,28378261,28378367,0,0,0,106
37029,28378321,28378321,28378390,0,0,0,69
37030,28378323,28378323,28378392,0,0,0,69
37031,28378325,28378325,28378394,0,0,0,69
37028,28378293,28378293,28378399,0,0,0,106
37034,28378360,28378360,28378429,0,0,0,69
37035,28378362,28378362,28378431,0,0,0,69
37032,28378328,28378328,28378434,0,0,0,106
37036,28378365,28378365,28378434,0,0,0,69
37033,28378330,28378330,28378436,0,0,0,106
37038,28378390,28378390,28378459,0,0,0,69
37039,28378392,28378392,28378461,0,0,0,69
37040,28378394,28378394,28378463,0,0,0,69
37037,28378367,28378367,28378468,0,0,0,101
37043,28378427,28378427,28378490,0,0,0,63
37044,28378429,28378429,28378492,0,0,0,63
37041,28378397,28378397,28378497,0,0,0,100
37042,28378399,28378399,28378499,0,0,0,100
37047,28378461,28378461,28378529,0,0,0,68
37045,28378431,28378431,28378531,0,0,0,100
37048,28378463,28378463,28378531,0,0,0,68
37046,28378434,28378434,28378534,0,0,0,100
37049,28378466,28378466,28378534,0,0,0,68
37051,28378490,28378490,28378564,0,0,0,74
37052,28378493,28378493,28378567,0,0,0,74
37053,28378495,28378495,28378569,0,0,0,74
37054,28378498,28378498,28378572,0,0,0,74
37050,28378468,28378468,28378573,0,0,0,105
37056,28378527,28378527,28378596,0,0,0,69
37057,28378529,28378529,28378598,0,0,0,69
37058,28378531,28378531,28378600,0,0,0,69
37055,28378500,28378500,28378606,0,0,0,106
37061,28378566,28378566,28378635,0,0,0,69
37062,28378568,28378568,28378637,0,0,0,69
37059,28378534,28378534,28378640,0,0,0,106
37063,28378571,28378571,28378640,0,0,0,69
37060,28378536,28378536,28378642,0,0,0,106
37065,28378596,28378596,28378665,0,0,0,69
37066,28378598,28378598,28378667,0,0,0,69
37067,28378600,28378600,28378669,0,0,0,69
37064,28378573,28378573,28378674,0,0,0,101
37070,28378633,28378633,28378697,0,0,0,64
37072,28378635,28378635,28378699,0,0,0,64
37068,28378603,28378603,28378704,0,0,0,101
37069,28378605,28378605,28378706,0,0,0,101
37077,28378667,28378667,28378736,0,0,0,69
37073,28378637,28378637,28378738,0,0,0,101
37078,28378669,28378669,28378738,0,0,0,69
37074,28378640,28378640,28378741,0,0,0,101
37079,28378672,28378672,28378741,0,0,0,69
37081,28378697,28378697,28378771,0,0,0,74
37082,28378699,28378699,28378773,0,0,0,74
37083,28378701,28378701,28378775,0,0,0,74
37084,28378704,28378704,28378778,0,0,0,74
37080,28378674,28378674,28378780,0,0,0,106
37086,28378734,28378734,28378803,0,0,0,69
37088,28378736,28378736,28378805,0,0,0,69
37089,28378738,28378738,28378807,0,0,0,69
37085,28378706,28378706,28378812,0,0,0,106
37094,28378773,28378773,28378837,0,0,0,64
37095,28378776,28378776,28378840,0,0,0,64
37090,28378741,28378741,28378842,0,0,0,101
37091,28378743,28378743,28378844,0,0,0,101
37099,28378803,28378803,28378862,0,0,0,59
37101,28378805,28378805,28378864,0,0,0,59
37096,28378778,28378778,28378869,0,0,0,91
37098,28378780,28378780,28378871,0,0,0,91
37102,28378810,28378810,28378895,0,0,0,85
37103,28378812,28378812,28378897,0,0,0,85
37104,28378835,28378835,28378925,0,0,0,90
37105,28378837,28378837,28378927,0,0,0,90
37106,28378839,28378839,28378929,0,0,0,90
37107,28378866,28378866,28378929,0,0,0,63
37108,28378868,28378868,28378931,0,0,0,63
37110,28378888,28378888,28378957,0,0,0,69
37111,28378891,28378891,28378960,0,0,0,69
37112,28378893,28378893,28378962,0,0,0,69
37109,28378871,28378871,28378966,0,0,0,95
37115,28378925,28378925,28378989,0,0,0,64
37116,28378927,28378927,28378991,0,0,0,64
37113,28378895,28378895,28378996,0,0,0,101
37114,28378898,28378898,28378999,0,0,0,101
37119,28378959,28378959,28379028,0,0,0,69
37117,28378929,28378929,28379030,0,0,0,101
37120,28378961,28378961,28379030,0,0,0,69
37118,28378932,28378932,28379033,0,0,0,101
37121,28378964,28378964,28379033,0,0,0,69
37123,28378989,28378989,28379047,0,0,0,58
37122,28378966,28378966,28379056,0,0,0,90
37124,28378991,28378991,28379080,0,0,0,89
37125,28378993,28378993,28379082,0,0,0,89
37126,28378996,28378996,28379085,0,0,0,89
37127,28378998,28378998,28379087,0,0,0,89
37128,28379026,28379026,28379115,0,0,0,89
37129,28379028,28379028,28379117,0,0,0,89
37130,28379050,28379050,28379118,0,0,0,68
37131,28379052,28379052,28379120,0,0,0,68
37132,28379054,28379054,28379122,0,0,0,68
37071,28378633,28378633,28379142,0,0,0,509
37134,28379078,28379078,28379142,0,0,0,64
37135,28379081,28379081,28379145,0,0,0,64
37133,28379057,28379057,28379152,0,0,0,95
37139,28379115,28379115,28379174,0,0,0,59
37136,28379083,28379083,28379179,0,0,0,96
37137,28379085,28379085,28379181,0,0,0,96
37138,28379088,28379088,28379184,0,0,0,96
37140,28379117,28379117,28379213,0,0,0,96
37142,28379144,28379144,28379213,0,0,0,69
37141,28379119,28379119,28379215,0,0,0,96
37143,28379146,28379146,28379215,0,0,0,69
37144,28379148,28379148,28379217,0,0,0,69
37146,28379174,28379174,28379232,0,0,0,58
37147,28379176,28379176,28379234,0,0,0,58
37145,28379151,28379151,28379241,0,0,0,90
37148,28379178,28379178,28379267,0,0,0,89
37149,28379181,28379181,28379270,0,0,0,89
37150,28379183,28379183,28379272,0,0,0,89
37100,28378803,28378803,28379300,0,0,0,497
37151,28379211,28379211,28379300,0,0,0,89
37152,28379213,28379213,28379302,0,0,0,89
37153,28379235,28379235,28379303,0,0,0,68
37154,28379237,28379237,28379305,0,0,0,68
37157,28379263,28379263,28379327,0,0,0,64
37158,28379266,28379266,28379330,0,0,0,64
37159,28379268,28379268,28379332,0,0,0,64
37155,28379239,28379239,28379334,0,0,0,95
37075,28378641,28378641,28379335,0,0,0,694
37156,28379242,28379242,28379337,0,0,0,95
37162,28379300,28379300,28379359,0,0,0,59
37160,28379271,28379271,28379367,0,0,0,96
37161,28379273,28379273,28379369,0,0,0,96
37163,28379302,28379302,28379398,0,0,0,96
37165,28379329,28379329,28379398,0,0,0,69
37164,28379304,28379304,28379400,0,0,0,96
37166,28379331,28379331,28379400,0,0,0,69
37167,28379334,28379334,28379403,0,0,0,69
37169,28379359,28379359,28379418,0,0,0,59
37168,28379336,28379336,28379427,0,0,0,91
37170,28379361,28379361,28379451,0,0,0,90
37171,28379363,28379363,28379453,0,0,0,90
37097,28378778,28378778,28379456,0,0,0,678
37172,28379366,28379366,28379456,0,0,0,90
37173,28379368,28379368,28379458,0,0,0,90
37174,28379396,28379396,28379486,0,0,0,90
37175,28379398,28379398,28379488,0,0,0,90
37176,28379420,28379420,28379488,0,0,0,68
37177,28379422,28379422,28379490,0,0,0,68
37178,28379424,28379424,28379492,0,0,0,68
37180,28379449,28379449,28379513,0,0,0,64
37181,28379452,28379452,28379516,0,0,0,64
37179,28379427,28379427,28379522,0,0,0,95
37185,28379486,28379486,28379545,0,0,0,59
37182,28379454,28379454,28379550,0,0,0,96
37183,28379456,28379456,28379552,0,0,0,96
37184,28379459,28379459,28379555,0,0,0,96
37186,28379488,28379488,28379584,0,0,0,96
37188,28379515,28379515,28379584,0,0,0,69
37187,28379490,28379490,28379586,0,0,0,96
37189,28379517,28379517,28379586,0,0,0,69
37190,28379520,28379520,28379589,0,0,0,69
37192,28379545,28379545,28379603,0,0,0,58
37191,28379522,28379522,28379612,0,0,0,90
37193,28379547,28379547,28379636,0,0,0,89
37194,28379549,28379549,28379638,0,0,0,89
37195,28379552,28379552,28379641,0,0,0,89
37196,28379554,28379554,28379643,0,0,0,89
37197,28379582,28379582,28379671,0,0,0,89
37198,28379584,28379584,28379673,0,0,0,89
37199,28379606,28379606,28379674,0,0,0,68
37200,28379608,28379608,28379676,0,0,0,68
37201,28379610,28379610,28379678,0,0,0,68
37076,28378665,28378665,28379698,0,0,0,1033
37203,28379634,28379634,28379698,0,0,0,64
37204,28379637,28379637,28379701,0,0,0,64
37202,28379613,28379613,28379708,0,0,0,95
37208,28379671,28379671,28379730,0,0,0,59
37205,28379639,28379639,28379735,0,0,0,96
37206,28379641,28379641,28379737,0,0,0,96
37207,28379644,28379644,28379740,0,0,0,96
37209,28379673,28379673,28379769,0,0,0,96
37211,28379700,28379700,28379769,0,0,0,69
37210,28379675,28379675,28379771,0,0,0,96
37212,28379702,28379702,28379771,0,0,0,69
37213,28379705,28379705,28379774,0,0,0,69
37093,28378771,28378771,28379789,0,0,0,1018
37215,28379730,28379730,28379789,0,0,0,59
37214,28379707,28379707,28379798,0,0,0,91
37216,28379732,28379732,28379822,0,0,0,90
37217,28379734,28379734,28379824,0,0,0,90
37218,28379737,28379737,28379827,0,0,0,90
37219,28379739,28379739,28379829,0,0,0,90
37220,28379767,28379767,28379857,0,0,0,90
37221,28379769,28379769,28379859,0,0,0,90
37222,28379791,28379791,28379859,0,0,0,68
37223,28379793,28379793,28379861,0,0,0,68
37224,28379795,28379795,28379863,0,0,0,68
37226,28379821,28379821,28379885,0,0,0,64
37227,28379823,28379823,28379887,0,0,0,64
37228,28379825,28379825,28379889,0,0,0,64
37225,28379798,28379798,28379893,0,0,0,95
37231,28379857,28379857,28379916,0,0,0,59
37232,28379859,28379859,28379918,0,0,0,59
37229,28379828,28379828,28379924,0,0,0,96
37230,28379830,28379830,28379926,0,0,0,96
37234,28379886,28379886,28379955,0,0,0,69
37233,28379861,28379861,28379957,0,0,0,96
37235,28379888,28379888,28379957,0,0,0,69
37236,28379891,28379891,28379960,0,0,0,69
37237,28379893,28379893,28379978,0,0,0,85
37238,28379916,28379916,28380000,0,0,0,84
37239,28379918,28379918,28380002,0,0,0,84
37240,28379920,28379920,28380004,0,0,0,84
37241,28379923,28379923,28380007,0,0,0,84
37242,28379925,28379925,28380009,0,0,0,84
37243,28379953,28379953,28380037,0,0,0,84
37244,28379972,28379972,28380040,0,0,0,68
37245,28379974,28379974,28380042,0,0,0,68
37246,28379976,28379976,28380044,0,0,0,68
37248,28380000,28380000,28380064,0,0,0,64
37249,28380003,28380003,28380067,0,0,0,64
37247,28379979,28379979,28380074,0,0,0,95
37253,28380037,28380037,28380096,0,0,0,59
37250,28380005,28380005,28380101,0,0,0,96
37251,28380007,28380007,28380103,0,0,0,96
37252,28380010,28380010,28380106,0,0,0,96
37254,28380039,28380039,28380135,0,0,0,96
37256,28380066,28380066,28380135,0,0,0,69
37255,28380041,28380041,28380137,0,0,0,96
37257,28380068,28380068,28380137,0,0,0,69
37258,28380071,28380071,28380140,0,0,0,69
37259,28380073,28380073,28380158,0,0,0,85
37260,28380096,28380096,28380180,0,0,0,84
37261,28380098,28380098,28380182,0,0,0,84
37262,28380100,28380100,28380184,0,0,0,84
37263,28380103,28380103,28380187,0,0,0,84
37264,28380105,28380105,28380189,0,0,0,84
37265,28380133,28380133,28380217,0,0,0,84
37266,28380152,28380152,28380220,0,0,0,68
37267,28380154,28380154,28380222,0,0,0,68
37268,28380156,28380156,28380224,0,0,0,68
37270,28380180,28380180,28380238,0,0,0,58
37271,28380183,28380183,28380241,0,0,0,58
37269,28380159,28380159,28380248,0,0,0,89
37272,28380185,28380185,28380275,0,0,0,90
37273,28380187,28380187,28380277,0,0,0,90
37274,28380190,28380190,28380280,0,0,0,90
37275,28380217,28380217,28380307,0,0,0,90
37276,28380219,28380219,28380309,0,0,0,90
37277,28380241,28380241,28380310,0,0,0,69
37278,28380243,28380243,28380312,0,0,0,69
37279,28380245,28380245,28380314,0,0,0,69
37281,28380270,28380270,28380329,0,0,0,59
37280,28380248,28380248,28380339,0,0,0,91
37087,28378734,28378734,28380360,0,0,0,1626
37282,28380272,28380272,28380362,0,0,0,90
37283,28380274,28380274,28380364,0,0,0,90
37284,28380277,28380277,28380367,0,0,0,90
37092,28378743,28378743,28380369,0,0,0,1626
37285,28380279,28380279,28380369,0,0,0,90
37286,28380307,28380307,28380397,0,0,0,90
37287,28380309,28380309,28380399,0,0,0,90
37288,28380331,28380331,28380399,0,0,0,68
37289,28380333,28380333,28380401,0,0,0,68
37290,28380336,28380336,28380404,0,0,0,68
37292,28380360,28380360,28380419,0,0,0,59
37291,28380338,28380338,28380428,0,0,0,90
37293,28380363,28380363,28380453,0,0,0,90
37295,28380367,28380367,28380457,0,0,0,90
37296,28380370,28380370,28380460,0,0,0,90
35448,28294242,28294242,28380461,0,0,0,86219
37297,28380397,28380397,28380487,0,0,0,90
37299,28380399,28380399,28380489,0,0,0,90
37300,28380421,28380421,28380489,0,0,0,68
37301,28380423,28380423,28380491,0,0,0,68
37294,28380365,28380365,28380492,0,0,0,127
37302,28380426,28380426,28380494,0,0,0,68
37298,28380397,28380397,28380504,0,0,0,107
37303,28380428,28380428,28380513,0,0,0,85
37304,28380451,28380451,28380537,0,0,0,86
37305,28380453,28380453,28380539,0,0,0,86
37306,28380455,28380455,28380541,0,0,0,86
37307,28380458,28380458,28380544,0,0,0,86
37308,28380460,28380460,28380546,0,0,0,86
37309,28380487,28380487,28380573,0,0,0,86
37310,28380506,28380506,28380575,0,0,0,69
37311,28380508,28380508,28380577,0,0,0,69
37312,28380510,28380510,28380579,0,0,0,69
37314,28380536,28380536,28380594,0,0,0,58
37313,28380513,28380513,28380603,0,0,0,90
37315,28380538,28380538,28380627,0,0,0,89
37316,28380540,28380540,28380629,0,0,0,89
37317,28380543,28380543,28380632,0,0,0,89
37318,28380545,28380545,28380634,0,0,0,89
36192,28365938,28365938,28380657,0,0,0,14719
37319,28380573,28380573,28380657,0,0,0,84
37320,28380575,28380575,28380659,0,0,0,84
37321,28380597,28380597,28380660,0,0,0,63
37322,28380599,28380599,28380662,0,0,0,63
37323,28380601,28380601,28380686,0,0,0,85
37324,28380604,28380604,28380689,0,0,0,85
37325,28380626,28380626,28380712,0,0,0,86
37326,28380628,28380628,28380714,0,0,0,86
37327,28380630,28380630,28380716,0,0,0,86
37328,28380635,28380635,28380721,0,0,0,86
37329,28380657,28380657,28380748,0,0,0,91
37330,28380659,28380659,28380750,0,0,0,91
37331,28380681,28380681,28380750,0,0,0,69
37332,28380683,28380683,28380752,0,0,0,69
37333,28380686,28380686,28380771,0,0,0,85
37334,28380688,28380688,28380773,0,0,0,85
37335,28380711,28380711,28380795,0,0,0,84
37336,28380713,28380713,28380797,0,0,0,84
37337,28380715,28380715,28380799,0,0,0,84
37338,28380718,28380718,28380802,0,0,0,84
37339,28380720,28380720,28380804,0,0,0,84
37340,28380748,28380748,28380832,0,0,0,84
37341,28380767,28380767,28380835,0,0,0,68
37342,28380769,28380769,28380837,0,0,0,68
37343,28380771,28380771,28380839,0,0,0,68
37344,28380774,28380774,28380858,0,0,0,84
37345,28380796,28380796,28380880,0,0,0,84
37346,28380798,28380798,28380882,0,0,0,84
37347,28380800,28380800,28380884,0,0,0,84
37348,28380803,28380803,28380887,0,0,0,84
37349,28380805,28380805,28380889,0,0,0,84
37350,28380832,28380832,28380916,0,0,0,84
37351,28380851,28380851,28380919,0,0,0,68
37352,28380853,28380853,28380921,0,0,0,68
37353,28380855,28380855,28380923,0,0,0,68
37354,28380858,28380858,28380942,0,0,0,84
37355,28380879,28380879,28380963,0,0,0,84
37356,28380882,28380882,28380966,0,0,0,84
37357,28380884,28380884,28380968,0,0,0,84
37358,28380887,28380887,28380971,0,0,0,84
37359,28380889,28380889,28380973,0,0,0,84
37360,28380916,28380916,28380995,0,0,0,79
37361,28380935,28380935,28380998,0,0,0,63
37362,28380937,28380937,28381000,0,0,0,63
37363,28380939,28380939,28381019,0,0,0,80
37364,28380942,28380942,28381022,0,0,0,80
37365,28380963,28380963,28381043,0,0,0,80
37366,28380968,28380968,28381048,0,0,0,80
37367,28380971,28380971,28381051,0,0,0,80
37368,28380973,28380973,28381053,0,0,0,80
37369,28380995,28380995,28381080,0,0,0,85
37370,28381014,28381014,28381082,0,0,0,68
37371,28381016,28381016,28381084,0,0,0,68
37372,28381019,28381019,28381087,0,0,0,68
37374,28381043,28381043,28381112,0,0,0,69
37375,28381046,28381046,28381115,0,0,0,69
37376,28381048,28381048,28381117,0,0,0,69
37373,28381021,28381021,28381121,0,0,0,100
37379,28381082,28381082,28381146,0,0,0,64
37380,28381084,28381084,28381148,0,0,0,64
37377,28381051,28381051,28381152,0,0,0,101
37378,28381053,28381053,28381154,0,0,0,101
37383,28381112,28381112,28381176,0,0,0,64
37384,28381114,28381114,28381178,0,0,0,64
37381,28381087,28381087,28381183,0,0,0,96
37386,28381119,28381119,28381183,0,0,0,64
37382,28381089,28381089,28381185,0,0,0,96
37387,28381146,28381146,28381205,0,0,0,59
37385,28381116,28381116,28381207,0,0,0,91
37390,28381151,28381151,28381210,0,0,0,59
37392,28381176,28381176,28381235,0,0,0,59
37388,28381148,28381148,28381239,0,0,0,91
37389,28381150,28381150,28381241,0,0,0,91
37391,28381153,28381153,28381244,0,0,0,91
37393,28381178,28381178,28381269,0,0,0,91
37395,28381205,28381205,28381269,0,0,0,64
37394,28381180,28381180,28381271,0,0,0,91
37396,28381207,28381207,28381271,0,0,0,64
37397,28381210,28381210,28381274,0,0,0,64
37399,28381235,28381235,28381299,0,0,0,64
37400,28381237,28381237,28381301,0,0,0,64
37401,28381239,28381239,28381303,0,0,0,64
37398,28381212,28381212,28381308,0,0,0,96
37403,28381269,28381269,28381333,0,0,0,64
37404,28381271,28381271,28381335,0,0,0,64
37402,28381242,28381242,28381338,0,0,0,96
37407,28381299,28381299,28381363,0,0,0,64
37408,28381301,28381301,28381365,0,0,0,64
37405,28381274,28381274,28381370,0,0,0,96
36197,28368421,28368421,28381371,0,0,0,12950
37406,28381276,28381276,28381372,0,0,0,96
37411,28381333,28381333,28381397,0,0,0,64
37409,28381303,28381303,28381399,0,0,0,96
37412,28381335,28381335,28381399,0,0,0,64
37410,28381306,28381306,28381402,0,0,0,96
37415,28381363,28381363,28381427,0,0,0,64
37416,28381365,28381365,28381429,0,0,0,64
37413,28381338,28381338,28381434,0,0,0,96
37414,28381340,28381340,28381436,0,0,0,96
37419,28381397,28381397,28381461,0,0,0,64
37417,28381367,28381367,28381463,0,0,0,96
37420,28381399,28381399,28381463,0,0,0,64
37418,28381370,28381370,28381466,0,0,0,96
37423,28381427,28381427,28381491,0,0,0,64
37424,28381429,28381429,28381493,0,0,0,64
37421,28381402,28381402,28381498,0,0,0,96
37422,28381404,28381404,28381500,0,0,0,96
37427,28381461,28381461,28381525,0,0,0,64
37425,28381431,28381431,28381527,0,0,0,96
37428,28381463,28381463,28381527,0,0,0,64
37426,28381434,28381434,28381530,0,0,0,96
37431,28381491,28381491,28381555,0,0,0,64
37432,28381493,28381493,28381557,0,0,0,64
37429,28381466,28381466,28381562,0,0,0,96
37430,28381468,28381468,28381564,0,0,0,96
37435,28381525,28381525,28381589,0,0,0,64
37433,28381495,28381495,28381591,0,0,0,96
37436,28381527,28381527,28381591,0,0,0,64
37434,28381498,28381498,28381594,0,0,0,96
37439,28381555,28381555,28381619,0,0,0,64
37440,28381557,28381557,28381621,0,0,0,64
37437,28381530,28381530,28381626,0,0,0,96
37438,28381532,28381532,28381628,0,0,0,96
37443,28381589,28381589,28381653,0,0,0,64
37441,28381559,28381559,28381655,0,0,0,96
37444,28381591,28381591,28381655,0,0,0,64
37442,28381562,28381562,28381658,0,0,0,96
37447,28381619,28381619,28381683,0,0,0,64
37448,28381621,28381621,28381685,0,0,0,64
37445,28381594,28381594,28381690,0,0,0,96
37446,28381596,28381596,28381692,0,0,0,96
37451,28381653,28381653,28381717,0,0,0,64
37449,28381623,28381623,28381719,0,0,0,96
37452,28381655,28381655,28381719,0,0,0,64
37450,28381626,28381626,28381722,0,0,0,96
37453,28381658,28381658,28381722,0,0,0,64
37455,28381683,28381683,28381747,0,0,0,64
37456,28381685,28381685,28381749,0,0,0,64
37457,28381687,28381687,28381751,0,0,0,64
37454,28381660,28381660,28381756,0,0,0,96
37459,28381717,28381717,28381781,0,0,0,64
37460,28381719,28381719,28381783,0,0,0,64
37458,28381690,28381690,28381786,0,0,0,96
37463,28381747,28381747,28381811,0,0,0,64
37464,28381749,28381749,28381813,0,0,0,64
37461,28381722,28381722,28381818,0,0,0,96
37462,28381724,28381724,28381820,0,0,0,96
37467,28381781,28381781,28381845,0,0,0,64
37468,28381783,28381783,28381847,0,0,0,64
37465,28381752,28381752,28381848,0,0,0,96
37466,28381755,28381755,28381851,0,0,0,96
37471,28381811,28381811,28381875,0,0,0,64
37472,28381813,28381813,28381877,0,0,0,64
37469,28381786,28381786,28381882,0,0,0,96
37470,28381788,28381788,28381884,0,0,0,96
37475,28381845,28381845,28381909,0,0,0,64
37473,28381815,28381815,28381911,0,0,0,96
37476,28381847,28381847,28381911,0,0,0,64
37474,28381818,28381818,28381914,0,0,0,96
37479,28381875,28381875,28381939,0,0,0,64
37480,28381877,28381877,28381941,0,0,0,64
37481,28381879,28381879,28381943,0,0,0,64
37477,28381850,28381850,28381946,0,0,0,96
37478,28381852,28381852,28381948,0,0,0,96
37483,28381909,28381909,28381973,0,0,0,64
37484,28381911,28381911,28381975,0,0,0,64
37482,28381882,28381882,28381978,0,0,0,96
37487,28381939,28381939,28382003,0,0,0,64
37485,28381914,28381914,28382010,0,0,0,96
37486,28381916,28381916,28382012,0,0,0,96
37488,28381941,28381941,28382037,0,0,0,96
37491,28381973,28381973,28382037,0,0,0,64
37489,28381943,28381943,28382039,0,0,0,96
37492,28381975,28381975,28382039,0,0,0,64
37490,28381946,28381946,28382042,0,0,0,96
37495,28382003,28382003,28382067,0,0,0,64
37496,28382005,28382005,28382069,0,0,0,64
37493,28381978,28381978,28382074,0,0,0,96
37494,28381980,28381980,28382076,0,0,0,96
37499,28382037,28382037,28382106,0,0,0,69
37497,28382007,28382007,28382108,0,0,0,101
37500,28382039,28382039,28382108,0,0,0,69
37498,28382010,28382010,28382111,0,0,0,101
37501,28382042,28382042,28382111,0,0,0,69
37503,28382067,28382067,28382136,0,0,0,69
37504,28382069,28382069,28382138,0,0,0,69
37505,28382071,28382071,28382140,0,0,0,69
37502,28382044,28382044,28382145,0,0,0,101
37507,28382106,28382106,28382170,0,0,0,64
37508,28382108,28382108,28382172,0,0,0,64
37506,28382074,28382074,28382175,0,0,0,101
37511,28382136,28382136,28382200,0,0,0,64
37512,28382138,28382138,28382202,0,0,0,64
37509,28382111,28382111,28382207,0,0,0,96
37510,28382113,28382113,28382209,0,0,0,96
37515,28382170,28382170,28382234,0,0,0,64
37513,28382140,28382140,28382236,0,0,0,96
37516,28382172,28382172,28382236,0,0,0,64
37514,28382143,28382143,28382239,0,0,0,96
37519,28382200,28382200,28382264,0,0,0,64
37520,28382202,28382202,28382266,0,0,0,64
37517,28382175,28382175,28382271,0,0,0,96
37518,28382177,28382177,28382273,0,0,0,96
37524,28382234,28382234,28382298,0,0,0,64
37521,28382204,28382204,28382300,0,0,0,96
37525,28382236,28382236,28382300,0,0,0,64
37522,28382207,28382207,28382303,0,0,0,96
37528,28382264,28382264,28382328,0,0,0,64
37529,28382266,28382266,28382330,0,0,0,64
37526,28382239,28382239,28382335,0,0,0,96
37527,28382241,28382241,28382337,0,0,0,96
37532,28382298,28382298,28382367,0,0,0,69
37530,28382268,28382268,28382369,0,0,0,101
37533,28382300,28382300,28382369,0,0,0,69
37531,28382271,28382271,28382372,0,0,0,101
37534,28382303,28382303,28382372,0,0,0,69
37536,28382328,28382328,28382397,0,0,0,69
37537,28382330,28382330,28382399,0,0,0,69
37535,28382305,28382305,28382406,0,0,0,101
37540,28382367,28382367,28382431,0,0,0,64
37538,28382332,28382332,28382433,0,0,0,101
37541,28382370,28382370,28382434,0,0,0,64
37539,28382335,28382335,28382436,0,0,0,101
37544,28382397,28382397,28382461,0,0,0,64
37545,28382399,28382399,28382463,0,0,0,64
37542,28382372,28382372,28382468,0,0,0,96
37543,28382374,28382374,28382470,0,0,0,96
37548,28382431,28382431,28382495,0,0,0,64
37546,28382401,28382401,28382497,0,0,0,96
37549,28382433,28382433,28382497,0,0,0,64
37547,28382404,28382404,28382500,0,0,0,96
37553,28382461,28382461,28382525,0,0,0,64
37554,28382463,28382463,28382527,0,0,0,64
37551,28382436,28382436,28382532,0,0,0,96
37552,28382438,28382438,28382534,0,0,0,96
37557,28382495,28382495,28382559,0,0,0,64
37555,28382465,28382465,28382561,0,0,0,96
37558,28382497,28382497,28382561,0,0,0,64
37556,28382468,28382468,28382564,0,0,0,96
37559,28382500,28382500,28382564,0,0,0,64
37561,28382525,28382525,28382589,0,0,0,64
37562,28382527,28382527,28382591,0,0,0,64
37560,28382502,28382502,28382598,0,0,0,96
35514,28300662,28300662,28382621,0,0,0,81959
37565,28382559,28382559,28382623,0,0,0,64
37563,28382529,28382529,28382625,0,0,0,96
37566,28382561,28382561,28382625,0,0,0,64
37564,28382532,28382532,28382628,0,0,0,96
37569,28382589,28382589,28382653,0,0,0,64
37570,28382591,28382591,28382655,0,0,0,64
37567,28382564,28382564,28382660,0,0,0,96
37568,28382566,28382566,28382662,0,0,0,96
37573,28382623,28382623,28382687,0,0,0,64
37571,28382593,28382593,28382689,0,0,0,96
37574,28382625,28382625,28382689,0,0,0,64
37572,28382596,28382596,28382692,0,0,0,96
37577,28382653,28382653,28382717,0,0,0,64
37578,28382655,28382655,28382719,0,0,0,64
37575,28382628,28382628,28382724,0,0,0,96
37576,28382630,28382630,28382726,0,0,0,96
37581,28382687,28382687,28382751,0,0,0,64
37579,28382657,28382657,28382753,0,0,0,96
37582,28382689,28382689,28382753,0,0,0,64
37580,28382660,28382660,28382756,0,0,0,96
37585,28382717,28382717,28382781,0,0,0,64
37586,28382719,28382719,28382783,0,0,0,64
37583,28382692,28382692,28382788,0,0,0,96
37584,28382694,28382694,28382790,0,0,0,96
37589,28382751,28382751,28382815,0,0,0,64
37587,28382721,28382721,28382817,0,0,0,96
37590,28382753,28382753,28382817,0,0,0,64
37588,28382724,28382724,28382820,0,0,0,96
37593,28382781,28382781,28382845,0,0,0,64
37594,28382783,28382783,28382847,0,0,0,64
37591,28382756,28382756,28382852,0,0,0,96
37592,28382758,28382758,28382854,0,0,0,96
37597,28382815,28382815,28382879,0,0,0,64
37595,28382785,28382785,28382881,0,0,0,96
37598,28382817,28382817,28382881,0,0,0,64
37596,28382788,28382788,28382884,0,0,0,96
37601,28382845,28382845,28382909,0,0,0,64
37602,28382847,28382847,28382911,0,0,0,64
37599,28382820,28382820,28382916,0,0,0,96
37600,28382822,28382822,28382918,0,0,0,96
37605,28382879,28382879,28382943,0,0,0,64
37603,28382849,28382849,28382945,0,0,0,96
37606,28382881,28382881,28382945,0,0,0,64
37604,28382852,28382852,28382948,0,0,0,96
37609,28382909,28382909,28382973,0,0,0,64
37610,28382911,28382911,28382975,0,0,0,64
37611,28382913,28382913,28382977,0,0,0,64
37607,28382884,28382884,28382980,0,0,0,96
37608,28382886,28382886,28382982,0,0,0,96
37613,28382943,28382943,28383007,0,0,0,64
37614,28382945,28382945,28383009,0,0,0,64
37612,28382916,28382916,28383012,0,0,0,96
37615,28382948,28382948,28383023,0,0,0,75
37616,28382950,28382950,28383025,0,0,0,75
37617,28382973,28382973,28383038,0,0,0,65
37618,28382975,28382975,28383040,0,0,0,65
37619,28382977,28382977,28383053,0,0,0,76
37620,28382980,28382980,28383056,0,0,0,76
37622,28385420,28385420,28385535,0,0,0,115
36216,28370722,28370722,28385559,0,0,0,14837
37671,28386218,28386218,28386266,0,0,0,48
37675,28386219,28386219,28386278,0,0,0,59
37676,28386219,28386219,28386278,0,0,0,59
37677,28386219,28386219,28386278,0,0,0,59
37678,28386219,28386219,28386278,0,0,0,59
37624,28386056,28386056,28386413,0,0,0,357
37625,28386056,28386056,28386413,0,0,0,357
37626,28386056,28386056,28386413,0,0,0,357
37627,28386057,28386057,28386414,0,0,0,357
37628,28386057,28386057,28386414,0,0,0,357
37629,28386057,28386057,28386414,0,0,0,357
37630,28386057,28386057,28386414,0,0,0,357
37631,28386057,28386057,28386414,0,0,0,357
37632,28386057,28386057,28386414,0,0,0,357
37633,28386058,28386058,28386415,0,0,0,357
37634,28386058,28386058,28386415,0,0,0,357
37635,28386058,28386058,28386415,0,0,0,357
37636,28386058,28386058,28386415,0,0,0,357
37637,28386058,28386058,28386415,0,0,0,357
37638,28386211,28386211,28386453,0,0,0,242
37647,28386213,28386213,28386455,0,0,0,242
37652,28386214,28386214,28386456,0,0,0,242
37654,28386215,28386215,28386457,0,0,0,242
37655,28386215,28386215,28386457,0,0,0,242
37664,28386217,28386217,28386459,0,0,0,242
37669,28386218,28386218,28386460,0,0,0,242
37670,28386218,28386218,28386460,0,0,0,242
37639,28386211,28386211,28386464,0,0,0,253
37640,28386211,28386211,28386464,0,0,0,253
37641,28386211,28386211,28386464,0,0,0,253
37642,28386212,28386212,28386465,0,0,0,253
37643,28386212,28386212,28386465,0,0,0,253
37644,28386212,28386212,28386465,0,0,0,253
37645,28386212,28386212,28386465,0,0,0,253
37646,28386212,28386212,28386465,0,0,0,253
37648,28386213,28386213,28386466,0,0,0,253
37649,28386213,28386213,28386466,0,0,0,253
37650,28386213,28386213,28386466,0,0,0,253
37651,28386213,28386213,28386466,0,0,0,253
37653,28386214,28386214,28386467,0,0,0,253
37656,28386215,28386215,28386468,0,0,0,253
37657,28386215,28386215,28386468,0,0,0,253
37658,28386215,28386215,28386468,0,0,0,253
37659,28386216,28386216,28386469,0,0,0,253
37660,28386216,28386216,28386469,0,0,0,253
37661,28386216,28386216,28386469,0,0,0,253
37662,28386216,28386216,28386469,0,0,0,253
37663,28386216,28386216,28386469,0,0,0,253
37665,28386217,28386217,28386470,0,0,0,253
37666,28386217,28386217,28386470,0,0,0,253
37667,28386217,28386217,28386470,0,0,0,253
37668,28386217,28386217,28386470,0,0,0,253
37672,28386218,28386218,28386471,0,0,0,253
37673,28386218,28386218,28386471,0,0,0,253
37674,28386218,28386218,28386471,0,0,0,253
36212,28370446,28370446,28386530,0,0,0,16084
36213,28370465,28370465,28386560,0,0,0,16095
37681,28386669,28386669,28386869,0,0,0,200
37683,28386975,28386975,28387239,0,0,0,264
37684,28386975,28386975,28387239,0,0,0,264
37685,28386975,28386975,28387239,0,0,0,264
37686,28386976,28386976,28387240,0,0,0,264
37687,28386976,28386976,28387240,0,0,0,264
37688,28386976,28386976,28387240,0,0,0,264
37689,28386976,28386976,28387240,0,0,0,264
37690,28386977,28386977,28387241,0,0,0,264
37691,28386977,28386977,28387241,0,0,0,264
37692,28386977,28386977,28387241,0,0,0,264
37694,28386978,28386978,28387242,0,0,0,264
37695,28386978,28386978,28387242,0,0,0,264
37696,28386978,28386978,28387242,0,0,0,264
37697,28386978,28386978,28387242,0,0,0,264
37698,28386979,28386979,28387243,0,0,0,264
37699,28386979,28386979,28387243,0,0,0,264
37693,28386977,28386977,28387258,0,0,0,281
37700,28386979,28386979,28387260,0,0,0,281
37701,28386979,28386979,28387260,0,0,0,281
37702,28386979,28386979,28387260,0,0,0,281
37703,28386980,28386980,28387261,0,0,0,281
37704,28386980,28386980,28387261,0,0,0,281
37705,28386980,28386980,28387261,0,0,0,281
37706,28386980,28386980,28387261,0,0,0,281
37707,28386980,28386980,28387261,0,0,0,281
37708,28386980,28386980,28387261,0,0,0,281
37709,28386981,28386981,28387262,0,0,0,281
37710,28386981,28386981,28387262,0,0,0,281
37711,28386981,28386981,28387262,0,0,0,281
37712,28386981,28386981,28387262,0,0,0,281
37715,28386982,28386982,28387263,0,0,0,281
37716,28386982,28386982,28387263,0,0,0,281
37717,28386982,28386982,28387263,0,0,0,281
37718,28386982,28386982,28387263,0,0,0,281
37719,28386982,28386982,28387263,0,0,0,281
37721,28386983,28386983,28387264,0,0,0,281
37722,28386983,28386983,28387264,0,0,0,281
37723,28386983,28386983,28387264,0,0,0,281
37724,28386983,28386983,28387264,0,0,0,281
37725,28386983,28386983,28387264,0,0,0,281
37727,28386984,28386984,28387265,0,0,0,281
37728,28386984,28386984,28387265,0,0,0,281
37729,28386984,28386984,28387265,0,0,0,281
37730,28386984,28386984,28387265,0,0,0,281
37713,28386981,28386981,28387274,0,0,0,293
37714,28386981,28386981,28387274,0,0,0,293
37720,28386982,28386982,28387275,0,0,0,293
37726,28386983,28386983,28387276,0,0,0,293
37731,28386984,28386984,28387277,0,0,0,293
37732,28387238,28387238,28387320,0,0,0,82
37789,28387476,28387476,28387621,0,0,0,145
37786,28387475,28387475,28387647,0,0,0,172
37788,28387476,28387476,28387675,0,0,0,199
37733,28387407,28387407,28387730,0,0,0,323
37777,28387422,28387422,28387731,0,0,0,309
37755,28387418,28387418,28387734,0,0,0,316
37756,28387419,28387419,28387735,0,0,0,316
37760,28387419,28387419,28387741,0,0,0,322
37734,28387413,28387413,28387742,0,0,0,329
37762,28387420,28387420,28387742,0,0,0,322
37778,28387422,28387422,28387742,0,0,0,320
37779,28387423,28387423,28387743,0,0,0,320
37781,28387423,28387423,28387743,0,0,0,320
37783,28387423,28387423,28387745,0,0,0,322
37745,28387416,28387416,28387746,0,0,0,330
37746,28387416,28387416,28387746,0,0,0,330
37757,28387419,28387419,28387746,0,0,0,327
37758,28387419,28387419,28387746,0,0,0,327
37766,28387420,28387420,28387746,0,0,0,326
37767,28387420,28387420,28387746,0,0,0,326
37747,28387417,28387417,28387747,0,0,0,330
37748,28387417,28387417,28387747,0,0,0,330
37749,28387417,28387417,28387747,0,0,0,330
37750,28387417,28387417,28387747,0,0,0,330
37768,28387421,28387421,28387747,0,0,0,326
37769,28387421,28387421,28387747,0,0,0,326
37770,28387421,28387421,28387747,0,0,0,326
37782,28387423,28387423,28387750,0,0,0,327
37744,28387416,28387416,28387752,0,0,0,336
37784,28387423,28387423,28387756,0,0,0,333
37754,28387418,28387418,28387758,0,0,0,340
37765,28387420,28387420,28387758,0,0,0,338
37772,28387421,28387421,28387758,0,0,0,337
37773,28387421,28387421,28387758,0,0,0,337
37735,28387414,28387414,28387759,0,0,0,345
37736,28387414,28387414,28387759,0,0,0,345
37737,28387414,28387414,28387759,0,0,0,345
37774,28387422,28387422,28387759,0,0,0,337
37775,28387422,28387422,28387759,0,0,0,337
37776,28387422,28387422,28387759,0,0,0,337
37761,28387419,28387419,28387762,0,0,0,343
37763,28387420,28387420,28387763,0,0,0,343
37764,28387420,28387420,28387763,0,0,0,343
37771,28387421,28387421,28387763,0,0,0,342
37780,28387423,28387423,28387764,0,0,0,341
37759,28387419,28387419,28387767,0,0,0,348
37751,28387418,28387418,28387769,0,0,0,351
37752,28387418,28387418,28387769,0,0,0,351
37753,28387418,28387418,28387769,0,0,0,351
37738,28387414,28387414,28387785,0,0,0,371
37739,28387415,28387415,28387786,0,0,0,371
37740,28387415,28387415,28387786,0,0,0,371
37741,28387415,28387415,28387786,0,0,0,371
37742,28387415,28387415,28387786,0,0,0,371
37790,28387476,28387476,28387787,0,0,0,311
37787,28387476,28387476,28387814,0,0,0,338
37743,28387416,28387416,28387824,0,0,0,408
37785,28387475,28387475,28387834,0,0,0,359
37823,28389146,28389146,28389356,0,0,0,210
37821,28389146,28389146,28389377,0,0,0,231
37822,28389146,28389146,28389377,0,0,0,231
37820,28389146,28389146,28389387,0,0,0,241
37819,28389145,28389145,28389397,0,0,0,252
37817,28389145,28389145,28389418,0,0,0,273
37818,28389145,28389145,28389418,0,0,0,273
37816,28389145,28389145,28389423,0,0,0,278
37815,28389145,28389145,28389439,0,0,0,294
37792,28389140,28389140,28389447,0,0,0,307
37804,28389143,28389143,28389454,0,0,0,311
37803,28389143,28389143,28389455,0,0,0,312
37814,28389145,28389145,28389455,0,0,0,310
37802,28389143,28389143,28389458,0,0,0,315
37813,28389145,28389145,28389458,0,0,0,313
37812,28389144,28389144,28389459,0,0,0,315
37799,28389142,28389142,28389462,0,0,0,320
37800,28389142,28389142,28389462,0,0,0,320
37793,28389141,28389141,28389465,0,0,0,324
37794,28389141,28389141,28389465,0,0,0,324
37806,28389143,28389143,28389465,0,0,0,322
37808,28389144,28389144,28389465,0,0,0,321
37809,28389144,28389144,28389465,0,0,0,321
37810,28389144,28389144,28389465,0,0,0,321
37811,28389144,28389144,28389465,0,0,0,321
37807,28389144,28389144,28389466,0,0,0,322
37805,28389143,28389143,28389470,0,0,0,327
37797,28389142,28389142,28389473,0,0,0,331
37798,28389142,28389142,28389473,0,0,0,331
37795,28389141,28389141,28389486,0,0,0,345
37796,28389141,28389141,28389486,0,0,0,345
37801,28389143,28389143,28389490,0,0,0,347
37825,28390075,28390075,28390157,0,0,0,82
37827,28390160,28390160,28390207,0,0,0,47
37826,28390136,28390136,28390234,0,0,0,98
37828,28390243,28390243,28390283,0,0,0,40
37831,28390317,28390317,28390373,0,0,0,56
37830,28390308,28390308,28390386,0,0,0,78
37832,28390359,28390359,28390409,0,0,0,50
37834,28390480,28390480,28390529,0,0,0,49
37835,28390736,28390736,28390772,0,0,0,36
37837,28390806,28390806,28390846,0,0,0,40
37849,28391477,28391477,28391820,0,0,0,343
37860,28391480,28391480,28391821,0,0,0,341
37861,28391480,28391480,28391821,0,0,0,341
37838,28391474,28391474,28391822,0,0,0,348
37839,28391475,28391475,28391823,0,0,0,348
37840,28391475,28391475,28391823,0,0,0,348
37856,28391479,28391479,28391823,0,0,0,344
37889,28391485,28391485,28391824,0,0,0,339
37893,28391486,28391486,28391826,0,0,0,340
37894,28391486,28391486,28391826,0,0,0,340
37868,28391481,28391481,28391828,0,0,0,347
37869,28391481,28391481,28391828,0,0,0,347
37871,28391481,28391481,28391830,0,0,0,349
37872,28391482,28391482,28391831,0,0,0,349
37873,28391482,28391482,28391831,0,0,0,349
37874,28391482,28391482,28391831,0,0,0,349
37875,28391482,28391482,28391831,0,0,0,349
37876,28391482,28391482,28391831,0,0,0,349
37877,28391482,28391482,28391831,0,0,0,349
37852,28391478,28391478,28391832,0,0,0,354
37853,28391478,28391478,28391832,0,0,0,354
37863,28391480,28391480,28391832,0,0,0,352
37864,28391480,28391480,28391832,0,0,0,352
37865,28391480,28391480,28391832,0,0,0,352
37866,28391481,28391481,28391833,0,0,0,352
37882,28391483,28391483,28391833,0,0,0,350
37883,28391484,28391484,28391834,0,0,0,350
37884,28391484,28391484,28391834,0,0,0,350
37885,28391484,28391484,28391834,0,0,0,350
37886,28391484,28391484,28391834,0,0,0,350
37887,28391484,28391484,28391834,0,0,0,350
37888,28391484,28391484,28391834,0,0,0,350
37895,28391487,28391487,28391835,0,0,0,348
37850,28391477,28391477,28391836,0,0,0,359
37892,28391486,28391486,28391836,0,0,0,350
37851,28391478,28391478,28391837,0,0,0,359
37862,28391480,28391480,28391837,0,0,0,357
37890,28391485,28391485,28391840,0,0,0,355
37891,28391486,28391486,28391841,0,0,0,355
37878,28391483,28391483,28391843,0,0,0,360
37879,28391483,28391483,28391843,0,0,0,360
37880,28391483,28391483,28391843,0,0,0,360
37881,28391483,28391483,28391843,0,0,0,360
37841,28391475,28391475,28391849,0,0,0,374
37842,28391475,28391475,28391849,0,0,0,374
37857,28391479,28391479,28391849,0,0,0,370
37858,28391479,28391479,28391849,0,0,0,370
37859,28391479,28391479,28391849,0,0,0,370
37843,28391476,28391476,28391850,0,0,0,374
37844,28391476,28391476,28391850,0,0,0,374
37854,28391479,28391479,28391854,0,0,0,375
37855,28391479,28391479,28391854,0,0,0,375
37867,28391481,28391481,28391854,0,0,0,373
37870,28391481,28391481,28391854,0,0,0,373
37845,28391476,28391476,28391881,0,0,0,405
37846,28391476,28391476,28391881,0,0,0,405
37847,28391477,28391477,28391882,0,0,0,405
37848,28391477,28391477,28391882,0,0,0,405
37896,28392735,28392735,28392776,0,0,0,41
36979,28377945,28377945,28392796,0,0,0,14851
37903,28393647,28393647,28393908,0,0,0,261
37904,28393647,28393647,28393908,0,0,0,261
37905,28393647,28393647,28393908,0,0,0,261
37906,28393647,28393647,28393908,0,0,0,261
37907,28393647,28393647,28393908,0,0,0,261
37908,28393648,28393648,28393909,0,0,0,261
37909,28393648,28393648,28393909,0,0,0,261
37910,28393648,28393648,28393909,0,0,0,261
37911,28393648,28393648,28393909,0,0,0,261
37912,28393648,28393648,28393909,0,0,0,261
37913,28393648,28393648,28393909,0,0,0,261
37931,28393852,28393852,28393967,0,0,0,115
37932,28393852,28393852,28393967,0,0,0,115
37933,28393852,28393852,28393967,0,0,0,115
37934,28393852,28393852,28393967,0,0,0,115
37935,28393853,28393853,28393968,0,0,0,115
37936,28393853,28393853,28393968,0,0,0,115
37937,28393853,28393853,28393968,0,0,0,115
37938,28393853,28393853,28393968,0,0,0,115
37939,28393853,28393853,28393968,0,0,0,115
37940,28393854,28393854,28393969,0,0,0,115
37941,28393854,28393854,28393969,0,0,0,115
37942,28393854,28393854,28393969,0,0,0,115
37943,28393854,28393854,28393969,0,0,0,115
37944,28393854,28393854,28393969,0,0,0,115
37945,28393854,28393854,28393969,0,0,0,115
37946,28393855,28393855,28393970,0,0,0,115
37947,28393855,28393855,28393970,0,0,0,115
37916,28393848,28393848,28394027,0,0,0,179
37918,28393849,28393849,28394028,0,0,0,179
37919,28393849,28393849,28394028,0,0,0,179
37920,28393849,28393849,28394028,0,0,0,179
37921,28393849,28393849,28394028,0,0,0,179
37922,28393850,28393850,28394029,0,0,0,179
37923,28393850,28393850,28394029,0,0,0,179
37924,28393850,28393850,28394029,0,0,0,179
37925,28393850,28393850,28394029,0,0,0,179
37926,28393851,28393851,28394030,0,0,0,179
37927,28393851,28393851,28394030,0,0,0,179
37928,28393851,28393851,28394030,0,0,0,179
37929,28393851,28393851,28394030,0,0,0,179
37930,28393852,28393852,28394031,0,0,0,179
37914,28393847,28393847,28394108,0,0,0,261
37915,28393848,28393848,28394109,0,0,0,261
37623,28385720,28385720,28394113,0,0,0,8393
37898,28393646,28393646,28394116,0,0,0,470
37899,28393646,28393646,28394116,0,0,0,470
37900,28393646,28393646,28394116,0,0,0,470
37901,28393646,28393646,28394116,0,0,0,470
37902,28393647,28393647,28394117,0,0,0,470
37917,28393848,28393848,28394127,0,0,0,279
37981,28394477,28394477,28394676,0,0,0,199
37982,28394477,28394477,28394676,0,0,0,199
37964,28394474,28394474,28394682,0,0,0,208
37965,28394474,28394474,28394682,0,0,0,208
37983,28394478,28394478,28394688,0,0,0,210
37991,28394567,28394567,28394689,0,0,0,122
37966,28394474,28394474,28394693,0,0,0,219
37967,28394474,28394474,28394693,0,0,0,219
37968,28394475,28394475,28394694,0,0,0,219
37984,28394478,28394478,28394699,0,0,0,221
37985,28394478,28394478,28394699,0,0,0,221
37969,28394475,28394475,28394705,0,0,0,230
37970,28394475,28394475,28394705,0,0,0,230
37986,28394478,28394478,28394710,0,0,0,232
37971,28394475,28394475,28394716,0,0,0,241
37972,28394475,28394475,28394716,0,0,0,241
37973,28394476,28394476,28394728,0,0,0,252
37974,28394476,28394476,28394728,0,0,0,252
37975,28394476,28394476,28394739,0,0,0,263
37976,28394476,28394476,28394739,0,0,0,263
37977,28394476,28394476,28394739,0,0,0,263
37948,28394470,28394470,28394747,0,0,0,277
37949,28394470,28394470,28394747,0,0,0,277
37950,28394470,28394470,28394747,0,0,0,277
37951,28394471,28394471,28394748,0,0,0,277
37952,28394471,28394471,28394748,0,0,0,277
37953,28394471,28394471,28394748,0,0,0,277
37954,28394472,28394472,28394749,0,0,0,277
37955,28394472,28394472,28394749,0,0,0,277
37956,28394472,28394472,28394749,0,0,0,277
37957,28394472,28394472,28394749,0,0,0,277
37958,28394473,28394473,28394750,0,0,0,277
37959,28394473,28394473,28394750,0,0,0,277
37960,28394473,28394473,28394750,0,0,0,277
37961,28394473,28394473,28394750,0,0,0,277
37962,28394474,28394474,28394751,0,0,0,277
37978,28394477,28394477,28394751,0,0,0,274
37979,28394477,28394477,28394751,0,0,0,274
37980,28394477,28394477,28394762,0,0,0,285
37963,28394474,28394474,28394763,0,0,0,289
37987,28394566,28394566,28394798,0,0,0,232
37988,28394566,28394566,28394809,0,0,0,243
37992,28394567,28394567,28394810,0,0,0,243
37989,28394566,28394566,28394820,0,0,0,254
37993,28394567,28394567,28394821,0,0,0,254
37994,28394568,28394568,28394822,0,0,0,254
37990,28394566,28394566,28394831,0,0,0,265
37995,28394568,28394568,28394833,0,0,0,265
37997,28395583,28395583,28395769,0,0,0,186
38032,28396368,28396368,28396564,0,0,0,196
38016,28396365,28396365,28396566,0,0,0,201
38017,28396365,28396365,28396577,0,0,0,212
38033,28396368,28396368,28396586,0,0,0,218
38034,28396369,28396369,28396587,0,0,0,218
38018,28396366,28396366,28396589,0,0,0,223
38019,28396366,28396366,28396589,0,0,0,223
38020,28396366,28396366,28396589,0,0,0,223
38035,28396369,28396369,28396598,0,0,0,229
38036,28396369,28396369,28396598,0,0,0,229
38021,28396366,28396366,28396600,0,0,0,234
38037,28396369,28396369,28396609,0,0,0,240
38022,28396366,28396366,28396611,0,0,0,245
38023,28396367,28396367,28396612,0,0,0,245
38024,28396367,28396367,28396612,0,0,0,245
37998,28396361,28396361,28396613,0,0,0,252
37999,28396361,28396361,28396613,0,0,0,252
38000,28396361,28396361,28396613,0,0,0,252
38001,28396361,28396361,28396613,0,0,0,252
38002,28396362,28396362,28396614,0,0,0,252
38003,28396362,28396362,28396614,0,0,0,252
38004,28396362,28396362,28396614,0,0,0,252
38005,28396362,28396362,28396614,0,0,0,252
38025,28396367,28396367,28396623,0,0,0,256
38026,28396367,28396367,28396623,0,0,0,256
38006,28396363,28396363,28396626,0,0,0,263
38027,28396367,28396367,28396634,0,0,0,267
38028,28396367,28396367,28396634,0,0,0,267
38007,28396363,28396363,28396637,0,0,0,274
38008,28396363,28396363,28396637,0,0,0,274
38009,28396364,28396364,28396638,0,0,0,274
38029,28396368,28396368,28396646,0,0,0,278
38030,28396368,28396368,28396646,0,0,0,278
38010,28396364,28396364,28396649,0,0,0,285
38011,28396364,28396364,28396649,0,0,0,285
38031,28396368,28396368,28396657,0,0,0,289
38012,28396364,28396364,28396660,0,0,0,296
38013,28396365,28396365,28396661,0,0,0,296
38014,28396365,28396365,28396672,0,0,0,307
38015,28396365,28396365,28396672,0,0,0,307
36201,28369008,28369008,28397154,0,0,0,28146
38067,28396918,28396918,28397157,0,0,0,239
38043,28396886,28396886,28397161,0,0,0,275
38044,28396886,28396886,28397161,0,0,0,275
38045,28396886,28396886,28397188,0,0,0,302
38046,28396886,28396886,28397188,0,0,0,302
38047,28396886,28396886,28397188,0,0,0,302
38048,28396912,28396912,28397204,0,0,0,292
38049,28396913,28396913,28397205,0,0,0,292
38050,28396913,28396913,28397205,0,0,0,292
38051,28396913,28396913,28397205,0,0,0,292
38052,28396913,28396913,28397205,0,0,0,292
38088,28396922,28396922,28397209,0,0,0,287
38089,28396922,28396922,28397209,0,0,0,287
38091,28396922,28396922,28397209,0,0,0,287
38092,28396922,28396922,28397209,0,0,0,287
38093,28396922,28396922,28397209,0,0,0,287
38090,28396922,28396922,28397220,0,0,0,298
38053,28396914,28396914,28397238,0,0,0,324
38054,28396914,28396914,28397238,0,0,0,324
38055,28396914,28396914,28397238,0,0,0,324
38056,28396915,28396915,28397239,0,0,0,324
38057,28396915,28396915,28397239,0,0,0,324
38058,28396915,28396915,28397239,0,0,0,324
38059,28396915,28396915,28397239,0,0,0,324
38060,28396916,28396916,28397240,0,0,0,324
38094,28397151,28397151,28397248,0,0,0,97
38095,28397151,28397151,28397248,0,0,0,97
38061,28396916,28396916,28397252,0,0,0,336
38062,28396916,28396916,28397252,0,0,0,336
38063,28396916,28396916,28397264,0,0,0,348
38064,28396917,28396917,28397265,0,0,0,348
38065,28396917,28396917,28397276,0,0,0,359
38066,28396917,28396917,28397276,0,0,0,359
38068,28396918,28396918,28397356,0,0,0,438
38070,28396919,28396919,28397368,0,0,0,449
38071,28396919,28396919,28397368,0,0,0,449
38072,28396919,28396919,28397368,0,0,0,449
38069,28396918,28396918,28397378,0,0,0,460
38073,28396919,28396919,28397379,0,0,0,460
38076,28396920,28396920,28397380,0,0,0,460
38077,28396920,28396920,28397380,0,0,0,460
38078,28396920,28396920,28397391,0,0,0,471
38079,28396920,28396920,28397391,0,0,0,471
38080,28396920,28396920,28397391,0,0,0,471
38074,28396919,28396919,28397401,0,0,0,482
38075,28396919,28396919,28397401,0,0,0,482
38081,28396920,28396920,28397402,0,0,0,482
38082,28396921,28396921,28397403,0,0,0,482
38083,28396921,28396921,28397403,0,0,0,482
38084,28396921,28396921,28397403,0,0,0,482
38085,28396921,28396921,28397403,0,0,0,482
38096,28397151,28397151,28397423,0,0,0,272
38086,28396921,28396921,28397425,0,0,0,504
38087,28396921,28396921,28397425,0,0,0,504
38097,28397151,28397151,28397434,0,0,0,283
38099,28397152,28397152,28397435,0,0,0,283
38100,28397152,28397152,28397446,0,0,0,294
38042,28396741,28396741,28397713,0,0,0,972
38158,28397456,28397456,28397723,0,0,0,267
38109,28397281,28397281,28397726,0,0,0,445
38110,28397281,28397281,28397742,0,0,0,461
38111,28397281,28397281,28397742,0,0,0,461
38112,28397281,28397281,28397742,0,0,0,461
38125,28397306,28397306,28397747,0,0,0,441
38127,28397306,28397306,28397747,0,0,0,441
38128,28397306,28397306,28397747,0,0,0,441
38156,28397311,28397311,28397747,0,0,0,436
38142,28397309,28397309,28397748,0,0,0,439
38132,28397307,28397307,28397749,0,0,0,442
38143,28397309,28397309,28397749,0,0,0,440
38133,28397308,28397308,28397750,0,0,0,442
38134,28397308,28397308,28397750,0,0,0,442
38153,28397311,28397311,28397750,0,0,0,439
38155,28397311,28397311,28397750,0,0,0,439
38121,28397305,28397305,28397751,0,0,0,446
38122,28397305,28397305,28397751,0,0,0,446
38123,28397305,28397305,28397751,0,0,0,446
38135,28397308,28397308,28397751,0,0,0,443
38136,28397308,28397308,28397751,0,0,0,443
38150,28397310,28397310,28397751,0,0,0,441
38154,28397311,28397311,28397752,0,0,0,441
38113,28397303,28397303,28397758,0,0,0,455
38114,28397303,28397303,28397758,0,0,0,455
38151,28397311,28397311,28397758,0,0,0,447
38152,28397311,28397311,28397758,0,0,0,447
38145,28397310,28397310,28397760,0,0,0,450
38148,28397310,28397310,28397761,0,0,0,451
38149,28397310,28397310,28397761,0,0,0,451
38139,28397309,28397309,28397763,0,0,0,454
38140,28397309,28397309,28397763,0,0,0,454
38141,28397309,28397309,28397763,0,0,0,454
38130,28397307,28397307,28397764,0,0,0,457
38131,28397307,28397307,28397764,0,0,0,457
38144,28397310,28397310,28397766,0,0,0,456
38147,28397310,28397310,28397766,0,0,0,456
38137,28397308,28397308,28397767,0,0,0,459
38126,28397306,28397306,28397768,0,0,0,462
38138,28397309,28397309,28397768,0,0,0,459
38124,28397305,28397305,28397772,0,0,0,467
38129,28397307,28397307,28397774,0,0,0,467
38146,28397310,28397310,28397776,0,0,0,466
38115,28397303,28397303,28397779,0,0,0,476
38116,28397303,28397303,28397779,0,0,0,476
38118,28397304,28397304,28397780,0,0,0,476
38119,28397304,28397304,28397806,0,0,0,502
38120,28397304,28397304,28397806,0,0,0,502
38038,28396477,28396477,28397880,0,0,0,1403
38039,28396671,28396671,28397928,0,0,0,1257
38040,28396702,28396702,28398133,0,0,0,1431
38041,28396719,28396719,28398363,0,0,0,1644
37682,28386800,28386800,28399042,0,0,0,12242
38107,28397271,28397271,28400649,0,0,0,3378
38102,28397246,28397246,28400929,0,0,0,3683
38104,28397258,28397258,28400940,0,0,0,3682
38108,28397277,28397277,28400983,0,0,0,3706
38103,28397253,28397253,28401106,0,0,0,3853
38098,28397151,28397151,28401144,0,0,0,3993
38105,28397262,28397262,28401363,0,0,0,4101
38106,28397266,28397266,28401410,0,0,0,4144
38117,28397303,28397303,28401753,0,0,0,4450
38101,28397236,28397236,28401919,0,0,0,4683
38157,28397312,28397312,28402191,0,0,0,4879
37679,28386484,28386484,28402557,0,0,0,16073
37680,28386513,28386513,28402568,0,0,0,16055
38159,28401999,28401999,28403101,0,0,0,1102
37996,28394853,28394853,28403136,0,0,0,8283
36209,28370162,28370162,28406162,0,0,0,36000
38162,28406225,28406225,28407210,0,0,0,985
37897,28392764,28392764,28407728,0,0,0,14964
38180,28412833,28412833,28413034,0,0,0,201
38181,28412834,28412834,28413035,0,0,0,201
38182,28412834,28412834,28413035,0,0,0,201
38183,28412834,28412834,28413035,0,0,0,201
38184,28412834,28412834,28413035,0,0,0,201
38185,28412835,28412835,28413036,0,0,0,201
38186,28412835,28412835,28413036,0,0,0,201
38187,28412835,28412835,28413036,0,0,0,201
38188,28412835,28412835,28413036,0,0,0,201
38189,28412836,28412836,28413037,0,0,0,201
38190,28412836,28412836,28413037,0,0,0,201
38191,28412836,28412836,28413037,0,0,0,201
38192,28412837,28412837,28413038,0,0,0,201
38165,28412754,28412754,28413042,0,0,0,288
38168,28412755,28412755,28413043,0,0,0,288
38169,28412755,28412755,28413043,0,0,0,288
38173,28412756,28412756,28413044,0,0,0,288
38174,28412756,28412756,28413044,0,0,0,288
38175,28412756,28412756,28413044,0,0,0,288
38176,28412756,28412756,28413044,0,0,0,288
38193,28412837,28412837,28413055,0,0,0,218
38194,28412837,28412837,28413055,0,0,0,218
38195,28412837,28412837,28413055,0,0,0,218
38196,28412838,28412838,28413056,0,0,0,218
38197,28412838,28412838,28413056,0,0,0,218
38198,28412838,28412838,28413056,0,0,0,218
38199,28412838,28412838,28413056,0,0,0,218
38200,28412838,28412838,28413056,0,0,0,218
38201,28412838,28412838,28413056,0,0,0,218
38202,28412839,28412839,28413057,0,0,0,218
38203,28412839,28412839,28413057,0,0,0,218
38204,28412839,28412839,28413057,0,0,0,218
38205,28412839,28412839,28413057,0,0,0,218
38206,28412839,28412839,28413057,0,0,0,218
38207,28412840,28412840,28413058,0,0,0,218
38208,28412840,28412840,28413058,0,0,0,218
38209,28412840,28412840,28413058,0,0,0,218
38210,28412840,28412840,28413058,0,0,0,218
38211,28412840,28412840,28413058,0,0,0,218
38212,28412840,28412840,28413058,0,0,0,218
38213,28412840,28412840,28413058,0,0,0,218
38166,28412754,28412754,28413059,0,0,0,305
38167,28412754,28412754,28413059,0,0,0,305
38214,28412841,28412841,28413059,0,0,0,218
38170,28412755,28412755,28413060,0,0,0,305
38171,28412755,28412755,28413060,0,0,0,305
38172,28412755,28412755,28413060,0,0,0,305
38177,28412756,28412756,28413061,0,0,0,305
38178,28412756,28412756,28413061,0,0,0,305
38179,28412756,28412756,28413061,0,0,0,305
38215,28413022,28413022,28413367,0,0,0,345
38256,28413663,28413663,28413737,0,0,0,74
38257,28413664,28413664,28413738,0,0,0,74
38258,28413664,28413664,28413738,0,0,0,74
38216,28413454,28413454,28413741,0,0,0,287
38217,28413454,28413454,28413741,0,0,0,287
38220,28413455,28413455,28413742,0,0,0,287
38221,28413455,28413455,28413742,0,0,0,287
38222,28413455,28413455,28413742,0,0,0,287
38225,28413456,28413456,28413743,0,0,0,287
38226,28413456,28413456,28413743,0,0,0,287
38227,28413456,28413456,28413743,0,0,0,287
38228,28413456,28413456,28413743,0,0,0,287
38232,28413457,28413457,28413744,0,0,0,287
38238,28413458,28413458,28413745,0,0,0,287
38244,28413459,28413459,28413746,0,0,0,287
38245,28413459,28413459,28413746,0,0,0,287
38250,28413460,28413460,28413747,0,0,0,287
38259,28413664,28413664,28413755,0,0,0,91
38260,28413664,28413664,28413755,0,0,0,91
38261,28413665,28413665,28413756,0,0,0,91
38262,28413665,28413665,28413756,0,0,0,91
38263,28413665,28413665,28413756,0,0,0,91
38264,28413665,28413665,28413756,0,0,0,91
38265,28413666,28413666,28413757,0,0,0,91
38218,28413454,28413454,28413758,0,0,0,304
38219,28413454,28413454,28413758,0,0,0,304
38223,28413455,28413455,28413759,0,0,0,304
38224,28413455,28413455,28413759,0,0,0,304
38229,28413456,28413456,28413760,0,0,0,304
38230,28413456,28413456,28413760,0,0,0,304
38231,28413456,28413456,28413760,0,0,0,304
38233,28413457,28413457,28413761,0,0,0,304
38234,28413457,28413457,28413761,0,0,0,304
38235,28413457,28413457,28413761,0,0,0,304
38236,28413457,28413457,28413761,0,0,0,304
38237,28413457,28413457,28413761,0,0,0,304
38239,28413458,28413458,28413762,0,0,0,304
38240,28413458,28413458,28413762,0,0,0,304
38241,28413458,28413458,28413762,0,0,0,304
38242,28413458,28413458,28413762,0,0,0,304
38243,28413458,28413458,28413762,0,0,0,304
38246,28413459,28413459,28413763,0,0,0,304
38247,28413459,28413459,28413763,0,0,0,304
38248,28413459,28413459,28413763,0,0,0,304
38249,28413459,28413459,28413763,0,0,0,304
38251,28413460,28413460,28413764,0,0,0,304
38252,28413460,28413460,28413764,0,0,0,304
38253,28413460,28413460,28413764,0,0,0,304
38254,28413460,28413460,28413764,0,0,0,304
38255,28413460,28413460,28413764,0,0,0,304
38266,28413833,28413833,28414163,0,0,0,330
38267,28413833,28413833,28414179,0,0,0,346
38268,28413833,28413833,28414195,0,0,0,362
38269,28413833,28413833,28414195,0,0,0,362
38270,28413833,28413833,28414195,0,0,0,362
38271,28413833,28413833,28414221,0,0,0,388
38272,28413834,28413834,28414222,0,0,0,388
38273,28413834,28413834,28414222,0,0,0,388
38274,28413834,28413834,28414222,0,0,0,388
38275,28413834,28413834,28414222,0,0,0,388
38310,28414196,28414196,28414303,0,0,0,107
38311,28414197,28414197,28414304,0,0,0,107
38313,28414199,28414199,28414306,0,0,0,107
38314,28414200,28414200,28414307,0,0,0,107
38312,28414198,28414198,28414316,0,0,0,118
38315,28414216,28414216,28414323,0,0,0,107
38316,28414217,28414217,28414324,0,0,0,107
38317,28414217,28414217,28414324,0,0,0,107
38318,28414218,28414218,28414325,0,0,0,107
38320,28414219,28414219,28414326,0,0,0,107
38321,28414219,28414219,28414326,0,0,0,107
38319,28414218,28414218,28414336,0,0,0,118
38322,28414219,28414219,28414337,0,0,0,118
38323,28414220,28414220,28414338,0,0,0,118
38324,28414220,28414220,28414338,0,0,0,118
38325,28414221,28414221,28414339,0,0,0,118
38292,28414147,28414147,28414346,0,0,0,199
38293,28414149,28414149,28414348,0,0,0,199
38294,28414150,28414150,28414349,0,0,0,199
38295,28414150,28414150,28414349,0,0,0,199
38296,28414152,28414152,28414351,0,0,0,199
38297,28414152,28414152,28414351,0,0,0,199
38298,28414152,28414152,28414351,0,0,0,199
38299,28414153,28414153,28414352,0,0,0,199
38300,28414153,28414153,28414352,0,0,0,199
38301,28414155,28414155,28414354,0,0,0,199
38302,28414156,28414156,28414355,0,0,0,199
38303,28414156,28414156,28414355,0,0,0,199
38304,28414156,28414156,28414355,0,0,0,199
38305,28414157,28414157,28414356,0,0,0,199
38306,28414157,28414157,28414356,0,0,0,199
38307,28414159,28414159,28414358,0,0,0,199
38308,28414160,28414160,28414359,0,0,0,199
38309,28414160,28414160,28414359,0,0,0,199
38277,28414138,28414138,28414502,0,0,0,364
38278,28414139,28414139,28414503,0,0,0,364
38279,28414140,28414140,28414504,0,0,0,364
38280,28414141,28414141,28414505,0,0,0,364
38281,28414141,28414141,28414505,0,0,0,364
38282,28414141,28414141,28414505,0,0,0,364
38283,28414141,28414141,28414505,0,0,0,364
38284,28414142,28414142,28414506,0,0,0,364
38285,28414143,28414143,28414507,0,0,0,364
38286,28414143,28414143,28414507,0,0,0,364
38287,28414144,28414144,28414508,0,0,0,364
38288,28414144,28414144,28414508,0,0,0,364
38289,28414144,28414144,28414508,0,0,0,364
38290,28414144,28414144,28414508,0,0,0,364
38291,28414145,28414145,28414509,0,0,0,364
38276,28414137,28414137,28414580,0,0,0,443
38326,28415216,28415216,28415579,0,0,0,363
38327,28415216,28415216,28415579,0,0,0,363
38328,28415217,28415217,28415601,0,0,0,384
38329,28415217,28415217,28415601,0,0,0,384
38330,28415217,28415217,28415601,0,0,0,384
38331,28415217,28415217,28415601,0,0,0,384
38334,28415424,28415424,28415774,0,0,0,350
38335,28415424,28415424,28415774,0,0,0,350
38332,28415423,28415423,28415778,0,0,0,355
38338,28415425,28415425,28415792,0,0,0,367
38339,28415425,28415425,28415792,0,0,0,367
38340,28415425,28415425,28415792,0,0,0,367
38341,28415425,28415425,28415792,0,0,0,367
38342,28415425,28415425,28415792,0,0,0,367
38333,28415423,28415423,28415794,0,0,0,371
38349,28415516,28415516,28415795,0,0,0,279
38336,28415424,28415424,28415801,0,0,0,377
38337,28415424,28415424,28415801,0,0,0,377
38343,28415426,28415426,28415830,0,0,0,404
38344,28415426,28415426,28415830,0,0,0,404
38345,28415426,28415426,28415830,0,0,0,404
38347,28415490,28415490,28415847,0,0,0,357
38348,28415490,28415490,28415847,0,0,0,357
38346,28415489,28415489,28415862,0,0,0,373
38373,28415981,28415981,28416090,0,0,0,109
38375,28415982,28415982,28416091,0,0,0,109
38376,28415982,28415982,28416091,0,0,0,109
38379,28415983,28415983,28416092,0,0,0,109
38374,28415981,28415981,28416102,0,0,0,121
38377,28415982,28415982,28416103,0,0,0,121
38378,28415982,28415982,28416103,0,0,0,121
38380,28415995,28415995,28416104,0,0,0,109
38381,28415995,28415995,28416104,0,0,0,109
38382,28415996,28415996,28416105,0,0,0,109
38372,28415980,28415980,28416112,0,0,0,132
38383,28415996,28415996,28416117,0,0,0,121
38384,28415996,28415996,28416117,0,0,0,121
38385,28415997,28415997,28416118,0,0,0,121
38386,28415999,28415999,28416120,0,0,0,121
38387,28415999,28415999,28416120,0,0,0,121
38388,28416002,28416002,28416123,0,0,0,121
38389,28416002,28416002,28416123,0,0,0,121
38390,28416003,28416003,28416155,0,0,0,152
38350,28415973,28415973,28416206,0,0,0,233
38351,28415973,28415973,28416206,0,0,0,233
38352,28415973,28415973,28416206,0,0,0,233
38353,28415973,28415973,28416206,0,0,0,233
38354,28415974,28415974,28416207,0,0,0,233
38355,28415974,28415974,28416207,0,0,0,233
38356,28415974,28415974,28416207,0,0,0,233
38357,28415975,28415975,28416208,0,0,0,233
38358,28415976,28415976,28416209,0,0,0,233
38359,28415976,28415976,28416209,0,0,0,233
38360,28415976,28415976,28416209,0,0,0,233
38361,28415977,28415977,28416210,0,0,0,233
38362,28415977,28415977,28416210,0,0,0,233
38363,28415977,28415977,28416210,0,0,0,233
38364,28415978,28415978,28416211,0,0,0,233
38365,28415978,28415978,28416211,0,0,0,233
38366,28415978,28415978,28416211,0,0,0,233
38367,28415978,28415978,28416211,0,0,0,233
38368,28415978,28415978,28416211,0,0,0,233
38369,28415979,28415979,28416212,0,0,0,233
38370,28415979,28415979,28416212,0,0,0,233
38371,28415979,28415979,28416224,0,0,0,245
36883,28377198,28377198,28416617,0,0,0,39419
38160,28402515,28402515,28418425,0,0,0,15910
38161,28402533,28402533,28418440,0,0,0,15907
38163,28407678,28407678,28422523,0,0,0,14845
38392,28418403,28418403,28434408,0,0,0,16005
38391,28418377,28418377,28434429,0,0,0,16052
38393,28422488,28422488,28437257,0,0,0,14769
37621,28384844,28384844,28442624,0,0,0,57780
38395,28434398,28434398,28450367,0,0,0,15969
38394,28434359,28434359,28450447,0,0,0,16088
38396,28437208,28437208,28451927,0,0,0,14719
38403,28452172,28452172,28452267,0,0,0,95
38407,28452746,28452746,28452830,0,0,0,84
38412,28452970,28452970,28453230,0,0,0,260
38411,28452934,28452934,28453233,0,0,0,299
38413,28452970,28452970,28453334,0,0,0,364
38417,28452979,28452979,28453338,0,0,0,359
38418,28452979,28452979,28453338,0,0,0,359
38414,28452971,28452971,28453351,0,0,0,380
38415,28452971,28452971,28453351,0,0,0,380
38416,28452971,28452971,28453351,0,0,0,380
38421,28453230,28453230,28453584,0,0,0,354
38422,28453230,28453230,28453584,0,0,0,354
38419,28453229,28453229,28453588,0,0,0,359
38450,28453249,28453249,28453589,0,0,0,340
38428,28453232,28453232,28453596,0,0,0,364
38429,28453232,28453232,28453596,0,0,0,364
38431,28453233,28453233,28453597,0,0,0,364
38432,28453233,28453233,28453597,0,0,0,364
38458,28453251,28453251,28453597,0,0,0,346
38437,28453234,28453234,28453599,0,0,0,365
38438,28453235,28453235,28453600,0,0,0,365
38439,28453235,28453235,28453600,0,0,0,365
38420,28453230,28453230,28453610,0,0,0,380
38423,28453230,28453230,28453610,0,0,0,380
38469,28453253,28453253,28453610,0,0,0,357
38470,28453253,28453253,28453610,0,0,0,357
38424,28453231,28453231,28453611,0,0,0,380
38425,28453231,28453231,28453611,0,0,0,380
38426,28453231,28453231,28453611,0,0,0,380
38441,28453247,28453247,28453613,0,0,0,366
38442,28453247,28453247,28453613,0,0,0,366
38490,28453258,28453258,28453617,0,0,0,359
38443,28453247,28453247,28453618,0,0,0,371
38444,28453247,28453247,28453618,0,0,0,371
38445,28453248,28453248,28453619,0,0,0,371
38446,28453248,28453248,28453619,0,0,0,371
38447,28453248,28453248,28453619,0,0,0,371
38449,28453249,28453249,28453620,0,0,0,371
38451,28453249,28453249,28453621,0,0,0,372
38452,28453250,28453250,28453622,0,0,0,372
38453,28453250,28453250,28453622,0,0,0,372
38454,28453250,28453250,28453622,0,0,0,372
38455,28453250,28453250,28453622,0,0,0,372
38456,28453250,28453250,28453622,0,0,0,372
38457,28453250,28453250,28453622,0,0,0,372
38463,28453252,28453252,28453624,0,0,0,372
38464,28453252,28453252,28453624,0,0,0,372
38465,28453252,28453252,28453624,0,0,0,372
38466,28453252,28453252,28453624,0,0,0,372
38483,28453256,28453256,28453625,0,0,0,369
38484,28453256,28453256,28453625,0,0,0,369
38485,28453257,28453257,28453626,0,0,0,369
38440,28453246,28453246,28453628,0,0,0,382
38459,28453251,28453251,28453629,0,0,0,378
38460,28453251,28453251,28453629,0,0,0,378
38461,28453251,28453251,28453629,0,0,0,378
38462,28453251,28453251,28453629,0,0,0,378
38493,28453259,28453259,28453629,0,0,0,370
38494,28453259,28453259,28453629,0,0,0,370
38495,28453259,28453259,28453629,0,0,0,370
38430,28453232,28453232,28453633,0,0,0,401
38476,28453254,28453254,28453633,0,0,0,379
38477,28453254,28453254,28453633,0,0,0,379
38478,28453254,28453254,28453633,0,0,0,379
38433,28453233,28453233,28453634,0,0,0,401
38479,28453255,28453255,28453634,0,0,0,379
38480,28453255,28453255,28453634,0,0,0,379
38434,28453234,28453234,28453635,0,0,0,401
38497,28453263,28453263,28453637,0,0,0,374
38498,28453264,28453264,28453638,0,0,0,374
38499,28453264,28453264,28453638,0,0,0,374
38500,28453264,28453264,28453638,0,0,0,374
38501,28453264,28453264,28453638,0,0,0,374
38502,28453264,28453264,28453638,0,0,0,374
38503,28453265,28453265,28453639,0,0,0,374
38523,28453270,28453270,28453640,0,0,0,370
38524,28453271,28453271,28453641,0,0,0,370
38471,28453253,28453253,28453642,0,0,0,389
38472,28453253,28453253,28453642,0,0,0,389
38427,28453232,28453232,28453643,0,0,0,411
38473,28453254,28453254,28453643,0,0,0,389
38474,28453254,28453254,28453643,0,0,0,389
38475,28453254,28453254,28453643,0,0,0,389
38518,28453269,28453269,28453643,0,0,0,374
38519,28453269,28453269,28453643,0,0,0,374
38520,28453270,28453270,28453644,0,0,0,374
38521,28453270,28453270,28453644,0,0,0,374
38504,28453266,28453266,28453645,0,0,0,379
38505,28453266,28453266,28453645,0,0,0,379
38506,28453266,28453266,28453645,0,0,0,379
38507,28453266,28453266,28453645,0,0,0,379
38508,28453266,28453266,28453645,0,0,0,379
38509,28453266,28453266,28453645,0,0,0,379
38510,28453266,28453266,28453645,0,0,0,379
38511,28453267,28453267,28453646,0,0,0,379
38512,28453267,28453267,28453646,0,0,0,379
38513,28453268,28453268,28453647,0,0,0,379
38514,28453268,28453268,28453647,0,0,0,379
38515,28453268,28453268,28453647,0,0,0,379
38516,28453269,28453269,28453648,0,0,0,379
38517,28453269,28453269,28453648,0,0,0,379
38448,28453248,28453248,28453651,0,0,0,403
38491,28453258,28453258,28453654,0,0,0,396
38492,28453258,28453258,28453654,0,0,0,396
38467,28453252,28453252,28453656,0,0,0,404
38468,28453253,28453253,28453657,0,0,0,404
38435,28453234,28453234,28453661,0,0,0,427
38436,28453234,28453234,28453661,0,0,0,427
38486,28453257,28453257,28453663,0,0,0,406
38487,28453257,28453257,28453663,0,0,0,406
38488,28453257,28453257,28453663,0,0,0,406
38489,28453258,28453258,28453664,0,0,0,406
38496,28453263,28453263,28453668,0,0,0,405
38481,28453255,28453255,28453671,0,0,0,416
38482,28453255,28453255,28453671,0,0,0,416
38522,28453270,28453270,28453676,0,0,0,406
38525,28454507,28454507,28454633,0,0,0,126
38556,28460720,28460720,28460782,0,0,0,62
38557,28460720,28460720,28460782,0,0,0,62
38548,28460660,28460660,28460784,0,0,0,124
38549,28460661,28460661,28460785,0,0,0,124
38550,28460663,28460663,28460787,0,0,0,124
38551,28460663,28460663,28460787,0,0,0,124
38552,28460665,28460665,28460789,0,0,0,124
38553,28460666,28460666,28460790,0,0,0,124
38554,28460667,28460667,28460791,0,0,0,124
38555,28460668,28460668,28460792,0,0,0,124
38564,28461189,28461189,28461293,0,0,0,104
38565,28461189,28461189,28461293,0,0,0,104
38566,28461191,28461191,28461295,0,0,0,104
38567,28461191,28461191,28461295,0,0,0,104
38568,28461193,28461193,28461297,0,0,0,104
38569,28461194,28461194,28461298,0,0,0,104
38570,28461195,28461195,28461299,0,0,0,104
38571,28461196,28461196,28461300,0,0,0,104
38572,28461248,28461248,28461322,0,0,0,74
38573,28461248,28461248,28461322,0,0,0,74
38574,28461250,28461250,28461324,0,0,0,74
38575,28461253,28461253,28461327,0,0,0,74
38576,28461255,28461255,28461351,0,0,0,96
38577,28461257,28461257,28461353,0,0,0,96
38578,28461292,28461292,28461378,0,0,0,86
38579,28461295,28461295,28461381,0,0,0,86
38580,28461297,28461297,28461383,0,0,0,86
38581,28461299,28461299,28461385,0,0,0,86
38582,28461322,28461322,28461413,0,0,0,91
38583,28461324,28461324,28461415,0,0,0,91
38584,28461346,28461346,28461415,0,0,0,69
38585,28461348,28461348,28461417,0,0,0,69
38586,28461351,28461351,28461420,0,0,0,69
38588,28461376,28461376,28461450,0,0,0,74
38589,28461378,28461378,28461452,0,0,0,74
38590,28461380,28461380,28461454,0,0,0,74
38591,28461383,28461383,28461457,0,0,0,74
38587,28461353,28461353,28461459,0,0,0,106
38593,28461413,28461413,28461487,0,0,0,74
38594,28461415,28461415,28461489,0,0,0,74
38595,28461417,28461417,28461491,0,0,0,74
38596,28461420,28461420,28461494,0,0,0,74
38592,28461385,28461385,28461496,0,0,0,111
38598,28461450,28461450,28461524,0,0,0,74
38599,28461452,28461452,28461526,0,0,0,74
38600,28461454,28461454,28461528,0,0,0,74
38601,28461457,28461457,28461531,0,0,0,74
38597,28461422,28461422,28461533,0,0,0,111
38603,28461487,28461487,28461561,0,0,0,74
38604,28461489,28461489,28461563,0,0,0,74
38605,28461491,28461491,28461565,0,0,0,74
38606,28461494,28461494,28461568,0,0,0,74
38602,28461459,28461459,28461570,0,0,0,111
38608,28461524,28461524,28461598,0,0,0,74
38609,28461526,28461526,28461600,0,0,0,74
38610,28461528,28461528,28461602,0,0,0,74
38611,28461531,28461531,28461605,0,0,0,74
38607,28461496,28461496,28461607,0,0,0,111
38613,28461598,28461598,28461677,0,0,0,79
38614,28461600,28461600,28461679,0,0,0,79
38615,28461602,28461602,28461681,0,0,0,79
38397,28449728,28449728,28461682,0,0,0,11954
38616,28461605,28461605,28461684,0,0,0,79
38612,28461570,28461570,28461686,0,0,0,116
38617,28461607,28461607,28461686,0,0,0,79
38618,28461635,28461635,28461694,0,0,0,59
38619,28461637,28461637,28461712,0,0,0,75
38620,28461640,28461640,28461715,0,0,0,75
38621,28461642,28461642,28461717,0,0,0,75
38558,28460729,28460729,28461719,0,0,0,990
38559,28460729,28460729,28461719,0,0,0,990
38622,28461644,28461644,28461730,0,0,0,86
38623,28461677,28461677,28461732,0,0,0,55
38624,28461694,28461694,28461743,0,0,0,49
38561,28460782,28460782,28461842,0,0,0,1060
38530,28458138,28458138,28462386,0,0,0,4248
38531,28458200,28458200,28462400,0,0,0,4200
38540,28460472,28460472,28462544,0,0,0,2072
38560,28460729,28460729,28462599,0,0,0,1870
38536,28458386,28458386,28462602,0,0,0,4216
38526,28455202,28455202,28462904,0,0,0,7702
38544,28460473,28460473,28463340,0,0,0,2867
38545,28460473,28460473,28463726,0,0,0,3253
38541,28460472,28460472,28463736,0,0,0,3264
38542,28460472,28460472,28463736,0,0,0,3264
38538,28460471,28460471,28463766,0,0,0,3295
38546,28460473,28460473,28464038,0,0,0,3565
38537,28460181,28460181,28464627,0,0,0,4446
38529,28458085,28458085,28465718,0,0,0,7633
38532,28458207,28458207,28465768,0,0,0,7561
38535,28458334,28458334,28465845,0,0,0,7511
38630,28466397,28466397,28466493,0,0,0,96
38398,28450315,28450315,28466496,0,0,0,16181
38539,28460471,28460471,28466517,0,0,0,6046
38400,28451889,28451889,28466544,0,0,0,14655
38399,28450399,28450399,28466589,0,0,0,16190
38543,28460472,28460472,28466855,0,0,0,6383
38634,28467693,28467693,28467741,0,0,0,48
38635,28467958,28467958,28467989,0,0,0,31
38636,28468007,28468007,28468057,0,0,0,50
38637,28468177,28468177,28468211,0,0,0,34
38638,28468218,28468218,28468251,0,0,0,33
37550,28382434,28382434,28468266,0,0,0,85832
38640,28468413,28468413,28468460,0,0,0,47
38641,28468532,28468532,28468574,0,0,0,42
38626,28463670,28463670,28468646,0,0,0,4976
38642,28468586,28468586,28468657,0,0,0,71
38629,28465240,28465240,28470198,0,0,0,4958
38645,28470398,28470398,28470448,0,0,0,50
38646,28470434,28470434,28470570,0,0,0,136
38527,28455411,28455411,28470615,0,0,0,15204
38647,28470530,28470530,28470629,0,0,0,99
38648,28470798,28470798,28470898,0,0,0,100
38697,28471311,28471311,28471354,0,0,0,43
38649,28471093,28471093,28471379,0,0,0,286
38650,28471099,28471099,28471380,0,0,0,281
38652,28471100,28471100,28471381,0,0,0,281
38651,28471099,28471099,28471391,0,0,0,292
38653,28471100,28471100,28471392,0,0,0,292
38654,28471100,28471100,28471392,0,0,0,292
38698,28471348,28471348,28471402,0,0,0,54
38655,28471100,28471100,28471403,0,0,0,303
38656,28471101,28471101,28471415,0,0,0,314
38657,28471101,28471101,28471415,0,0,0,314
38658,28471101,28471101,28471426,0,0,0,325
38659,28471102,28471102,28471427,0,0,0,325
38660,28471102,28471102,28471427,0,0,0,325
38661,28471102,28471102,28471427,0,0,0,325
38662,28471102,28471102,28471449,0,0,0,347
38663,28471103,28471103,28471450,0,0,0,347
38664,28471103,28471103,28471461,0,0,0,358
38665,28471103,28471103,28471461,0,0,0,358
38666,28471103,28471103,28471461,0,0,0,358
38667,28471104,28471104,28471462,0,0,0,358
38668,28471104,28471104,28471473,0,0,0,369
38669,28471104,28471104,28471484,0,0,0,380
38670,28471104,28471104,28471484,0,0,0,380
38671,28471104,28471104,28471495,0,0,0,391
38672,28471104,28471104,28471495,0,0,0,391
38673,28471105,28471105,28471496,0,0,0,391
38674,28471105,28471105,28471507,0,0,0,402
38675,28471105,28471105,28471507,0,0,0,402
38699,28471383,28471383,28471520,0,0,0,137
38676,28471105,28471105,28471523,0,0,0,418
38677,28471105,28471105,28471523,0,0,0,418
38678,28471105,28471105,28471523,0,0,0,418
38679,28471106,28471106,28471535,0,0,0,429
38680,28471106,28471106,28471535,0,0,0,429
38681,28471106,28471106,28471535,0,0,0,429
38682,28471106,28471106,28471546,0,0,0,440
38683,28471106,28471106,28471546,0,0,0,440
38702,28471505,28471505,28471554,0,0,0,49
38684,28471106,28471106,28471568,0,0,0,462
38685,28471107,28471107,28471569,0,0,0,462
38686,28471107,28471107,28471569,0,0,0,462
38687,28471107,28471107,28471569,0,0,0,462
38688,28471107,28471107,28471591,0,0,0,484
38689,28471107,28471107,28471591,0,0,0,484
38691,28471108,28471108,28471592,0,0,0,484
38690,28471107,28471107,28471602,0,0,0,495
38701,28471476,28471476,28471602,0,0,0,126
38692,28471108,28471108,28471614,0,0,0,506
38693,28471108,28471108,28471614,0,0,0,506
38694,28471108,28471108,28471625,0,0,0,517
38695,28471108,28471108,28471625,0,0,0,517
38696,28471108,28471108,28471636,0,0,0,528
38703,28471562,28471562,28471659,0,0,0,97
38704,28471724,28471724,28471817,0,0,0,93
38547,28460534,28460534,28472197,0,0,0,11663
38528,28458076,28458076,28473126,0,0,0,15050
38533,28458262,28458262,28473189,0,0,0,14927
38534,28458324,28458324,28473752,0,0,0,15428
38708,28473204,28473204,28473997,0,0,0,793
38644,28470390,28470390,28474234,0,0,0,3844
38732,28474259,28474259,28474651,0,0,0,392
38733,28475163,28475163,28475458,0,0,0,295
38734,28475624,28475624,28475671,0,0,0,47
38735,28475732,28475732,28475774,0,0,0,42
38736,28475945,28475945,28475986,0,0,0,41
38643,28470110,28470110,28476134,0,0,0,6024
38737,28476120,28476120,28476161,0,0,0,41
38738,28476268,28476268,28476309,0,0,0,41
38741,28476579,28476579,28476621,0,0,0,42
38742,28476651,28476651,28476895,0,0,0,244
38744,28477193,28477193,28477233,0,0,0,40
38743,28476998,28476998,28477240,0,0,0,242
38745,28477344,28477344,28477598,0,0,0,254
38404,28452215,28452215,28477856,0,0,0,25641
38747,28477944,28477944,28478220,0,0,0,276
38406,28452604,28452604,28478306,0,0,0,25702
38749,28478446,28478446,28478683,0,0,0,237
38750,28478975,28478975,28479014,0,0,0,39
38705,28471894,28471894,28479093,0,0,0,7199
38706,28471941,28471941,28479107,0,0,0,7166
38752,28479086,28479086,28479186,0,0,0,100
38401,28451923,28451923,28479187,0,0,0,27264
38402,28452007,28452007,28479322,0,0,0,27315
38751,28479061,28479061,28479323,0,0,0,262
38408,28452828,28452828,28479327,0,0,0,26499
38410,28452854,28452854,28479479,0,0,0,26625
38628,28464775,28464775,28479572,0,0,0,14797
38405,28452571,28452571,28479581,0,0,0,27010
37523,28382232,28382232,28479894,0,0,0,97662
38758,28480426,28480426,28480535,0,0,0,109
38632,28466503,28466503,28481374,0,0,0,14871
38748,28478283,28478283,28481612,0,0,0,3329
38766,28481649,28481649,28481693,0,0,0,44
38763,28481075,28481075,28482042,0,0,0,967
38764,28481547,28481547,28482509,0,0,0,962
38631,28466459,28466459,28482660,0,0,0,16201
38633,28466546,28466546,28482744,0,0,0,16198
38767,28481908,28481908,28482762,0,0,0,854
38769,28482573,28482573,28482821,0,0,0,248
38772,28483743,28483743,28483807,0,0,0,64
38782,28483836,28483836,28485173,0,0,0,1337
38775,28483826,28483826,28485177,0,0,0,1351
38781,28483836,28483836,28485178,0,0,0,1342
38774,28483820,28483820,28485188,0,0,0,1368
38776,28483826,28483826,28485198,0,0,0,1372
38784,28483836,28483836,28485206,0,0,0,1370
38777,28483826,28483826,28485214,0,0,0,1388
38778,28483827,28483827,28485215,0,0,0,1388
38779,28483827,28483827,28485215,0,0,0,1388
38780,28483828,28483828,28485216,0,0,0,1388
38783,28483836,28483836,28485221,0,0,0,1385
38785,28483836,28483836,28485248,0,0,0,1412
38789,28484082,28484082,28485410,0,0,0,1328
38804,28484086,28484086,28485418,0,0,0,1332
38809,28484087,28484087,28485419,0,0,0,1332
38796,28484084,28484084,28485424,0,0,0,1340
38810,28484087,28484087,28485427,0,0,0,1340
38825,28484090,28484090,28485435,0,0,0,1345
38800,28484085,28484085,28485447,0,0,0,1362
38801,28484085,28484085,28485447,0,0,0,1362
38806,28484086,28484086,28485451,0,0,0,1365
38807,28484086,28484086,28485451,0,0,0,1365
38820,28484089,28484089,28485451,0,0,0,1362
38790,28484082,28484082,28485452,0,0,0,1370
38798,28484084,28484084,28485457,0,0,0,1373
38799,28484084,28484084,28485457,0,0,0,1373
38826,28484090,28484090,28485457,0,0,0,1367
38827,28484090,28484090,28485457,0,0,0,1367
38803,28484086,28484086,28485459,0,0,0,1373
38814,28484088,28484088,28485461,0,0,0,1373
38815,28484088,28484088,28485461,0,0,0,1373
38791,28484082,28484082,28485463,0,0,0,1381
38813,28484087,28484087,28485471,0,0,0,1384
38816,28484088,28484088,28485472,0,0,0,1384
38808,28484086,28484086,28485473,0,0,0,1387
38821,28484089,28484089,28485473,0,0,0,1384
38822,28484089,28484089,28485473,0,0,0,1384
38788,28484081,28484081,28485475,0,0,0,1394
38792,28484083,28484083,28485475,0,0,0,1392
38828,28484090,28484090,28485479,0,0,0,1389
38829,28484090,28484090,28485479,0,0,0,1389
38802,28484085,28484085,28485480,0,0,0,1395
38817,28484088,28484088,28485483,0,0,0,1395
38811,28484087,28484087,28485485,0,0,0,1398
38812,28484087,28484087,28485485,0,0,0,1398
38797,28484084,28484084,28485487,0,0,0,1403
38824,28484089,28484089,28485489,0,0,0,1400
38831,28484091,28484091,28485490,0,0,0,1399
38805,28484086,28484086,28485492,0,0,0,1406
38818,28484088,28484088,28485494,0,0,0,1406
38786,28484081,28484081,28485504,0,0,0,1423
38823,28484089,28484089,28485506,0,0,0,1417
38793,28484083,28484083,28485508,0,0,0,1425
38787,28484081,28484081,28485515,0,0,0,1434
38819,28484088,28484088,28485516,0,0,0,1428
38794,28484083,28484083,28485519,0,0,0,1436
38830,28484090,28484090,28485523,0,0,0,1433
38795,28484083,28484083,28485530,0,0,0,1447
38773,28483749,28483749,28486449,0,0,0,2700
38700,28471461,28471461,28489461,0,0,0,18000
38562,28460819,28460819,28493680,0,0,0,32861
38563,28460876,28460876,28494756,0,0,0,33880
38746,28477531,28477531,28495531,0,0,0,18000
38846,28496523,28496523,28497854,0,0,0,1331
38833,28496514,28496514,28497874,0,0,0,1360
38837,28496515,28496515,28497875,0,0,0,1360
38834,28496514,28496514,28497895,0,0,0,1381
38835,28496514,28496514,28497895,0,0,0,1381
38836,28496514,28496514,28497895,0,0,0,1381
38838,28496515,28496515,28497896,0,0,0,1381
38840,28496516,28496516,28497897,0,0,0,1381
38841,28496516,28496516,28497933,0,0,0,1417
38842,28496516,28496516,28497933,0,0,0,1417
38843,28496517,28496517,28497934,0,0,0,1417
38832,28496513,28496513,28497956,0,0,0,1443
38839,28496515,28496515,28497958,0,0,0,1443
38844,28496517,28496517,28497960,0,0,0,1443
38845,28496518,28496518,28497961,0,0,0,1443
38853,28496779,28496779,28498106,0,0,0,1327
38857,28496780,28496780,28498114,0,0,0,1334
38849,28496778,28496778,28498119,0,0,0,1341
38860,28496781,28496781,28498124,0,0,0,1343
38850,28496778,28496778,28498130,0,0,0,1352
38889,28496786,28496786,28498131,0,0,0,1345
38893,28496787,28496787,28498132,0,0,0,1345
38858,28496780,28496780,28498136,0,0,0,1356
38881,28496785,28496785,28498136,0,0,0,1351
38882,28496785,28496785,28498136,0,0,0,1351
38864,28496782,28496782,28498137,0,0,0,1355
38855,28496779,28496779,28498139,0,0,0,1360
38856,28496780,28496780,28498140,0,0,0,1360
38851,28496778,28496778,28498141,0,0,0,1363
38894,28496787,28496787,28498143,0,0,0,1356
38862,28496781,28496781,28498147,0,0,0,1366
38852,28496778,28496778,28498152,0,0,0,1374
38870,28496783,28496783,28498152,0,0,0,1369
38854,28496779,28496779,28498153,0,0,0,1374
38875,28496784,28496784,28498153,0,0,0,1369
38890,28496786,28496786,28498153,0,0,0,1367
38877,28496784,28496784,28498157,0,0,0,1373
38863,28496781,28496781,28498158,0,0,0,1377
38883,28496785,28496785,28498158,0,0,0,1373
38865,28496782,28496782,28498159,0,0,0,1377
38869,28496782,28496782,28498162,0,0,0,1380
38871,28496783,28496783,28498163,0,0,0,1380
38872,28496783,28496783,28498163,0,0,0,1380
38859,28496780,28496780,28498166,0,0,0,1386
38884,28496785,28496785,28498169,0,0,0,1384
38866,28496782,28496782,28498170,0,0,0,1388
38876,28496784,28496784,28498175,0,0,0,1391
38861,28496781,28496781,28498178,0,0,0,1397
38885,28496785,28496785,28498180,0,0,0,1395
38867,28496782,28496782,28498181,0,0,0,1399
38847,28496777,28496777,28498183,0,0,0,1406
38873,28496783,28496783,28498185,0,0,0,1402
38886,28496785,28496785,28498191,0,0,0,1406
38868,28496782,28496782,28498192,0,0,0,1410
38887,28496786,28496786,28498192,0,0,0,1406
38888,28496786,28496786,28498203,0,0,0,1417
38880,28496784,28496784,28498212,0,0,0,1428
38895,28496787,28496787,28498220,0,0,0,1433
38848,28496777,28496777,28498221,0,0,0,1444
38874,28496783,28496783,28498229,0,0,0,1446
38878,28496784,28496784,28498230,0,0,0,1446
38891,28496786,28496786,28498258,0,0,0,1472
38879,28496784,28496784,28498263,0,0,0,1479
38892,28496786,28496786,28498269,0,0,0,1483
38770,28482617,28482617,28498936,0,0,0,16319
38771,28482713,28482713,28499001,0,0,0,16288
38762,28481025,28481025,28499025,0,0,0,18000
38740,28476502,28476502,28499647,0,0,0,23145
38963,28500196,28500196,28500307,0,0,0,111
38965,28500197,28500197,28500318,0,0,0,121
38898,28499911,28499911,28500611,0,0,0,700
38899,28499911,28499911,28500627,0,0,0,716
38900,28499911,28499911,28500627,0,0,0,716
38906,28499913,28499913,28500650,0,0,0,737
38902,28499912,28499912,28500665,0,0,0,753
38903,28499912,28499912,28500665,0,0,0,753
38901,28499911,28499911,28500685,0,0,0,774
38904,28499912,28499912,28500686,0,0,0,774
38905,28499912,28499912,28500686,0,0,0,774
38907,28499913,28499913,28500687,0,0,0,774
38908,28499914,28499914,28500688,0,0,0,774
38920,28500177,28500177,28500885,0,0,0,708
38913,28500175,28500175,28500888,0,0,0,713
38909,28500174,28500174,28500897,0,0,0,723
38926,28500179,28500179,28500897,0,0,0,718
38927,28500179,28500179,28500897,0,0,0,718
38914,28500175,28500175,28500898,0,0,0,723
38915,28500176,28500176,28500899,0,0,0,723
38916,28500176,28500176,28500899,0,0,0,723
38918,28500177,28500177,28500900,0,0,0,723
38943,28500188,28500188,28500903,0,0,0,715
38944,28500188,28500188,28500903,0,0,0,715
38962,28500195,28500195,28500903,0,0,0,708
38973,28500199,28500199,28500903,0,0,0,704
38911,28500175,28500175,28500909,0,0,0,734
38912,28500175,28500175,28500909,0,0,0,734
38936,28500186,28500186,28500910,0,0,0,724
38964,28500196,28500196,28500910,0,0,0,714
38921,28500177,28500177,28500911,0,0,0,734
38949,28500190,28500190,28500911,0,0,0,721
38950,28500190,28500190,28500911,0,0,0,721
38981,28500201,28500201,28500911,0,0,0,710
38922,28500178,28500178,28500912,0,0,0,734
38923,28500178,28500178,28500912,0,0,0,734
38946,28500189,28500189,28500915,0,0,0,726
38975,28500199,28500199,28500915,0,0,0,716
38977,28500200,28500200,28500916,0,0,0,716
38956,28500191,28500191,28500917,0,0,0,726
38928,28500179,28500179,28500918,0,0,0,739
38929,28500179,28500179,28500918,0,0,0,739
38917,28500176,28500176,28500920,0,0,0,744
38919,28500177,28500177,28500921,0,0,0,744
38935,28500186,28500186,28500921,0,0,0,735
38989,28500202,28500202,28500922,0,0,0,720
38941,28500187,28500187,28500923,0,0,0,736
38942,28500187,28500187,28500923,0,0,0,736
38971,28500198,28500198,28500923,0,0,0,725
38974,28500199,28500199,28500925,0,0,0,726
38986,28500202,28500202,28500925,0,0,0,723
38966,28500197,28500197,28500926,0,0,0,729
38967,28500197,28500197,28500926,0,0,0,729
38969,28500198,28500198,28500927,0,0,0,729
38939,28500187,28500187,28500928,0,0,0,741
38978,28500200,28500200,28500929,0,0,0,729
38996,28500203,28500203,28500931,0,0,0,728
38998,28500204,28500204,28500932,0,0,0,728
38983,28500201,28500201,28500933,0,0,0,732
38984,28500201,28500201,28500933,0,0,0,732
38990,28500202,28500202,28500933,0,0,0,731
38972,28500198,28500198,28500934,0,0,0,736
38992,28500203,28500203,28500934,0,0,0,731
38993,28500203,28500203,28500934,0,0,0,731
38937,28500186,28500186,28500937,0,0,0,751
38951,28500190,28500190,28500937,0,0,0,747
38952,28500190,28500190,28500937,0,0,0,747
38968,28500197,28500197,28500937,0,0,0,740
38976,28500199,28500199,28500937,0,0,0,738
38987,28500202,28500202,28500937,0,0,0,735
38910,28500174,28500174,28500938,0,0,0,764
38970,28500198,28500198,28500938,0,0,0,740
38945,28500188,28500188,28500940,0,0,0,752
38953,28500190,28500190,28500942,0,0,0,752
38954,28500190,28500190,28500942,0,0,0,752
38955,28500190,28500190,28500942,0,0,0,752
38980,28500201,28500201,28500942,0,0,0,741
38940,28500187,28500187,28500944,0,0,0,757
38991,28500202,28500202,28500944,0,0,0,742
38930,28500180,28500180,28500945,0,0,0,765
38931,28500180,28500180,28500945,0,0,0,765
38994,28500203,28500203,28500945,0,0,0,742
38995,28500203,28500203,28500945,0,0,0,742
39004,28500205,28500205,28500947,0,0,0,742
39005,28500205,28500205,28500947,0,0,0,742
38957,28500191,28500191,28500948,0,0,0,757
38958,28500191,28500191,28500948,0,0,0,757
38959,28500191,28500191,28500948,0,0,0,757
38988,28500202,28500202,28500948,0,0,0,746
38982,28500201,28500201,28500953,0,0,0,752
38999,28500204,28500204,28500954,0,0,0,750
39000,28500204,28500204,28500954,0,0,0,750
39001,28500204,28500204,28500954,0,0,0,750
38947,28500189,28500189,28500957,0,0,0,768
38948,28500189,28500189,28500957,0,0,0,768
39006,28500205,28500205,28500958,0,0,0,753
38924,28500178,28500178,28500959,0,0,0,781
38961,28500195,28500195,28500963,0,0,0,768
39002,28500204,28500204,28500965,0,0,0,761
39003,28500204,28500204,28500965,0,0,0,761
38979,28500200,28500200,28500974,0,0,0,774
38997,28500203,28500203,28500975,0,0,0,772
38985,28500201,28500201,28500978,0,0,0,777
38925,28500178,28500178,28500985,0,0,0,807
38932,28500184,28500184,28500997,0,0,0,813
38933,28500185,28500185,28500998,0,0,0,813
38934,28500185,28500185,28500998,0,0,0,813
38960,28500195,28500195,28501020,0,0,0,825
38938,28500186,28500186,28501027,0,0,0,841
39007,28500764,28500764,28501517,0,0,0,753
39008,28500826,28500826,28501579,0,0,0,753
39009,28500906,28500906,28501659,0,0,0,753
38739,28476363,28476363,28502110,0,0,0,25747
39010,28501530,28501530,28502294,0,0,0,764
39011,28502204,28502204,28502927,0,0,0,723
39012,28502225,28502225,28502948,0,0,0,723
35441,28286206,28286206,28503969,0,0,0,217763
38760,28480505,28480505,28510187,0,0,0,29682
38759,28480446,28480446,28510292,0,0,0,29846
38756,28480161,28480161,28510979,0,0,0,30818
38757,28480220,28480220,28511016,0,0,0,30796
38754,28480089,28480089,28511374,0,0,0,31285
39015,28505226,28505226,28511429,0,0,0,6203
39016,28505239,28505239,28511524,0,0,0,6285
38755,28480119,28480119,28511553,0,0,0,31434
38765,28481627,28481627,28511659,0,0,0,30032
38761,28480531,28480531,28511740,0,0,0,31209
38768,28482111,28482111,28512051,0,0,0,29940
38896,28498893,28498893,28515135,0,0,0,16242
38897,28498952,28498952,28515234,0,0,0,16282
38164,28408276,28408276,28516673,0,0,0,108397
38627,28464693,28464693,28519090,0,0,0,54397
37824,28389663,28389663,28519263,0,0,0,129600
38625,28462029,28462029,28519815,0,0,0,57786
37829,28390249,28390249,28519849,0,0,0,129600
37833,28390464,28390464,28520064,0,0,0,129600
38710,28474052,28474052,28520944,0,0,0,46892
38712,28474053,28474053,28520989,0,0,0,46936
38713,28474053,28474053,28521333,0,0,0,47280
38711,28474052,28474052,28521634,0,0,0,47582
38714,28474053,28474053,28522135,0,0,0,48082
39014,28504916,28504916,28525194,0,0,0,20278
39013,28504910,28504910,28527970,0,0,0,23060
39017,28515088,28515088,28531445,0,0,0,16357
39018,28515199,28515199,28531556,0,0,0,16357
38409,28452842,28452842,28532276,0,0,0,79434
39021,28538878,28538878,28538969,0,0,0,91
39031,28540500,28540500,28540634,0,0,0,134
39032,28540500,28540500,28540634,0,0,0,134
39033,28540500,28540500,28540634,0,0,0,134
39034,28540500,28540500,28540634,0,0,0,134
39035,28540501,28540501,28540635,0,0,0,134
39036,28540501,28540501,28540635,0,0,0,134
39037,28540501,28540501,28540635,0,0,0,134
39038,28540501,28540501,28540635,0,0,0,134
39039,28540501,28540501,28540635,0,0,0,134
39040,28540501,28540501,28540635,0,0,0,134
39041,28540502,28540502,28540636,0,0,0,134
39042,28540502,28540502,28540636,0,0,0,134
39043,28540502,28540502,28540636,0,0,0,134
39044,28540502,28540502,28540636,0,0,0,134
39045,28540502,28540502,28540636,0,0,0,134
39046,28540502,28540502,28540636,0,0,0,134
39047,28540503,28540503,28540674,0,0,0,171
39048,28540503,28540503,28540674,0,0,0,171
39049,28540503,28540503,28540674,0,0,0,171
39050,28540503,28540503,28540674,0,0,0,171
39051,28540503,28540503,28540674,0,0,0,171
39052,28540504,28540504,28540675,0,0,0,171
39053,28540504,28540504,28540675,0,0,0,171
39054,28540504,28540504,28540712,0,0,0,208
39022,28540498,28540498,28540856,0,0,0,358
39023,28540498,28540498,28540856,0,0,0,358
39024,28540498,28540498,28540856,0,0,0,358
39025,28540498,28540498,28540856,0,0,0,358
39026,28540499,28540499,28540857,0,0,0,358
39027,28540499,28540499,28540857,0,0,0,358
39028,28540499,28540499,28540857,0,0,0,358
39029,28540500,28540500,28540858,0,0,0,358
39030,28540500,28540500,28540858,0,0,0,358
39055,28540853,28540853,28540927,0,0,0,74
39056,28540855,28540855,28540929,0,0,0,74
39057,28540858,28540858,28540932,0,0,0,74
39058,28540860,28540860,28540934,0,0,0,74
39060,28540890,28540890,28540958,0,0,0,68
39061,28540893,28540893,28540961,0,0,0,68
39062,28540895,28540895,28540963,0,0,0,68
39059,28540863,28540863,28540968,0,0,0,105
39066,28540929,28540929,28540991,0,0,0,62
39067,28540932,28540932,28540994,0,0,0,62
39064,28540898,28540898,28540997,0,0,0,99
39065,28540900,28540900,28540999,0,0,0,99
39070,28540958,28540958,28541020,0,0,0,62
39071,28540961,28540961,28541023,0,0,0,62
39068,28540934,28540934,28541027,0,0,0,93
39069,28540937,28540937,28541030,0,0,0,93
39074,28540989,28540989,28541051,0,0,0,62
39075,28540992,28540992,28541054,0,0,0,62
39072,28540964,28540964,28541057,0,0,0,93
39073,28540966,28540966,28541059,0,0,0,93
39078,28541020,28541020,28541082,0,0,0,62
39079,28541023,28541023,28541085,0,0,0,62
39076,28540995,28540995,28541088,0,0,0,93
39080,28541026,28541026,28541088,0,0,0,62
39077,28540997,28540997,28541090,0,0,0,93
39082,28541051,28541051,28541113,0,0,0,62
39083,28541054,28541054,28541116,0,0,0,62
39081,28541028,28541028,28541121,0,0,0,93
39086,28541082,28541082,28541144,0,0,0,62
39087,28541085,28541085,28541147,0,0,0,62
39084,28541057,28541057,28541150,0,0,0,93
39085,28541059,28541059,28541152,0,0,0,93
39090,28541113,28541113,28541175,0,0,0,62
39091,28541116,28541116,28541178,0,0,0,62
39088,28541088,28541088,28541181,0,0,0,93
39092,28541119,28541119,28541181,0,0,0,62
39089,28541090,28541090,28541183,0,0,0,93
39099,28541201,28541201,28541242,0,0,0,41
39095,28541175,28541175,28541247,0,0,0,72
39096,28541178,28541178,28541250,0,0,0,72
39093,28541150,28541150,28541253,0,0,0,103
39097,28541181,28541181,28541253,0,0,0,72
39094,28541152,28541152,28541255,0,0,0,103
39098,28541183,28541183,28541255,0,0,0,72
39100,28541206,28541206,28541279,0,0,0,73
39101,28541206,28541206,28541279,0,0,0,73
39102,28541209,28541209,28541282,0,0,0,73
39105,28541247,28541247,28541315,0,0,0,68
39106,28541250,28541250,28541318,0,0,0,68
39103,28541212,28541212,28541321,0,0,0,109
39107,28541253,28541253,28541321,0,0,0,68
39104,28541214,28541214,28541323,0,0,0,109
39108,28541255,28541255,28541323,0,0,0,68
39109,28541279,28541279,28541430,0,0,0,151
39114,28541315,28541315,28541430,0,0,0,115
39110,28541281,28541281,28541432,0,0,0,151
39111,28541284,28541284,28541435,0,0,0,151
39112,28541286,28541286,28541437,0,0,0,151
39113,28541289,28541289,28541440,0,0,0,151
39063,28540896,28540896,28541581,0,0,0,685
39115,28541683,28541683,28541775,0,0,0,92
36494,28371189,28371189,28542378,0,0,0,171189
39116,28541786,28541786,28542471,0,0,0,685
39232,28542467,28542467,28542506,0,0,0,39
39117,28542075,28542075,28542785,0,0,0,710
39118,28542075,28542075,28542801,0,0,0,726
39120,28542096,28542096,28542807,0,0,0,711
39124,28542106,28542106,28542811,0,0,0,705
39125,28542106,28542106,28542812,0,0,0,706
39126,28542106,28542106,28542816,0,0,0,710
39119,28542075,28542075,28542817,0,0,0,742
39128,28542106,28542106,28542828,0,0,0,722
39121,28542097,28542097,28542829,0,0,0,732
39122,28542097,28542097,28542829,0,0,0,732
39123,28542098,28542098,28542830,0,0,0,732
39127,28542106,28542106,28542833,0,0,0,727
39129,28542106,28542106,28542849,0,0,0,743
39182,28542364,28542364,28543055,0,0,0,691
39131,28542345,28542345,28543062,0,0,0,717
39198,28542367,28542367,28543066,0,0,0,699
39130,28542345,28542345,28543067,0,0,0,722
39154,28542355,28542355,28543067,0,0,0,712
39148,28542354,28542354,28543068,0,0,0,714
39187,28542365,28542365,28543068,0,0,0,703
39194,28542366,28542366,28543068,0,0,0,702
39184,28542364,28542364,28543069,0,0,0,705
39167,28542359,28542359,28543070,0,0,0,711
39172,28542360,28542360,28543071,0,0,0,711
39147,28542354,28542354,28543072,0,0,0,718
39186,28542365,28542365,28543072,0,0,0,707
39146,28542354,28542354,28543073,0,0,0,719
39149,28542354,28542354,28543075,0,0,0,721
39150,28542354,28542354,28543076,0,0,0,722
39185,28542364,28542364,28543076,0,0,0,712
39160,28542357,28542357,28543079,0,0,0,722
39161,28542357,28542357,28543079,0,0,0,722
39189,28542365,28542365,28543079,0,0,0,714
39195,28542366,28542366,28543079,0,0,0,713
39163,28542358,28542358,28543080,0,0,0,722
39217,28542372,28542372,28543082,0,0,0,710
39153,28542355,28542355,28543083,0,0,0,728
39183,28542364,28542364,28543083,0,0,0,719
39192,28542366,28542366,28543083,0,0,0,717
39134,28542346,28542346,28543084,0,0,0,738
39223,28542373,28542373,28543085,0,0,0,712
39224,28542373,28542373,28543085,0,0,0,712
39204,28542369,28542369,28543087,0,0,0,718
39140,28542349,28542349,28543088,0,0,0,739
39141,28542349,28542349,28543088,0,0,0,739
39152,28542355,28542355,28543088,0,0,0,733
39156,28542355,28542355,28543088,0,0,0,733
39142,28542350,28542350,28543089,0,0,0,739
39143,28542350,28542350,28543089,0,0,0,739
39200,28542368,28542368,28543089,0,0,0,721
39133,28542345,28542345,28543090,0,0,0,745
39159,28542357,28542357,28543090,0,0,0,733
39196,28542366,28542366,28543090,0,0,0,724
39190,28542365,28542365,28543091,0,0,0,726
39214,28542371,28542371,28543091,0,0,0,720
39215,28542372,28542372,28543092,0,0,0,720
39151,28542355,28542355,28543093,0,0,0,738
39219,28542372,28542372,28543093,0,0,0,721
39193,28542366,28542366,28543094,0,0,0,728
39208,28542370,28542370,28543094,0,0,0,724
39179,28542361,28542361,28543098,0,0,0,737
39205,28542369,28542369,28543098,0,0,0,729
39132,28542345,28542345,28543099,0,0,0,754
39180,28542362,28542362,28543099,0,0,0,737
39181,28542362,28542362,28543099,0,0,0,737
39135,28542346,28542346,28543100,0,0,0,754
39136,28542346,28542346,28543100,0,0,0,754
39137,28542346,28542346,28543100,0,0,0,754
39201,28542368,28542368,28543100,0,0,0,732
39202,28542368,28542368,28543100,0,0,0,732
39138,28542347,28542347,28543101,0,0,0,754
39197,28542366,28542366,28543101,0,0,0,735
39191,28542365,28542365,28543104,0,0,0,739
39209,28542370,28542370,28543105,0,0,0,735
39210,28542370,28542370,28543105,0,0,0,735
39168,28542359,28542359,28543106,0,0,0,747
39169,28542359,28542359,28543106,0,0,0,747
39170,28542359,28542359,28543106,0,0,0,747
39171,28542360,28542360,28543107,0,0,0,747
39173,28542360,28542360,28543107,0,0,0,747
39174,28542361,28542361,28543108,0,0,0,747
39175,28542361,28542361,28543108,0,0,0,747
39176,28542361,28542361,28543108,0,0,0,747
39177,28542361,28542361,28543108,0,0,0,747
39227,28542374,28542374,28543108,0,0,0,734
39188,28542365,28542365,28543111,0,0,0,746
39203,28542368,28542368,28543111,0,0,0,743
39199,28542367,28542367,28543113,0,0,0,746
39216,28542372,28542372,28543114,0,0,0,742
39157,28542356,28542356,28543115,0,0,0,759
39158,28542356,28542356,28543115,0,0,0,759
39162,28542357,28542357,28543115,0,0,0,758
39220,28542372,28542372,28543115,0,0,0,743
39164,28542358,28542358,28543116,0,0,0,758
39165,28542358,28542358,28543116,0,0,0,758
39166,28542358,28542358,28543116,0,0,0,758
39212,28542371,28542371,28543117,0,0,0,746
39228,28542374,28542374,28543119,0,0,0,745
39229,28542374,28542374,28543119,0,0,0,745
39155,28542355,28542355,28543125,0,0,0,770
39218,28542372,28542372,28543125,0,0,0,753
39221,28542373,28542373,28543127,0,0,0,754
39222,28542373,28542373,28543127,0,0,0,754
39213,28542371,28542371,28543128,0,0,0,757
39206,28542369,28542369,28543129,0,0,0,760
39230,28542374,28542374,28543130,0,0,0,756
39234,28543010,28543010,28543134,0,0,0,124
39225,28542373,28542373,28543138,0,0,0,765
39139,28542349,28542349,28543140,0,0,0,791
39144,28542353,28542353,28543140,0,0,0,787
39145,28542353,28542353,28543140,0,0,0,787
39207,28542369,28542369,28543140,0,0,0,771
39178,28542361,28542361,28543145,0,0,0,784
39226,28542373,28542373,28543151,0,0,0,778
39211,28542370,28542370,28543152,0,0,0,782
39235,28543087,28543087,28543571,0,0,0,484
39238,28544035,28544035,28544296,0,0,0,261
39237,28543896,28543896,28544476,0,0,0,580
39240,28545372,28545372,28545470,0,0,0,98
39231,28542432,28542432,28545846,0,0,0,3414
39269,28545845,28545845,28545888,0,0,0,43
39272,28545846,28545846,28545942,0,0,0,96
39374,28545895,28545895,28545978,0,0,0,83
39241,28545580,28545580,28546057,0,0,0,477
39242,28545580,28545580,28546073,0,0,0,493
39243,28545581,28545581,28546090,0,0,0,509
39244,28545581,28545581,28546090,0,0,0,509
39245,28545581,28545581,28546090,0,0,0,509
39246,28545581,28545581,28546090,0,0,0,509
39247,28545581,28545581,28546121,0,0,0,540
39248,28545581,28545581,28546121,0,0,0,540
39259,28545631,28545631,28546123,0,0,0,492
39261,28545631,28545631,28546123,0,0,0,492
39267,28545632,28545632,28546130,0,0,0,498
39249,28545623,28545623,28546138,0,0,0,515
39250,28545623,28545623,28546138,0,0,0,515
39253,28545624,28545624,28546139,0,0,0,515
39254,28545624,28545624,28546139,0,0,0,515
39265,28545632,28545632,28546140,0,0,0,508
39262,28545631,28545631,28546144,0,0,0,513
39263,28545632,28545632,28546145,0,0,0,513
39264,28545632,28545632,28546145,0,0,0,513
39268,28545632,28545632,28546151,0,0,0,519
39260,28545631,28545631,28546155,0,0,0,524
39266,28545632,28545632,28546156,0,0,0,524
39251,28545623,28545623,28546170,0,0,0,547
39252,28545623,28545623,28546170,0,0,0,547
39255,28545624,28545624,28546171,0,0,0,547
39256,28545624,28545624,28546171,0,0,0,547
39257,28545625,28545625,28546172,0,0,0,547
39279,28545847,28545847,28546345,0,0,0,498
39274,28545846,28545846,28546354,0,0,0,508
39275,28545846,28545846,28546354,0,0,0,508
39273,28545846,28545846,28546365,0,0,0,519
39283,28545868,28545868,28546366,0,0,0,498
39287,28545869,28545869,28546367,0,0,0,498
39288,28545869,28545869,28546367,0,0,0,498
39280,28545867,28545867,28546370,0,0,0,503
39282,28545868,28545868,28546371,0,0,0,503
39289,28545870,28545870,28546373,0,0,0,503
39312,28545877,28545877,28546373,0,0,0,496
39298,28545871,28545871,28546374,0,0,0,503
39313,28545878,28545878,28546374,0,0,0,496
39299,28545872,28545872,28546375,0,0,0,503
39349,28545885,28545885,28546375,0,0,0,490
39330,28545882,28545882,28546378,0,0,0,496
39360,28545888,28545888,28546378,0,0,0,490
39361,28545889,28545889,28546379,0,0,0,490
39276,28545846,28545846,28546380,0,0,0,534
39277,28545847,28545847,28546381,0,0,0,534
39278,28545847,28545847,28546381,0,0,0,534
39286,28545869,28545869,28546383,0,0,0,514
39326,28545881,28545881,28546383,0,0,0,502
39366,28545893,28545893,28546383,0,0,0,490
39291,28545870,28545870,28546384,0,0,0,514
39292,28545870,28545870,28546384,0,0,0,514
39270,28545845,28545845,28546385,0,0,0,540
39293,28545871,28545871,28546385,0,0,0,514
39294,28545871,28545871,28546385,0,0,0,514
39295,28545871,28545871,28546385,0,0,0,514
39344,28545884,28545884,28546385,0,0,0,501
39281,28545867,28545867,28546386,0,0,0,519
39284,28545868,28545868,28546387,0,0,0,519
39285,28545868,28545868,28546387,0,0,0,519
39319,28545879,28545879,28546387,0,0,0,508
39321,28545880,28545880,28546387,0,0,0,507
39310,28545876,28545876,28546388,0,0,0,512
39290,28545870,28545870,28546389,0,0,0,519
39311,28545877,28545877,28546389,0,0,0,512
39359,28545887,28545887,28546389,0,0,0,502
39314,28545878,28545878,28546390,0,0,0,512
39370,28545894,28545894,28546390,0,0,0,496
39271,28545845,28545845,28546391,0,0,0,546
39305,28545873,28545873,28546392,0,0,0,519
39306,28545873,28545873,28546392,0,0,0,519
39307,28545873,28545873,28546392,0,0,0,519
39308,28545873,28545873,28546392,0,0,0,519
39372,28545894,28545894,28546395,0,0,0,501
39315,28545878,28545878,28546396,0,0,0,518
39412,28545902,28545902,28546396,0,0,0,494
39364,28545891,28545891,28546397,0,0,0,506
39367,28545893,28545893,28546399,0,0,0,506
39320,28545879,28545879,28546402,0,0,0,523
39381,28545896,28545896,28546403,0,0,0,507
39324,28545881,28545881,28546404,0,0,0,523
39325,28545881,28545881,28546404,0,0,0,523
39416,28545903,28545903,28546404,0,0,0,501
39334,28545883,28545883,28546405,0,0,0,522
39335,28545883,28545883,28546405,0,0,0,522
39336,28545883,28545883,28546405,0,0,0,522
39337,28545883,28545883,28546405,0,0,0,522
39338,28545883,28545883,28546405,0,0,0,522
39424,28545905,28545905,28546405,0,0,0,500
39434,28545906,28545906,28546405,0,0,0,499
39296,28545871,28545871,28546406,0,0,0,535
39297,28545871,28545871,28546406,0,0,0,535
39339,28545884,28545884,28546406,0,0,0,522
39340,28545884,28545884,28546406,0,0,0,522
39300,28545872,28545872,28546407,0,0,0,535
39301,28545872,28545872,28546407,0,0,0,535
39302,28545872,28545872,28546407,0,0,0,535
39303,28545872,28545872,28546407,0,0,0,535
39377,28545895,28545895,28546407,0,0,0,512
39378,28545895,28545895,28546407,0,0,0,512
39379,28545895,28545895,28546407,0,0,0,512
39406,28545901,28545901,28546407,0,0,0,506
39407,28545901,28545901,28546407,0,0,0,506
39322,28545880,28545880,28546408,0,0,0,528
39323,28545880,28545880,28546408,0,0,0,528
39327,28545881,28545881,28546409,0,0,0,528
39331,28545882,28545882,28546409,0,0,0,527
39332,28545882,28545882,28546409,0,0,0,527
39333,28545882,28545882,28546409,0,0,0,527
39415,28545903,28545903,28546409,0,0,0,506
39449,28545909,28545909,28546409,0,0,0,500
39258,28545631,28545631,28546410,0,0,0,779
39328,28545882,28545882,28546410,0,0,0,528
39329,28545882,28545882,28546410,0,0,0,528
39389,28545897,28545897,28546410,0,0,0,513
39390,28545897,28545897,28546410,0,0,0,513
39417,28545904,28545904,28546411,0,0,0,507
39350,28545885,28545885,28546412,0,0,0,527
39362,28545890,28545890,28546412,0,0,0,522
39363,28545890,28545890,28546412,0,0,0,522
39375,28545895,28545895,28546412,0,0,0,517
39376,28545895,28545895,28546412,0,0,0,517
39402,28545900,28545900,28546412,0,0,0,512
39403,28545900,28545900,28546412,0,0,0,512
39411,28545902,28545902,28546412,0,0,0,510
39317,28545879,28545879,28546413,0,0,0,534
39318,28545879,28545879,28546413,0,0,0,534
39351,28545886,28545886,28546413,0,0,0,527
39352,28545886,28545886,28546413,0,0,0,527
39353,28545886,28545886,28546413,0,0,0,527
39354,28545886,28545886,28546413,0,0,0,527
39365,28545892,28545892,28546414,0,0,0,522
39430,28545906,28545906,28546414,0,0,0,508
39431,28545906,28545906,28546414,0,0,0,508
39392,28545897,28545897,28546415,0,0,0,518
39432,28545906,28545906,28546415,0,0,0,509
39442,28545908,28545908,28546415,0,0,0,507
39371,28545894,28545894,28546416,0,0,0,522
39373,28545894,28545894,28546416,0,0,0,522
39393,28545898,28545898,28546416,0,0,0,518
39394,28545898,28545898,28546416,0,0,0,518
39396,28545898,28545898,28546416,0,0,0,518
39397,28545898,28545898,28546416,0,0,0,518
39398,28545898,28545898,28546416,0,0,0,518
39345,28545885,28545885,28546417,0,0,0,532
39346,28545885,28545885,28546417,0,0,0,532
39347,28545885,28545885,28546417,0,0,0,532
39348,28545885,28545885,28546417,0,0,0,532
39427,28545905,28545905,28546417,0,0,0,512
39445,28545908,28545908,28546417,0,0,0,509
39446,28545908,28545908,28546417,0,0,0,509
39429,28545906,28545906,28546418,0,0,0,512
39384,28545896,28545896,28546419,0,0,0,523
39385,28545896,28545896,28546419,0,0,0,523
39413,28545903,28545903,28546419,0,0,0,516
39414,28545903,28545903,28546419,0,0,0,516
39422,28545904,28545904,28546419,0,0,0,515
39387,28545897,28545897,28546420,0,0,0,523
39423,28545905,28545905,28546420,0,0,0,515
39450,28545909,28545909,28546420,0,0,0,511
39368,28545894,28545894,28546421,0,0,0,527
39369,28545894,28545894,28546421,0,0,0,527
39418,28545904,28545904,28546422,0,0,0,518
39453,28545909,28545909,28546422,0,0,0,513
39419,28545904,28545904,28546423,0,0,0,519
39420,28545904,28545904,28546423,0,0,0,519
39421,28545904,28545904,28546423,0,0,0,519
39437,28545907,28545907,28546423,0,0,0,516
39438,28545907,28545907,28546423,0,0,0,516
39455,28545910,28545910,28546423,0,0,0,513
39456,28545910,28545910,28546423,0,0,0,513
39382,28545896,28545896,28546424,0,0,0,528
39383,28545896,28545896,28546424,0,0,0,528
39441,28545907,28545907,28546425,0,0,0,518
39433,28545906,28545906,28546426,0,0,0,520
39426,28545905,28545905,28546427,0,0,0,522
39436,28545907,28545907,28546428,0,0,0,521
39447,28545908,28545908,28546428,0,0,0,520
39448,28545908,28545908,28546428,0,0,0,520
39451,28545909,28545909,28546431,0,0,0,522
39341,28545884,28545884,28546432,0,0,0,548
39342,28545884,28545884,28546432,0,0,0,548
39343,28545884,28545884,28546432,0,0,0,548
39425,28545905,28545905,28546432,0,0,0,527
39316,28545878,28545878,28546433,0,0,0,555
39380,28545895,28545895,28546433,0,0,0,538
39454,28545909,28545909,28546433,0,0,0,524
39439,28545907,28545907,28546434,0,0,0,527
39440,28545907,28545907,28546434,0,0,0,527
39443,28545908,28545908,28546437,0,0,0,529
39444,28545908,28545908,28546437,0,0,0,529
39304,28545872,28545872,28546438,0,0,0,566
39435,28545906,28545906,28546438,0,0,0,532
39428,28545905,28545905,28546439,0,0,0,534
39391,28545897,28545897,28546441,0,0,0,544
39401,28545899,28545899,28546442,0,0,0,543
39452,28545909,28545909,28546442,0,0,0,533
39404,28545900,28545900,28546443,0,0,0,543
39405,28545901,28545901,28546444,0,0,0,543
39408,28545901,28545901,28546444,0,0,0,543
39409,28545902,28545902,28546445,0,0,0,543
39386,28545896,28545896,28546446,0,0,0,550
39309,28545876,28545876,28546447,0,0,0,571
39388,28545897,28545897,28546447,0,0,0,550
39395,28545898,28545898,28546447,0,0,0,549
39399,28545898,28545898,28546447,0,0,0,549
39400,28545899,28545899,28546448,0,0,0,549
39355,28545886,28545886,28546450,0,0,0,564
39356,28545886,28545886,28546450,0,0,0,564
39357,28545887,28545887,28546451,0,0,0,564
39358,28545887,28545887,28546451,0,0,0,564
39410,28545902,28545902,28546466,0,0,0,564
39457,28546549,28546549,28546644,0,0,0,95
39458,28546918,28546918,28547015,0,0,0,97
39459,28547385,28547385,28547489,0,0,0,104
39019,28531400,28531400,28547699,0,0,0,16299
39460,28547387,28547387,28547896,0,0,0,509
39461,28547429,28547429,28547927,0,0,0,498
39020,28531515,28531515,28547955,0,0,0,16440
39465,28548100,28548100,28548201,0,0,0,101
39463,28547823,28547823,28548322,0,0,0,499
39467,28548607,28548607,28548705,0,0,0,98
39468,28548607,28548607,28548705,0,0,0,98
39466,28548346,28548346,28549212,0,0,0,866
39469,28549590,28549590,28550004,0,0,0,414
39470,28549591,28549591,28550021,0,0,0,430
39471,28549591,28549591,28550021,0,0,0,430
39472,28549591,28549591,28550042,0,0,0,451
39473,28549591,28549591,28550042,0,0,0,451
39474,28549591,28549591,28550042,0,0,0,451
39475,28549591,28549591,28550042,0,0,0,451
39476,28549592,28549592,28550075,0,0,0,483
39477,28549592,28549592,28550075,0,0,0,483
39478,28549592,28549592,28550075,0,0,0,483
39479,28549592,28549592,28550075,0,0,0,483
39480,28549592,28549592,28550075,0,0,0,483
39482,28549702,28549702,28550114,0,0,0,412
39484,28549702,28549702,28550130,0,0,0,428
39485,28549702,28549702,28550130,0,0,0,428
39486,28549702,28549702,28550130,0,0,0,428
39501,28549705,28549705,28550138,0,0,0,433
39502,28549705,28549705,28550138,0,0,0,433
39489,28549703,28549703,28550141,0,0,0,438
39490,28549703,28549703,28550141,0,0,0,438
39483,28549702,28549702,28550146,0,0,0,444
39487,28549703,28549703,28550152,0,0,0,449
39488,28549703,28549703,28550152,0,0,0,449
39494,28549704,28549704,28550152,0,0,0,448
39495,28549704,28549704,28550152,0,0,0,448
39496,28549704,28549704,28550152,0,0,0,448
39497,28549704,28549704,28550152,0,0,0,448
39498,28549704,28549704,28550152,0,0,0,448
39491,28549703,28549703,28550162,0,0,0,459
39492,28549703,28549703,28550162,0,0,0,459
39493,28549704,28549704,28550163,0,0,0,459
39499,28549705,28549705,28550190,0,0,0,485
39500,28549705,28549705,28550190,0,0,0,485
39505,28549864,28549864,28550278,0,0,0,414
39506,28549864,28549864,28550278,0,0,0,414
39521,28549867,28549867,28550282,0,0,0,415
39524,28549868,28549868,28550282,0,0,0,414
39510,28549865,28549865,28550285,0,0,0,420
39529,28549869,28549869,28550288,0,0,0,419
39503,28549858,28549858,28550289,0,0,0,431
39508,28549865,28549865,28550290,0,0,0,425
39507,28549865,28549865,28550295,0,0,0,430
39541,28549876,28549876,28550300,0,0,0,424
39512,28549865,28549865,28550301,0,0,0,436
39513,28549866,28549866,28550302,0,0,0,436
39514,28549866,28549866,28550302,0,0,0,436
39515,28549866,28549866,28550302,0,0,0,436
39516,28549866,28549866,28550302,0,0,0,436
39517,28549866,28549866,28550302,0,0,0,436
39592,28549887,28549887,28550304,0,0,0,417
39509,28549865,28549865,28550306,0,0,0,441
39511,28549865,28549865,28550306,0,0,0,441
39525,28549868,28549868,28550308,0,0,0,440
39526,28549868,28549868,28550308,0,0,0,440
39570,28549882,28549882,28550309,0,0,0,427
39538,28549875,28549875,28550310,0,0,0,435
39556,28549878,28549878,28550310,0,0,0,432
39558,28549879,28549879,28550311,0,0,0,432
39522,28549867,28549867,28550313,0,0,0,446
39523,28549868,28549868,28550314,0,0,0,446
39593,28549887,28549887,28550314,0,0,0,427
39596,28549887,28549887,28550314,0,0,0,427
39530,28549870,28549870,28550315,0,0,0,445
39531,28549870,28549870,28550315,0,0,0,445
39532,28549870,28549870,28550315,0,0,0,445
39605,28549889,28549889,28550315,0,0,0,426
39539,28549876,28549876,28550316,0,0,0,440
39540,28549876,28549876,28550316,0,0,0,440
39543,28549876,28549876,28550316,0,0,0,440
39544,28549876,28549876,28550316,0,0,0,440
39545,28549876,28549876,28550316,0,0,0,440
39559,28549879,28549879,28550316,0,0,0,437
39560,28549879,28549879,28550316,0,0,0,437
39561,28549879,28549879,28550316,0,0,0,437
39546,28549877,28549877,28550317,0,0,0,440
39547,28549877,28549877,28550317,0,0,0,440
39548,28549877,28549877,28550317,0,0,0,440
39549,28549877,28549877,28550317,0,0,0,440
39550,28549877,28549877,28550317,0,0,0,440
39551,28549877,28549877,28550317,0,0,0,440
39518,28549866,28549866,28550318,0,0,0,452
39552,28549878,28549878,28550318,0,0,0,440
39553,28549878,28549878,28550318,0,0,0,440
39519,28549867,28549867,28550319,0,0,0,452
39520,28549867,28549867,28550319,0,0,0,452
39554,28549878,28549878,28550319,0,0,0,441
39594,28549887,28549887,28550319,0,0,0,432
39542,28549876,28549876,28550321,0,0,0,445
39562,28549879,28549879,28550322,0,0,0,443
39563,28549879,28549879,28550322,0,0,0,443
39639,28549897,28549897,28550322,0,0,0,425
39645,28549898,28549898,28550322,0,0,0,424
39564,28549880,28549880,28550323,0,0,0,443
39584,28549885,28549885,28550323,0,0,0,438
39585,28549885,28549885,28550323,0,0,0,438
39565,28549881,28549881,28550324,0,0,0,443
39566,28549881,28549881,28550324,0,0,0,443
39567,28549881,28549881,28550324,0,0,0,443
39590,28549886,28549886,28550324,0,0,0,438
39537,28549875,28549875,28550326,0,0,0,451
39612,28549890,28549890,28550326,0,0,0,436
39613,28549890,28549890,28550326,0,0,0,436
39614,28549890,28549890,28550326,0,0,0,436
39626,28549894,28549894,28550326,0,0,0,432
39578,28549884,28549884,28550327,0,0,0,443
39579,28549884,28549884,28550327,0,0,0,443
39627,28549895,28549895,28550327,0,0,0,432
39581,28549885,28549885,28550328,0,0,0,443
39642,28549898,28549898,28550328,0,0,0,430
39643,28549898,28549898,28550328,0,0,0,430
39527,28549868,28549868,28550329,0,0,0,461
39528,28549868,28549868,28550329,0,0,0,461
39654,28549900,28549900,28550329,0,0,0,429
39655,28549900,28549900,28550329,0,0,0,429
39621,28549893,28549893,28550330,0,0,0,437
39622,28549893,28549893,28550330,0,0,0,437
39623,28549893,28549893,28550330,0,0,0,437
39661,28549901,28549901,28550330,0,0,0,429
39662,28549901,28549901,28550330,0,0,0,429
39608,28549889,28549889,28550331,0,0,0,442
39609,28549889,28549889,28550331,0,0,0,442
39599,28549888,28549888,28550332,0,0,0,444
39600,28549888,28549888,28550332,0,0,0,444
39601,28549888,28549888,28550332,0,0,0,444
39602,28549888,28549888,28550332,0,0,0,444
39603,28549888,28549888,28550332,0,0,0,444
39604,28549889,28549889,28550332,0,0,0,443
39610,28549890,28549890,28550332,0,0,0,442
39615,28549891,28549891,28550333,0,0,0,442
39616,28549891,28549891,28550333,0,0,0,442
39650,28549899,28549899,28550333,0,0,0,434
39651,28549899,28549899,28550333,0,0,0,434
39617,28549892,28549892,28550334,0,0,0,442
39618,28549892,28549892,28550334,0,0,0,442
39670,28549904,28549904,28550334,0,0,0,430
39671,28549904,28549904,28550334,0,0,0,430
39674,28549905,28549905,28550334,0,0,0,429
39675,28549905,28549905,28550334,0,0,0,429
39572,28549882,28549882,28550335,0,0,0,453
39587,28549886,28549886,28550335,0,0,0,449
39588,28549886,28549886,28550335,0,0,0,449
39595,28549887,28549887,28550335,0,0,0,448
39597,28549887,28549887,28550335,0,0,0,448
39620,28549893,28549893,28550335,0,0,0,442
39658,28549901,28549901,28550335,0,0,0,434
39659,28549901,28549901,28550335,0,0,0,434
39678,28549906,28549906,28550335,0,0,0,429
39555,28549878,28549878,28550336,0,0,0,458
39573,28549883,28549883,28550336,0,0,0,453
39574,28549883,28549883,28550336,0,0,0,453
39575,28549883,28549883,28550336,0,0,0,453
39598,28549888,28549888,28550336,0,0,0,448
39606,28549889,28549889,28550336,0,0,0,447
39607,28549889,28549889,28550336,0,0,0,447
39644,28549898,28549898,28550338,0,0,0,440
39656,28549900,28549900,28550339,0,0,0,439
39589,28549886,28549886,28550340,0,0,0,454
39706,28549911,28549911,28550341,0,0,0,430
39715,28549912,28549912,28550342,0,0,0,430
39716,28549912,28549912,28550342,0,0,0,430
39646,28549898,28549898,28550343,0,0,0,445
39762,28549922,28549922,28550345,0,0,0,423
39636,28549896,28549896,28550347,0,0,0,451
39718,28549913,28549913,28550347,0,0,0,434
39631,28549896,28549896,28550348,0,0,0,452
39632,28549896,28549896,28550348,0,0,0,452
39633,28549896,28549896,28550348,0,0,0,452
39634,28549896,28549896,28550348,0,0,0,452
39635,28549896,28549896,28550348,0,0,0,452
39637,28549897,28549897,28550348,0,0,0,451
39638,28549897,28549897,28550348,0,0,0,451
39697,28549909,28549909,28550348,0,0,0,439
39698,28549909,28549909,28550348,0,0,0,439
39647,28549898,28549898,28550349,0,0,0,451
39649,28549899,28549899,28550349,0,0,0,450
39699,28549910,28549910,28550349,0,0,0,439
39700,28549910,28549910,28550349,0,0,0,439
39701,28549910,28549910,28550349,0,0,0,439
39702,28549910,28549910,28550349,0,0,0,439
39703,28549910,28549910,28550349,0,0,0,439
39568,28549881,28549881,28550350,0,0,0,469
39591,28549886,28549886,28550350,0,0,0,464
39648,28549899,28549899,28550350,0,0,0,451
39569,28549882,28549882,28550351,0,0,0,469
39665,28549902,28549902,28550352,0,0,0,450
39707,28549911,28549911,28550352,0,0,0,441
39708,28549911,28549911,28550352,0,0,0,441
39709,28549911,28549911,28550352,0,0,0,441
39710,28549911,28549911,28550352,0,0,0,441
39711,28549911,28549911,28550352,0,0,0,441
39771,28549925,28549925,28550352,0,0,0,427
39534,28549875,28549875,28550353,0,0,0,478
39535,28549875,28549875,28550353,0,0,0,478
39536,28549875,28549875,28550353,0,0,0,478
39640,28549897,28549897,28550353,0,0,0,456
39641,28549897,28549897,28550353,0,0,0,456
39666,28549903,28549903,28550353,0,0,0,450
39667,28549903,28549903,28550353,0,0,0,450
39668,28549903,28549903,28550354,0,0,0,451
39669,28549903,28549903,28550354,0,0,0,451
39739,28549918,28549918,28550354,0,0,0,436
39740,28549918,28549918,28550354,0,0,0,436
39747,28549920,28549920,28550354,0,0,0,434
39619,28549892,28549892,28550355,0,0,0,463
39749,28549920,28549920,28550355,0,0,0,435
39660,28549901,28549901,28550356,0,0,0,455
39681,28549907,28549907,28550357,0,0,0,450
39682,28549907,28549907,28550357,0,0,0,450
39683,28549907,28549907,28550357,0,0,0,450
39684,28549907,28549907,28550357,0,0,0,450
39685,28549907,28549907,28550357,0,0,0,450
39686,28549907,28549907,28550357,0,0,0,450
39744,28549919,28549919,28550357,0,0,0,438
39611,28549890,28549890,28550358,0,0,0,468
39628,28549895,28549895,28550358,0,0,0,463
39629,28549895,28549895,28550358,0,0,0,463
39630,28549895,28549895,28550358,0,0,0,463
39687,28549908,28549908,28550358,0,0,0,450
39688,28549908,28549908,28550358,0,0,0,450
39689,28549908,28549908,28550358,0,0,0,450
39690,28549908,28549908,28550358,0,0,0,450
39691,28549908,28549908,28550358,0,0,0,450
39692,28549908,28549908,28550358,0,0,0,450
39746,28549919,28549919,28550358,0,0,0,439
39757,28549921,28549921,28550358,0,0,0,437
39779,28549927,28549927,28550358,0,0,0,431
39781,28549927,28549927,28550358,0,0,0,431
39652,28549899,28549899,28550359,0,0,0,460
39693,28549909,28549909,28550359,0,0,0,450
39694,28549909,28549909,28550359,0,0,0,450
39695,28549909,28549909,28550359,0,0,0,450
39696,28549909,28549909,28550359,0,0,0,450
39721,28549914,28549914,28550359,0,0,0,445
39767,28549923,28549923,28550359,0,0,0,436
39768,28549923,28549923,28550359,0,0,0,436
39586,28549885,28549885,28550360,0,0,0,475
39653,28549900,28549900,28550360,0,0,0,460
39723,28549915,28549915,28550360,0,0,0,445
39724,28549915,28549915,28550360,0,0,0,445
39725,28549915,28549915,28550360,0,0,0,445
39726,28549915,28549915,28550360,0,0,0,445
39759,28549922,28549922,28550360,0,0,0,438
39760,28549922,28549922,28550360,0,0,0,438
39679,28549906,28549906,28550361,0,0,0,455
39727,28549916,28549916,28550361,0,0,0,445
39728,28549916,28549916,28550361,0,0,0,445
39770,28549924,28549924,28550361,0,0,0,437
39557,28549878,28549878,28550362,0,0,0,484
39663,28549901,28549901,28550362,0,0,0,461
39680,28549907,28549907,28550362,0,0,0,455
39624,28549894,28549894,28550363,0,0,0,469
39625,28549894,28549894,28550363,0,0,0,469
39664,28549902,28549902,28550363,0,0,0,461
39713,28549912,28549912,28550363,0,0,0,451
39714,28549912,28549912,28550363,0,0,0,451
39754,28549921,28549921,28550363,0,0,0,442
39755,28549921,28549921,28550363,0,0,0,442
39772,28549925,28549925,28550363,0,0,0,438
39580,28549884,28549884,28550364,0,0,0,480
39582,28549885,28549885,28550365,0,0,0,480
39583,28549885,28549885,28550365,0,0,0,480
39672,28549904,28549904,28550365,0,0,0,461
39676,28549905,28549905,28550365,0,0,0,460
39748,28549920,28549920,28550365,0,0,0,445
39673,28549905,28549905,28550366,0,0,0,461
39677,28549906,28549906,28550366,0,0,0,460
39729,28549916,28549916,28550366,0,0,0,450
39730,28549916,28549916,28550366,0,0,0,450
39750,28549920,28549920,28550366,0,0,0,446
39751,28549920,28549920,28550366,0,0,0,446
39775,28549926,28549926,28550366,0,0,0,440
39776,28549926,28549926,28550366,0,0,0,440
39763,28549922,28549922,28550367,0,0,0,445
39719,28549913,28549913,28550368,0,0,0,455
39731,28549917,28549917,28550368,0,0,0,451
39732,28549917,28549917,28550368,0,0,0,451
39733,28549917,28549917,28550368,0,0,0,451
39734,28549917,28549917,28550368,0,0,0,451
39745,28549919,28549919,28550368,0,0,0,449
39765,28549923,28549923,28550368,0,0,0,445
39766,28549923,28549923,28550368,0,0,0,445
39720,28549914,28549914,28550369,0,0,0,455
39735,28549918,28549918,28550369,0,0,0,451
39736,28549918,28549918,28550369,0,0,0,451
39737,28549918,28549918,28550369,0,0,0,451
39738,28549918,28549918,28550369,0,0,0,451
39758,28549921,28549921,28550369,0,0,0,448
39780,28549927,28549927,28550369,0,0,0,442
39704,28549910,28549910,28550371,0,0,0,461
39761,28549922,28549922,28550371,0,0,0,449
39769,28549923,28549923,28550371,0,0,0,448
39705,28549911,28549911,28550372,0,0,0,461
39576,28549883,28549883,28550373,0,0,0,490
39717,28549912,28549912,28550373,0,0,0,461
39752,28549920,28549920,28550373,0,0,0,453
39753,28549920,28549920,28550373,0,0,0,453
39577,28549884,28549884,28550374,0,0,0,490
39756,28549921,28549921,28550374,0,0,0,453
39773,28549925,28549925,28550374,0,0,0,449
39774,28549925,28549925,28550374,0,0,0,449
39657,28549900,28549900,28550376,0,0,0,476
39571,28549882,28549882,28550377,0,0,0,495
39742,28549919,28549919,28550377,0,0,0,458
39743,28549919,28549919,28550377,0,0,0,458
39777,28549926,28549926,28550377,0,0,0,451
39764,28549922,28549922,28550378,0,0,0,456
39712,28549912,28549912,28550379,0,0,0,467
39741,28549918,28549918,28550396,0,0,0,478
39778,28549926,28549926,28550410,0,0,0,484
39722,28549914,28549914,28550421,0,0,0,507
39782,28550279,28550279,28550732,0,0,0,453
39783,28550622,28550622,28551097,0,0,0,475
39784,28550664,28550664,28551117,0,0,0,453
39785,28550726,28550726,28551154,0,0,0,428
39787,28551475,28551475,28551576,0,0,0,101
39788,28551475,28551475,28551576,0,0,0,101
39789,28551475,28551475,28551576,0,0,0,101
39791,28551849,28551849,28551939,0,0,0,90
35447,28292793,28292793,28551993,0,0,0,259200
39792,28551986,28551986,28552097,0,0,0,111
39793,28552065,28552065,28552195,0,0,0,130
39794,28552422,28552422,28552564,0,0,0,142
39795,28552472,28552472,28552814,0,0,0,342
39797,28552817,28552817,28552959,0,0,0,142
39799,28553307,28553307,28553356,0,0,0,49
39481,28549695,28549695,28553508,0,0,0,3813
39533,28549874,28549874,28553761,0,0,0,3887
39504,28549858,28549858,28553767,0,0,0,3909
39801,28554387,28554387,28554457,0,0,0,70
38639,28468221,28468221,28554716,0,0,0,86495
39798,28553033,28553033,28554857,0,0,0,1824
39810,28556001,28556001,28556089,0,0,0,88
39811,28556023,28556023,28556108,0,0,0,85
39812,28556102,28556102,28556198,0,0,0,96
39815,28556650,28556650,28556911,0,0,0,261
39813,28556642,28556642,28557008,0,0,0,366
39814,28556643,28556643,28557009,0,0,0,366
39816,28556652,28556652,28557017,0,0,0,365
39817,28556652,28556652,28557017,0,0,0,365
39818,28556652,28556652,28557017,0,0,0,365
39833,28556907,28556907,28557262,0,0,0,355
39819,28556903,28556903,28557268,0,0,0,365
39824,28556905,28556905,28557280,0,0,0,375
39825,28556905,28556905,28557280,0,0,0,375
39826,28556905,28556905,28557280,0,0,0,375
39827,28556905,28556905,28557280,0,0,0,375
39828,28556906,28556906,28557281,0,0,0,375
39820,28556904,28556904,28557290,0,0,0,386
39821,28556904,28556904,28557290,0,0,0,386
39822,28556904,28556904,28557290,0,0,0,386
39823,28556904,28556904,28557290,0,0,0,386
39829,28556906,28556906,28557318,0,0,0,412
39830,28556906,28556906,28557318,0,0,0,412
39831,28556907,28556907,28557319,0,0,0,412
39832,28556907,28556907,28557319,0,0,0,412
39837,28558961,28558961,28559233,0,0,0,272
39838,28559182,28559182,28559454,0,0,0,272
39840,28559184,28559184,28559456,0,0,0,272
39841,28559187,28559187,28559459,0,0,0,272
39842,28559189,28559189,28559461,0,0,0,272
39843,28559191,28559191,28559463,0,0,0,272
39844,28559407,28559407,28559497,0,0,0,90
39851,28559416,28559416,28559506,0,0,0,90
39848,28559409,28559409,28559681,0,0,0,272
39849,28559412,28559412,28559684,0,0,0,272
39850,28559414,28559414,28559686,0,0,0,272
39852,28559632,28559632,28559722,0,0,0,90
39855,28559634,28559634,28559724,0,0,0,90
39853,28559632,28559632,28559726,0,0,0,94
39856,28559637,28559637,28559727,0,0,0,90
39857,28559639,28559639,28559729,0,0,0,90
39858,28559641,28559641,28559731,0,0,0,90
39854,28559632,28559726,28559832,0,0,94,200
39859,28559851,28559851,28559978,0,0,0,127
39861,28559904,28559904,28559978,0,0,0,74
39862,28559907,28559907,28559981,0,0,0,74
39863,28559909,28559909,28559983,0,0,0,74
39864,28559911,28559911,28559985,0,0,0,74
39866,28559941,28559941,28560015,0,0,0,74
39867,28559943,28559943,28560017,0,0,0,74
39868,28559946,28559946,28560020,0,0,0,74
39869,28559948,28559948,28560022,0,0,0,74
39865,28559914,28559914,28560025,0,0,0,111
39871,28559978,28559978,28560052,0,0,0,74
39872,28559980,28559980,28560054,0,0,0,74
39873,28559983,28559983,28560057,0,0,0,74
39870,28559950,28559950,28560061,0,0,0,111
39876,28560015,28560015,28560089,0,0,0,74
39878,28560017,28560017,28560091,0,0,0,74
39879,28560020,28560020,28560094,0,0,0,74
39874,28559985,28559985,28560096,0,0,0,111
39880,28560022,28560022,28560096,0,0,0,74
39875,28559987,28559987,28560098,0,0,0,111
39882,28560052,28560052,28560126,0,0,0,74
39883,28560054,28560054,28560128,0,0,0,74
39884,28560057,28560057,28560131,0,0,0,74
39885,28560059,28560059,28560133,0,0,0,74
39881,28560024,28560024,28560135,0,0,0,111
39887,28560089,28560089,28560163,0,0,0,74
39888,28560091,28560091,28560165,0,0,0,74
39889,28560094,28560094,28560168,0,0,0,74
39890,28560096,28560096,28560170,0,0,0,74
39886,28560061,28560061,28560172,0,0,0,111
39892,28560126,28560126,28560200,0,0,0,74
39893,28560128,28560128,28560202,0,0,0,74
39894,28560131,28560131,28560205,0,0,0,74
39895,28560133,28560133,28560207,0,0,0,74
39891,28560098,28560098,28560209,0,0,0,111
39897,28560163,28560163,28560237,0,0,0,74
39898,28560165,28560165,28560239,0,0,0,74
39899,28560167,28560167,28560241,0,0,0,74
39900,28560170,28560170,28560244,0,0,0,74
39896,28560135,28560135,28560246,0,0,0,111
39902,28560200,28560200,28560274,0,0,0,74
39903,28560202,28560202,28560276,0,0,0,74
39904,28560204,28560204,28560278,0,0,0,74
39905,28560207,28560207,28560281,0,0,0,74
39901,28560172,28560172,28560283,0,0,0,111
39907,28560237,28560237,28560311,0,0,0,74
39908,28560239,28560239,28560313,0,0,0,74
39909,28560242,28560242,28560316,0,0,0,74
39910,28560244,28560244,28560318,0,0,0,74
39906,28560209,28560209,28560320,0,0,0,111
39912,28560274,28560274,28560348,0,0,0,74
39913,28560276,28560276,28560350,0,0,0,74
39914,28560278,28560278,28560352,0,0,0,74
39915,28560281,28560281,28560355,0,0,0,74
39911,28560246,28560246,28560357,0,0,0,111
39916,28560283,28560283,28560357,0,0,0,74
39917,28560311,28560311,28560385,0,0,0,74
39918,28560313,28560313,28560387,0,0,0,74
39919,28560315,28560315,28560389,0,0,0,74
39920,28560318,28560318,28560392,0,0,0,74
38709,28473993,28473993,28560393,0,0,0,86400
39921,28560320,28560320,28560394,0,0,0,74
39922,28560348,28560348,28560422,0,0,0,74
39923,28560350,28560350,28560424,0,0,0,74
39924,28560353,28560353,28560427,0,0,0,74
39925,28560355,28560355,28560429,0,0,0,74
39926,28560357,28560357,28560431,0,0,0,74
38715,28474053,28474053,28560453,0,0,0,86400
38716,28474054,28474054,28560454,0,0,0,86400
38717,28474054,28474054,28560454,0,0,0,86400
38718,28474054,28474054,28560454,0,0,0,86400
38719,28474055,28474055,28560455,0,0,0,86400
38720,28474055,28474055,28560455,0,0,0,86400
38721,28474055,28474055,28560455,0,0,0,86400
38722,28474055,28474055,28560455,0,0,0,86400
38723,28474056,28474056,28560456,0,0,0,86400
38724,28474056,28474056,28560456,0,0,0,86400
38725,28474056,28474056,28560456,0,0,0,86400
38726,28474056,28474056,28560456,0,0,0,86400
38727,28474057,28474057,28560457,0,0,0,86400
38728,28474057,28474057,28560457,0,0,0,86400
38729,28474057,28474057,28560457,0,0,0,86400
38730,28474057,28474057,28560457,0,0,0,86400
38731,28474057,28474057,28560457,0,0,0,86400
39927,28560385,28560385,28560459,0,0,0,74
39928,28560387,28560387,28560461,0,0,0,74
39929,28560389,28560389,28560463,0,0,0,74
39930,28560392,28560392,28560466,0,0,0,74
39932,28560422,28560422,28560496,0,0,0,74
39933,28560424,28560424,28560498,0,0,0,74
39934,28560427,28560427,28560501,0,0,0,74
39935,28560429,28560429,28560503,0,0,0,74
39931,28560394,28560394,28560505,0,0,0,111
39937,28560459,28560459,28560533,0,0,0,74
39938,28560461,28560461,28560535,0,0,0,74
39939,28560464,28560464,28560538,0,0,0,74
39940,28560466,28560466,28560540,0,0,0,74
39936,28560431,28560431,28560542,0,0,0,111
39942,28560496,28560496,28560570,0,0,0,74
39943,28560498,28560498,28560572,0,0,0,74
39944,28560501,28560501,28560575,0,0,0,74
39945,28560503,28560503,28560577,0,0,0,74
39941,28560468,28560468,28560579,0,0,0,111
39946,28560505,28560505,28560579,0,0,0,74
39947,28560533,28560533,28560607,0,0,0,74
39948,28560535,28560535,28560609,0,0,0,74
39949,28560538,28560538,28560612,0,0,0,74
39950,28560540,28560540,28560614,0,0,0,74
39952,28560570,28560570,28560644,0,0,0,74
39953,28560572,28560572,28560646,0,0,0,74
39954,28560575,28560575,28560649,0,0,0,74
39955,28560577,28560577,28560651,0,0,0,74
39951,28560542,28560542,28560653,0,0,0,111
39957,28560607,28560607,28560681,0,0,0,74
39958,28560609,28560609,28560683,0,0,0,74
39959,28560612,28560612,28560686,0,0,0,74
39960,28560614,28560614,28560688,0,0,0,74
39956,28560580,28560580,28560691,0,0,0,111
39962,28560644,28560644,28560718,0,0,0,74
39963,28560646,28560646,28560720,0,0,0,74
39964,28560648,28560648,28560722,0,0,0,74
39965,28560651,28560651,28560725,0,0,0,74
39961,28560616,28560616,28560727,0,0,0,111
39967,28560681,28560681,28560755,0,0,0,74
39968,28560683,28560683,28560757,0,0,0,74
39969,28560686,28560686,28560760,0,0,0,74
39970,28560688,28560688,28560762,0,0,0,74
39966,28560653,28560653,28560764,0,0,0,111
39972,28560718,28560718,28560792,0,0,0,74
39973,28560720,28560720,28560794,0,0,0,74
39974,28560723,28560723,28560797,0,0,0,74
39975,28560725,28560725,28560799,0,0,0,74
39971,28560690,28560690,28560801,0,0,0,111
39976,28560727,28560727,28560801,0,0,0,74
39977,28560755,28560755,28560829,0,0,0,74
39978,28560757,28560757,28560831,0,0,0,74
39979,28560760,28560760,28560834,0,0,0,74
39980,28560762,28560762,28560836,0,0,0,74
39981,28560764,28560764,28560838,0,0,0,74
37791,28388040,28388040,28560840,0,0,0,172800
39982,28560792,28560792,28560866,0,0,0,74
39983,28560794,28560794,28560868,0,0,0,74
39984,28560797,28560797,28560871,0,0,0,74
39985,28560799,28560799,28560873,0,0,0,74
39987,28560829,28560829,28560903,0,0,0,74
39988,28560831,28560831,28560905,0,0,0,74
39989,28560833,28560833,28560907,0,0,0,74
39990,28560836,28560836,28560910,0,0,0,74
39986,28560801,28560801,28560912,0,0,0,111
39992,28560866,28560866,28560940,0,0,0,74
39993,28560868,28560868,28560942,0,0,0,74
39994,28560871,28560871,28560945,0,0,0,74
39995,28560873,28560873,28560947,0,0,0,74
39991,28560838,28560838,28560949,0,0,0,111
39997,28560903,28560903,28560977,0,0,0,74
39998,28560905,28560905,28560979,0,0,0,74
39999,28560908,28560908,28560982,0,0,0,74
40000,28560910,28560910,28560984,0,0,0,74
39996,28560875,28560875,28560986,0,0,0,111
39835,28558530,28558530,28561542,0,0,0,3012
35608,28302386,28302386,28561586,0,0,0,259200
35609,28302386,28302386,28561586,0,0,0,259200
35619,28303524,28303524,28562724,0,0,0,259200
37836,28390790,28390790,28563590,0,0,0,172800
39462,28547657,28547657,28564073,0,0,0,16416
39464,28547917,28547917,28564292,0,0,0,16375
39786,28550879,28550879,28565561,0,0,0,14682
35792,28308570,28308570,28567770,0,0,0,259200
39834,28558527,28558527,28568632,0,0,0,10105
36170,28311452,28311452,28570652,0,0,0,259200
39803,28554551,28554551,28572551,0,0,0,18000
39809,28555814,28555814,28573814,0,0,0,18000
39805,28554828,28554828,28575506,0,0,0,20678
38753,28479860,28479860,28577279,0,0,0,97419
39845,28559407,28559407,28577407,0,0,0,18000
39860,28559852,28559852,28577852,0,0,0,18000
39806,28555441,28555441,28585428,0,0,0,29987
39807,28555445,28555445,28587407,0,0,0,31962
39790,28551628,28551628,28587628,0,0,0,36000
39846,28559407,28559407,28587674,0,0,0,28267
39800,28553676,28553676,28589676,0,0,0,36000
39808,28555448,28555448,28594367,0,0,0,38919
39877,28560016,28560016,28596016,0,0,0,36000
39233,28542483,28542483,28600425,0,0,0,57942
39802,28554463,28554463,28620945,0,0,0,66482
39239,28544191,28544191,28628272,0,0,0,84081
39804,28554674,28554674,28641840,0,0,0,87166
38707,28472767,28472767,28645567,0,0,0,172800
39236,28543645,28543645,28650891,0,0,0,107246
35552,28300878,28300878,28667496,0,0,0,366618
39836,28558748,28558748,28700012,0,0,0,141264
39847,28559407,28559407,28701773,0,0,0,142366
39839,28559182,28559182,28704141,0,0,0,144959
39796,28552786,28552786,28811986,0,0,0,259200
