id,Arrival,Start,Completion,No_of_expansion,No_of_shrinkage,Wait_time,Turn_around_time
10001,15340149,15340149,15340386,0,0,0,237
10002,15340547,15340547,15340769,0,0,0,222
10003,15341035,15341035,15341523,0,0,0,488
10010,15342571,15342571,15343379,0,0,0,808
10015,15344541,15344541,15344699,0,0,0,158
10016,15345138,15345138,15345285,0,0,0,147
10018,15345789,15345789,15345935,0,0,0,146
10011,15343404,15343404,15346696,0,0,0,3292
10019,15346646,15346646,15346792,0,0,0,146
10021,15346981,15346981,15347169,0,0,0,188
10004,15341724,15341724,15347187,0,0,0,5463
10023,15347412,15347412,15347567,0,0,0,155
10024,15347750,15347750,15347908,0,0,0,158
10027,15348061,15348061,15348197,0,0,0,136
10030,15349258,15349258,15349362,0,0,0,104
10031,15349677,15349677,15349823,0,0,0,146
10032,15349967,15349967,15350114,0,0,0,147
10033,15350201,15350201,15350347,0,0,0,146
10034,15350516,15350516,15350578,0,0,0,62
10035,15350549,15350549,15350778,0,0,0,229
10009,15342523,15342523,15361466,0,0,0,18943
10012,15343583,15343583,15364290,0,0,0,20707
10014,15344473,15344473,15365233,0,0,0,20760
10025,15347933,15347933,15369051,0,0,0,21118
10028,15348404,15348404,15369519,0,0,0,21115
10022,15347151,15347151,15374663,0,0,0,27512
10029,15348988,15348988,15375613,0,0,0,26625
10020,15346758,15346758,15376995,0,0,0,30237
10049,15374630,15374630,15377032,0,0,0,2402
10053,15376994,15376994,15380067,0,0,0,3073
10052,15376962,15376962,15380094,0,0,0,3132
10050,15375535,15375535,15383362,0,0,0,7827
10039,15365705,15365705,15386176,0,0,0,20471
10040,15365759,15365759,15386197,0,0,0,20438
10036,15356030,15356030,15386323,0,0,0,30293
10037,15358258,15358258,15388310,0,0,0,30052
10043,15369005,15369005,15389792,0,0,0,20787
10045,15369476,15369476,15390326,0,0,0,20850
10056,15383325,15383325,15391133,0,0,0,7808
10041,15368300,15368300,15392216,0,0,0,23916
10042,15368325,15368325,15392225,0,0,0,23900
10051,15376809,15376809,15395351,0,0,0,18542
10046,15371221,15371221,15397691,0,0,0,26470
10047,15371693,15371693,15398275,0,0,0,26582
10048,15371703,15371703,15398317,0,0,0,26614
10063,15391061,15391061,15398915,0,0,0,7854
10058,15386135,15386135,15406507,0,0,0,20372
10057,15386106,15386106,15406534,0,0,0,20428
10061,15389749,15389749,15410452,0,0,0,20703
10062,15390255,15390255,15410951,0,0,0,20696
10064,15392144,15392144,15416194,0,0,0,24050
10065,15392182,15392182,15416198,0,0,0,24016
10059,15386279,15386279,15416447,0,0,0,30168
10044,15369286,15369286,15417211,0,0,0,47925
10060,15388272,15388272,15417962,0,0,0,29690
10066,15397650,15397650,15424119,0,0,0,26469
10067,15398214,15398214,15425209,0,0,0,26995
10068,15398279,15398279,15425577,0,0,0,27298
10069,15398878,15398878,15425630,0,0,0,26752
10071,15406465,15406465,15426747,0,0,0,20282
10070,15406454,15406454,15426779,0,0,0,20325
10080,15423344,15423344,15426944,0,0,0,3600
10079,15421351,15421351,15428768,0,0,0,7417
10081,15423370,15426944,15430544,0,0,3574,7174
10072,15410384,15410384,15431065,0,0,0,20681
10073,15410904,15410904,15431520,0,0,0,20616
10088,15429798,15429798,15437253,0,0,0,7455
10075,15416124,15416124,15438370,0,0,0,22246
10074,15416115,15416115,15438372,0,0,0,22257
10026,15347964,15347964,15440261,0,0,0,92297
10005,15342163,15342163,15442257,0,0,0,100094
10008,15342341,15342341,15442546,0,0,0,100205
10007,15342295,15342295,15443392,0,0,0,101097
10006,15342274,15342274,15445239,0,0,0,102965
10076,15416404,15416404,15446359,0,0,0,29955
10078,15417890,15417890,15447107,0,0,0,29217
10097,15447070,15447070,15447239,0,0,0,169
10086,15426695,15426695,15447281,0,0,0,20586
10087,15426704,15426704,15447320,0,0,0,20616
10098,15447195,15447195,15447399,0,0,0,204
10101,15447328,15447328,15447541,0,0,0,213
10082,15424041,15424041,15450309,0,0,0,26268
10103,15450273,15450273,15450478,0,0,0,205
10104,15450402,15450402,15450575,0,0,0,173
10105,15450532,15450532,15450703,0,0,0,171
10089,15430984,15430984,15451949,0,0,0,20965
10085,15425584,15425584,15452022,0,0,0,26438
10083,15425166,15425166,15452298,0,0,0,27132
10090,15431482,15431482,15452455,0,0,0,20973
10084,15425503,15425503,15452633,0,0,0,27130
10093,15438301,15438301,15460379,0,0,0,22078
10092,15438281,15438281,15460424,0,0,0,22143
10100,15447243,15447243,15467726,0,0,0,20483
10099,15447238,15447238,15467763,0,0,0,20525
10107,15451913,15451913,15472811,0,0,0,20898
10013,15344234,15344234,15473086,0,0,0,128852
10110,15452378,15452378,15473211,0,0,0,20833
10096,15446281,15446281,15476146,0,0,0,29865
10106,15450662,15450662,15476973,0,0,0,26311
10119,15476893,15476893,15477091,0,0,0,198
10102,15447464,15447464,15477265,0,0,0,29801
10121,15477231,15477231,15477403,0,0,0,172
10122,15477363,15477363,15477540,0,0,0,177
10123,15477494,15477494,15477666,0,0,0,172
10108,15451983,15451983,15478271,0,0,0,26288
10109,15452255,15452255,15478954,0,0,0,26699
10111,15452560,15452560,15479132,0,0,0,26572
10112,15460336,15460336,15482428,0,0,0,22092
10113,15460377,15460377,15482469,0,0,0,22092
10114,15467680,15467680,15488311,0,0,0,20631
10115,15467688,15467688,15488339,0,0,0,20651
10118,15476110,15476110,15490379,0,0,0,14269
10117,15473173,15473173,15494174,0,0,0,21001
10116,15472768,15472768,15494367,0,0,0,21599
10135,15496589,15496589,15498424,0,0,0,1835
10091,15437631,15437631,15499770,0,0,0,62139
10017,15345553,15345553,15500262,0,0,0,154709
10140,15501049,15501049,15502034,0,0,0,985
10138,15498884,15498884,15502035,0,0,0,3151
10120,15477024,15477024,15503352,0,0,0,26328
10146,15503143,15503143,15503411,0,0,0,268
10147,15503308,15503308,15503510,0,0,0,202
10149,15503450,15503450,15503662,0,0,0,212
10077,15417883,15417883,15504381,0,0,0,86498
10125,15478228,15478228,15504649,0,0,0,26421
10126,15478874,15478874,15505351,0,0,0,26477
10127,15479048,15479048,15505543,0,0,0,26495
10128,15482389,15482389,15505662,0,0,0,23273
10129,15482429,15482429,15505744,0,0,0,23315
10158,15506502,15506502,15507022,0,0,0,520
10157,15506474,15506474,15507062,0,0,0,588
10160,15506538,15506538,15507108,0,0,0,570
10159,15506524,15506524,15507117,0,0,0,593
10124,15477627,15477627,15507460,0,0,0,29833
10161,15507380,15507380,15507600,0,0,0,220
10163,15507554,15507554,15508153,0,0,0,599
10131,15488268,15488268,15508717,0,0,0,20449
10130,15488259,15488259,15508751,0,0,0,20492
10167,15509112,15509112,15509694,0,0,0,582
10054,15380024,15380024,15509746,0,0,0,129722
10168,15509194,15509194,15509785,0,0,0,591
10169,15509259,15509259,15509872,0,0,0,613
10055,15380055,15380055,15510007,0,0,0,129952
10150,15503635,15503635,15510837,0,0,0,7202
10170,15510656,15510656,15510880,0,0,0,224
10171,15511546,15511546,15511764,0,0,0,218
10133,15494132,15494132,15514991,0,0,0,20859
10134,15494327,15494327,15515167,0,0,0,20840
10174,15515294,15515294,15515412,0,0,0,118
10176,15515704,15515704,15515765,0,0,0,61
10175,15515681,15515681,15515902,0,0,0,221
10177,15516657,15516657,15516854,0,0,0,197
10178,15517230,15517230,15517458,0,0,0,228
10179,15517486,15517486,15517683,0,0,0,197
10180,15519012,15519012,15519192,0,0,0,180
10132,15490301,15490301,15519418,0,0,0,29117
10144,15502700,15502700,15522013,0,0,0,19313
10143,15502033,15502033,15524400,0,0,0,22367
10155,15505620,15505620,15528985,0,0,0,23365
10156,15505701,15505701,15529034,0,0,0,23333
10166,15508675,15508675,15529229,0,0,0,20554
10165,15508667,15508667,15529233,0,0,0,20566
10148,15503439,15503439,15529839,0,0,0,26400
10152,15504607,15504607,15530858,0,0,0,26251
10153,15505316,15505316,15532120,0,0,0,26804
10191,15532114,15532114,15532222,0,0,0,108
10154,15505511,15505511,15532260,0,0,0,26749
10094,15440220,15440220,15532578,0,0,0,92358
10196,15532429,15532429,15533020,0,0,0,591
10038,15362081,15362081,15534881,0,0,0,172800
10172,15514948,15514948,15535936,0,0,0,20988
10173,15515125,15515125,15536039,0,0,0,20914
10162,15507518,15507518,15536796,0,0,0,29278
10187,15530813,15530813,15540234,0,0,0,9421
10181,15519382,15519382,15549243,0,0,0,29861
10205,15549199,15549199,15549372,0,0,0,173
10185,15529160,15529160,15549764,0,0,0,20604
10184,15529147,15529147,15549804,0,0,0,20657
10182,15528940,15528940,15551856,0,0,0,22916
10183,15528996,15528996,15551879,0,0,0,22883
10199,15532627,15532627,15552242,0,0,0,19615
10186,15529763,15529763,15556508,0,0,0,26745
10211,15556434,15556434,15556611,0,0,0,177
10201,15535892,15535892,15556999,0,0,0,21107
10202,15535997,15535997,15557032,0,0,0,21035
10189,15532055,15532055,15558762,0,0,0,26707
10193,15532186,15532186,15558928,0,0,0,26742
10203,15536758,15536758,15565906,0,0,0,29148
10095,15443182,15443182,15566343,0,0,0,123161
10204,15540195,15540195,15566821,0,0,0,26626
10188,15531872,15531872,15568547,0,0,0,36675
10207,15549725,15549725,15570352,0,0,0,20627
10208,15549727,15549727,15570374,0,0,0,20647
10164,15507701,15507701,15574387,0,0,0,66686
10209,15551782,15551782,15574847,0,0,0,23065
10210,15551817,15551817,15574881,0,0,0,23064
10213,15556922,15556922,15577942,0,0,0,21020
10214,15556990,15556990,15577952,0,0,0,20962
10206,15549332,15549332,15579229,0,0,0,29897
10136,15498343,15498343,15580334,0,0,0,81991
10212,15556574,15556574,15583102,0,0,0,26528
10227,15583063,15583063,15583231,0,0,0,168
10145,15502958,15502958,15584104,0,0,0,81146
10142,15501985,15501985,15584520,0,0,0,82535
10230,15585025,15585025,15585180,0,0,0,155
10215,15558715,15558715,15585249,0,0,0,26534
10216,15558886,15558886,15585585,0,0,0,26699
10234,15587922,15587922,15588135,0,0,0,213
10235,15588213,15588213,15588429,0,0,0,216
10233,15586257,15586257,15589962,0,0,0,3705
10236,15590095,15590095,15590334,0,0,0,239
10220,15570282,15570282,15590719,0,0,0,20437
10151,15504339,15504339,15590748,0,0,0,86409
10221,15570311,15570311,15590750,0,0,0,20439
10237,15590534,15590534,15590792,0,0,0,258
10241,15592731,15592731,15592824,0,0,0,93
10243,15592855,15592855,15592985,0,0,0,130
10244,15593061,15593061,15593191,0,0,0,130
10219,15566778,15566778,15593299,0,0,0,26521
10245,15593196,15593196,15593558,0,0,0,362
10247,15593450,15593450,15593594,0,0,0,144
10250,15593810,15593810,15593932,0,0,0,122
10251,15593996,15593996,15594131,0,0,0,135
10217,15565823,15565823,15595612,0,0,0,29789
10253,15595617,15595617,15595744,0,0,0,127
10254,15595941,15595941,15596034,0,0,0,93
10257,15597974,15597974,15598130,0,0,0,156
10222,15574776,15574776,15598134,0,0,0,23358
10223,15574809,15574809,15598178,0,0,0,23369
10139,15500762,15500762,15598472,0,0,0,97710
10224,15577873,15577873,15598709,0,0,0,20836
10225,15577909,15577909,15598742,0,0,0,20833
10249,15593519,15593519,15598848,0,0,0,5329
10252,15595579,15595579,15599249,0,0,0,3670
10255,15596235,15596235,15599291,0,0,0,3056
10266,15599301,15599301,15599447,0,0,0,146
10264,15598796,15598796,15599565,0,0,0,769
10263,15598747,15598747,15599580,0,0,0,833
10260,15598421,15598421,15599592,0,0,0,1171
10248,15593490,15593490,15599605,0,0,0,6115
10271,15599663,15599663,15599878,0,0,0,215
10272,15600119,15600119,15600266,0,0,0,147
10229,15584057,15584057,15601756,0,0,0,17699
10274,15602043,15602043,15602187,0,0,0,144
10242,15592833,15592833,15602228,0,0,0,9395
10276,15602318,15602318,15602465,0,0,0,147
10275,15602312,15602312,15602774,0,0,0,462
10278,15602403,15602403,15602812,0,0,0,409
10279,15602419,15602419,15602823,0,0,0,404
10277,15602383,15602383,15602851,0,0,0,468
10284,15603637,15603637,15603730,0,0,0,93
10286,15604356,15604356,15604461,0,0,0,105
10285,15604115,15604115,15604749,0,0,0,634
10289,15604854,15604854,15604981,0,0,0,127
10287,15604468,15604468,15605475,0,0,0,1007
10141,15501278,15501278,15605499,0,0,0,104221
10291,15605383,15605383,15605571,0,0,0,188
10293,15605613,15605613,15605750,0,0,0,137
10292,15605589,15605589,15605801,0,0,0,212
10294,15605633,15605633,15605834,0,0,0,201
10288,15604841,15604841,15605869,0,0,0,1028
10296,15606159,15606159,15606378,0,0,0,219
10297,15606204,15606204,15606416,0,0,0,212
10299,15606745,15606745,15606950,0,0,0,205
10300,15606939,15606939,15607066,0,0,0,127
10301,15607229,15607229,15607374,0,0,0,145
10302,15607245,15607245,15607400,0,0,0,155
10303,15608172,15608172,15608320,0,0,0,148
10304,15608330,15608330,15608373,0,0,0,43
10305,15608359,15608359,15608413,0,0,0,54
10306,15608395,15608395,15608437,0,0,0,42
10298,15606558,15606558,15608452,0,0,0,1894
10307,15608447,15608447,15608594,0,0,0,147
10309,15608510,15608510,15608601,0,0,0,91
10308,15608479,15608479,15608616,0,0,0,137
10310,15608621,15608621,15608695,0,0,0,74
10226,15579184,15579184,15608703,0,0,0,29519
10311,15608627,15608627,15608745,0,0,0,118
10313,15608701,15608701,15608761,0,0,0,60
10315,15608849,15608849,15608939,0,0,0,90
10314,15608833,15608833,15609018,0,0,0,185
10316,15608859,15608859,15609070,0,0,0,211
10317,15609095,15609095,15609165,0,0,0,70
10318,15609137,15609137,15609270,0,0,0,133
10320,15609270,15609270,15609405,0,0,0,135
10321,15609410,15609410,15609521,0,0,0,111
10319,15609139,15609139,15609609,0,0,0,470
10323,15609479,15609479,15609644,0,0,0,165
10228,15583189,15583189,15609649,0,0,0,26460
10324,15609569,15609569,15609754,0,0,0,185
10326,15609721,15609721,15609922,0,0,0,201
10322,15609461,15609461,15609940,0,0,0,479
10327,15609816,15609816,15609966,0,0,0,150
10328,15609850,15609850,15610050,0,0,0,200
10312,15608654,15608654,15610070,0,0,0,1416
10329,15609968,15609968,15610102,0,0,0,134
10332,15610009,15610009,15610188,0,0,0,179
10330,15609974,15609974,15610191,0,0,0,217
10331,15609985,15609985,15610456,0,0,0,471
10335,15610409,15610409,15610547,0,0,0,138
10337,15610593,15610593,15610729,0,0,0,136
10338,15610682,15610682,15610859,0,0,0,177
10341,15610988,15610988,15611077,0,0,0,89
10239,15590666,15590666,15611078,0,0,0,20412
10340,15610986,15610986,15611117,0,0,0,131
10238,15590651,15590651,15611127,0,0,0,20476
10339,15610985,15610985,15611170,0,0,0,185
10345,15611587,15611587,15611733,0,0,0,146
10344,15611358,15611358,15611835,0,0,0,477
10346,15611751,15611751,15611897,0,0,0,146
10347,15611933,15611933,15612146,0,0,0,213
10231,15585206,15585206,15612274,0,0,0,27068
10232,15585539,15585539,15612307,0,0,0,26768
10351,15612317,15612317,15612536,0,0,0,219
10352,15612673,15612673,15612737,0,0,0,64
10353,15612706,15612706,15612848,0,0,0,142
10354,15612720,15612720,15612851,0,0,0,131
10355,15612849,15612849,15613004,0,0,0,155
10356,15612913,15612913,15613015,0,0,0,102
10358,15613028,15613028,15613106,0,0,0,78
10359,15613243,15613243,15613378,0,0,0,135
10360,15613486,15613486,15613589,0,0,0,103
10361,15613592,15613592,15613636,0,0,0,44
10362,15613623,15613623,15613714,0,0,0,91
10363,15613660,15613660,15613782,0,0,0,122
10364,15613708,15613708,15613843,0,0,0,135
10366,15613723,15613723,15613878,0,0,0,155
10357,15612936,15612936,15613917,0,0,0,981
10367,15613829,15613829,15613955,0,0,0,126
10368,15614193,15614193,15614317,0,0,0,124
10365,15613721,15613721,15614400,0,0,0,679
10369,15614426,15614426,15614473,0,0,0,47
10370,15614601,15614601,15614722,0,0,0,121
10372,15614772,15614772,15615014,0,0,0,242
10373,15615022,15615022,15615127,0,0,0,105
10374,15615082,15615082,15615163,0,0,0,81
10375,15615235,15615235,15615464,0,0,0,229
10381,15616062,15616062,15616166,0,0,0,104
10377,15615520,15615520,15616208,0,0,0,688
10378,15615553,15615553,15616483,0,0,0,930
10290,15604889,15604889,15617134,0,0,0,12245
10371,15614734,15614734,15618334,0,0,0,3600
10376,15615373,15615373,15618973,0,0,0,3600
10379,15615600,15615600,15619200,0,0,0,3600
10261,15598637,15598637,15619459,0,0,0,20822
10262,15598669,15598669,15619520,0,0,0,20851
10380,15615926,15615926,15619526,0,0,0,3600
10246,15593257,15593257,15619699,0,0,0,26442
10382,15616363,15616363,15619963,0,0,0,3600
10258,15598091,15598091,15621464,0,0,0,23373
10259,15598141,15598141,15621491,0,0,0,23350
10198,15532497,15532497,15625283,0,0,0,92786
10265,15599176,15599176,15629309,0,0,0,30133
10348,15612163,15612163,15629800,0,0,0,17637
10342,15611042,15611042,15631486,0,0,0,20444
10343,15611083,15611083,15631516,0,0,0,20433
10387,15619463,15619463,15631701,0,0,0,12238
10383,15616454,15616454,15634454,0,0,0,18000
10384,15616465,15616465,15634465,0,0,0,18000
10333,15610105,15610105,15636442,0,0,0,26337
10350,15612238,15612238,15638737,0,0,0,26499
10349,15612217,15612217,15638926,0,0,0,26709
10334,15610151,15610151,15639294,0,0,0,29143
10398,15639255,15639255,15639428,0,0,0,173
10385,15619402,15619402,15640250,0,0,0,20848
10386,15619433,15619433,15640281,0,0,0,20848
10389,15621392,15621392,15644540,0,0,0,23148
10390,15621449,15621449,15644628,0,0,0,23179
10388,15619652,15619652,15645824,0,0,0,26172
10137,15498422,15498422,15648992,0,0,0,150570
10393,15631413,15631413,15652019,0,0,0,20606
10394,15631446,15631446,15652073,0,0,0,20627
10392,15629267,15629267,15657553,0,0,0,28286
10273,15601780,15601780,15660356,0,0,0,58576
10400,15640183,15640183,15661199,0,0,0,21016
10401,15640208,15640208,15661231,0,0,0,21023
10192,15532149,15532149,15661260,0,0,0,129111
10197,15532447,15532447,15661527,0,0,0,129080
10194,15532314,15532314,15661761,0,0,0,129447
10195,15532390,15532390,15661907,0,0,0,129517
10395,15636406,15636406,15662877,0,0,0,26471
10396,15638695,15638695,15665403,0,0,0,26708
10397,15638846,15638846,15665863,0,0,0,27017
10413,15666657,15666657,15666877,0,0,0,220
10414,15666756,15666756,15666933,0,0,0,177
10402,15644503,15644503,15667601,0,0,0,23098
10200,15533042,15533042,15667699,0,0,0,134657
10403,15644588,15644588,15667987,0,0,0,23399
10416,15667943,15667943,15668158,0,0,0,215
10418,15668075,15668075,15668266,0,0,0,191
10190,15532086,15532086,15668309,0,0,0,136223
10419,15668309,15668309,15668528,0,0,0,219
10267,15599531,15599531,15668759,0,0,0,69228
10268,15599539,15599539,15668778,0,0,0,69239
10269,15599546,15599546,15668785,0,0,0,69239
10270,15599562,15599562,15668801,0,0,0,69239
10399,15639386,15639386,15669072,0,0,0,29686
10426,15669914,15669914,15670131,0,0,0,217
10427,15670130,15670130,15670343,0,0,0,213
10429,15671561,15671561,15671727,0,0,0,166
10404,15645787,15645787,15672365,0,0,0,26578
10405,15651978,15651978,15672462,0,0,0,20484
10406,15652027,15652027,15672528,0,0,0,20501
10435,15673454,15673454,15673591,0,0,0,137
10436,15673530,15673530,15673918,0,0,0,388
10437,15673713,15673713,15674149,0,0,0,436
10438,15674735,15674735,15674933,0,0,0,198
10439,15676469,15676469,15676728,0,0,0,259
10428,15670993,15670993,15677214,0,0,0,6221
10434,15673409,15673409,15677248,0,0,0,3839
10240,15590672,15590672,15677279,0,0,0,86607
10256,15597843,15597843,15678008,0,0,0,80165
10445,15677839,15677839,15678082,0,0,0,243
10446,15677921,15677921,15678165,0,0,0,244
10440,15677174,15677174,15679984,0,0,0,2810
10442,15677206,15677206,15679997,0,0,0,2791
10443,15677280,15677280,15680016,0,0,0,2736
10444,15677310,15677310,15680016,0,0,0,2706
10408,15661133,15661133,15682076,0,0,0,20943
10409,15661157,15661157,15682114,0,0,0,20957
10454,15682264,15682264,15682482,0,0,0,218
10455,15682313,15682313,15682509,0,0,0,196
10460,15682673,15682673,15682870,0,0,0,197
10421,15668722,15668722,15682882,0,0,0,14160
10423,15668743,15668743,15682892,0,0,0,14149
10422,15668733,15668733,15682893,0,0,0,14160
10424,15668755,15668755,15682904,0,0,0,14149
10461,15682913,15682913,15683104,0,0,0,191
10466,15683281,15683281,15683448,0,0,0,167
10467,15684293,15684293,15684486,0,0,0,193
10468,15685036,15685036,15685225,0,0,0,189
10420,15668370,15668370,15685528,0,0,0,17158
10407,15657521,15657521,15685663,0,0,0,28142
10469,15685616,15685616,15685821,0,0,0,205
10471,15685904,15685904,15686120,0,0,0,216
10430,15671944,15671944,15686946,0,0,0,15002
10472,15688379,15688379,15688463,0,0,0,84
10410,15662805,15662805,15689019,0,0,0,26214
10218,15566303,15566303,15689253,0,0,0,122950
10474,15689409,15689409,15689534,0,0,0,125
10475,15689734,15689734,15689838,0,0,0,104
10476,15689990,15689990,15690136,0,0,0,146
10477,15690241,15690241,15690345,0,0,0,104
10478,15690387,15690387,15690516,0,0,0,129
10479,15690401,15690401,15690530,0,0,0,129
10480,15690518,15690518,15690660,0,0,0,142
10481,15690626,15690626,15690767,0,0,0,141
10482,15690662,15690662,15690786,0,0,0,124
10483,15690785,15690785,15690909,0,0,0,124
10415,15667562,15667562,15691028,0,0,0,23466
10485,15690971,15690971,15691100,0,0,0,129
10486,15691105,15691105,15691246,0,0,0,141
10417,15667944,15667944,15691370,0,0,0,23426
10487,15691312,15691312,15691495,0,0,0,183
10411,15665361,15665361,15692081,0,0,0,26720
10412,15665796,15665796,15692549,0,0,0,26753
10456,15682354,15682354,15692748,0,0,0,10394
10448,15680756,15680756,15692908,0,0,0,12152
10449,15680864,15680864,15692923,0,0,0,12059
10432,15672420,15672420,15692926,0,0,0,20506
10450,15680905,15680905,15692944,0,0,0,12039
10451,15680949,15680949,15692946,0,0,0,11997
10433,15672490,15672490,15692969,0,0,0,20479
10457,15682359,15682359,15692976,0,0,0,10617
10458,15682364,15682364,15692981,0,0,0,10617
10459,15682367,15682367,15692995,0,0,0,10628
10462,15682935,15682935,15693008,0,0,0,10073
10463,15682938,15682938,15693033,0,0,0,10095
10464,15682944,15682944,15693050,0,0,0,10106
10465,15682947,15682947,15693064,0,0,0,10117
10499,15692948,15692948,15693089,0,0,0,141
10325,15609572,15609572,15694459,0,0,0,84887
10510,15695633,15695633,15695810,0,0,0,177
10511,15696607,15696607,15696784,0,0,0,177
10447,15679558,15679558,15697558,0,0,0,18000
10512,15697323,15697323,15698012,0,0,0,689
10513,15698034,15698034,15698123,0,0,0,89
10281,15602741,15602741,15698208,0,0,0,95467
10282,15602757,15602757,15698213,0,0,0,95456
10280,15602725,15602725,15698214,0,0,0,95489
10283,15602792,15602792,15698219,0,0,0,95427
10431,15672293,15672293,15698805,0,0,0,26512
10518,15698675,15698675,15698908,0,0,0,233
10425,15669025,15669025,15699080,0,0,0,30055
10521,15699558,15699558,15699693,0,0,0,135
10523,15700073,15700073,15700190,0,0,0,117
10524,15700107,15700107,15700667,0,0,0,560
10525,15700571,15700571,15700737,0,0,0,166
10527,15700866,15700866,15700926,0,0,0,60
10529,15701367,15701367,15701427,0,0,0,60
10453,15682041,15682041,15702930,0,0,0,20889
10452,15682007,15682007,15702931,0,0,0,20924
10491,15692712,15692712,15704324,0,0,0,11612
10505,15693020,15693020,15704668,0,0,0,11648
10493,15692870,15692870,15704673,0,0,0,11803
10497,15692906,15692906,15704697,0,0,0,11791
10495,15692897,15692897,15704710,0,0,0,11813
10500,15692948,15692948,15704737,0,0,0,11789
10503,15692994,15692994,15704801,0,0,0,11807
10498,15692931,15692931,15704860,0,0,0,11929
10504,15693008,15693008,15704860,0,0,0,11852
10501,15692960,15692960,15704910,0,0,0,11950
10494,15692885,15692885,15704943,0,0,0,12058
10502,15692973,15692973,15705109,0,0,0,12136
10506,15694336,15694336,15706248,0,0,0,11912
10508,15694350,15694350,15706251,0,0,0,11901
10509,15694355,15694355,15706349,0,0,0,11994
10507,15694340,15694340,15706387,0,0,0,12047
10528,15701185,15701185,15707922,0,0,0,6737
10295,15605821,15605821,15708814,0,0,0,102993
10492,15692852,15692852,15713550,0,0,0,20698
10496,15692904,15692904,15713570,0,0,0,20666
10470,15685753,15685753,15713702,0,0,0,27949
10536,15713659,15713659,15713827,0,0,0,168
10484,15690949,15690949,15714466,0,0,0,23517
10488,15691331,15691331,15714844,0,0,0,23513
10473,15688977,15688977,15715672,0,0,0,26695
10391,15625218,15625218,15718951,0,0,0,93733
10489,15692039,15692039,15718989,0,0,0,26950
10490,15692508,15692508,15719237,0,0,0,26729
10531,15702889,15702889,15724000,0,0,0,21111
10530,15702883,15702883,15724061,0,0,0,21178
10519,15698768,15698768,15725118,0,0,0,26350
10520,15699041,15699041,15727411,0,0,0,28370
10551,15727371,15727371,15727544,0,0,0,173
10526,15700860,15700860,15733015,0,0,0,32155
10534,15713478,15713478,15734052,0,0,0,20574
10535,15713508,15713508,15734089,0,0,0,20581
10533,15708995,15708995,15738526,0,0,0,29531
10538,15714425,15714425,15738610,0,0,0,24185
10539,15714761,15714761,15738977,0,0,0,24216
10540,15715626,15715626,15741942,0,0,0,26316
10537,15713785,15713785,15743226,0,0,0,29441
10548,15723931,15723931,15744845,0,0,0,20914
10549,15723970,15723970,15744895,0,0,0,20925
10544,15718916,15718916,15745340,0,0,0,26424
10545,15719194,15719194,15745956,0,0,0,26762
10532,15707817,15707817,15748316,0,0,0,40499
10542,15718711,15718711,15751018,0,0,0,32307
10550,15725074,15725074,15751179,0,0,0,26105
10563,15751136,15751136,15751304,0,0,0,168
10564,15751264,15751264,15751432,0,0,0,168
10541,15718448,15718448,15752250,0,0,0,33802
10566,15752358,15752358,15752418,0,0,0,60
10567,15752540,15752540,15752600,0,0,0,60
10568,15752997,15752997,15753057,0,0,0,60
10569,15753260,15753260,15753320,0,0,0,60
10570,15753382,15753382,15753575,0,0,0,193
10572,15753557,15753557,15754013,0,0,0,456
10554,15734003,15734003,15754424,0,0,0,20421
10553,15733995,15733995,15754459,0,0,0,20464
10552,15727501,15727501,15755807,0,0,0,28306
10580,15761112,15761112,15761251,0,0,0,139
10582,15761183,15761183,15761367,0,0,0,184
10585,15761597,15761597,15761686,0,0,0,89
10592,15761892,15761892,15761972,0,0,0,80
10599,15762031,15762031,15762136,0,0,0,105
10600,15762088,15762088,15762184,0,0,0,96
10583,15761209,15761209,15762189,0,0,0,980
10601,15762135,15762135,15762216,0,0,0,81
10603,15762499,15762499,15762579,0,0,0,80
10604,15762580,15762580,15762670,0,0,0,90
10555,15738571,15738571,15762747,0,0,0,24176
10556,15738904,15738904,15763056,0,0,0,24152
10607,15762837,15762837,15763437,0,0,0,600
10605,15762716,15762716,15763993,0,0,0,1277
10441,15677203,15677203,15764154,0,0,0,86951
10611,15764890,15764890,15764979,0,0,0,89
10612,15765424,15765424,15765484,0,0,0,60
10559,15744810,15744810,15765840,0,0,0,21030
10560,15744860,15744860,15765869,0,0,0,21009
10613,15765616,15765616,15766216,0,0,0,600
10618,15767374,15767374,15767434,0,0,0,60
10616,15767310,15767310,15767494,0,0,0,184
10619,15767668,15767668,15767854,0,0,0,186
10617,15767334,15767334,15768278,0,0,0,944
10557,15741902,15741902,15768415,0,0,0,26513
10623,15768386,15768386,15768446,0,0,0,60
10622,15768362,15768362,15768521,0,0,0,159
10621,15768337,15768337,15768540,0,0,0,203
10624,15768478,15768478,15768696,0,0,0,218
10631,15770048,15770048,15770126,0,0,0,78
10575,15755417,15755417,15770218,0,0,0,14801
10632,15770213,15770213,15770302,0,0,0,89
10634,15770400,15770400,15770537,0,0,0,137
10635,15770632,15770632,15770711,0,0,0,79
10630,15769814,15769814,15770724,0,0,0,910
10638,15771608,15771608,15771720,0,0,0,112
10639,15771920,15771920,15771980,0,0,0,60
10640,15772107,15772107,15772166,0,0,0,59
10561,15745296,15745296,15772190,0,0,0,26894
10642,15772176,15772176,15772236,0,0,0,60
10643,15772188,15772188,15772266,0,0,0,78
10644,15772383,15772383,15772443,0,0,0,60
10645,15772479,15772479,15772564,0,0,0,85
10646,15772552,15772552,15772612,0,0,0,60
10562,15745883,15745883,15772938,0,0,0,27055
10558,15743145,15743145,15772988,0,0,0,29843
10649,15772955,15772955,15773130,0,0,0,175
10647,15772598,15772598,15773198,0,0,0,600
10595,15761909,15761909,15773303,0,0,0,11394
10650,15773129,15773129,15773337,0,0,0,208
10586,15761756,15761756,15773347,0,0,0,11591
10579,15761095,15761095,15773451,0,0,0,12356
10590,15761883,15761883,15773666,0,0,0,11783
10587,15761760,15761760,15773707,0,0,0,11947
10581,15761162,15761162,15773708,0,0,0,12546
10589,15761774,15761774,15773847,0,0,0,12073
10584,15761328,15761328,15773863,0,0,0,12535
10597,15761918,15761918,15773879,0,0,0,11961
10588,15761765,15761765,15773902,0,0,0,12137
10593,15761900,15761900,15773926,0,0,0,12026
10598,15761922,15761922,15773926,0,0,0,12004
10625,15768595,15768595,15773927,0,0,0,5332
10591,15761886,15761886,15773928,0,0,0,12042
10594,15761903,15761903,15773971,0,0,0,12068
10596,15761913,15761913,15774008,0,0,0,12095
10654,15773999,15773999,15774150,0,0,0,151
10602,15762219,15762219,15774408,0,0,0,12189
10577,15755753,15755753,15774448,0,0,0,18695
10656,15774337,15774337,15774468,0,0,0,131
10657,15774507,15774507,15774638,0,0,0,131
10658,15774636,15774636,15774795,0,0,0,159
10573,15754353,15754353,15775036,0,0,0,20683
10659,15774926,15774926,15775069,0,0,0,143
10574,15754386,15754386,15775326,0,0,0,20940
10663,15775035,15775035,15775635,0,0,0,600
10673,15775635,15775635,15775706,0,0,0,71
10672,15775595,15775595,15775748,0,0,0,153
10674,15775821,15775821,15775903,0,0,0,82
10671,15775298,15775298,15776501,0,0,0,1203
10675,15775916,15775916,15776516,0,0,0,600
10565,15751390,15751390,15777724,0,0,0,26334
10677,15777678,15777678,15777738,0,0,0,60
10655,15774151,15774151,15777852,0,0,0,3701
10678,15777815,15777815,15778415,0,0,0,600
10669,15775210,15775210,15781450,0,0,0,6240
10682,15782274,15782274,15782359,0,0,0,85
10681,15782132,15782132,15782484,0,0,0,352
10683,15782385,15782385,15782759,0,0,0,374
10686,15782772,15782772,15782820,0,0,0,48
10336,15610567,15610567,15783367,0,0,0,172800
10685,15782681,15782681,15783505,0,0,0,824
10576,15755728,15755728,15783712,0,0,0,27984
10684,15782392,15782392,15783871,0,0,0,1479
10679,15781111,15781111,15783990,0,0,0,2879
10688,15783196,15783196,15784046,0,0,0,850
10687,15783054,15783054,15784082,0,0,0,1028
10609,15763979,15763979,15784220,0,0,0,20241
10696,15784104,15784104,15784264,0,0,0,160
10695,15784092,15784092,15784721,0,0,0,629
10693,15783739,15783739,15784828,0,0,0,1089
10701,15784728,15784728,15784930,0,0,0,202
10698,15784166,15784166,15785107,0,0,0,941
10662,15775024,15775024,15785279,0,0,0,10255
10652,15773671,15773671,15785480,0,0,0,11809
10653,15773675,15773675,15785484,0,0,0,11809
10702,15785570,15785570,15785719,0,0,0,149
10703,15785649,15785649,15785820,0,0,0,171
10700,15784602,15784602,15786187,0,0,0,1585
10637,15771192,15771192,15786190,0,0,0,14998
10705,15786017,15786017,15786364,0,0,0,347
10706,15786249,15786249,15786414,0,0,0,165
10636,15771132,15771132,15786445,0,0,0,15313
10704,15785859,15785859,15786462,0,0,0,603
10606,15762716,15762716,15786663,0,0,0,23947
10666,15775105,15775105,15786703,0,0,0,11598
10608,15763022,15763022,15786854,0,0,0,23832
10699,15784300,15784300,15786863,0,0,0,2563
10615,15765798,15765798,15786878,0,0,0,21080
10664,15775056,15775056,15786882,0,0,0,11826
10614,15765787,15765787,15786936,0,0,0,21149
10661,15775000,15775000,15786989,0,0,0,11989
10667,15775129,15775129,15786989,0,0,0,11860
10668,15775193,15775193,15787137,0,0,0,11944
10707,15786483,15786483,15787422,0,0,0,939
10665,15775080,15775080,15787680,0,0,0,12600
10517,15698306,15698306,15788061,0,0,0,89755
10716,15788366,15788366,15788484,0,0,0,118
10722,15788610,15788610,15789197,0,0,0,587
10731,15789122,15789122,15789345,0,0,0,223
10728,15788748,15788748,15789357,0,0,0,609
10732,15789365,15789365,15789479,0,0,0,114
10726,15788709,15788709,15789786,0,0,0,1077
10730,15788840,15788840,15789928,0,0,0,1088
10727,15788735,15788735,15790622,0,0,0,1887
10729,15788815,15788815,15790714,0,0,0,1899
10719,15788506,15788506,15790786,0,0,0,2280
10723,15788618,15788618,15790876,0,0,0,2258
10725,15788674,15788674,15791268,0,0,0,2594
10724,15788645,15788645,15791319,0,0,0,2674
10629,15769228,15769228,15791609,0,0,0,22381
10692,15783697,15783697,15791929,0,0,0,8232
10689,15783576,15783576,15792330,0,0,0,8754
10690,15783649,15783649,15792560,0,0,0,8911
10733,15789556,15789556,15792756,0,0,0,3200
10721,15788585,15788585,15792887,0,0,0,4302
10718,15788481,15788481,15793076,0,0,0,4595
10680,15781419,15781419,15793125,0,0,0,11706
10717,15788466,15788466,15793377,0,0,0,4911
10720,15788555,15788555,15793421,0,0,0,4866
10736,15792729,15792729,15793422,0,0,0,693
10737,15792761,15792761,15793442,0,0,0,681
10739,15792847,15792847,15793516,0,0,0,669
10734,15789767,15789767,15793573,0,0,0,3806
10738,15792792,15792792,15793592,0,0,0,800
10742,15793697,15793697,15793775,0,0,0,78
10626,15768615,15768615,15795322,0,0,0,26707
10547,15722819,15722819,15795442,0,0,0,72623
10660,15774983,15774983,15795473,0,0,0,20490
10735,15790628,15790628,15795508,0,0,0,4880
10670,15775251,15775251,15795688,0,0,0,20437
10620,15768323,15768323,15795781,0,0,0,27458
10641,15772116,15772116,15798979,0,0,0,26863
10648,15772856,15772856,15799433,0,0,0,26577
10514,15698226,15698226,15799465,0,0,0,101239
10628,15769207,15769207,15799521,0,0,0,30314
10516,15698285,15698285,15799605,0,0,0,101320
10633,15770382,15770382,15800093,0,0,0,29711
10743,15793739,15793739,15800304,0,0,0,6565
10744,15793774,15793774,15800406,0,0,0,6632
10651,15773434,15773434,15802116,0,0,0,28682
10745,15793906,15793906,15803511,0,0,0,9605
10740,15793050,15793050,15803722,0,0,0,10672
10741,15793083,15793083,15803797,0,0,0,10714
10746,15794006,15794006,15803838,0,0,0,9832
10627,15769194,15769194,15804231,0,0,0,35037
10676,15777668,15777668,15804334,0,0,0,26666
10515,15698265,15698265,15805364,0,0,0,107099
10711,15786824,15786824,15805517,0,0,0,18693
10714,15787511,15787511,15806126,0,0,0,18615
10715,15787710,15787710,15806174,0,0,0,18464
10713,15787448,15787448,15806431,0,0,0,18983
10546,15722782,15722782,15807065,0,0,0,84283
10710,15786817,15786817,15807668,0,0,0,20851
10712,15786841,15786841,15807711,0,0,0,20870
10708,15786590,15786590,15810633,0,0,0,24043
10709,15786784,15786784,15810852,0,0,0,24068
10764,15811245,15811245,15811318,0,0,0,73
10543,15718887,15718887,15812086,0,0,0,93199
10752,15800799,15800799,15812538,0,0,0,11739
10753,15800898,15800898,15812725,0,0,0,11827
10691,15783662,15783662,15813069,0,0,0,29407
10754,15801013,15801013,15813283,0,0,0,12270
10748,15795400,15795400,15816020,0,0,0,20620
10749,15795654,15795654,15816196,0,0,0,20542
10747,15795247,15795247,15821613,0,0,0,26366
10756,15803691,15803691,15822240,0,0,0,18549
10578,15758972,15758972,15823334,0,0,0,64362
10757,15803753,15803753,15823744,0,0,0,19991
10750,15798982,15798982,15825737,0,0,0,26755
10751,15799452,15799452,15826166,0,0,0,26714
10760,15807625,15807625,15828564,0,0,0,20939
10759,15807615,15807615,15828691,0,0,0,21076
10762,15810769,15810769,15829877,0,0,0,19108
10765,15811394,15811394,15830075,0,0,0,18681
10767,15811638,15811638,15830153,0,0,0,18515
10766,15811570,15811570,15830228,0,0,0,18658
10758,15804253,15804253,15830711,0,0,0,26458
10777,15830646,15830646,15830850,0,0,0,204
10755,15802077,15802077,15831228,0,0,0,29151
10761,15810589,15810589,15833534,0,0,0,22945
10571,15753431,15753431,15833569,0,0,0,80138
10763,15810807,15810807,15833803,0,0,0,22996
10770,15815934,15815934,15836347,0,0,0,20413
10771,15816154,15816154,15836595,0,0,0,20441
10784,15837214,15837214,15837349,0,0,0,135
10785,15837747,15837747,15838469,0,0,0,722
10790,15839749,15839749,15839838,0,0,0,89
10792,15840066,15840066,15840193,0,0,0,127
10795,15840367,15840367,15840467,0,0,0,100
10797,15840978,15840978,15841076,0,0,0,98
10798,15841042,15841042,15841141,0,0,0,99
10799,15841099,15841099,15841159,0,0,0,60
10800,15841320,15841320,15841489,0,0,0,169
10801,15841535,15841535,15841670,0,0,0,135
10803,15841794,15841794,15841841,0,0,0,47
10791,15839899,15839899,15842013,0,0,0,2114
10796,15840417,15840417,15842372,0,0,0,1955
10804,15841800,15841800,15842407,0,0,0,607
10769,15813047,15813047,15842532,0,0,0,29485
10806,15842468,15842468,15842678,0,0,0,210
10805,15842275,15842275,15842951,0,0,0,676
10807,15842529,15842529,15843077,0,0,0,548
10793,15840313,15840313,15843096,0,0,0,2783
10794,15840345,15840345,15843099,0,0,0,2754
10802,15841699,15841699,15843100,0,0,0,1401
10811,15843146,15843146,15843227,0,0,0,81
10820,15843393,15843393,15843536,0,0,0,143
10829,15843655,15843655,15843731,0,0,0,76
10831,15843696,15843696,15843888,0,0,0,192
10832,15843926,15843926,15843985,0,0,0,59
10834,15844106,15844106,15844213,0,0,0,107
10835,15844280,15844280,15844369,0,0,0,89
10833,15843990,15843990,15844435,0,0,0,445
10830,15843683,15843683,15844551,0,0,0,868
10836,15844461,15844461,15844683,0,0,0,222
10837,15844740,15844740,15844961,0,0,0,221
10839,15845134,15845134,15845211,0,0,0,77
10838,15844977,15844977,15845221,0,0,0,244
10840,15845210,15845210,15845282,0,0,0,72
10841,15845283,15845283,15845336,0,0,0,53
10842,15845289,15845289,15845372,0,0,0,83
10843,15845424,15845424,15845513,0,0,0,89
10814,15843222,15843222,15845889,0,0,0,2667
10810,15843036,15843036,15845985,0,0,0,2949
10813,15843189,15843189,15845985,0,0,0,2796
10812,15843158,15843158,15846007,0,0,0,2849
10816,15843289,15843289,15846051,0,0,0,2762
10817,15843325,15843325,15846056,0,0,0,2731
10819,15843363,15843363,15846061,0,0,0,2698
10818,15843343,15843343,15846079,0,0,0,2736
10821,15843397,15843397,15846111,0,0,0,2714
10822,15843425,15843425,15846129,0,0,0,2704
10823,15843440,15843440,15846139,0,0,0,2699
10824,15843460,15843460,15846148,0,0,0,2688
10825,15843506,15843506,15846163,0,0,0,2657
10826,15843558,15843558,15846173,0,0,0,2615
10827,15843571,15843571,15846186,0,0,0,2615
10828,15843593,15843593,15846197,0,0,0,2604
10809,15843009,15843009,15846239,0,0,0,3230
10815,15843268,15843268,15846306,0,0,0,3038
10860,15846597,15846597,15846719,0,0,0,122
10861,15846929,15846929,15847056,0,0,0,127
10862,15847006,15847006,15847095,0,0,0,89
10865,15847739,15847739,15847833,0,0,0,94
10772,15821559,15821559,15848020,0,0,0,26461
10867,15848042,15848042,15848116,0,0,0,74
10864,15847659,15847659,15849221,0,0,0,1562
10775,15828523,15828523,15849383,0,0,0,20860
10776,15828649,15828649,15849498,0,0,0,20849
10870,15849919,15849919,15850034,0,0,0,115
10871,15850023,15850023,15850123,0,0,0,100
10872,15850169,15850169,15850307,0,0,0,138
10873,15850254,15850254,15850450,0,0,0,196
10874,15850482,15850482,15850571,0,0,0,89
10610,15764073,15764073,15850884,0,0,0,86811
10877,15851144,15851144,15851223,0,0,0,79
10878,15851471,15851471,15851553,0,0,0,82
10879,15851817,15851817,15851895,0,0,0,78
10880,15852182,15852182,15852260,0,0,0,78
10881,15852284,15852284,15852373,0,0,0,89
10773,15825659,15825659,15852461,0,0,0,26802
10882,15852377,15852377,15852634,0,0,0,257
10884,15852553,15852553,15852860,0,0,0,307
10774,15826129,15826129,15852914,0,0,0,26785
10875,15850636,15850636,15853672,0,0,0,3036
10859,15846152,15846152,15853886,0,0,0,7734
10847,15845991,15845991,15853915,0,0,0,7924
10886,15854486,15854486,15854643,0,0,0,157
10887,15854611,15854611,15854764,0,0,0,153
10888,15854701,15854701,15854890,0,0,0,189
10889,15854826,15854826,15854970,0,0,0,144
10846,15845981,15845981,15855304,0,0,0,9323
10890,15855246,15855246,15855380,0,0,0,134
10844,15845958,15845958,15855456,0,0,0,9498
10845,15845971,15845971,15855484,0,0,0,9513
10849,15846022,15846022,15855589,0,0,0,9567
10858,15846142,15846142,15855616,0,0,0,9474
10850,15846038,15846038,15855627,0,0,0,9589
10851,15846065,15846065,15855640,0,0,0,9575
10852,15846081,15846081,15855703,0,0,0,9622
10853,15846093,15846093,15855742,0,0,0,9649
10854,15846105,15846105,15855776,0,0,0,9671
10855,15846115,15846115,15855808,0,0,0,9693
10856,15846123,15846123,15855830,0,0,0,9707
10857,15846133,15846133,15855868,0,0,0,9735
10901,15855734,15855734,15855875,0,0,0,141
10906,15855838,15855838,15855953,0,0,0,115
10780,15833488,15833488,15856022,0,0,0,22534
10910,15856052,15856052,15856172,0,0,0,120
10848,15846012,15846012,15856227,0,0,0,10215
10911,15856168,15856168,15856293,0,0,0,125
10781,15833733,15833733,15856334,0,0,0,22601
10913,15856383,15856383,15856528,0,0,0,145
10916,15856504,15856504,15856621,0,0,0,117
10782,15836310,15836310,15856701,0,0,0,20391
10918,15856634,15856634,15856743,0,0,0,109
10783,15836547,15836547,15856937,0,0,0,20390
10920,15856992,15856992,15857130,0,0,0,138
10921,15857077,15857077,15857225,0,0,0,148
10922,15857171,15857171,15857271,0,0,0,100
10778,15830786,15830786,15857393,0,0,0,26607
10924,15857383,15857383,15857502,0,0,0,119
10923,15857317,15857317,15857524,0,0,0,207
10788,15839176,15839176,15857825,0,0,0,18649
10926,15857829,15857829,15857983,0,0,0,154
10787,15839171,15839171,15857985,0,0,0,18814
10927,15857933,15857933,15858086,0,0,0,153
10928,15858047,15858047,15858162,0,0,0,115
10789,15839179,15839179,15858201,0,0,0,19022
10786,15839167,15839167,15858350,0,0,0,19183
10929,15858271,15858271,15858376,0,0,0,105
10931,15859523,15859523,15859649,0,0,0,126
10930,15859517,15859517,15859655,0,0,0,138
10779,15831190,15831190,15860497,0,0,0,29307
10932,15860441,15860441,15860533,0,0,0,92
10697,15784135,15784135,15860539,0,0,0,76404
10934,15860975,15860975,15861173,0,0,0,198
10935,15861194,15861194,15862172,0,0,0,978
10936,15862380,15862380,15862527,0,0,0,147
10938,15862999,15862999,15863059,0,0,0,60
10940,15863151,15863151,15863211,0,0,0,60
10941,15863187,15863187,15863247,0,0,0,60
10942,15863216,15863216,15863276,0,0,0,60
10943,15863323,15863323,15863445,0,0,0,122
10863,15847583,15847583,15863482,0,0,0,15899
10944,15863434,15863434,15863569,0,0,0,135
10939,15863036,15863036,15863615,0,0,0,579
10946,15864113,15864113,15864202,0,0,0,89
10948,15864335,15864335,15864422,0,0,0,87
10949,15864380,15864380,15864460,0,0,0,80
10950,15864421,15864421,15864493,0,0,0,72
10951,15864848,15864848,15864953,0,0,0,105
10952,15864998,15864998,15865079,0,0,0,81
10954,15865124,15865124,15865211,0,0,0,87
10953,15865082,15865082,15865227,0,0,0,145
10955,15865211,15865211,15865263,0,0,0,52
10956,15865269,15865269,15865321,0,0,0,52
10958,15865362,15865362,15865443,0,0,0,81
10957,15865354,15865354,15865495,0,0,0,141
10959,15865447,15865447,15865519,0,0,0,72
10960,15865519,15865519,15865725,0,0,0,206
10961,15865727,15865727,15865809,0,0,0,82
10962,15865881,15865881,15865950,0,0,0,69
10963,15865920,15865920,15866018,0,0,0,98
10964,15865955,15865955,15866024,0,0,0,69
10966,15866063,15866063,15866110,0,0,0,47
10965,15866043,15866043,15866126,0,0,0,83
10967,15866104,15866104,15866178,0,0,0,74
10969,15866197,15866197,15866286,0,0,0,89
10968,15866166,15866166,15866700,0,0,0,534
10971,15866660,15866660,15866776,0,0,0,116
10972,15866806,15866806,15866922,0,0,0,116
10973,15867039,15867039,15867144,0,0,0,105
10947,15864226,15864226,15867376,0,0,0,3150
10979,15867978,15867978,15868047,0,0,0,69
10978,15867965,15867965,15868068,0,0,0,103
10984,15868254,15868254,15868319,0,0,0,65
10945,15863694,15863694,15868604,0,0,0,4910
10970,15866646,15866646,15868611,0,0,0,1965
10974,15867115,15867115,15869074,0,0,0,1959
10999,15869074,15869074,15869206,0,0,0,132
10975,15867441,15867441,15869367,0,0,0,1926
11000,15869340,15869340,15869477,0,0,0,137
10976,15867573,15867573,15869518,0,0,0,1945
10986,15868362,15868362,15869549,0,0,0,1187
10977,15867699,15867699,15869616,0,0,0,1917
10997,15868978,15868978,15869730,0,0,0,752
11010,15869849,15869849,15869945,0,0,0,96
10981,15868147,15868147,15870092,0,0,0,1945
10868,15849339,15849339,15870143,0,0,0,20804
10694,15783789,15783789,15870189,0,0,0,86400
10985,15868275,15868275,15870195,0,0,0,1920
10869,15849426,15849426,15870230,0,0,0,20804
10987,15868393,15868393,15870289,0,0,0,1896
11003,15869720,15869720,15870322,0,0,0,602
10988,15868499,15868499,15870428,0,0,0,1929
11004,15869816,15869816,15870462,0,0,0,646
11008,15869844,15869844,15870464,0,0,0,620
11006,15869822,15869822,15870490,0,0,0,668
11007,15869839,15869839,15870516,0,0,0,677
10989,15868620,15868620,15870554,0,0,0,1934
10990,15868730,15868730,15870698,0,0,0,1968
10991,15868842,15868842,15870774,0,0,0,1932
10996,15868948,15868948,15870846,0,0,0,1898
11005,15869819,15869819,15870883,0,0,0,1064
11009,15869846,15869846,15870884,0,0,0,1038
11011,15869870,15869870,15870919,0,0,0,1049
10998,15869043,15869043,15870962,0,0,0,1919
10894,15855494,15855494,15871099,0,0,0,15605
11013,15870437,15870437,15871113,0,0,0,676
10908,15855905,15855905,15871156,0,0,0,15251
10903,15855767,15855767,15871261,0,0,0,15494
10898,15855611,15855611,15871281,0,0,0,15670
10808,15842607,15842607,15871477,0,0,0,28870
11017,15871549,15871549,15871620,0,0,0,71
11019,15871642,15871642,15871772,0,0,0,130
11012,15869875,15869875,15872164,0,0,0,2289
10522,15699928,15699928,15872728,0,0,0,172800
10915,15856464,15856464,15872925,0,0,0,16461
11023,15874062,15874062,15874122,0,0,0,60
10866,15847952,15847952,15874363,0,0,0,26411
10937,15862900,15862900,15874546,0,0,0,11646
11024,15874529,15874529,15874589,0,0,0,60
10893,15855475,15855475,15874700,0,0,0,19225
11025,15874707,15874707,15874767,0,0,0,60
11026,15875016,15875016,15875076,0,0,0,60
11027,15875105,15875105,15875165,0,0,0,60
10907,15855867,15855867,15875659,0,0,0,19792
10917,15856616,15856616,15877112,0,0,0,20496
10919,15856892,15856892,15877321,0,0,0,20429
11030,15877191,15877191,15877364,0,0,0,173
11014,15870486,15870486,15878347,0,0,0,7861
10883,15852396,15852396,15879061,0,0,0,26665
10885,15852872,15852872,15879510,0,0,0,26638
10909,15855946,15855946,15879812,0,0,0,23866
10912,15856265,15856265,15880160,0,0,0,23895
11021,15873006,15873006,15880308,0,0,0,7302
11022,15873087,15873087,15881621,0,0,0,8534
11020,15871966,15871966,15883232,0,0,0,11266
10925,15857456,15857456,15883883,0,0,0,26427
11037,15883807,15883807,15883974,0,0,0,167
11038,15883935,15883935,15884101,0,0,0,166
11039,15884069,15884069,15884246,0,0,0,177
10897,15855581,15855581,15885960,0,0,0,30379
10905,15855828,15855828,15886675,0,0,0,30847
10995,15868862,15868862,15887409,0,0,0,18547
10994,15868859,15868859,15887464,0,0,0,18605
10992,15868852,15868852,15887578,0,0,0,18726
10993,15868856,15868856,15887582,0,0,0,18726
10933,15860444,15860444,15889814,0,0,0,29370
11041,15889774,15889774,15889950,0,0,0,176
10982,15868217,15868217,15891188,0,0,0,22971
11001,15869508,15869508,15891544,0,0,0,22036
11002,15869671,15869671,15891930,0,0,0,22259
11016,15871548,15871548,15892358,0,0,0,20810
11018,15871565,15871565,15892364,0,0,0,20799
11029,15877074,15877074,15897443,0,0,0,20369
11031,15877263,15877263,15897694,0,0,0,20431
10891,15855416,15855416,15898616,0,0,0,43200
10892,15855447,15855447,15898647,0,0,0,43200
10895,15855529,15855529,15898729,0,0,0,43200
10896,15855553,15855553,15898753,0,0,0,43200
10899,15855668,15855668,15898868,0,0,0,43200
10900,15855708,15855708,15898908,0,0,0,43200
10902,15855742,15855742,15898942,0,0,0,43200
10904,15855793,15855793,15898993,0,0,0,43200
11015,15871398,15871398,15900490,0,0,0,29092
11047,15900448,15900448,15900652,0,0,0,204
11048,15900579,15900579,15900756,0,0,0,177
11049,15900710,15900710,15900934,0,0,0,224
11032,15877325,15877325,15903369,0,0,0,26044
11035,15879774,15879774,15903635,0,0,0,23861
11036,15880150,15880150,15904021,0,0,0,23871
10768,15812016,15812016,15904650,0,0,0,92634
11033,15878988,15878988,15905875,0,0,0,26887
11034,15879467,15879467,15906416,0,0,0,26949
11040,15884194,15884194,15910602,0,0,0,26408
11043,15892324,15892324,15913076,0,0,0,20752
11044,15892324,15892324,15913149,0,0,0,20825
10914,15856428,15856428,15916808,0,0,0,60380
11045,15897403,15897403,15917944,0,0,0,20541
11046,15897627,15897627,15918111,0,0,0,20484
11042,15889908,15889908,15918903,0,0,0,28995
11061,15918828,15918828,15919000,0,0,0,172
11062,15918958,15918958,15919126,0,0,0,168
11063,15919082,15919082,15919251,0,0,0,169
11064,15919211,15919211,15919382,0,0,0,171
10980,15868044,15868044,15923799,0,0,0,55755
11066,15924321,15924321,15924431,0,0,0,110
11067,15924328,15924328,15924438,0,0,0,110
11068,15924334,15924334,15924480,0,0,0,146
10983,15868230,15868230,15925064,0,0,0,56834
11072,15925178,15925178,15925242,0,0,0,64
11075,15925306,15925306,15925366,0,0,0,60
11077,15926699,15926699,15926871,0,0,0,172
11052,15903594,15903594,15927019,0,0,0,23425
11053,15903977,15903977,15927377,0,0,0,23400
11078,15926881,15926881,15928105,0,0,0,1224
11076,15925722,15925722,15928705,0,0,0,2983
11051,15903326,15903326,15929459,0,0,0,26133
11093,15930042,15930042,15930109,0,0,0,67
11094,15930091,15930091,15930160,0,0,0,69
11050,15900838,15900838,15930186,0,0,0,29348
11097,15930224,15930224,15930286,0,0,0,62
11096,15930219,15930219,15930337,0,0,0,118
11098,15930241,15930241,15930386,0,0,0,145
11099,15930275,15930275,15930392,0,0,0,117
11104,15930777,15930777,15930866,0,0,0,89
11105,15930828,15930828,15930909,0,0,0,81
11103,15930679,15930679,15930995,0,0,0,316
11102,15930554,15930554,15931059,0,0,0,505
11101,15930536,15930536,15931064,0,0,0,528
11106,15931030,15931030,15931098,0,0,0,68
11100,15930366,15930366,15931539,0,0,0,1173
11107,15931988,15931988,15932173,0,0,0,185
11109,15932185,15932185,15932250,0,0,0,65
11108,15932169,15932169,15932310,0,0,0,141
11111,15932325,15932325,15932426,0,0,0,101
11110,15932218,15932218,15932574,0,0,0,356
11054,15905798,15905798,15932883,0,0,0,27085
11084,15929335,15929335,15933201,0,0,0,3866
11081,15927930,15927930,15933228,0,0,0,5298
11085,15929354,15929354,15933231,0,0,0,3877
11086,15929380,15929380,15933251,0,0,0,3871
11088,15929413,15929413,15933295,0,0,0,3882
11089,15929447,15929447,15933305,0,0,0,3858
11082,15928231,15928231,15933312,0,0,0,5081
11083,15928235,15928235,15933327,0,0,0,5092
11090,15929479,15929479,15933338,0,0,0,3859
11055,15906374,15906374,15933448,0,0,0,27074
11129,15933363,15933363,15933552,0,0,0,189
11057,15912998,15912998,15933936,0,0,0,20938
11058,15913107,15913107,15934112,0,0,0,21005
11113,15932759,15932759,15935221,0,0,0,2462
11056,15910536,15910536,15937245,0,0,0,26709
10876,15850819,15850819,15937649,0,0,0,86830
11059,15917866,15917866,15938208,0,0,0,20342
11060,15918068,15918068,15938426,0,0,0,20358
11139,15939590,15939590,15940021,0,0,0,431
11112,15932498,15932498,15940080,0,0,0,7582
11114,15932768,15932768,15940144,0,0,0,7376
11140,15940198,15940198,15940270,0,0,0,72
11141,15940329,15940329,15940402,0,0,0,73
11134,15936374,15936374,15941429,0,0,0,5055
11145,15941625,15941625,15941745,0,0,0,120
11144,15941593,15941593,15941749,0,0,0,156
11122,15933229,15933229,15941789,0,0,0,8560
11126,15933273,15933273,15941789,0,0,0,8516
11127,15933285,15933285,15941790,0,0,0,8505
11119,15933188,15933188,15941792,0,0,0,8604
11117,15933171,15933171,15941797,0,0,0,8626
11118,15933182,15933182,15941797,0,0,0,8615
11123,15933238,15933238,15941798,0,0,0,8560
11121,15933206,15933206,15941799,0,0,0,8593
11125,15933261,15933261,15941799,0,0,0,8538
11128,15933295,15933295,15941836,0,0,0,8541
11120,15933197,15933197,15941837,0,0,0,8640
11092,15929562,15929562,15941846,0,0,0,12284
11124,15933250,15933250,15941846,0,0,0,8596
11091,15929503,15929503,15941908,0,0,0,12405
11142,15940430,15940430,15942185,0,0,0,1755
11143,15941455,15941455,15943209,0,0,0,1754
11149,15943154,15943154,15943299,0,0,0,145
11148,15943112,15943112,15943321,0,0,0,209
11150,15943186,15943186,15943348,0,0,0,162
11151,15943222,15943222,15943370,0,0,0,148
11169,15944230,15944230,15944300,0,0,0,70
11170,15944429,15944429,15944465,0,0,0,36
11171,15945458,15945458,15945815,0,0,0,357
11147,15942143,15942143,15946003,0,0,0,3860
11172,15946704,15946704,15947570,0,0,0,866
11161,15943493,15943493,15948017,0,0,0,4524
11156,15943321,15943321,15948022,0,0,0,4701
11159,15943423,15943423,15948024,0,0,0,4601
11167,15943674,15943674,15948026,0,0,0,4352
11154,15943282,15943282,15948027,0,0,0,4745
11164,15943566,15943566,15948027,0,0,0,4461
11153,15943257,15943257,15948028,0,0,0,4771
11158,15943384,15943384,15948028,0,0,0,4644
11162,15943515,15943515,15948028,0,0,0,4513
11163,15943538,15943538,15948028,0,0,0,4490
11165,15943624,15943624,15948028,0,0,0,4404
11166,15943654,15943654,15948028,0,0,0,4374
11168,15943699,15943699,15948028,0,0,0,4329
11157,15943349,15943349,15948029,0,0,0,4680
11155,15943304,15943304,15948039,0,0,0,4735
11160,15943450,15943450,15948039,0,0,0,4589
11176,15948220,15948220,15948300,0,0,0,80
11065,15919341,15919341,15948421,0,0,0,29080
11175,15948211,15948211,15948429,0,0,0,218
11184,15948342,15948342,15948510,0,0,0,168
11190,15948760,15948760,15948992,0,0,0,232
11189,15948514,15948514,15949014,0,0,0,500
11079,15926949,15926949,15950814,0,0,0,23865
11080,15927337,15927337,15951106,0,0,0,23769
11131,15933746,15933746,15951145,0,0,0,17399
11193,15950878,15950878,15951771,0,0,0,893
11192,15950771,15950771,15952572,0,0,0,1801
11146,15941929,15941929,15953463,0,0,0,11534
11132,15933889,15933889,15954613,0,0,0,20724
11133,15934072,15934072,15954765,0,0,0,20693
11087,15929388,15929388,15955685,0,0,0,26297
11197,15955605,15955605,15955762,0,0,0,157
11198,15955724,15955724,15955874,0,0,0,150
11137,15938171,15938171,15958439,0,0,0,20268
11138,15938385,15938385,15958608,0,0,0,20223
11095,15930110,15930110,15959395,0,0,0,29285
11116,15932809,15932809,15959526,0,0,0,26717
11130,15933365,15933365,15960194,0,0,0,26829
11135,15937203,15937203,15963501,0,0,0,26298
11191,15950742,15950742,15974643,0,0,0,23901
11173,15948177,15948177,15974982,0,0,0,26805
11194,15951063,15951063,15975012,0,0,0,23949
11174,15948199,15948199,15975079,0,0,0,26880
11179,15948285,15948285,15975107,0,0,0,26822
11178,15948268,15948268,15975124,0,0,0,26856
11177,15948243,15948243,15975134,0,0,0,26891
11180,15948303,15948303,15975136,0,0,0,26833
11181,15948316,15948316,15975149,0,0,0,26833
11182,15948326,15948326,15975170,0,0,0,26844
11183,15948337,15948337,15975181,0,0,0,26844
11185,15948350,15948350,15975194,0,0,0,26844
11186,15948361,15948361,15975205,0,0,0,26844
11187,15948371,15948371,15975215,0,0,0,26844
11195,15954576,15954576,15975223,0,0,0,20647
11196,15954729,15954729,15975364,0,0,0,20635
11188,15948468,15948468,15977894,0,0,0,29426
11222,15977855,15977855,15978054,0,0,0,199
11223,15977976,15977976,15978164,0,0,0,188
11200,15958396,15958396,15978747,0,0,0,20351
11201,15958565,15958565,15978844,0,0,0,20279
11199,15955837,15955837,15982244,0,0,0,26407
11203,15959451,15959451,15986264,0,0,0,26813
11204,15960131,15960131,15987100,0,0,0,26969
11202,15959363,15959363,15988561,0,0,0,29198
11230,15988519,15988519,15988677,0,0,0,158
11205,15963458,15963458,15989454,0,0,0,25996
11217,15975152,15975152,15995873,0,0,0,20721
11221,15975322,15975322,15995977,0,0,0,20655
11206,15974601,15974601,15998277,0,0,0,23676
11207,15974929,15974929,15998574,0,0,0,23645
11225,15978668,15978668,15998887,0,0,0,20219
11226,15978802,15978802,15999083,0,0,0,20281
11224,15978088,15978088,16007331,0,0,0,29243
11239,16007296,16007296,16007447,0,0,0,151
11227,15982161,15982161,16008732,0,0,0,26571
11228,15986229,15986229,16012694,0,0,0,26465
11229,15987061,15987061,16013482,0,0,0,26421
11115,15932797,15932797,16015795,0,0,0,82998
11232,15989408,15989408,16015975,0,0,0,26567
11244,16015899,16015899,16016087,0,0,0,188
11233,15995797,15995797,16016457,0,0,0,20660
11234,15995939,15995939,16016706,0,0,0,20767
11231,15988630,15988630,16017656,0,0,0,29026
11248,16017618,16017618,16017800,0,0,0,182
11237,15998854,15998854,16019340,0,0,0,20486
11238,15999037,15999037,16019503,0,0,0,20466
11235,15998235,15998235,16021370,0,0,0,23135
11236,15998535,15998535,16021649,0,0,0,23114
11136,15937613,15937613,16024245,0,0,0,86632
11216,15975141,15975141,16024831,0,0,0,49690
11210,15975069,15975069,16026487,0,0,0,51418
11213,15975105,15975105,16029802,0,0,0,54697
11073,15925224,15925224,16033628,0,0,0,108404
11241,16008699,16008699,16035432,0,0,0,26733
11246,16016410,16016410,16037315,0,0,0,20905
11240,16007406,16007406,16037372,0,0,0,29966
11247,16016627,16016627,16037516,0,0,0,20889
11257,16037326,16037326,16037518,0,0,0,192
11069,15924961,15924961,16038067,0,0,0,113106
11250,16019294,16019294,16039455,0,0,0,20161
11242,16012621,16012621,16039670,0,0,0,27049
11251,16019466,16019466,16039702,0,0,0,20236
11243,16013442,16013442,16040220,0,0,0,26778
11219,15975166,15975166,16040415,0,0,0,65249
11245,16016014,16016014,16042062,0,0,0,26048
11252,16021327,16021327,16045154,0,0,0,23827
11253,16021606,16021606,16045452,0,0,0,23846
11215,15975129,15975129,16045533,0,0,0,70404
11249,16017726,16017726,16047018,0,0,0,29292
11074,15925250,15925250,16047440,0,0,0,122190
11212,15975092,15975092,16049612,0,0,0,74520
11028,15876829,15876829,16049629,0,0,0,172800
11220,15975183,15975183,16050773,0,0,0,75590
11276,16057643,16057643,16057736,0,0,0,93
11256,16037237,16037237,16057803,0,0,0,20566
11278,16057723,16057723,16058013,0,0,0,290
11259,16037480,16037480,16058044,0,0,0,20564
11208,15974947,15974947,16058617,0,0,0,83670
11209,15975041,15975041,16058634,0,0,0,83593
11271,16057130,16057130,16058647,0,0,0,1517
11211,15975082,15975082,16058650,0,0,0,83568
11274,16057246,16057246,16058669,0,0,0,1423
11270,16057116,16057116,16058681,0,0,0,1565
11214,15975119,15975119,16058687,0,0,0,83568
11273,16057213,16057213,16058703,0,0,0,1490
11269,16056597,16056597,16058717,0,0,0,2120
11218,15975153,15975153,16058732,0,0,0,83579
11272,16057189,16057189,16058746,0,0,0,1557
11268,16056582,16056582,16058758,0,0,0,2176
11275,16057567,16057567,16058768,0,0,0,1201
11277,16057690,16057690,16058818,0,0,0,1128
11294,16058735,16058735,16058987,0,0,0,252
11260,16039416,16039416,16060014,0,0,0,20598
11262,16039628,16039628,16060176,0,0,0,20548
11255,16035359,16035359,16061479,0,0,0,26120
11299,16061432,16061432,16061576,0,0,0,144
11070,15925042,15925042,16065590,0,0,0,140548
11261,16039611,16039611,16066287,0,0,0,26676
11263,16040174,16040174,16066750,0,0,0,26576
11258,16037440,16037440,16067191,0,0,0,29751
11264,16041988,16041988,16068636,0,0,0,26648
11265,16045080,16045080,16068926,0,0,0,23846
11266,16045410,16045410,16069185,0,0,0,23775
11267,16046977,16046977,16076671,0,0,0,29694
11279,16057770,16057770,16078729,0,0,0,20959
11280,16057972,16057972,16078924,0,0,0,20952
11297,16059970,16059970,16080282,0,0,0,20312
11298,16060134,16060134,16080478,0,0,0,20344
11316,16081612,16081612,16081698,0,0,0,86
11318,16081620,16081620,16081726,0,0,0,106
11320,16081878,16081878,16082080,0,0,0,202
11321,16082080,16082080,16082308,0,0,0,228
11314,16081605,16081605,16082347,0,0,0,742
11324,16082515,16082515,16082734,0,0,0,219
11323,16082410,16082410,16082745,0,0,0,335
11322,16082319,16082319,16082746,0,0,0,427
11317,16081616,16081616,16082755,0,0,0,1139
11319,16081659,16081659,16082756,0,0,0,1097
11315,16081608,16081608,16082758,0,0,0,1150
11313,16081601,16081601,16082762,0,0,0,1161
11312,16081596,16081596,16082779,0,0,0,1183
11152,15943225,15943225,16083526,0,0,0,140301
11332,16083325,16083325,16083750,0,0,0,425
11331,16083322,16083322,16085402,0,0,0,2080
11300,16061538,16061538,16088040,0,0,0,26502
11330,16083318,16083318,16092000,0,0,0,8682
11305,16068884,16068884,16092578,0,0,0,23694
11301,16066239,16066239,16092760,0,0,0,26521
11306,16069145,16069145,16092849,0,0,0,23704
11302,16066710,16066710,16093273,0,0,0,26563
11304,16068562,16068562,16095148,0,0,0,26586
11339,16095115,16095115,16095272,0,0,0,157
11303,16067154,16067154,16097080,0,0,0,29926
11341,16097034,16097034,16097185,0,0,0,151
11342,16097147,16097147,16097298,0,0,0,151
11343,16097255,16097255,16097406,0,0,0,151
11344,16097363,16097363,16097506,0,0,0,143
11071,15925156,15925156,16097956,0,0,0,172800
11308,16078688,16078688,16099421,0,0,0,20733
11309,16078881,16078881,16099567,0,0,0,20686
11310,16080243,16080243,16100475,0,0,0,20232
11311,16080405,16080405,16100652,0,0,0,20247
11307,16076639,16076639,16106774,0,0,0,30135
11254,16024198,16024198,16110338,0,0,0,86140
11334,16087993,16087993,16114052,0,0,0,26059
11352,16114011,16114011,16114210,0,0,0,199
11353,16114134,16114134,16114322,0,0,0,188
11335,16092535,16092535,16116333,0,0,0,23798
11337,16092768,16092768,16116471,0,0,0,23703
11326,16083297,16083297,16118438,0,0,0,35141
11327,16083300,16083300,16118441,0,0,0,35141
11333,16084542,16084542,16118445,0,0,0,33903
11325,16083294,16083294,16118446,0,0,0,35152
11329,16083312,16083312,16118453,0,0,0,35141
11328,16083303,16083303,16118455,0,0,0,35152
11336,16092684,16092684,16119025,0,0,0,26341
11338,16093192,16093192,16119835,0,0,0,26643
11346,16099378,16099378,16120078,0,0,0,20700
11347,16099523,16099523,16120149,0,0,0,20626
11348,16100430,16100430,16120849,0,0,0,20419
11349,16100608,16100608,16120965,0,0,0,20357
11340,16095226,16095226,16121587,0,0,0,26361
11369,16121548,16121548,16121728,0,0,0,180
11362,16118815,16118815,16123750,0,0,0,4935
11345,16097464,16097464,16127566,0,0,0,30102
11350,16106731,16106731,16136345,0,0,0,29614
11355,16116251,16116251,16139944,0,0,0,23693
11356,16116438,16116438,16140120,0,0,0,23682
11295,16058776,16058776,16140466,0,0,0,81690
11354,16114249,16114249,16140709,0,0,0,26460
11365,16119996,16119996,16140770,0,0,0,20774
11376,16140674,16140674,16140865,0,0,0,191
11378,16140782,16140782,16140933,0,0,0,151
11366,16120106,16120106,16140940,0,0,0,20834
11380,16140900,16140900,16141075,0,0,0,175
11367,16120809,16120809,16141201,0,0,0,20392
11381,16141001,16141001,16141201,0,0,0,200
11382,16141109,16141109,16141257,0,0,0,148
11368,16120922,16120922,16141315,0,0,0,20393
11363,16118950,16118950,16145473,0,0,0,26523
11364,16119802,16119802,16146396,0,0,0,26594
11370,16121654,16121654,16148278,0,0,0,26624
11388,16148232,16148232,16148382,0,0,0,150
11296,16059040,16059040,16152281,0,0,0,93241
11371,16127523,16127523,16156658,0,0,0,29135
11390,16156577,16156577,16156765,0,0,0,188
11391,16156693,16156693,16156881,0,0,0,188
11392,16156806,16156806,16156994,0,0,0,188
11394,16159482,16159482,16159650,0,0,0,168
11405,16159490,16159490,16159651,0,0,0,161
11411,16159491,16159491,16159654,0,0,0,163
11412,16159492,16159492,16159655,0,0,0,163
11404,16159490,16159490,16159661,0,0,0,171
11407,16159490,16159490,16159662,0,0,0,172
11408,16159491,16159491,16159663,0,0,0,172
11409,16159491,16159491,16159663,0,0,0,172
11395,16159487,16159487,16159666,0,0,0,179
11396,16159488,16159488,16159667,0,0,0,179
11406,16159490,16159490,16159667,0,0,0,177
11414,16159492,16159492,16159670,0,0,0,178
11397,16159488,16159488,16159688,0,0,0,200
11398,16159488,16159488,16159688,0,0,0,200
11399,16159488,16159488,16159688,0,0,0,200
11400,16159489,16159489,16159689,0,0,0,200
11410,16159491,16159491,16159689,0,0,0,198
11413,16159492,16159492,16159696,0,0,0,204
11401,16159489,16159489,16159740,0,0,0,251
11402,16159489,16159489,16159740,0,0,0,251
11403,16159489,16159489,16159740,0,0,0,251
11433,16159769,16159769,16159914,0,0,0,145
11452,16159772,16159772,16159915,0,0,0,143
11453,16159772,16159772,16159915,0,0,0,143
11434,16159769,16159769,16159917,0,0,0,148
11444,16159770,16159770,16159918,0,0,0,148
11415,16159764,16159764,16159925,0,0,0,161
11421,16159766,16159766,16159927,0,0,0,161
11416,16159764,16159764,16159930,0,0,0,166
11417,16159765,16159765,16159931,0,0,0,166
11418,16159765,16159765,16159931,0,0,0,166
11436,16159769,16159769,16159934,0,0,0,165
11450,16159771,16159771,16159935,0,0,0,164
11424,16159766,16159766,16159939,0,0,0,173
11437,16159769,16159769,16159939,0,0,0,170
11438,16159769,16159769,16159939,0,0,0,170
11445,16159770,16159770,16159939,0,0,0,169
11425,16159767,16159767,16159940,0,0,0,173
11426,16159767,16159767,16159940,0,0,0,173
11427,16159767,16159767,16159940,0,0,0,173
11439,16159770,16159770,16159940,0,0,0,170
11440,16159770,16159770,16159940,0,0,0,170
11441,16159770,16159770,16159940,0,0,0,170
11428,16159768,16159768,16159941,0,0,0,173
11429,16159768,16159768,16159941,0,0,0,173
11430,16159768,16159768,16159941,0,0,0,173
11431,16159768,16159768,16159941,0,0,0,173
11420,16159765,16159765,16159942,0,0,0,177
11504,16159782,16159782,16159942,0,0,0,160
11461,16159773,16159773,16159943,0,0,0,170
11505,16159782,16159782,16159944,0,0,0,162
11472,16159775,16159775,16159945,0,0,0,170
11473,16159775,16159775,16159945,0,0,0,170
11423,16159766,16159766,16159947,0,0,0,181
11492,16159780,16159780,16159950,0,0,0,170
11493,16159780,16159780,16159950,0,0,0,170
11506,16159782,16159782,16159950,0,0,0,168
11514,16159783,16159783,16159950,0,0,0,167
11422,16159766,16159766,16159951,0,0,0,185
11432,16159769,16159769,16159951,0,0,0,182
11447,16159771,16159771,16159951,0,0,0,180
11448,16159771,16159771,16159951,0,0,0,180
11449,16159771,16159771,16159951,0,0,0,180
11419,16159765,16159765,16159952,0,0,0,187
11455,16159772,16159772,16159952,0,0,0,180
11456,16159772,16159772,16159952,0,0,0,180
11457,16159772,16159772,16159952,0,0,0,180
11458,16159773,16159773,16159953,0,0,0,180
11459,16159773,16159773,16159953,0,0,0,180
11460,16159773,16159773,16159953,0,0,0,180
11464,16159773,16159773,16159953,0,0,0,180
11509,16159783,16159783,16159953,0,0,0,170
11465,16159774,16159774,16159954,0,0,0,180
11466,16159774,16159774,16159954,0,0,0,180
11467,16159774,16159774,16159954,0,0,0,180
11468,16159774,16159774,16159954,0,0,0,180
11469,16159774,16159774,16159954,0,0,0,180
11470,16159774,16159774,16159954,0,0,0,180
11471,16159774,16159774,16159954,0,0,0,180
11511,16159783,16159783,16159954,0,0,0,171
11435,16159769,16159769,16159955,0,0,0,186
11446,16159771,16159771,16159956,0,0,0,185
11474,16159776,16159776,16159956,0,0,0,180
11475,16159776,16159776,16159956,0,0,0,180
11476,16159776,16159776,16159956,0,0,0,180
11477,16159776,16159776,16159956,0,0,0,180
11478,16159777,16159777,16159957,0,0,0,180
11479,16159777,16159777,16159957,0,0,0,180
11480,16159777,16159777,16159957,0,0,0,180
11481,16159777,16159777,16159957,0,0,0,180
11484,16159778,16159778,16159957,0,0,0,179
11485,16159778,16159778,16159957,0,0,0,179
11486,16159779,16159779,16159958,0,0,0,179
11487,16159779,16159779,16159958,0,0,0,179
11488,16159779,16159779,16159958,0,0,0,179
11489,16159779,16159779,16159958,0,0,0,179
11442,16159770,16159770,16159959,0,0,0,189
11443,16159770,16159770,16159959,0,0,0,189
11490,16159780,16159780,16159959,0,0,0,179
11491,16159780,16159780,16159959,0,0,0,179
11494,16159780,16159780,16159960,0,0,0,180
11495,16159780,16159780,16159960,0,0,0,180
11496,16159781,16159781,16159961,0,0,0,180
11497,16159781,16159781,16159961,0,0,0,180
11498,16159781,16159781,16159961,0,0,0,180
11499,16159781,16159781,16159961,0,0,0,180
11500,16159781,16159781,16159961,0,0,0,180
11501,16159781,16159781,16159961,0,0,0,180
11512,16159783,16159783,16159961,0,0,0,178
11513,16159783,16159783,16159961,0,0,0,178
11507,16159782,16159782,16159962,0,0,0,180
11508,16159782,16159782,16159962,0,0,0,180
11510,16159783,16159783,16159964,0,0,0,181
11451,16159771,16159771,16159966,0,0,0,195
11482,16159778,16159778,16159967,0,0,0,189
11483,16159778,16159778,16159967,0,0,0,189
11462,16159773,16159773,16159969,0,0,0,196
11463,16159773,16159773,16159969,0,0,0,196
11502,16159782,16159782,16159972,0,0,0,190
11503,16159782,16159782,16159972,0,0,0,190
11454,16159772,16159772,16159973,0,0,0,201
11377,16140722,16140722,16161654,0,0,0,20932
11379,16140862,16140862,16161754,0,0,0,20892
11383,16141158,16141158,16161798,0,0,0,20640
11385,16141275,16141275,16161840,0,0,0,20565
11374,16139912,16139912,16163989,0,0,0,24077
11375,16140083,16140083,16164129,0,0,0,24046
11373,16136272,16136272,16165977,0,0,0,29705
11384,16141222,16141222,16167477,0,0,0,26255
11386,16145441,16145441,16172040,0,0,0,26599
11387,16146350,16146350,16173113,0,0,0,26763
11389,16148344,16148344,16174875,0,0,0,26531
11525,16174794,16174794,16174982,0,0,0,188
11526,16174910,16174910,16175098,0,0,0,188
11527,16175024,16175024,16175212,0,0,0,188
11528,16175140,16175140,16175328,0,0,0,188
11530,16180459,16180459,16180671,0,0,0,212
11517,16161719,16161719,16182310,0,0,0,20591
11518,16161797,16161797,16182390,0,0,0,20593
11515,16161590,16161590,16182591,0,0,0,21001
11516,16161665,16161665,16182689,0,0,0,21024
11535,16184812,16184812,16184881,0,0,0,69
11393,16156923,16156923,16185199,0,0,0,28276
11536,16185159,16185159,16185340,0,0,0,181
11537,16185273,16185273,16185423,0,0,0,150
11283,16058603,16058603,16186863,0,0,0,128260
11288,16058659,16058659,16187055,0,0,0,128396
11539,16185432,16185432,16187224,0,0,0,1792
11519,16163947,16163947,16187502,0,0,0,23555
11520,16164087,16164087,16187642,0,0,0,23555
11358,16118679,16118679,16191241,0,0,0,72562
11357,16118677,16118677,16191250,0,0,0,72573
11359,16118716,16118716,16191258,0,0,0,72542
11360,16118749,16118749,16191260,0,0,0,72511
11361,16118783,16118783,16191272,0,0,0,72489
11547,16192330,16192330,16192445,0,0,0,115
11522,16167434,16167434,16193660,0,0,0,26226
11549,16193580,16193580,16193762,0,0,0,182
11546,16192272,16192272,16195227,0,0,0,2955
11282,16058591,16058591,16195392,0,0,0,136801
11521,16165939,16165939,16195873,0,0,0,29934
11552,16195832,16195832,16196022,0,0,0,190
11351,16110300,16110300,16196765,0,0,0,86465
11555,16196064,16196064,16196942,0,0,0,878
11554,16196042,16196042,16196943,0,0,0,901
11556,16196090,16196090,16196943,0,0,0,853
11523,16171996,16171996,16198360,0,0,0,26364
11524,16173074,16173074,16199557,0,0,0,26483
11560,16199679,16199679,16199744,0,0,0,65
11561,16199721,16199721,16200157,0,0,0,436
11562,16199734,16199734,16200314,0,0,0,580
11563,16199750,16199750,16201206,0,0,0,1456
11564,16200523,16200523,16201346,0,0,0,823
11566,16200781,16200781,16201543,0,0,0,762
11529,16175254,16175254,16201581,0,0,0,26327
11565,16200742,16200742,16201588,0,0,0,846
11568,16202346,16202346,16202492,0,0,0,146
11569,16202443,16202443,16202585,0,0,0,142
11570,16202525,16202525,16202667,0,0,0,142
11571,16202595,16202595,16202672,0,0,0,77
11572,16202731,16202731,16202787,0,0,0,56
11531,16182275,16182275,16202875,0,0,0,20600
11532,16182349,16182349,16202917,0,0,0,20568
11573,16202765,16202765,16202918,0,0,0,153
11576,16202848,16202848,16202997,0,0,0,149
11577,16202932,16202932,16203083,0,0,0,151
11578,16203007,16203007,16203155,0,0,0,148
11579,16203071,16203071,16203219,0,0,0,148
11580,16203143,16203143,16203306,0,0,0,163
11581,16203206,16203206,16203339,0,0,0,133
11582,16203275,16203275,16203437,0,0,0,162
11583,16203341,16203341,16203469,0,0,0,128
11584,16203397,16203397,16203551,0,0,0,154
11533,16182557,16182557,16203583,0,0,0,21026
11585,16203468,16203468,16203616,0,0,0,148
11534,16182614,16182614,16203651,0,0,0,21037
11587,16203530,16203530,16203656,0,0,0,126
11589,16203600,16203600,16203750,0,0,0,150
11548,16193566,16193566,16204626,0,0,0,11060
11590,16205169,16205169,16205219,0,0,0,50
11591,16205192,16205192,16205989,0,0,0,797
11593,16206056,16206056,16206891,0,0,0,835
11594,16208133,16208133,16208256,0,0,0,123
11595,16208196,16208196,16208267,0,0,0,71
11596,16208353,16208353,16208460,0,0,0,107
11597,16208449,16208449,16208564,0,0,0,115
11599,16210031,16210031,16210148,0,0,0,117
11603,16210110,16210110,16210225,0,0,0,115
11598,16209877,16209877,16210308,0,0,0,431
11600,16210051,16210051,16210611,0,0,0,560
11601,16210060,16210060,16210859,0,0,0,799
11604,16210760,16210760,16210948,0,0,0,188
11602,16210069,16210069,16211453,0,0,0,1384
11541,16187458,16187458,16211524,0,0,0,24066
11542,16187600,16187600,16211883,0,0,0,24283
11605,16210954,16210954,16213780,0,0,0,2826
11609,16213735,16213735,16213834,0,0,0,99
11610,16213907,16213907,16213980,0,0,0,73
11611,16213929,16213929,16214031,0,0,0,102
11612,16213957,16213957,16214031,0,0,0,74
11613,16214121,16214121,16214218,0,0,0,97
11606,16211372,16211372,16214245,0,0,0,2873
11614,16214142,16214142,16214248,0,0,0,106
11616,16214362,16214362,16214420,0,0,0,58
11615,16214317,16214317,16214428,0,0,0,111
11538,16185384,16185384,16215245,0,0,0,29861
11286,16058636,16058636,16217142,0,0,0,158506
11550,16193698,16193698,16220011,0,0,0,26313
11289,16058682,16058682,16220308,0,0,0,161626
11574,16202804,16202804,16223359,0,0,0,20555
11575,16202839,16202839,16223417,0,0,0,20578
11558,16198278,16198278,16224399,0,0,0,26121
11586,16203518,16203518,16224463,0,0,0,20945
11588,16203572,16203572,16224551,0,0,0,20979
11292,16058716,16058716,16224626,0,0,0,165910
11553,16195938,16195938,16224701,0,0,0,28763
11559,16199509,16199509,16225793,0,0,0,26284
11567,16201496,16201496,16227940,0,0,0,26444
11592,16205940,16205940,16229785,0,0,0,23845
11551,16193954,16193954,16229954,0,0,0,36000
11281,16058580,16058580,16231380,0,0,0,172800
11284,16058614,16058614,16231414,0,0,0,172800
11285,16058627,16058627,16231427,0,0,0,172800
11287,16058645,16058645,16231445,0,0,0,172800
11290,16058696,16058696,16231496,0,0,0,172800
11291,16058706,16058706,16231506,0,0,0,172800
11293,16058725,16058725,16231525,0,0,0,172800
11620,16217262,16217262,16232966,0,0,0,15704
11607,16211484,16211484,16235278,0,0,0,23794
11608,16211815,16211815,16235640,0,0,0,23825
11622,16223277,16223277,16243694,0,0,0,20417
11623,16223382,16223382,16243830,0,0,0,20448
11619,16215205,16215205,16244744,0,0,0,29539
11626,16224470,16224470,16245400,0,0,0,20930
11625,16224424,16224424,16245407,0,0,0,20983
11621,16219974,16219974,16246181,0,0,0,26207
11637,16246137,16246137,16246325,0,0,0,188
11624,16224354,16224354,16250669,0,0,0,26315
11628,16225719,16225719,16252268,0,0,0,26549
11627,16224658,16224658,16253156,0,0,0,28498
11629,16227898,16227898,16254382,0,0,0,26484
11630,16235234,16235234,16259121,0,0,0,23887
11631,16235598,16235598,16259404,0,0,0,23806
11632,16243630,16243630,16264320,0,0,0,20690
11633,16243787,16243787,16264576,0,0,0,20789
11635,16245314,16245314,16266046,0,0,0,20732
11636,16245361,16245361,16266127,0,0,0,20766
11638,16246284,16246284,16272326,0,0,0,26042
11540,16186506,16186506,16272608,0,0,0,86102
11651,16272485,16272485,16272612,0,0,0,127
11653,16272725,16272725,16272795,0,0,0,70
11649,16271586,16271586,16273345,0,0,0,1759
11652,16272671,16272671,16273607,0,0,0,936
11658,16273392,16273392,16273891,0,0,0,499
11655,16273301,16273301,16273986,0,0,0,685
11634,16244701,16244701,16274090,0,0,0,29389
11657,16273378,16273378,16274113,0,0,0,735
11659,16273657,16273657,16274288,0,0,0,631
11656,16273323,16273323,16274375,0,0,0,1052
11662,16274646,16274646,16275040,0,0,0,394
11661,16274618,16274618,16275595,0,0,0,977
11664,16275140,16275140,16275980,0,0,0,840
11663,16275068,16275068,16277124,0,0,0,2056
11639,16250628,16250628,16277181,0,0,0,26553
11666,16276953,16276953,16277276,0,0,0,323
11668,16277255,16277255,16277427,0,0,0,172
11665,16276815,16276815,16277615,0,0,0,800
11669,16277402,16277402,16278174,0,0,0,772
11640,16252228,16252228,16278812,0,0,0,26584
11642,16254342,16254342,16280689,0,0,0,26347
11673,16278682,16278682,16280900,0,0,0,2218
11672,16278101,16278101,16281947,0,0,0,3846
11676,16282114,16282114,16282190,0,0,0,76
11643,16259041,16259041,16283127,0,0,0,24086
11641,16253113,16253113,16283166,0,0,0,30053
11644,16259362,16259362,16283465,0,0,0,24103
11557,16196723,16196723,16283496,0,0,0,86773
11677,16282148,16282148,16284419,0,0,0,2271
11645,16264283,16264283,16284999,0,0,0,20716
11679,16282266,16282266,16285052,0,0,0,2786
11646,16264495,16264495,16285234,0,0,0,20739
11670,16277909,16277909,16286197,0,0,0,8288
11687,16285397,16285397,16286229,0,0,0,832
11678,16282227,16282227,16286494,0,0,0,4267
11647,16266013,16266013,16287105,0,0,0,21092
11686,16285355,16285355,16287105,0,0,0,1750
11648,16266089,16266089,16287138,0,0,0,21049
11690,16288129,16288129,16288202,0,0,0,73
11692,16289450,16289450,16289576,0,0,0,126
11696,16290514,16290514,16290608,0,0,0,94
11697,16290566,16290566,16290629,0,0,0,63
11698,16290619,16290619,16290694,0,0,0,75
11699,16290741,16290741,16290811,0,0,0,70
11700,16290839,16290839,16290912,0,0,0,73
11701,16291027,16291027,16291096,0,0,0,69
11705,16291680,16291680,16291787,0,0,0,107
11695,16290069,16290069,16292389,0,0,0,2320
11711,16292833,16292833,16292906,0,0,0,73
11710,16292813,16292813,16293056,0,0,0,243
11712,16293068,16293068,16293141,0,0,0,73
11709,16292764,16292764,16293150,0,0,0,386
11713,16293654,16293654,16293727,0,0,0,73
11714,16293883,16293883,16293956,0,0,0,73
11706,16291725,16291725,16294004,0,0,0,2279
11671,16277940,16277940,16294454,0,0,0,16514
11694,16290042,16290042,16295143,0,0,0,5101
11703,16291282,16291282,16295318,0,0,0,4036
11715,16294999,16294999,16295362,0,0,0,363
11716,16295436,16295436,16295567,0,0,0,131
11718,16295513,16295567,16295771,0,0,54,258
11719,16295706,16295706,16295824,0,0,0,118
11717,16295446,16295446,16295938,0,0,0,492
11721,16295880,16295880,16295958,0,0,0,78
11720,16295727,16295727,16295967,0,0,0,240
11722,16295894,16295894,16296003,0,0,0,109
11723,16295941,16295941,16296011,0,0,0,70
11724,16296009,16296009,16296609,0,0,0,600
11726,16296521,16296521,16296656,0,0,0,135
11727,16296578,16296578,16296876,0,0,0,298
11702,16291205,16291205,16296905,0,0,0,5700
11728,16296753,16296753,16296930,0,0,0,177
11704,16291672,16291672,16297392,0,0,0,5720
11725,16296119,16296119,16297763,0,0,0,1644
11650,16272285,16272285,16298293,0,0,0,26008
11693,16289528,16289528,16298773,0,0,0,9245
11736,16298924,16298924,16298994,0,0,0,70
11731,16297235,16297235,16299079,0,0,0,1844
11733,16297445,16297445,16299469,0,0,0,2024
11730,16297216,16297216,16300501,0,0,0,3285
11732,16297429,16297429,16300781,0,0,0,3352
11707,16292481,16292481,16301176,0,0,0,8695
11737,16298934,16298934,16301718,0,0,0,2784
11739,16300907,16300907,16302618,0,0,0,1711
11372,16130834,16130834,16303634,0,0,0,172800
11660,16274018,16274018,16303769,0,0,0,29751
11667,16277140,16277140,16303809,0,0,0,26669
11738,16300886,16300886,16304134,0,0,0,3248
11674,16278775,16278775,16305148,0,0,0,26373
11734,16297743,16297743,16305409,0,0,0,7666
11684,16284916,16284916,16305594,0,0,0,20678
11729,16296795,16296795,16305795,0,0,0,9000
11685,16285168,16285168,16305815,0,0,0,20647
11743,16301604,16301604,16306621,0,0,0,5017
11675,16280649,16280649,16306694,0,0,0,26045
11680,16283083,16283083,16307110,0,0,0,24027
11682,16283399,16283399,16307424,0,0,0,24025
11689,16287065,16287065,16308127,0,0,0,21062
11688,16287029,16287029,16308229,0,0,0,21200
11741,16301505,16301505,16308807,0,0,0,7302
11758,16310707,16310707,16310822,0,0,0,115
11748,16305532,16305532,16310883,0,0,0,5351
11708,16292488,16292488,16311950,0,0,0,19462
11681,16283091,16283091,16312779,0,0,0,29688
11761,16312700,16312700,16312857,0,0,0,157
11747,16305515,16305515,16318221,0,0,0,12706
11735,16298249,16298249,16324293,0,0,0,26044
11763,16324252,16324252,16324452,0,0,0,200
11764,16324372,16324372,16324534,0,0,0,162
11765,16324498,16324498,16324655,0,0,0,157
11749,16305561,16305561,16326121,0,0,0,20560
11750,16305741,16305741,16326301,0,0,0,20560
11740,16301488,16301488,16329025,0,0,0,27537
11756,16308084,16308084,16329119,0,0,0,21035
11757,16308189,16308189,16329234,0,0,0,21045
11745,16303733,16303733,16330123,0,0,0,26390
11754,16307067,16307067,16331342,0,0,0,24275
11755,16307381,16307381,16331565,0,0,0,24184
11746,16305102,16305102,16331605,0,0,0,26503
11753,16306651,16306651,16332943,0,0,0,26292
11775,16332902,16332902,16333054,0,0,0,152
11744,16303710,16303710,16333425,0,0,0,29715
11742,16301560,16301560,16333657,0,0,0,32097
11762,16312821,16312821,16342061,0,0,0,29240
11778,16342021,16342021,16342178,0,0,0,157
11767,16326074,16326074,16346627,0,0,0,20553
11768,16326230,16326230,16346752,0,0,0,20522
11769,16329038,16329038,16349964,0,0,0,20926
11770,16329151,16329151,16350119,0,0,0,20968
11766,16324610,16324610,16350671,0,0,0,26061
11784,16350600,16350600,16350788,0,0,0,188
11785,16350709,16350709,16350855,0,0,0,146
11691,16288804,16288804,16354429,0,0,0,65625
11772,16331300,16331300,16355557,0,0,0,24257
11773,16331513,16331513,16355743,0,0,0,24230
11789,16355823,16355823,16356423,0,0,0,600
11771,16330079,16330079,16356786,0,0,0,26707
11792,16356923,16356923,16357104,0,0,0,181
11793,16357286,16357286,16357443,0,0,0,157
11543,16192043,16192043,16357485,0,0,0,165442
11774,16331566,16331566,16358515,0,0,0,26949
11776,16333011,16333011,16359142,0,0,0,26131
11797,16360389,16360389,16360493,0,0,0,104
11798,16360439,16360439,16360573,0,0,0,134
11799,16360529,16360529,16360675,0,0,0,146
11802,16362278,16362278,16362381,0,0,0,103
11803,16362342,16362342,16362412,0,0,0,70
11804,16362442,16362442,16362510,0,0,0,68
11805,16362526,16362526,16362576,0,0,0,50
11777,16333347,16333347,16362626,0,0,0,29279
11807,16362635,16362635,16362721,0,0,0,86
11808,16362688,16362688,16362758,0,0,0,70
11809,16362820,16362820,16362890,0,0,0,70
11813,16363559,16363559,16363628,0,0,0,69
11812,16363544,16363544,16363629,0,0,0,85
11810,16363188,16363188,16363861,0,0,0,673
11824,16366160,16366160,16366233,0,0,0,73
11780,16346585,16346585,16367193,0,0,0,20608
11781,16346683,16346683,16367298,0,0,0,20615
11827,16367434,16367434,16367507,0,0,0,73
11828,16367658,16367658,16367754,0,0,0,96
11829,16367716,16367716,16367787,0,0,0,71
11823,16365352,16365352,16368591,0,0,0,3239
11821,16365257,16365257,16368736,0,0,0,3479
11830,16369074,16369074,16369256,0,0,0,182
11831,16369390,16369390,16369437,0,0,0,47
11832,16369494,16369494,16369704,0,0,0,210
11833,16369703,16369703,16369834,0,0,0,131
11683,16283423,16283423,16369835,0,0,0,86412
11834,16370534,16370534,16370670,0,0,0,136
11817,16363743,16363743,16370726,0,0,0,6983
11835,16370633,16370633,16370763,0,0,0,130
11822,16365310,16365310,16370799,0,0,0,5489
11782,16349930,16349930,16370805,0,0,0,20875
11783,16350047,16350047,16370934,0,0,0,20887
11837,16370875,16370875,16371030,0,0,0,155
11839,16371193,16371193,16371340,0,0,0,147
11801,16361858,16361858,16371388,0,0,0,9530
11779,16342131,16342131,16371693,0,0,0,29562
11545,16192239,16192239,16372208,0,0,0,179969
11843,16372305,16372305,16372482,0,0,0,177
11654,16272746,16272746,16372622,0,0,0,99876
11845,16372691,16372691,16372786,0,0,0,95
11844,16372466,16372466,16372818,0,0,0,352
11820,16365010,16365010,16372823,0,0,0,7813
11847,16372897,16372897,16373008,0,0,0,111
11815,16363656,16363656,16373018,0,0,0,9362
11846,16372776,16372776,16373376,0,0,0,600
11840,16371404,16371404,16373454,0,0,0,2050
11617,16214429,16214429,16373635,0,0,0,159206
11618,16214482,16214482,16373646,0,0,0,159164
11544,16192108,16192108,16374684,0,0,0,182576
11850,16375335,16375335,16375383,0,0,0,48
11851,16375779,16375779,16375860,0,0,0,81
11818,16363845,16363845,16376096,0,0,0,12251
11852,16375951,16375951,16376102,0,0,0,151
11853,16376059,16376059,16376137,0,0,0,78
11848,16373436,16373436,16376653,0,0,0,3217
11862,16376545,16376545,16376662,0,0,0,117
11858,16376437,16376437,16376750,0,0,0,313
11854,16376347,16376347,16376751,0,0,0,404
11855,16376358,16376358,16376751,0,0,0,393
11856,16376369,16376369,16376751,0,0,0,382
11857,16376427,16376427,16376751,0,0,0,324
11859,16376504,16376504,16376752,0,0,0,248
11860,16376513,16376513,16376760,0,0,0,247
11861,16376535,16376535,16376760,0,0,0,225
11863,16376599,16376599,16376760,0,0,0,161
11864,16376631,16376631,16376761,0,0,0,130
11865,16376672,16376672,16376780,0,0,0,108
11786,16350817,16350817,16376792,0,0,0,25975
11880,16376947,16376947,16377051,0,0,0,104
11886,16377025,16377025,16377083,0,0,0,58
11890,16377115,16377115,16377210,0,0,0,95
11867,16376750,16376750,16377216,0,0,0,466
11876,16376900,16376900,16377389,0,0,0,489
11868,16376758,16376758,16377390,0,0,0,632
11877,16376923,16376923,16377390,0,0,0,467
11888,16377042,16377042,16377500,0,0,0,458
11878,16376930,16376930,16377523,0,0,0,593
11875,16376892,16376892,16377529,0,0,0,637
11887,16377034,16377034,16377627,0,0,0,593
11869,16376780,16376780,16377696,0,0,0,916
11874,16376880,16376880,16377782,0,0,0,902
11879,16376939,16376939,16377822,0,0,0,883
11893,16377790,16377790,16377868,0,0,0,78
11885,16377019,16377019,16377940,0,0,0,921
11816,16363715,16363715,16377948,0,0,0,14233
11894,16377986,16377986,16378056,0,0,0,70
11895,16378081,16378081,16378206,0,0,0,125
11896,16378305,16378305,16378420,0,0,0,115
11897,16378877,16378877,16378992,0,0,0,115
11898,16379357,16379357,16379472,0,0,0,115
11787,16355509,16355509,16379646,0,0,0,24137
11900,16379656,16379656,16379765,0,0,0,109
11788,16355706,16355706,16379839,0,0,0,24133
11903,16379742,16379742,16379871,0,0,0,129
11908,16379811,16379811,16379948,0,0,0,137
11910,16379817,16379817,16380026,0,0,0,209
11913,16379829,16379829,16380027,0,0,0,198
11907,16379810,16379810,16380030,0,0,0,220
11909,16379813,16379813,16380033,0,0,0,220
11911,16379824,16379824,16380033,0,0,0,209
11906,16379804,16379804,16380035,0,0,0,231
11912,16379827,16379827,16380036,0,0,0,209
11921,16380144,16380144,16380286,0,0,0,142
11922,16380224,16380224,16380295,0,0,0,71
11923,16380240,16380240,16380313,0,0,0,73
11924,16380242,16380242,16380374,0,0,0,132
11915,16380015,16380015,16380399,0,0,0,384
11905,16379785,16379785,16380400,0,0,0,615
11919,16380061,16380061,16380401,0,0,0,340
11916,16380030,16380030,16380403,0,0,0,373
11918,16380052,16380052,16380403,0,0,0,351
11917,16380043,16380043,16380405,0,0,0,362
11901,16379733,16379733,16380407,0,0,0,674
11920,16380079,16380079,16380408,0,0,0,329
11914,16380003,16380003,16380409,0,0,0,406
11935,16380430,16380430,16380541,0,0,0,111
11939,16380754,16380754,16380820,0,0,0,66
11870,16376803,16376803,16381097,0,0,0,4294
11925,16380315,16380315,16381098,0,0,0,783
11873,16376858,16376858,16381217,0,0,0,4359
11926,16380376,16380376,16381278,0,0,0,902
11927,16380380,16380380,16381287,0,0,0,907
11928,16380385,16380385,16381292,0,0,0,907
11929,16380390,16380390,16381297,0,0,0,907
11930,16380397,16380397,16381315,0,0,0,918
11931,16380409,16380409,16381327,0,0,0,918
11884,16377000,16377000,16381334,0,0,0,4334
11932,16380414,16380414,16381343,0,0,0,929
11881,16376958,16376958,16381358,0,0,0,4400
11933,16380418,16380418,16381358,0,0,0,940
11934,16380424,16380424,16381375,0,0,0,951
11936,16380457,16380457,16381394,0,0,0,937
11938,16380496,16380496,16381400,0,0,0,904
11937,16380479,16380479,16381405,0,0,0,926
11940,16381028,16381028,16381417,0,0,0,389
11953,16381397,16381397,16381444,0,0,0,47
11954,16381500,16381500,16381571,0,0,0,71
11941,16381234,16381234,16382183,0,0,0,949
11871,16376823,16376823,16382223,0,0,0,5400
11872,16376850,16376850,16382250,0,0,0,5400
11882,16376967,16376967,16382367,0,0,0,5400
11883,16376990,16376990,16382390,0,0,0,5400
11955,16382333,16382333,16382432,0,0,0,99
11958,16382473,16382473,16382740,0,0,0,267
11957,16382440,16382440,16382837,0,0,0,397
11960,16382799,16382799,16382902,0,0,0,103
11791,16356709,16356709,16383017,0,0,0,26308
11947,16381308,16381308,16383102,0,0,0,1794
11952,16381363,16381363,16383102,0,0,0,1739
11945,16381271,16381271,16383103,0,0,0,1832
11948,16381321,16381321,16383104,0,0,0,1783
11944,16381262,16381262,16383105,0,0,0,1843
11951,16381355,16381355,16383105,0,0,0,1750
11943,16381252,16381252,16383106,0,0,0,1854
11949,16381335,16381335,16383107,0,0,0,1772
11946,16381292,16381292,16383108,0,0,0,1816
11942,16381244,16381244,16383109,0,0,0,1865
11950,16381345,16381345,16383117,0,0,0,1772
11962,16383055,16383055,16383228,0,0,0,173
11974,16383343,16383343,16383471,0,0,0,128
11975,16383411,16383411,16383512,0,0,0,101
11976,16383697,16383697,16383806,0,0,0,109
11889,16377105,16377105,16383835,0,0,0,6730
11964,16383079,16383079,16384034,0,0,0,955
11966,16383088,16383088,16384116,0,0,0,1028
11977,16384010,16384010,16384116,0,0,0,106
11967,16383094,16383094,16384133,0,0,0,1039
11970,16383129,16383129,16384161,0,0,0,1032
11980,16384052,16384052,16384173,0,0,0,121
11973,16383146,16383146,16384178,0,0,0,1032
11800,16361821,16361821,16384351,0,0,0,22530
11814,16363640,16363640,16384497,0,0,0,20857
11986,16384497,16384497,16384548,0,0,0,51
11985,16384455,16384455,16384580,0,0,0,125
11795,16358434,16358434,16384776,0,0,0,26342
11988,16384733,16384733,16384864,0,0,0,131
11990,16384974,16384974,16385099,0,0,0,125
11796,16359100,16359100,16385142,0,0,0,26042
11992,16385311,16385311,16385446,0,0,0,135
11993,16385613,16385613,16385748,0,0,0,135
11994,16385903,16385903,16386027,0,0,0,124
11989,16384762,16384762,16386129,0,0,0,1367
11902,16379735,16379735,16386377,0,0,0,6642
11995,16386240,16386240,16386378,0,0,0,138
11996,16386312,16386312,16386418,0,0,0,106
11997,16386533,16386533,16386626,0,0,0,93
11998,16386696,16386696,16386793,0,0,0,97
11999,16386798,16386798,16386933,0,0,0,135
12000,16387027,16387027,16387138,0,0,0,111
12001,16387059,16387059,16387197,0,0,0,138
12002,16387240,16387240,16387314,0,0,0,74
12003,16387329,16387329,16387433,0,0,0,104
12004,16387504,16387504,16387620,0,0,0,116
12005,16387665,16387665,16387738,0,0,0,73
11825,16367156,16367156,16387846,0,0,0,20690
12006,16387784,16387784,16387910,0,0,0,126
12008,16387853,16387853,16387913,0,0,0,60
11826,16367258,16367258,16387916,0,0,0,20658
12009,16387935,16387935,16387995,0,0,0,60
12010,16387981,16387981,16388087,0,0,0,106
12011,16388036,16388036,16388125,0,0,0,89
12012,16388054,16388054,16388181,0,0,0,127
12013,16388190,16388190,16388265,0,0,0,75
12014,16388245,16388245,16388305,0,0,0,60
12015,16388303,16388303,16388389,0,0,0,86
12016,16388403,16388403,16388513,0,0,0,110
12017,16388465,16388465,16388525,0,0,0,60
12018,16388531,16388531,16388627,0,0,0,96
12019,16388536,16388536,16388664,0,0,0,128
12021,16388808,16388808,16388919,0,0,0,111
12022,16388840,16388840,16388979,0,0,0,139
11751,16306109,16306109,16389039,0,0,0,82930
12023,16388978,16388978,16389081,0,0,0,103
12024,16389144,16389144,16389204,0,0,0,60
12025,16389238,16389238,16389357,0,0,0,119
11759,16311081,16311081,16389590,0,0,0,78509
11760,16311312,16311312,16389593,0,0,0,78281
12026,16389494,16389494,16389631,0,0,0,137
12020,16388702,16388702,16389805,0,0,0,1103
12027,16389710,16389710,16389812,0,0,0,102
12028,16389935,16389935,16390024,0,0,0,89
12029,16390089,16390089,16390162,0,0,0,73
12030,16390416,16390416,16390489,0,0,0,73
11806,16362586,16362586,16391483,0,0,0,28897
12040,16391446,16391446,16391645,0,0,0,199
12041,16391566,16391566,16391754,0,0,0,188
11836,16370763,16370763,16391813,0,0,0,21050
12042,16391681,16391681,16391871,0,0,0,190
11838,16370901,16370901,16391909,0,0,0,21008
11972,16383140,16383140,16392122,0,0,0,8982
11971,16383136,16383136,16392129,0,0,0,8993
11983,16384154,16384154,16392137,0,0,0,7983
12033,16390804,16390804,16392948,0,0,0,2144
12032,16390801,16390801,16393186,0,0,0,2385
11891,16377204,16377204,16395204,0,0,0,18000
12031,16390792,16390792,16395432,0,0,0,4640
12039,16390858,16390858,16395989,0,0,0,5131
12051,16396163,16396163,16396271,0,0,0,108
12038,16390853,16390853,16396292,0,0,0,5439
12036,16390832,16390832,16396467,0,0,0,5635
12052,16396183,16396183,16396694,0,0,0,511
12035,16390810,16390810,16397234,0,0,0,6424
11794,16357408,16357408,16399681,0,0,0,42273
11841,16371657,16371657,16402468,0,0,0,30811
12034,16390806,16390806,16402884,0,0,0,12078
12037,16390842,16390842,16402911,0,0,0,12069
11899,16379605,16379605,16403584,0,0,0,23979
11904,16379772,16379772,16403704,0,0,0,23932
11866,16376726,16376726,16404258,0,0,0,27532
12061,16405408,16405408,16405560,0,0,0,152
11892,16377394,16377394,16406789,0,0,0,29395
11961,16382982,16382982,16409241,0,0,0,26259
11987,16384713,16384713,16411683,0,0,0,26970
11991,16385096,16385096,16412673,0,0,0,27577
12067,16412633,16412633,16412796,0,0,0,163
12056,16400374,16400374,16414820,0,0,0,14446
12048,16395257,16395257,16415958,0,0,0,20701
12047,16395228,16395228,16415962,0,0,0,20734
12057,16400380,16400380,16416629,0,0,0,16249
12049,16395606,16395606,16416665,0,0,0,21059
12050,16395642,16395642,16416691,0,0,0,21049
12043,16391805,16391805,16421358,0,0,0,29553
11984,16384338,16384338,16424249,0,0,0,39911
11978,16384019,16384019,16425213,0,0,0,41194
12075,16412965,16412965,16426870,0,0,0,13905
12069,16412916,16412916,16427225,0,0,0,14309
12073,16412940,16412940,16427456,0,0,0,14516
12058,16403517,16403517,16427478,0,0,0,23961
12071,16412934,16412934,16427505,0,0,0,14571
12059,16403621,16403621,16427623,0,0,0,24002
12070,16412920,16412920,16428803,0,0,0,15883
12074,16412942,16412942,16429257,0,0,0,16315
12076,16412968,16412968,16429293,0,0,0,16325
12072,16412937,16412937,16429340,0,0,0,16403
12060,16404219,16404219,16430114,0,0,0,25895
12084,16430071,16430071,16430217,0,0,0,146
12062,16405517,16405517,16435020,0,0,0,29503
12063,16409198,16409198,16435455,0,0,0,26257
12078,16415883,16415883,16436461,0,0,0,20578
12077,16415882,16415882,16436492,0,0,0,20610
12079,16416595,16416595,16437745,0,0,0,21150
12080,16416623,16416623,16437856,0,0,0,21233
12066,16411609,16411609,16438095,0,0,0,26486
12068,16412797,16412797,16438745,0,0,0,25948
12095,16448199,16448199,16448382,0,0,0,183
12096,16448774,16448774,16448940,0,0,0,166
12098,16449061,16449061,16449134,0,0,0,73
12097,16448986,16448986,16449144,0,0,0,158
12100,16449334,16449334,16449434,0,0,0,100
12099,16449322,16449322,16449444,0,0,0,122
12101,16449451,16449451,16449554,0,0,0,103
12104,16449850,16449850,16449953,0,0,0,103
12105,16449863,16449863,16450059,0,0,0,196
12103,16449833,16449833,16450181,0,0,0,348
12106,16450189,16450189,16450284,0,0,0,95
12108,16450275,16450275,16450615,0,0,0,340
12109,16450567,16450567,16450647,0,0,0,80
12110,16450661,16450661,16450774,0,0,0,113
12107,16450233,16450233,16450822,0,0,0,589
12111,16450717,16450717,16450828,0,0,0,111
12081,16421316,16421316,16450858,0,0,0,29542
12114,16450801,16450801,16450889,0,0,0,88
12115,16450809,16450809,16450970,0,0,0,161
12117,16450927,16450927,16451084,0,0,0,157
12118,16451041,16451041,16451190,0,0,0,149
12113,16450795,16450795,16451328,0,0,0,533
12120,16451222,16451222,16451329,0,0,0,107
12112,16450758,16450758,16451660,0,0,0,902
12082,16427419,16427419,16451669,0,0,0,24250
12122,16451475,16451475,16451698,0,0,0,223
12083,16427559,16427559,16451826,0,0,0,24267
12126,16451935,16451935,16452077,0,0,0,142
12123,16451504,16451504,16452166,0,0,0,662
12128,16452054,16452054,16452259,0,0,0,205
12121,16451461,16451461,16452595,0,0,0,1134
12129,16452078,16452078,16452641,0,0,0,563
12130,16452264,16452264,16452796,0,0,0,532
12127,16451984,16451984,16452934,0,0,0,950
12134,16455298,16455298,16455402,0,0,0,104
12135,16455551,16455551,16455677,0,0,0,126
12085,16430217,16430217,16456646,0,0,0,26429
12089,16436502,16436502,16457045,0,0,0,20543
12088,16436486,16436486,16457052,0,0,0,20566
12131,16452511,16452511,16457919,0,0,0,5408
12139,16458355,16458355,16458481,0,0,0,126
12090,16437730,16437730,16458736,0,0,0,21006
12132,16454298,16454298,16458816,0,0,0,4518
12091,16437849,16437849,16458866,0,0,0,21017
12142,16458869,16458869,16459116,0,0,0,247
12143,16459213,16459213,16459260,0,0,0,47
12144,16459569,16459569,16459617,0,0,0,48
12145,16459614,16459614,16459858,0,0,0,244
12148,16460890,16460890,16461192,0,0,0,302
12147,16460660,16460660,16461228,0,0,0,568
12146,16460639,16460639,16461587,0,0,0,948
12087,16435414,16435414,16461744,0,0,0,26330
12152,16462071,16462071,16462339,0,0,0,268
12156,16462722,16462722,16462997,0,0,0,275
12157,16463634,16463634,16463677,0,0,0,43
12149,16460959,16460959,16463743,0,0,0,2784
12158,16463661,16463661,16463775,0,0,0,114
12159,16463814,16463814,16463928,0,0,0,114
12160,16463876,16463876,16463936,0,0,0,60
12161,16463878,16463878,16463969,0,0,0,91
12162,16464022,16464022,16464120,0,0,0,98
12086,16434978,16434978,16464156,0,0,0,29178
12164,16464247,16464247,16464341,0,0,0,94
12093,16438745,16438745,16464504,0,0,0,25759
12092,16438087,16438087,16464797,0,0,0,26710
12168,16465128,16465128,16465195,0,0,0,67
12169,16465240,16465240,16465334,0,0,0,94
12170,16465864,16465864,16465958,0,0,0,94
12171,16466323,16466323,16466390,0,0,0,67
12166,16464673,16464673,16466844,0,0,0,2171
12172,16466789,16466789,16466868,0,0,0,79
12102,16449493,16449493,16467251,0,0,0,17758
12173,16469515,16469515,16469605,0,0,0,90
12174,16469974,16469974,16470063,0,0,0,89
12175,16470203,16470203,16470307,0,0,0,104
12176,16470269,16470269,16470803,0,0,0,534
12181,16470743,16470743,16470832,0,0,0,89
12182,16471201,16471201,16471316,0,0,0,115
12183,16471270,16471270,16471514,0,0,0,244
12054,16396621,16396621,16472291,0,0,0,75670
12184,16472986,16472986,16473056,0,0,0,70
12007,16387837,16387837,16474237,0,0,0,86400
12124,16451661,16451661,16475746,0,0,0,24085
12125,16451857,16451857,16475932,0,0,0,24075
12188,16477240,16477240,16477323,0,0,0,83
12189,16477542,16477542,16477631,0,0,0,89
12138,16457008,16457008,16477767,0,0,0,20759
12137,16457007,16457007,16477806,0,0,0,20799
12191,16478524,16478524,16478598,0,0,0,74
12192,16478529,16478529,16478632,0,0,0,103
11752,16306155,16306155,16478955,0,0,0,172800
12045,16393866,16393866,16479121,0,0,0,85255
12046,16393892,16393892,16479125,0,0,0,85233
12150,16461276,16461276,16479276,0,0,0,18000
12140,16458664,16458664,16479553,0,0,0,20889
12141,16458829,16458829,16479780,0,0,0,20951
12119,16451152,16451152,16480460,0,0,0,29308
12044,16393816,16393816,16480816,0,0,0,87000
12136,16456643,16456643,16482699,0,0,0,26056
12199,16482698,16482698,16482873,0,0,0,175
12200,16482804,16482804,16482992,0,0,0,188
12201,16482913,16482913,16483101,0,0,0,188
12133,16455042,16455042,16485639,0,0,0,30597
12151,16461699,16461699,16488508,0,0,0,26809
12195,16478772,16478772,16489070,0,0,0,10298
12194,16478742,16478742,16490073,0,0,0,11331
12167,16464763,16464763,16491841,0,0,0,27078
12165,16464461,16464461,16492720,0,0,0,28259
12163,16464156,16464156,16493951,0,0,0,29795
12064,16410200,16410200,16495358,0,0,0,85158
12065,16410237,16410237,16495418,0,0,0,85181
12205,16497600,16497600,16497788,0,0,0,188
12206,16497715,16497715,16497903,0,0,0,188
12207,16497829,16497829,16498017,0,0,0,188
12190,16477808,16477808,16498738,0,0,0,20930
12179,16470418,16470418,16499218,0,0,0,28800
12180,16470443,16470443,16499243,0,0,0,28800
12193,16478638,16478638,16499297,0,0,0,20659
12185,16475712,16475712,16499752,0,0,0,24040
12216,16499661,16499661,16499840,0,0,0,179
12186,16475889,16475889,16499944,0,0,0,24055
12222,16499699,16499699,16499975,0,0,0,276
12221,16499697,16499697,16499985,0,0,0,288
12218,16499690,16499690,16500397,0,0,0,707
12217,16499663,16499663,16500406,0,0,0,743
12214,16499656,16499656,16500442,0,0,0,786
12213,16499654,16499654,16500471,0,0,0,817
12196,16479583,16479583,16500753,0,0,0,21170
12197,16479740,16479740,16500961,0,0,0,21221
12202,16483028,16483028,16508976,0,0,0,25948
12198,16480416,16480416,16509987,0,0,0,29571
12203,16488468,16488468,16515162,0,0,0,26694
12155,16462418,16462418,16516374,0,0,0,53956
12153,16462332,16462332,16518730,0,0,0,56398
12209,16498690,16498690,16519336,0,0,0,20646
12210,16499253,16499253,16519861,0,0,0,20608
11849,16373670,16373670,16521115,0,0,0,147445
12224,16500711,16500711,16521760,0,0,0,21049
12225,16500920,16500920,16521978,0,0,0,21058
12219,16499690,16499690,16522947,0,0,0,23257
12223,16499903,16499903,16523176,0,0,0,23273
12204,16493868,16493868,16523620,0,0,0,29752
12208,16497945,16497945,16524032,0,0,0,26087
12234,16523997,16523997,16524148,0,0,0,151
12235,16524105,16524105,16524256,0,0,0,151
12236,16524214,16524214,16524363,0,0,0,149
12211,16499327,16499327,16526074,0,0,0,26747
11959,16382476,16382476,16531299,0,0,0,148823
12154,16462384,16462384,16533128,0,0,0,70744
12239,16534921,16534921,16535024,0,0,0,103
12226,16508940,16508940,16535232,0,0,0,26292
12242,16535184,16535184,16535352,0,0,0,168
12244,16535311,16535311,16535461,0,0,0,150
12246,16535645,16535645,16535718,0,0,0,73
12248,16536086,16536086,16536150,0,0,0,64
12252,16538013,16538013,16538084,0,0,0,71
12253,16538084,16538084,16538199,0,0,0,115
12227,16509916,16509916,16539397,0,0,0,29481
12257,16538927,16538927,16539746,0,0,0,819
12228,16515089,16515089,16541704,0,0,0,26615
12177,16470275,16470275,16542275,0,0,0,72000
12178,16470278,16470278,16542278,0,0,0,72000
12229,16521717,16521717,16542786,0,0,0,21069
12230,16521915,16521915,16542922,0,0,0,21007
12231,16522915,16522915,16546237,0,0,0,23322
12232,16523131,16523131,16546368,0,0,0,23237
12263,16547517,16547517,16547672,0,0,0,155
12094,16446534,16446534,16550122,0,0,0,103588
11981,16384080,16384080,16550128,0,0,0,166048
11979,16384045,16384045,16550130,0,0,0,166085
11965,16383083,16383083,16550134,0,0,0,167051
11956,16382335,16382335,16550135,0,0,0,167800
11963,16383075,16383075,16550137,0,0,0,167062
11969,16383108,16383108,16550137,0,0,0,167029
11968,16383099,16383099,16550139,0,0,0,167040
11982,16384105,16384105,16550139,0,0,0,166034
12237,16524320,16524320,16550364,0,0,0,26044
12266,16551400,16551400,16551597,0,0,0,197
12267,16551405,16551405,16551602,0,0,0,197
12265,16551396,16551396,16551604,0,0,0,208
12238,16526031,16526031,16552688,0,0,0,26657
12233,16523586,16523586,16552893,0,0,0,29307
12283,16552852,16552852,16553003,0,0,0,151
12285,16555367,16555367,16555730,0,0,0,363
12279,16552575,16552575,16556603,0,0,0,4028
12278,16552548,16552548,16556604,0,0,0,4056
12280,16552583,16552583,16556633,0,0,0,4050
12281,16552587,16552587,16556637,0,0,0,4050
12268,16552297,16552297,16556649,0,0,0,4352
12275,16552374,16552374,16556662,0,0,0,4288
12269,16552302,16552302,16556676,0,0,0,4374
12270,16552305,16552305,16556701,0,0,0,4396
12271,16552349,16552349,16556714,0,0,0,4365
12272,16552353,16552353,16556729,0,0,0,4376
12273,16552365,16552365,16556741,0,0,0,4376
12274,16552368,16552368,16556755,0,0,0,4387
12276,16552378,16552378,16556765,0,0,0,4387
12277,16552382,16552382,16556769,0,0,0,4387
12288,16556573,16556573,16556902,0,0,0,329
12290,16556600,16556600,16556907,0,0,0,307
12287,16556559,16556559,16556911,0,0,0,352
12289,16556593,16556593,16556911,0,0,0,318
12304,16558531,16558531,16558635,0,0,0,104
12305,16558822,16558822,16558917,0,0,0,95
12306,16558887,16558887,16558991,0,0,0,104
12307,16559055,16559055,16559215,0,0,0,160
12308,16560922,16560922,16560970,0,0,0,48
12309,16561050,16561050,16561098,0,0,0,48
12243,16535234,16535234,16561435,0,0,0,26201
12245,16535423,16535423,16561485,0,0,0,26062
12259,16541667,16541667,16568381,0,0,0,26714
12258,16539315,16539315,16569194,0,0,0,29879
12313,16569160,16569160,16569317,0,0,0,157
12314,16569270,16569270,16569420,0,0,0,150
12260,16546163,16546163,16570078,0,0,0,23915
12261,16546328,16546328,16570254,0,0,0,23926
12212,16499648,16499648,16571648,0,0,0,72000
12215,16499659,16499659,16571659,0,0,0,72000
12220,16499694,16499694,16571694,0,0,0,72000
12254,16538727,16538727,16574727,0,0,0,36000
12255,16538731,16538731,16574731,0,0,0,36000
12256,16538735,16538735,16574735,0,0,0,36000
12264,16550322,16550322,16576065,0,0,0,25743
12318,16575989,16575989,16576177,0,0,0,188
12282,16552646,16552646,16579509,0,0,0,26863
12284,16552961,16552961,16582669,0,0,0,29708
12321,16582575,16582575,16582732,0,0,0,157
12310,16561412,16561412,16587644,0,0,0,26232
12316,16570032,16570032,16594162,0,0,0,24130
12317,16570211,16570211,16594323,0,0,0,24112
12312,16568299,16568299,16594767,0,0,0,26468
12315,16569384,16569384,16598475,0,0,0,29091
12327,16598430,16598430,16598581,0,0,0,151
12247,16535820,16535820,16599526,0,0,0,63706
12319,16576135,16576135,16602489,0,0,0,26354
12311,16563153,16563153,16606438,0,0,0,43285
12320,16579466,16579466,16606545,0,0,0,27079
12251,16537827,16537827,16607658,0,0,0,69831
12322,16582695,16582695,16612512,0,0,0,29817
12323,16587596,16587596,16613928,0,0,0,26332
11790,16356664,16356664,16614766,0,0,0,258102
11811,16363271,16363271,16615871,0,0,0,252600
11819,16363917,16363917,16616517,0,0,0,252600
12324,16594093,16594093,16618182,0,0,0,24089
12325,16594283,16594283,16618370,0,0,0,24087
12240,16534939,16534939,16620206,0,0,0,85267
12326,16594692,16594692,16621649,0,0,0,26957
12116,16450846,16450846,16623646,0,0,0,172800
12241,16535012,16535012,16623777,0,0,0,88765
12249,16536127,16536127,16625592,0,0,0,89465
12329,16602419,16602419,16628511,0,0,0,26092
12328,16598541,16598541,16628619,0,0,0,30078
12337,16628466,16628466,16628647,0,0,0,181
12338,16628566,16628566,16628738,0,0,0,172
12339,16628578,16628578,16628759,0,0,0,181
11842,16372167,16372167,16631367,0,0,0,259200
12330,16606498,16606498,16633362,0,0,0,26864
12291,16556609,16556609,16636447,0,0,0,79838
12344,16637937,16637937,16637988,0,0,0,51
12296,16556703,16556703,16638325,0,0,0,81622
12299,16556736,16556736,16638325,0,0,0,81589
12297,16556715,16556715,16638326,0,0,0,81611
12298,16556728,16556728,16638328,0,0,0,81600
12301,16556903,16556903,16638328,0,0,0,81425
12293,16556630,16556630,16638329,0,0,0,81699
12302,16556906,16556906,16638331,0,0,0,81425
12303,16556917,16556917,16638331,0,0,0,81414
12292,16556622,16556622,16638332,0,0,0,81710
12294,16556679,16556679,16638334,0,0,0,81655
12295,16556690,16556690,16638334,0,0,0,81644
12300,16556899,16556899,16638335,0,0,0,81436
12343,16636425,16636425,16638349,0,0,0,1924
12332,16613891,16613891,16639911,0,0,0,26020
12349,16639870,16639870,16640023,0,0,0,153
12354,16639925,16639925,16640058,0,0,0,133
12357,16639947,16639947,16640058,0,0,0,111
12352,16639916,16639916,16640060,0,0,0,144
12356,16639939,16639939,16640061,0,0,0,122
12350,16639907,16639907,16640062,0,0,0,155
12355,16639929,16639929,16640062,0,0,0,133
12358,16639952,16639952,16640063,0,0,0,111
12353,16639920,16639920,16640064,0,0,0,144
12351,16639911,16639911,16640066,0,0,0,155
12359,16639981,16639981,16640156,0,0,0,175
12331,16612474,16612474,16642123,0,0,0,29649
12370,16642081,16642081,16642227,0,0,0,146
12334,16618137,16618137,16642359,0,0,0,24222
12335,16618290,16618290,16642554,0,0,0,24264
12286,16556505,16556505,16645169,0,0,0,88664
12336,16621604,16621604,16648480,0,0,0,26876
12187,16476894,16476894,16649694,0,0,0,172800
12341,16628696,16628696,16655055,0,0,0,26359
12053,16396234,16396234,16655434,0,0,0,259200
12055,16396673,16396673,16655873,0,0,0,259200
12379,16657584,16657584,16657959,0,0,0,375
12380,16658117,16658117,16658431,0,0,0,314
12340,16628670,16628670,16658585,0,0,0,29915
12342,16633284,16633284,16660337,0,0,0,27053
12383,16660686,16660686,16660999,0,0,0,313
12262,16547189,16547189,16666004,0,0,0,118815
12384,16665782,16665782,16666070,0,0,0,288
12372,16642319,16642319,16666523,0,0,0,24204
12386,16666464,16666464,16666697,0,0,0,233
12363,16640089,16640089,16666740,0,0,0,26651
12373,16642472,16642472,16666767,0,0,0,24295
12387,16666666,16666666,16667961,0,0,0,1295
12389,16667919,16667919,16668121,0,0,0,202
12371,16642184,16642184,16671830,0,0,0,29646
12374,16648410,16648410,16675152,0,0,0,26742
12376,16655017,16655017,16681025,0,0,0,26008
12377,16655926,16655926,16683042,0,0,0,27116
12382,16660306,16660306,16687027,0,0,0,26721
12381,16658502,16658502,16688186,0,0,0,29684
12396,16688154,16688154,16688305,0,0,0,151
12385,16666450,16666450,16690675,0,0,0,24225
12388,16666698,16666698,16690918,0,0,0,24220
12390,16668078,16668078,16694185,0,0,0,26107
12392,16671747,16671747,16701943,0,0,0,30196
12393,16675108,16675108,16701993,0,0,0,26885
12401,16701911,16701911,16702061,0,0,0,150
12378,16656094,16656094,16705843,0,0,0,49749
12394,16680980,16680980,16707089,0,0,0,26109
12333,16614703,16614703,16707926,0,0,0,93223
12405,16708924,16708924,16709043,0,0,0,119
12250,16537397,16537397,16710197,0,0,0,172800
12406,16708994,16708994,16712212,0,0,0,3218
12407,16713681,16713681,16713797,0,0,0,116
12395,16686984,16686984,16713911,0,0,0,26927
12398,16690633,16690633,16714739,0,0,0,24106
12399,16690884,16690884,16715058,0,0,0,24174
12397,16688263,16688263,16718019,0,0,0,29756
12400,16694138,16694138,16720456,0,0,0,26318
12409,16714523,16714523,16726285,0,0,0,11762
12402,16701950,16701950,16728722,0,0,0,26772
12403,16702020,16702020,16731954,0,0,0,29934
12404,16707020,16707020,16733519,0,0,0,26499
12420,16733477,16733477,16733656,0,0,0,179
12348,16639681,16639681,16738807,0,0,0,99126
12410,16714698,16714698,16738903,0,0,0,24205
12422,16738761,16738761,16739010,0,0,0,249
12411,16715018,16715018,16739182,0,0,0,24164
12345,16639670,16639670,16739680,0,0,0,100010
12347,16639677,16639677,16740443,0,0,0,100766
12346,16639674,16639674,16740783,0,0,0,101109
12408,16713831,16713831,16740826,0,0,0,26995
12416,16720414,16720414,16746639,0,0,0,26225
12426,16746561,16746561,16746707,0,0,0,146
12415,16717976,16717976,16747508,0,0,0,29532
12428,16747466,16747466,16747614,0,0,0,148
12391,16668390,16668390,16753540,0,0,0,85150
12418,16728684,16728684,16755492,0,0,0,26808
12421,16733583,16733583,16759740,0,0,0,26157
12431,16759693,16759693,16759844,0,0,0,151
12419,16731908,16731908,16761853,0,0,0,29945
12433,16761812,16761812,16761961,0,0,0,149
12434,16761921,16761921,16762072,0,0,0,151
12435,16762030,16762030,16762213,0,0,0,183
12425,16740791,16740791,16767728,0,0,0,26937
12365,16640118,16640118,16772570,0,0,0,132452
12427,16746672,16746672,16773258,0,0,0,26586
12438,16773187,16773187,16773376,0,0,0,189
12439,16773294,16773294,16773475,0,0,0,181
12429,16747571,16747571,16777695,0,0,0,30124
12441,16777650,16777650,16777798,0,0,0,148
12442,16777758,16777758,16777908,0,0,0,150
12430,16755460,16755460,16782481,0,0,0,27021
12367,16640148,16640148,16783136,0,0,0,142988
12412,16716317,16716317,16785154,0,0,0,68837
12432,16759806,16759806,16785903,0,0,0,26097
12445,16785859,16785859,16786005,0,0,0,146
12446,16785965,16785965,16786120,0,0,0,155
12447,16786073,16786073,16786222,0,0,0,149
12448,16786184,16786184,16786333,0,0,0,149
12436,16762139,16762139,16791790,0,0,0,29651
12437,16767655,16767655,16794523,0,0,0,26868
12375,16652580,16652580,16799155,0,0,0,146575
12440,16773411,16773411,16799728,0,0,0,26317
12459,16799691,16799691,16799837,0,0,0,146
12414,16716641,16716641,16801814,0,0,0,85173
12461,16801955,16801955,16802194,0,0,0,239
12462,16802178,16802178,16802402,0,0,0,224
12463,16802431,16802431,16806421,0,0,0,3990
12417,16726356,16726356,16806712,0,0,0,80356
12362,16640070,16640070,16807918,0,0,0,167848
12443,16777865,16777865,16808094,0,0,0,30229
12465,16808000,16808000,16808173,0,0,0,173
12467,16808876,16808876,16809223,0,0,0,347
12444,16782396,16782396,16809491,0,0,0,27095
12469,16809744,16809744,16809828,0,0,0,84
12471,16812296,16812296,16812387,0,0,0,91
12472,16812390,16812390,16812457,0,0,0,67
12449,16786290,16786290,16812777,0,0,0,26487
12473,16812695,16812695,16812862,0,0,0,167
12477,16817811,16817811,16817889,0,0,0,78
12478,16817873,16817873,16817962,0,0,0,89
12479,16818164,16818164,16818253,0,0,0,89
12483,16818535,16818535,16818664,0,0,0,129
12480,16818528,16818528,16818713,0,0,0,185
12481,16818534,16818534,16818726,0,0,0,192
12482,16818534,16818534,16818739,0,0,0,205
12484,16818535,16818535,16818740,0,0,0,205
12485,16818535,16818535,16818757,0,0,0,222
12486,16818750,16818750,16818932,0,0,0,182
12487,16818915,16818915,16818974,0,0,0,59
12488,16818974,16818974,16819145,0,0,0,171
12475,16815818,16815818,16819817,0,0,0,3999
12470,16810472,16810472,16820753,0,0,0,10281
12492,16820074,16820074,16821043,0,0,0,969
12453,16794481,16794481,16821518,0,0,0,27037
12450,16791748,16791748,16821612,0,0,0,29864
12491,16820035,16820035,16821762,0,0,0,1727
12495,16822073,16822073,16822133,0,0,0,60
12474,16812828,16812828,16822906,0,0,0,10078
12490,16819955,16819955,16823042,0,0,0,3087
12489,16819933,16819933,16825781,0,0,0,5848
12460,16799796,16799796,16826441,0,0,0,26645
12500,16826736,16826736,16826806,0,0,0,70
12364,16640105,16640105,16836006,0,0,0,195901
12468,16809420,16809420,16836281,0,0,0,26861
12360,16640032,16640032,16836344,0,0,0,196312
12466,16808047,16808047,16838195,0,0,0,30148
12361,16640051,16640051,16838231,0,0,0,198180
12369,16640175,16640175,16840461,0,0,0,200286
12366,16640135,16640135,16841344,0,0,0,201209
12493,16821476,16821476,16848377,0,0,0,26901
12496,16822860,16822860,16849092,0,0,0,26232
12506,16849054,16849054,16849212,0,0,0,158
12507,16849164,16849164,16849312,0,0,0,148
12508,16849276,16849276,16849426,0,0,0,150
12509,16849384,16849384,16849533,0,0,0,149
12510,16849490,16849490,16849641,0,0,0,151
12494,16821569,16821569,16851560,0,0,0,29991
12512,16851518,16851518,16851675,0,0,0,157
12499,16826367,16826367,16852790,0,0,0,26423
12497,16823490,16823490,16859541,0,0,0,36051
12503,16836237,16836237,16862823,0,0,0,26586
12424,16739024,16739024,16863034,0,0,0,124010
12458,16795814,16795814,16864815,0,0,0,69001
12504,16838123,16838123,16868020,0,0,0,29897
12498,16825813,16825813,16869287,0,0,0,43474
12501,16826785,16826785,16870246,0,0,0,43461
12502,16826867,16826867,16870323,0,0,0,43456
12505,16848334,16848334,16875109,0,0,0,26775
12511,16849599,16849599,16876130,0,0,0,26531
12518,16876087,16876087,16876237,0,0,0,150
12514,16852748,16852748,16879383,0,0,0,26635
12513,16851629,16851629,16881496,0,0,0,29867
12523,16881429,16881429,16881586,0,0,0,157
12368,16640162,16640162,16882353,0,0,0,242191
12522,16881265,16881265,16882535,0,0,0,1270
12528,16881971,16881971,16882711,0,0,0,740
12527,16881922,16881922,16883277,0,0,0,1355
12526,16881674,16881674,16883567,0,0,0,1893
12531,16883879,16883879,16883996,0,0,0,117
12532,16884038,16884038,16884132,0,0,0,94
12521,16881230,16881230,16885622,0,0,0,4392
12539,16886802,16886802,16886922,0,0,0,120
12540,16887019,16887019,16887112,0,0,0,93
12541,16887153,16887153,16887273,0,0,0,120
12524,16881443,16881443,16887724,0,0,0,6281
12413,16716397,16716397,16889197,0,0,0,172800
12515,16862744,16862744,16889917,0,0,0,27173
12543,16888026,16888026,16890181,0,0,0,2155
12456,16794864,16794864,16893107,0,0,0,98243
12565,16893059,16893059,16893186,0,0,0,127
12566,16893143,16893143,16893221,0,0,0,78
12567,16893350,16893350,16893439,0,0,0,89
12454,16794834,16794834,16893667,0,0,0,98833
12455,16794850,16794850,16893703,0,0,0,98853
12457,16794882,16794882,16893709,0,0,0,98827
12544,16888069,16888069,16893820,0,0,0,5751
12568,16893498,16893498,16894064,0,0,0,566
12569,16893575,16893575,16894198,0,0,0,623
12548,16889376,16889376,16894667,0,0,0,5291
12549,16889651,16889651,16894813,0,0,0,5162
12551,16890058,16890058,16895223,0,0,0,5165
12552,16890183,16890183,16895366,0,0,0,5183
12553,16890253,16890253,16895407,0,0,0,5154
12563,16890680,16890680,16895758,0,0,0,5078
12571,16895961,16895961,16896032,0,0,0,71
12572,16896194,16896194,16896260,0,0,0,66
12574,16896754,16896754,16896843,0,0,0,89
12576,16897018,16897018,16897088,0,0,0,70
12577,16897342,16897342,16897412,0,0,0,70
12578,16897752,16897752,16897822,0,0,0,70
12516,16867980,16867980,16897951,0,0,0,29971
12579,16897906,16897906,16898068,0,0,0,162
12582,16898334,16898334,16898441,0,0,0,107
12588,16898541,16898541,16898679,0,0,0,138
12589,16898567,16898567,16898689,0,0,0,122
12594,16899342,16899342,16900740,0,0,0,1398
12593,16898707,16898707,16901370,0,0,0,2663
12517,16875066,16875066,16901996,0,0,0,26930
12586,16898531,16898531,16902496,0,0,0,3965
12519,16876194,16876194,16902603,0,0,0,26409
12597,16902561,16902561,16902823,0,0,0,262
12590,16898602,16898602,16903557,0,0,0,4955
12585,16898457,16898457,16903836,0,0,0,5379
12520,16879336,16879336,16906287,0,0,0,26951
12609,16906550,16906550,16907150,0,0,0,600
12580,16897907,16897907,16908017,0,0,0,10110
12595,16899586,16899586,16908347,0,0,0,8761
12610,16907891,16907891,16909174,0,0,0,1283
12603,16904393,16904393,16909741,0,0,0,5348
12604,16904539,16904539,16909813,0,0,0,5274
12605,16904740,16904740,16909927,0,0,0,5187
12606,16904822,16904822,16910055,0,0,0,5233
12607,16904983,16904983,16910278,0,0,0,5295
12525,16881539,16881539,16911685,0,0,0,30146
12537,16884529,16884529,16912195,0,0,0,27666
12587,16898531,16898531,16916687,0,0,0,18156
12550,16889884,16889884,16916819,0,0,0,26935
12611,16908994,16908994,16917984,0,0,0,8990
12583,16898405,16898405,16918696,0,0,0,20291
12584,16898433,16898433,16920637,0,0,0,22204
12591,16898654,16898654,16920876,0,0,0,22222
12592,16898663,16898663,16921694,0,0,0,23031
12530,16883208,16883208,16926664,0,0,0,43456
12529,16883188,16883188,16926667,0,0,0,43479
12581,16898021,16898021,16928283,0,0,0,30262
12596,16901913,16901913,16928620,0,0,0,26707
12598,16902780,16902780,16929153,0,0,0,26373
12608,16906249,16906249,16932805,0,0,0,26556
12616,16921592,16921592,16933434,0,0,0,11842
12617,16921618,16921618,16935039,0,0,0,13421
12618,16921645,16921645,16936641,0,0,0,14996
12635,16937894,16937894,16938011,0,0,0,117
12633,16937824,16937824,16938050,0,0,0,226
12634,16937847,16937847,16938073,0,0,0,226
12636,16937978,16937978,16938397,0,0,0,419
12638,16938096,16938096,16938594,0,0,0,498
12637,16938054,16938054,16938834,0,0,0,780
12614,16911642,16911642,16941514,0,0,0,29872
12615,16916777,16916777,16943324,0,0,0,26547
12624,16931453,16931453,16945403,0,0,0,13950
12464,16802911,16802911,16950260,0,0,0,147349
12626,16933551,16933551,16952657,0,0,0,19106
12612,16911180,16911180,16954614,0,0,0,43434
12613,16911418,16911418,16954951,0,0,0,43533
12620,16928583,16928583,16955209,0,0,0,26626
12623,16929111,16929111,16955649,0,0,0,26538
12619,16928244,16928244,16958276,0,0,0,30032
12625,16932762,16932762,16959302,0,0,0,26540
12643,16960083,16960083,16960306,0,0,0,223
12644,16960606,16960606,16960775,0,0,0,169
12646,16964114,16964114,16964469,0,0,0,355
12651,16969692,16969692,16969765,0,0,0,73
12645,16962232,16962232,16969969,0,0,0,7737
12654,16970606,16970606,16970898,0,0,0,292
12656,16970851,16970851,16970988,0,0,0,137
12639,16941439,16941439,16971389,0,0,0,29950
12659,16971978,16971978,16972216,0,0,0,238
12621,16929002,16929002,16972468,0,0,0,43466
12622,16929046,16929046,16972512,0,0,0,43466
12628,16937182,16937182,16974739,0,0,0,37557
12629,16937193,16937193,16974998,0,0,0,37805
12658,16971967,16971967,16975675,0,0,0,3708
12627,16937173,16937173,16975736,0,0,0,38563
12660,16976018,16976018,16976184,0,0,0,166
12663,16978411,16978411,16978492,0,0,0,81
12664,16978411,16978411,16978504,0,0,0,93
12665,16978411,16978411,16978504,0,0,0,93
12666,16978411,16978411,16978504,0,0,0,93
12675,16978678,16978678,16978767,0,0,0,89
12667,16978432,16978432,16979032,0,0,0,600
12679,16979074,16979074,16979276,0,0,0,202
12682,16979261,16979261,16979861,0,0,0,600
12684,16979798,16979798,16979873,0,0,0,75
12683,16979789,16979789,16980389,0,0,0,600
12689,16980333,16980333,16980622,0,0,0,289
12690,16980336,16980336,16980636,0,0,0,300
12692,16981370,16981370,16981440,0,0,0,70
12691,16981153,16981153,16981753,0,0,0,600
12640,16955607,16955607,16982058,0,0,0,26451
12693,16981613,16981613,16982213,0,0,0,600
12674,16978610,16978610,16982278,0,0,0,3668
12662,16978244,16978244,16982784,0,0,0,4540
12647,16964497,16964497,16983049,0,0,0,18552
12648,16964844,16964844,16983432,0,0,0,18588
12686,16980326,16980326,16983464,0,0,0,3138
12650,16967577,16967577,16984593,0,0,0,17016
12642,16959226,16959226,16985885,0,0,0,26659
12698,16983841,16983841,16986748,0,0,0,2907
12655,16970659,16970659,16986804,0,0,0,16145
12641,16958230,16958230,16987877,0,0,0,29647
12704,16987840,16987840,16987997,0,0,0,157
12705,16987951,16987951,16988101,0,0,0,150
12701,16986257,16986257,16988179,0,0,0,1922
12661,16978209,16978209,16989609,0,0,0,11400
12712,16989616,16989616,16989680,0,0,0,64
12713,16989669,16989669,16989736,0,0,0,67
12714,16989716,16989716,16989816,0,0,0,100
12707,16988948,16988948,16990771,0,0,0,1823
12715,16989877,16989877,16990831,0,0,0,954
12673,16978572,16978572,16991616,0,0,0,13044
12533,16884528,16884528,16992357,0,0,0,107829
12680,16979118,16979118,16992893,0,0,0,13775
12534,16884528,16884528,16992930,0,0,0,108402
12535,16884528,16884528,16993003,0,0,0,108475
12668,16978464,16978464,16993449,0,0,0,14985
12699,16985844,16985844,16993861,0,0,0,8017
12538,16884529,16884529,16994200,0,0,0,109671
12700,16986215,16986215,16994751,0,0,0,8536
12536,16884528,16884528,16995315,0,0,0,110787
12718,16991110,16991110,16995393,0,0,0,4283
12716,16990175,16990175,16995527,0,0,0,5352
12708,16988997,16988997,16995576,0,0,0,6579
12711,16989566,16989566,16995681,0,0,0,6115
12720,16992739,16992739,16995760,0,0,0,3021
12697,16983809,16983809,16995835,0,0,0,12026
12722,16996814,16996814,16997414,0,0,0,600
12723,16996945,16996945,16997545,0,0,0,600
12710,16989534,16989534,16997552,0,0,0,8018
12728,16997675,16997675,16997840,0,0,0,165
12729,16997686,16997686,16997851,0,0,0,165
12730,16997695,16997695,16997860,0,0,0,165
12423,16738952,16738952,16998152,0,0,0,259200
12601,16903236,16903236,16998781,0,0,0,95545
12599,16903227,16903227,16998783,0,0,0,95556
12600,16903232,16903232,16998788,0,0,0,95556
12731,16998798,16998798,16998901,0,0,0,103
12733,16998889,16998889,16998989,0,0,0,100
12732,16998859,16998859,16998992,0,0,0,133
12727,16997252,16997252,16999168,0,0,0,1916
12725,16997126,16997126,16999603,0,0,0,2477
12657,16971324,16971324,17001412,0,0,0,30088
12719,16992695,16992695,17001801,0,0,0,9106
12721,16993821,16993821,17001926,0,0,0,8105
12649,16967542,16967542,17002227,0,0,0,34685
12555,16890353,16890353,17003203,0,0,0,112850
12709,16989084,16989084,17004404,0,0,0,15320
12602,16903239,16903239,17004566,0,0,0,101327
12726,16997220,16997220,17005308,0,0,0,8088
12724,16997086,16997086,17006095,0,0,0,9009
12717,16991096,16991096,17006949,0,0,0,15853
12741,17007167,17007167,17007252,0,0,0,85
12740,17006296,17006296,17007789,0,0,0,1493
12694,16981987,16981987,17008198,0,0,0,26211
12745,17008528,17008528,17008632,0,0,0,104
12746,17010629,17010629,17010702,0,0,0,73
12747,17010881,17010881,17010954,0,0,0,73
12748,17011377,17011377,17011478,0,0,0,101
12736,16999124,16999124,17011481,0,0,0,12357
12749,17011950,17011950,17012163,0,0,0,213
12751,17012109,17012109,17012211,0,0,0,102
12750,17012058,17012058,17012213,0,0,0,155
12752,17012253,17012253,17012358,0,0,0,105
12734,16999113,16999113,17012647,0,0,0,13534
12753,17012786,17012786,17012888,0,0,0,102
12676,16978731,16978731,17013083,0,0,0,34352
12737,17001375,17001375,17013205,0,0,0,11830
12754,17013162,17013162,17013355,0,0,0,193
12652,16969959,16969959,17013386,0,0,0,43427
12756,17013423,17013423,17013496,0,0,0,73
12653,16970151,16970151,17013569,0,0,0,43418
12758,17014510,17014510,17014583,0,0,0,73
12759,17014603,17014603,17014707,0,0,0,104
12677,16978757,16978757,17014870,0,0,0,36113
12760,17014713,17014713,17014982,0,0,0,269
12761,17014827,17014827,17014989,0,0,0,162
12762,17015045,17015045,17015119,0,0,0,74
12763,17015174,17015174,17015272,0,0,0,98
12735,16999120,16999120,17015729,0,0,0,16609
12764,17015662,17015662,17015736,0,0,0,74
12765,17016038,17016038,17016112,0,0,0,74
12766,17016536,17016536,17016609,0,0,0,73
12767,17016945,17016945,17017019,0,0,0,74
12768,17017105,17017105,17017178,0,0,0,73
12678,16978769,16978769,17017232,0,0,0,38463
12769,17017195,17017195,17017268,0,0,0,73
12706,16988064,16988064,17017493,0,0,0,29429
12771,17017488,17017488,17017577,0,0,0,89
12770,17017410,17017410,17017603,0,0,0,193
12773,17017722,17017722,17017795,0,0,0,73
12774,17018082,17018082,17018155,0,0,0,73
12755,17013283,17013283,17018870,0,0,0,5587
12776,17018833,17018833,17018984,0,0,0,151
12739,17006236,17006236,17019345,0,0,0,13109
12742,17007246,17007246,17026423,0,0,0,19177
12743,17007325,17007325,17026464,0,0,0,19139
12738,17001879,17001879,17028619,0,0,0,26740
12702,16987459,16987459,17030893,0,0,0,43434
12703,16987487,16987487,17030952,0,0,0,43465
12573,16896739,16896739,17033000,0,0,0,136261
12558,16890393,16890393,17034466,0,0,0,144073
12744,17008160,17008160,17034818,0,0,0,26658
12561,16890427,16890427,17036604,0,0,0,146177
12451,16793577,16793577,17046177,0,0,0,252600
12452,16793600,16793600,17046200,0,0,0,252600
12772,17017539,17017539,17046824,0,0,0,29285
12546,16888916,16888916,17048821,0,0,0,159905
12777,17018942,17018942,17049078,0,0,0,30136
12783,17049034,17049034,17049187,0,0,0,153
12787,17050589,17050589,17050726,0,0,0,137
12685,16980320,16980320,17052320,0,0,0,72000
12687,16980328,16980328,17052328,0,0,0,72000
12688,16980331,16980331,17052331,0,0,0,72000
12800,17052465,17052465,17052658,0,0,0,193
12801,17052813,17052813,17052919,0,0,0,106
12805,17053533,17053533,17053663,0,0,0,130
12806,17053693,17053693,17053864,0,0,0,171
12807,17053749,17053749,17053980,0,0,0,231
12808,17053906,17053906,17054085,0,0,0,179
12809,17054069,17054069,17054198,0,0,0,129
12810,17054240,17054240,17054334,0,0,0,94
12813,17054381,17054381,17054558,0,0,0,177
12814,17054509,17054509,17054686,0,0,0,177
12815,17054754,17054754,17054889,0,0,0,135
12786,17049236,17049236,17054937,0,0,0,5701
12784,17049098,17049098,17054941,0,0,0,5843
12780,17028544,17028544,17055094,0,0,0,26550
12757,17013666,17013666,17057145,0,0,0,43479
12825,17057686,17057686,17057782,0,0,0,96
12826,17057723,17057723,17057825,0,0,0,102
12823,17057586,17057586,17058461,0,0,0,875
12802,17053029,17053029,17058790,0,0,0,5761
12799,17052273,17052273,17061000,0,0,0,8727
12781,17034777,17034777,17061311,0,0,0,26534
12798,17052241,17052241,17062723,0,0,0,10482
12797,17052184,17052184,17062789,0,0,0,10605
12821,17057055,17057055,17062851,0,0,0,5796
12839,17062699,17062699,17063880,0,0,0,1181
12840,17062711,17062711,17063881,0,0,0,1170
12841,17062734,17062734,17063882,0,0,0,1148
12837,17059922,17059922,17064229,0,0,0,4307
12564,16892294,16892294,17065094,0,0,0,172800
12788,17051052,17051052,17067264,0,0,0,16212
12804,17053501,17053501,17067430,0,0,0,13929
12822,17057443,17057443,17067678,0,0,0,10235
12795,17052037,17052037,17067763,0,0,0,15726
12792,17051838,17051838,17067807,0,0,0,15969
12824,17057623,17057623,17068418,0,0,0,10795
12830,17058436,17058436,17068986,0,0,0,10550
12832,17059068,17059068,17069133,0,0,0,10065
12831,17059052,17059052,17069139,0,0,0,10087
12843,17063716,17063716,17069427,0,0,0,5711
12842,17063640,17063640,17069430,0,0,0,5790
12833,17059080,17059080,17069455,0,0,0,10375
12855,17070129,17070129,17070233,0,0,0,104
12827,17057880,17057880,17071391,0,0,0,13511
12860,17071442,17071442,17071590,0,0,0,148
12856,17070240,17070240,17071747,0,0,0,1507
12866,17071852,17071852,17071920,0,0,0,68
12867,17071890,17071890,17071961,0,0,0,71
12803,17053463,17053463,17072411,0,0,0,18948
12570,16895852,16895852,17073988,0,0,0,178136
12790,17051151,17051151,17074348,0,0,0,23197
12874,17074480,17074480,17074527,0,0,0,47
12793,17051847,17051847,17074950,0,0,0,23103
12476,16816026,16816026,17075226,0,0,0,259200
12876,17075249,17075249,17075550,0,0,0,301
12796,17052088,17052088,17075684,0,0,0,23596
12850,17064326,17064326,17075815,0,0,0,11489
12782,17046788,17046788,17076847,0,0,0,30059
12879,17076660,17076660,17077188,0,0,0,528
12880,17076710,17076710,17077196,0,0,0,486
12888,17077201,17077201,17077775,0,0,0,574
12887,17077180,17077180,17077901,0,0,0,721
12671,16978569,16978569,17077941,0,0,0,99372
12849,17064291,17064291,17078030,0,0,0,13739
12848,17064254,17064254,17078523,0,0,0,14269
12883,17076843,17076843,17078799,0,0,0,1956
12785,17049145,17049145,17079133,0,0,0,29988
12891,17079053,17079053,17079235,0,0,0,182
12882,17076807,17076807,17079276,0,0,0,2469
12892,17079171,17079171,17079322,0,0,0,151
12889,17078736,17078736,17079411,0,0,0,675
12885,17076878,17076878,17079506,0,0,0,2628
12834,17059762,17059762,17079922,0,0,0,20160
12817,17055232,17055232,17080720,0,0,0,25488
12789,17051148,17051148,17080923,0,0,0,29775
12835,17059826,17059826,17081337,0,0,0,21511
12630,16937659,16937659,17081658,0,0,0,143999
12894,17079379,17079379,17081867,0,0,0,2488
12890,17078746,17078746,17081876,0,0,0,3130
12895,17079392,17079392,17081891,0,0,0,2499
12896,17079549,17079549,17081896,0,0,0,2347
12791,17051735,17051735,17082241,0,0,0,30506
12794,17051951,17051951,17083933,0,0,0,31982
12878,17075804,17075804,17085155,0,0,0,9351
12631,16937669,16937669,17085443,0,0,0,147774
12903,17086983,17086983,17087056,0,0,0,73
12873,17072411,17072411,17087458,0,0,0,15047
12838,17061231,17061231,17087481,0,0,0,26250
12857,17070410,17070410,17087558,0,0,0,17148
12672,16978569,16978569,17087603,0,0,0,109034
12556,16890370,16890370,17087837,0,0,0,197467
12905,17088370,17088370,17088471,0,0,0,101
12545,16888912,16888912,17088554,0,0,0,199642
12858,17070451,17070451,17088663,0,0,0,18212
12906,17088766,17088766,17088881,0,0,0,115
12907,17088923,17088923,17089027,0,0,0,104
12560,16890419,16890419,17089393,0,0,0,198974
12829,17058138,17058138,17089766,0,0,0,31628
12859,17070789,17070789,17090035,0,0,0,19246
12669,16978568,16978568,17090168,0,0,0,111600
12554,16890341,16890341,17090408,0,0,0,200067
12872,17072375,17072375,17091559,0,0,0,19184
12828,17058095,17058095,17091744,0,0,0,33649
12886,17076895,17076895,17091792,0,0,0,14897
12557,16890380,16890380,17092288,0,0,0,201908
12547,16888919,16888919,17092994,0,0,0,204075
12696,16983090,16983090,17093470,0,0,0,110380
12559,16890403,16890403,17095716,0,0,0,205313
12864,17071715,17071715,17097195,0,0,0,25480
12695,16983041,16983041,17098312,0,0,0,115271
12909,17098323,17098323,17098399,0,0,0,76
12908,17098308,17098308,17098406,0,0,0,98
12910,17098503,17098503,17098603,0,0,0,100
12911,17098541,17098541,17098632,0,0,0,91
12816,17055192,17055192,17098645,0,0,0,43453
12818,17055234,17055234,17098714,0,0,0,43480
12819,17055266,17055266,17098716,0,0,0,43450
12884,17076862,17076862,17101145,0,0,0,24283
12901,17085699,17085699,17102494,0,0,0,16795
12897,17081987,17081987,17103822,0,0,0,21835
12899,17081996,17081996,17104166,0,0,0,22170
12898,17081991,17081991,17104285,0,0,0,22294
12562,16890434,16890434,17106434,0,0,0,216000
12863,17071675,17071675,17106826,0,0,0,35151
12846,17063956,17063956,17106832,0,0,0,42876
12881,17076794,17076794,17107268,0,0,0,30474
12893,17079286,17079286,17108402,0,0,0,29116
12775,17018653,17018653,17108533,0,0,0,89880
12845,17063952,17063952,17108622,0,0,0,44670
12918,17108729,17108729,17108802,0,0,0,73
12919,17108764,17108764,17108893,0,0,0,129
12920,17109374,17109374,17109478,0,0,0,104
12921,17109676,17109676,17109811,0,0,0,135
12922,17109912,17109912,17110088,0,0,0,176
12868,17072114,17072114,17111047,0,0,0,38933
12904,17087416,17087416,17113679,0,0,0,26263
12670,16978568,16978568,17114358,0,0,0,135790
12871,17072362,17072362,17115190,0,0,0,42828
12862,17071595,17071595,17116110,0,0,0,44515
12870,17072266,17072266,17116276,0,0,0,44010
12836,17059881,17059881,17125313,0,0,0,65432
12844,17063948,17063948,17125912,0,0,0,61964
12869,17072201,17072201,17127907,0,0,0,55706
12877,17075286,17075286,17130252,0,0,0,54966
12902,17086771,17086771,17130301,0,0,0,43530
12912,17098634,17098634,17132136,0,0,0,33502
12861,17071559,17071559,17132918,0,0,0,61359
12820,17055741,17055741,17132998,0,0,0,77257
12913,17098652,17098652,17133414,0,0,0,34762
12847,17064208,17064208,17134635,0,0,0,70427
12865,17071720,17071720,17136165,0,0,0,64445
12916,17107226,17107226,17137403,0,0,0,30177
12917,17108357,17108357,17137783,0,0,0,29426
12933,17137921,17137921,17138011,0,0,0,90
12934,17138016,17138016,17138087,0,0,0,71
12936,17138172,17138172,17138242,0,0,0,70
12940,17138652,17138652,17138896,0,0,0,244
12632,16937786,16937786,17139332,0,0,0,201546
12941,17138884,17138884,17139485,0,0,0,601
12923,17113615,17113615,17140063,0,0,0,26448
12945,17139499,17139499,17141720,0,0,0,2221
12944,17139473,17139473,17141727,0,0,0,2254
12946,17139527,17139527,17141727,0,0,0,2200
12943,17139449,17139449,17141728,0,0,0,2279
12947,17140020,17140020,17141873,0,0,0,1853
12938,17138302,17138302,17143781,0,0,0,5479
12953,17143605,17143605,17143909,0,0,0,304
12955,17145850,17145850,17146129,0,0,0,279
12939,17138398,17138398,17146197,0,0,0,7799
12542,16887302,16887302,17146502,0,0,0,259200
12952,17142586,17142586,17146764,0,0,0,4178
12949,17142493,17142493,17146768,0,0,0,4275
12950,17142515,17142515,17146768,0,0,0,4253
12951,17142548,17142548,17146769,0,0,0,4221
12959,17146802,17146802,17147093,0,0,0,291
12960,17147022,17147022,17147404,0,0,0,382
12956,17146196,17146196,17147975,0,0,0,1779
12957,17146574,17146574,17148304,0,0,0,1730
12962,17149016,17149016,17149124,0,0,0,108
12958,17146589,17146589,17149239,0,0,0,2650
12961,17147639,17147639,17149391,0,0,0,1752
12900,17085187,17085187,17149731,0,0,0,64544
12965,17149935,17149935,17150008,0,0,0,73
12963,17149737,17149737,17150039,0,0,0,302
12966,17150043,17150043,17150117,0,0,0,74
12967,17150397,17150397,17150569,0,0,0,172
12968,17150643,17150643,17150913,0,0,0,270
12681,16979201,16979201,17151298,0,0,0,172097
12964,17149866,17149866,17151576,0,0,0,1710
12942,17138942,17138942,17151773,0,0,0,12831
12969,17151933,17151933,17152299,0,0,0,366
12971,17152468,17152468,17152682,0,0,0,214
12972,17153416,17153416,17153490,0,0,0,74
12973,17154247,17154247,17154452,0,0,0,205
12974,17154364,17154364,17154712,0,0,0,348
12975,17154632,17154632,17154830,0,0,0,198
12976,17155511,17155511,17155890,0,0,0,379
12977,17155767,17155767,17155966,0,0,0,199
12575,16896812,16896812,17156012,0,0,0,259200
12978,17156421,17156421,17156820,0,0,0,399
12979,17157218,17157218,17157265,0,0,0,47
12980,17157304,17157304,17157963,0,0,0,659
12982,17158642,17158642,17158700,0,0,0,58
12983,17158651,17158651,17158709,0,0,0,58
12981,17158424,17158424,17158802,0,0,0,378
12988,17159062,17159062,17159116,0,0,0,54
12989,17159069,17159069,17159122,0,0,0,53
12984,17158709,17158709,17159507,0,0,0,798
12986,17158731,17158731,17159538,0,0,0,807
12985,17158721,17158721,17159539,0,0,0,818
12987,17158740,17158740,17159898,0,0,0,1158
12992,17160253,17160253,17161045,0,0,0,792
12875,17075173,17075173,17161974,0,0,0,86801
12993,17161855,17161855,17162489,0,0,0,634
12994,17162867,17162867,17163536,0,0,0,669
12851,17065262,17065262,17164201,0,0,0,98939
12853,17065307,17065307,17164450,0,0,0,99143
12854,17065328,17065328,17164736,0,0,0,99408
12852,17065284,17065284,17165784,0,0,0,100500
12932,17137713,17137713,17167722,0,0,0,30009
12931,17137356,17137356,17167868,0,0,0,30512
12997,17167679,17167679,17167873,0,0,0,194
12948,17141827,17141827,17168201,0,0,0,26374
13001,17171406,17171406,17171521,0,0,0,115
12914,17099616,17099616,17171915,0,0,0,72299
13002,17171515,17171515,17172173,0,0,0,658
13003,17172156,17172156,17172418,0,0,0,262
13004,17172399,17172399,17172844,0,0,0,445
13006,17172979,17172979,17173044,0,0,0,65
13007,17173032,17173032,17173147,0,0,0,115
13005,17172908,17172908,17173151,0,0,0,243
12996,17167604,17167604,17173251,0,0,0,5647
13009,17173469,17173469,17173615,0,0,0,146
13010,17173738,17173738,17173859,0,0,0,121
13008,17173431,17173431,17173968,0,0,0,537
13012,17174101,17174101,17174278,0,0,0,177
13011,17173965,17173965,17174392,0,0,0,427
13013,17174368,17174368,17174598,0,0,0,230
13014,17174432,17174432,17174625,0,0,0,193
13016,17174720,17174720,17174905,0,0,0,185
13015,17174619,17174619,17175019,0,0,0,400
12915,17099623,17099623,17175090,0,0,0,75467
13017,17174793,17174793,17175180,0,0,0,387
13019,17175081,17175081,17175265,0,0,0,184
13020,17175173,17175173,17175336,0,0,0,163
12925,17131923,17131923,17175380,0,0,0,43457
12926,17131953,17131953,17175382,0,0,0,43429
13018,17175021,17175021,17175383,0,0,0,362
13021,17175277,17175277,17175433,0,0,0,156
12927,17132003,17132003,17175435,0,0,0,43432
12928,17132034,17132034,17175490,0,0,0,43456
13022,17175454,17175454,17175634,0,0,0,180
13024,17175657,17175657,17175795,0,0,0,138
13026,17176167,17176167,17176314,0,0,0,147
13027,17176361,17176361,17176507,0,0,0,146
13028,17176563,17176563,17176716,0,0,0,153
12995,17163776,17163776,17177109,0,0,0,13333
13030,17176949,17176949,17177157,0,0,0,208
13031,17178229,17178229,17178468,0,0,0,239
13032,17178542,17178542,17178687,0,0,0,145
13023,17175594,17175594,17178807,0,0,0,3213
13029,17176865,17176865,17179154,0,0,0,2289
13025,17175724,17175724,17179346,0,0,0,3622
13033,17179421,17179421,17179682,0,0,0,261
13034,17180209,17180209,17180309,0,0,0,100
13036,17180563,17180563,17180771,0,0,0,208
13037,17181377,17181377,17181512,0,0,0,135
13038,17181565,17181565,17181678,0,0,0,113
13040,17182600,17182600,17183222,0,0,0,622
13041,17183239,17183239,17183634,0,0,0,395
13039,17181655,17181655,17183804,0,0,0,2149
13035,17180295,17180295,17184166,0,0,0,3871
13042,17183516,17183516,17185103,0,0,0,1587
13044,17185828,17185828,17186036,0,0,0,208
13045,17186502,17186502,17186710,0,0,0,208
13046,17186678,17186678,17186866,0,0,0,188
13047,17187721,17187721,17187919,0,0,0,198
13048,17187881,17187881,17188163,0,0,0,282
13049,17188596,17188596,17188748,0,0,0,152
13050,17188847,17188847,17188971,0,0,0,124
13043,17183608,17183608,17189444,0,0,0,5836
12930,17136176,17136176,17190595,0,0,0,54419
12990,17159139,17159139,17190616,0,0,0,31477
13051,17190022,17190022,17190709,0,0,0,687
13054,17190764,17190764,17192331,0,0,0,1567
12778,17019603,17019603,17192357,0,0,0,172754
13056,17190837,17190837,17192476,0,0,0,1639
13057,17190871,17190871,17192677,0,0,0,1806
12779,17020500,17020500,17193254,0,0,0,172754
13058,17193563,17193563,17193749,0,0,0,186
13000,17168162,17168162,17194391,0,0,0,26229
12999,17167800,17167800,17197986,0,0,0,30186
12998,17167779,17167779,17198292,0,0,0,30513
12954,17144049,17144049,17199931,0,0,0,55882
13055,17190798,17190798,17202839,0,0,0,12041
12929,17132281,17132281,17215649,0,0,0,83368
13061,17207426,17207426,17226832,0,0,0,19406
13059,17197941,17197941,17227166,0,0,0,29225
13063,17227187,17227187,17227964,0,0,0,777
13064,17227202,17227202,17227981,0,0,0,779
13065,17227213,17227213,17227993,0,0,0,780
13066,17227226,17227226,17228015,0,0,0,789
13053,17190590,17190590,17228403,0,0,0,37813
13060,17198249,17198249,17228586,0,0,0,30337
13068,17229865,17229865,17230342,0,0,0,477
13067,17228539,17228539,17230441,0,0,0,1902
13070,17230502,17230502,17231277,0,0,0,775
13071,17231953,17231953,17232726,0,0,0,773
13072,17234066,17234066,17234864,0,0,0,798
13073,17240908,17240908,17241446,0,0,0,538
13074,17241618,17241618,17241716,0,0,0,98
13075,17241692,17241692,17241810,0,0,0,118
13076,17242265,17242265,17242444,0,0,0,179
13077,17242530,17242530,17242620,0,0,0,90
13078,17242654,17242654,17242902,0,0,0,248
13079,17243617,17243617,17243737,0,0,0,120
12991,17159309,17159309,17247211,0,0,0,87902
13062,17227124,17227124,17257148,0,0,0,30024
13081,17243949,17243949,17259101,0,0,0,15152
13080,17243853,17243853,17259486,0,0,0,15633
13069,17230403,17230403,17260421,0,0,0,30018
13084,17270653,17270653,17274841,0,0,0,4188
13085,17271220,17271220,17274883,0,0,0,3663
13082,17257079,17257079,17287061,0,0,0,29982
13083,17260379,17260379,17290425,0,0,0,30046
13087,17298194,17298194,17298799,0,0,0,605
13089,17301706,17301706,17301788,0,0,0,82
13090,17301810,17301810,17301899,0,0,0,89
12924,17131778,17131778,17304578,0,0,0,172800
13088,17298810,17298810,17306158,0,0,0,7348
12811,17054306,17054306,17306906,0,0,0,252600
12812,17054323,17054323,17306923,0,0,0,252600
13091,17305346,17305346,17311268,0,0,0,5922
13093,17314219,17314219,17314626,0,0,0,407
13086,17287018,17287018,17317120,0,0,0,30102
13092,17311493,17311493,17319051,0,0,0,7558
12970,17152186,17152186,17324940,0,0,0,172754
13094,17314351,17314351,17333755,0,0,0,19404
13052,17190553,17190553,17336070,0,0,0,145517
13095,17317039,17317039,17347403,0,0,0,30364
13097,17329229,17329229,17372693,0,0,0,43464
13098,17329277,17329277,17372729,0,0,0,43452
13099,17329348,17329348,17372808,0,0,0,43460
13100,17329414,17329414,17372877,0,0,0,43463
13102,17347368,17347368,17377534,0,0,0,30166
13103,17377452,17377452,17386886,0,0,0,9434
12935,17138167,17138167,17390767,0,0,0,252600
12937,17138190,17138190,17390790,0,0,0,252600
13105,17393889,17393889,17394691,0,0,0,802
13109,17394964,17394964,17399311,0,0,0,4347
13113,17400068,17400068,17400327,0,0,0,259
13106,17394912,17394912,17400410,0,0,0,5498
13112,17394984,17394984,17400900,0,0,0,5916
13107,17394952,17394952,17400901,0,0,0,5949
13110,17394974,17394974,17400901,0,0,0,5927
13108,17394957,17394957,17400906,0,0,0,5949
13111,17394979,17394979,17400906,0,0,0,5927
13122,17401010,17401010,17401184,0,0,0,174
13114,17400173,17400173,17401793,0,0,0,1620
13115,17400224,17400224,17401818,0,0,0,1594
13116,17400242,17400242,17401825,0,0,0,1583
13132,17401799,17401799,17401869,0,0,0,70
13124,17401198,17401198,17402099,0,0,0,901
13125,17401222,17401222,17402101,0,0,0,879
13128,17401301,17401301,17402102,0,0,0,801
13123,17401166,17401166,17402103,0,0,0,937
13126,17401255,17401255,17402103,0,0,0,848
13127,17401278,17401278,17402103,0,0,0,825
13134,17402103,17402103,17402497,0,0,0,394
13137,17402114,17402114,17402497,0,0,0,383
13135,17402106,17402106,17402500,0,0,0,394
13138,17402118,17402118,17402501,0,0,0,383
13133,17402099,17402099,17402504,0,0,0,405
13136,17402110,17402110,17402504,0,0,0,394
13139,17403355,17403355,17403402,0,0,0,47
13140,17403479,17403479,17403561,0,0,0,82
13141,17403552,17403552,17403676,0,0,0,124
13142,17403745,17403745,17403843,0,0,0,98
13144,17403785,17403785,17403849,0,0,0,64
13143,17403766,17403766,17403852,0,0,0,86
13096,17329172,17329172,17403911,0,0,0,74739
13147,17403886,17403886,17404151,0,0,0,265
13149,17404085,17404085,17404201,0,0,0,116
13150,17404444,17404444,17404559,0,0,0,115
13151,17404730,17404730,17404851,0,0,0,121
13146,17403877,17403877,17404966,0,0,0,1089
13152,17405261,17405261,17405489,0,0,0,228
13145,17403862,17403862,17405719,0,0,0,1857
13153,17406952,17406952,17407192,0,0,0,240
13155,17413767,17413767,17413887,0,0,0,120
13156,17414218,17414218,17414297,0,0,0,79
13157,17414803,17414803,17414892,0,0,0,89
13131,17401786,17401786,17415753,0,0,0,13967
13130,17401767,17401767,17415756,0,0,0,13989
13117,17400288,17400288,17415770,0,0,0,15482
13129,17401750,17401750,17415773,0,0,0,14023
13158,17415915,17415915,17416106,0,0,0,191
13159,17415918,17415918,17416124,0,0,0,206
13160,17415926,17415926,17416143,0,0,0,217
13161,17415931,17415931,17416154,0,0,0,223
13163,17416084,17416084,17416693,0,0,0,609
13165,17416121,17416121,17416693,0,0,0,572
13164,17416098,17416098,17416697,0,0,0,599
13162,17416057,17416057,17416705,0,0,0,648
13104,17386848,17386848,17417125,0,0,0,30277
13169,17416670,17416670,17417871,0,0,0,1201
13166,17416660,17416660,17417872,0,0,0,1212
13167,17416664,17416664,17417876,0,0,0,1212
13168,17416667,17416667,17417879,0,0,0,1212
13171,17417241,17417241,17417972,0,0,0,731
13176,17418048,17418048,17418344,0,0,0,296
13177,17418683,17418683,17418989,0,0,0,306
13173,17417849,17417849,17419550,0,0,0,1701
13172,17417840,17417840,17419552,0,0,0,1712
13175,17417865,17417865,17419555,0,0,0,1690
13174,17417857,17417857,17419558,0,0,0,1701
13179,17419627,17419627,17419899,0,0,0,272
13180,17419790,17419790,17419940,0,0,0,150
13185,17419853,17419853,17420002,0,0,0,149
13186,17419940,17419940,17420088,0,0,0,148
13184,17419837,17419837,17420183,0,0,0,346
13187,17420065,17420065,17420219,0,0,0,154
13181,17419828,17419828,17420364,0,0,0,536
13182,17419832,17419832,17420379,0,0,0,547
13193,17420541,17420541,17420631,0,0,0,90
13194,17420645,17420645,17420735,0,0,0,90
13195,17420932,17420932,17421036,0,0,0,104
13188,17420128,17420128,17421522,0,0,0,1394
13196,17421438,17421438,17421558,0,0,0,120
13198,17421730,17421730,17421808,0,0,0,78
13183,17419835,17419835,17422620,0,0,0,2785
13190,17420333,17420333,17422662,0,0,0,2329
13192,17420367,17420367,17422663,0,0,0,2296
13191,17420350,17420350,17422668,0,0,0,2318
13189,17420164,17420164,17422669,0,0,0,2505
13199,17422595,17422595,17422711,0,0,0,116
13204,17422721,17422721,17422820,0,0,0,99
13209,17422842,17422842,17422962,0,0,0,120
13210,17423449,17423449,17423550,0,0,0,101
13211,17423697,17423697,17423775,0,0,0,78
13212,17424046,17424046,17424182,0,0,0,136
13213,17424135,17424135,17424244,0,0,0,109
13224,17427038,17427038,17427157,0,0,0,119
13227,17427073,17427073,17427159,0,0,0,86
13225,17427052,17427052,17427160,0,0,0,108
13223,17427033,17427033,17427163,0,0,0,130
13226,17427066,17427066,17427163,0,0,0,97
13219,17426290,17426290,17427831,0,0,0,1541
13234,17427207,17427207,17427831,0,0,0,624
13220,17426303,17426303,17427833,0,0,0,1530
13221,17426317,17426317,17427836,0,0,0,1519
13235,17427223,17427223,17427836,0,0,0,613
13228,17427089,17427089,17427837,0,0,0,748
13230,17427142,17427142,17427837,0,0,0,695
13214,17426121,17426121,17427838,0,0,0,1717
13231,17427154,17427154,17427838,0,0,0,684
13218,17426276,17426276,17427839,0,0,0,1563
13229,17427102,17427102,17427839,0,0,0,737
13232,17427166,17427166,17427839,0,0,0,673
13233,17427193,17427193,17427839,0,0,0,646
13215,17426151,17426151,17427840,0,0,0,1689
13216,17426177,17426177,17427840,0,0,0,1663
13217,17426203,17426203,17427840,0,0,0,1637
13101,17338068,17338068,17428228,0,0,0,90160
13243,17427997,17427997,17429254,0,0,0,1257
13246,17428010,17428010,17429256,0,0,0,1246
13249,17428021,17428021,17429256,0,0,0,1235
13238,17427978,17427978,17429257,0,0,0,1279
13244,17428000,17428000,17429257,0,0,0,1257
13253,17428033,17428033,17429257,0,0,0,1224
13202,17422662,17422662,17429258,0,0,0,6596
13203,17422673,17422673,17429258,0,0,0,6585
13241,17427990,17427990,17429258,0,0,0,1268
13247,17428013,17428013,17429259,0,0,0,1246
13250,17428024,17428024,17429259,0,0,0,1235
13239,17427982,17427982,17429261,0,0,0,1279
13242,17427993,17427993,17429261,0,0,0,1268
13251,17428026,17428026,17429261,0,0,0,1235
13245,17428005,17428005,17429262,0,0,0,1257
13240,17427985,17427985,17429264,0,0,0,1279
13248,17428018,17428018,17429264,0,0,0,1246
13252,17428029,17428029,17429264,0,0,0,1235
13200,17422635,17422635,17429265,0,0,0,6630
13201,17422646,17422646,17429265,0,0,0,6619
13274,17429960,17429960,17430090,0,0,0,130
13272,17429292,17429292,17430491,0,0,0,1199
13258,17429236,17429236,17430578,0,0,0,1342
13271,17429286,17429286,17430594,0,0,0,1308
13270,17429282,17429282,17430601,0,0,0,1319
13259,17429239,17429239,17430603,0,0,0,1364
13260,17429242,17429242,17430617,0,0,0,1375
13261,17429245,17429245,17430620,0,0,0,1375
13275,17430067,17430067,17430667,0,0,0,600
13284,17431032,17431032,17431121,0,0,0,89
13286,17431127,17431127,17431262,0,0,0,135
13287,17431308,17431308,17431401,0,0,0,93
13273,17429297,17429297,17431459,0,0,0,2162
13288,17431581,17431581,17431685,0,0,0,104
13276,17430532,17430532,17431715,0,0,0,1183
13277,17430563,17430563,17431735,0,0,0,1172
13278,17430572,17430572,17431744,0,0,0,1172
13279,17430585,17430585,17431749,0,0,0,1164
13280,17430700,17430700,17431768,0,0,0,1068
13281,17430716,17430716,17431774,0,0,0,1058
13282,17430731,17430731,17431789,0,0,0,1058
13283,17430734,17430734,17431803,0,0,0,1069
13285,17431095,17431095,17431972,0,0,0,877
13254,17429219,17429219,17432056,0,0,0,2837
13255,17429222,17429222,17432070,0,0,0,2848
13256,17429225,17429225,17432084,0,0,0,2859
13257,17429229,17429229,17432099,0,0,0,2870
13262,17429248,17429248,17432107,0,0,0,2859
13263,17429252,17429252,17432122,0,0,0,2870
13264,17429255,17429255,17432125,0,0,0,2870
13265,17429257,17429257,17432127,0,0,0,2870
13289,17431973,17431973,17432305,0,0,0,332
13303,17432288,17432288,17432407,0,0,0,119
13294,17432066,17432066,17432484,0,0,0,418
13295,17432077,17432077,17432495,0,0,0,418
13296,17432086,17432086,17432504,0,0,0,418
13297,17432094,17432094,17432512,0,0,0,418
13299,17432177,17432177,17432564,0,0,0,387
13300,17432180,17432180,17432577,0,0,0,397
13301,17432185,17432185,17432593,0,0,0,408
13302,17432188,17432188,17432596,0,0,0,408
13266,17429268,17429268,17432661,0,0,0,3393
13267,17429272,17429272,17432731,0,0,0,3459
13268,17429275,17429275,17432745,0,0,0,3470
13298,17432147,17432147,17432747,0,0,0,600
13269,17429278,17429278,17432748,0,0,0,3470
13308,17432521,17432521,17432825,0,0,0,304
13309,17432542,17432542,17432846,0,0,0,304
13311,17432556,17432556,17432871,0,0,0,315
13310,17432549,17432549,17432971,0,0,0,422
13315,17432791,17432791,17433477,0,0,0,686
13316,17432811,17432811,17433497,0,0,0,686
13317,17432828,17432828,17433503,0,0,0,675
13318,17432848,17432848,17433512,0,0,0,664
13322,17433566,17433566,17433931,0,0,0,365
13323,17433569,17433569,17433934,0,0,0,365
13320,17433530,17433530,17433937,0,0,0,407
13321,17433563,17433563,17433939,0,0,0,376
13197,17421694,17421694,17435457,0,0,0,13763
13328,17435496,17435496,17435600,0,0,0,104
13329,17435711,17435711,17435832,0,0,0,121
13330,17436129,17436129,17436256,0,0,0,127
13331,17436511,17436511,17436638,0,0,0,127
13332,17436679,17436679,17436824,0,0,0,145
13333,17436829,17436829,17436973,0,0,0,144
13304,17432443,17432443,17437006,0,0,0,4563
13305,17432454,17432454,17437006,0,0,0,4552
13306,17432462,17432462,17437025,0,0,0,4563
13307,17432474,17432474,17437037,0,0,0,4563
13324,17433944,17433944,17437054,0,0,0,3110
13325,17433947,17433947,17437057,0,0,0,3110
13326,17433950,17433950,17437071,0,0,0,3121
13327,17433954,17433954,17437075,0,0,0,3121
13342,17437067,17437067,17437246,0,0,0,179
13343,17437216,17437216,17437342,0,0,0,126
13334,17436961,17436961,17437480,0,0,0,519
13335,17436970,17436970,17437500,0,0,0,530
13336,17436984,17436984,17437504,0,0,0,520
13338,17437011,17437011,17437520,0,0,0,509
13339,17437021,17437021,17437530,0,0,0,509
13340,17437031,17437031,17437540,0,0,0,509
13341,17437040,17437040,17437549,0,0,0,509
13344,17437446,17437446,17437609,0,0,0,163
13353,17437852,17437852,17438072,0,0,0,220
13354,17438328,17438328,17438478,0,0,0,150
13355,17438565,17438565,17438713,0,0,0,148
13356,17438801,17438801,17438952,0,0,0,151
13357,17438867,17438867,17439310,0,0,0,443
13358,17439350,17439350,17439507,0,0,0,157
13359,17439589,17439589,17439996,0,0,0,407
13360,17439706,17439706,17440200,0,0,0,494
13363,17441591,17441591,17441768,0,0,0,177
13362,17441392,17441392,17441801,0,0,0,409
13291,17432030,17432030,17442028,0,0,0,9998
13361,17439914,17439914,17442495,0,0,0,2581
13290,17432015,17432015,17442699,0,0,0,10684
13293,17432052,17432052,17442725,0,0,0,10673
13292,17432043,17432043,17442727,0,0,0,10684
13319,17432880,17432880,17442732,0,0,0,9852
13312,17432691,17432691,17442752,0,0,0,10061
13313,17432699,17432699,17442760,0,0,0,10061
13314,17432709,17432709,17442783,0,0,0,10074
13365,17441779,17441779,17442975,0,0,0,1196
13364,17441742,17441742,17442982,0,0,0,1240
13345,17437454,17437454,17443301,0,0,0,5847
13376,17443261,17443261,17444279,0,0,0,1018
13346,17437748,17437748,17444293,0,0,0,6545
13347,17437753,17437753,17444298,0,0,0,6545
13348,17437757,17437757,17444302,0,0,0,6545
13349,17437768,17437768,17444313,0,0,0,6545
13350,17437777,17437777,17444322,0,0,0,6545
13351,17437782,17437782,17444327,0,0,0,6545
13352,17437787,17437787,17444343,0,0,0,6556
13170,17417048,17417048,17447164,0,0,0,30116
13385,17451212,17451212,17451336,0,0,0,124
13386,17451839,17451839,17451995,0,0,0,156
13387,17451962,17451962,17452091,0,0,0,129
13388,17452389,17452389,17452721,0,0,0,332
13389,17452679,17452679,17452835,0,0,0,156
13390,17453142,17453142,17453742,0,0,0,600
13154,17410744,17410744,17454172,0,0,0,43428
13375,17442948,17442948,17468749,0,0,0,25801
13374,17442938,17442938,17474347,0,0,0,31409
13337,17436994,17436994,17477646,0,0,0,40652
13371,17442714,17442714,17481347,0,0,0,38633
13370,17442701,17442701,17481672,0,0,0,38971
13366,17442663,17442663,17481915,0,0,0,39252
13367,17442671,17442671,17481923,0,0,0,39252
13368,17442681,17442681,17481933,0,0,0,39252
13369,17442690,17442690,17481942,0,0,0,39252
13393,17482168,17482168,17482204,0,0,0,36
13372,17442728,17442728,17482275,0,0,0,39547
13394,17482213,17482213,17482316,0,0,0,103
13395,17482300,17482300,17482459,0,0,0,159
13373,17442748,17442748,17482626,0,0,0,39878
13396,17482939,17482939,17483054,0,0,0,115
13381,17444272,17444272,17483282,0,0,0,39010
13380,17444263,17444263,17483284,0,0,0,39021
13383,17444296,17444296,17483284,0,0,0,38988
13384,17444308,17444308,17483285,0,0,0,38977
13379,17444255,17444255,17483287,0,0,0,39032
13378,17444246,17444246,17483289,0,0,0,39043
13377,17444236,17444236,17483290,0,0,0,39054
13382,17444280,17444280,17483290,0,0,0,39010
13399,17483190,17483190,17483291,0,0,0,101
13402,17483290,17483290,17483405,0,0,0,115
13404,17483583,17483583,17483695,0,0,0,112
13405,17483693,17483693,17483833,0,0,0,140
13406,17484326,17484326,17484466,0,0,0,140
13237,17427472,17427472,17484649,0,0,0,57177
13236,17427449,17427449,17486983,0,0,0,59534
13178,17419054,17419054,17486991,0,0,0,67937
13409,17484654,17484654,17488482,0,0,0,3828
13401,17483274,17483274,17488486,0,0,0,5212
13403,17483566,17483566,17488486,0,0,0,4920
13413,17485021,17485021,17488491,0,0,0,3470
13407,17484488,17484488,17488492,0,0,0,4004
13408,17484518,17484518,17488492,0,0,0,3974
13400,17483214,17483214,17488493,0,0,0,5279
13410,17484682,17484682,17488493,0,0,0,3811
13411,17484706,17484706,17488493,0,0,0,3787
13412,17484732,17484732,17488493,0,0,0,3761
13397,17483142,17483142,17488498,0,0,0,5356
13398,17483158,17483158,17488503,0,0,0,5345
13421,17488661,17488661,17488787,0,0,0,126
13423,17488677,17488677,17488792,0,0,0,115
13420,17488656,17488656,17488793,0,0,0,137
13424,17488680,17488680,17488795,0,0,0,115
13422,17488671,17488671,17488797,0,0,0,126
13419,17488639,17488639,17488798,0,0,0,159
13431,17490560,17490560,17490675,0,0,0,115
13432,17490874,17490874,17491026,0,0,0,152
13434,17491196,17491196,17491254,0,0,0,58
13433,17491169,17491169,17491307,0,0,0,138
13435,17491420,17491420,17491540,0,0,0,120
13436,17491711,17491711,17491831,0,0,0,120
13437,17492014,17492014,17492125,0,0,0,111
13438,17492156,17492156,17492237,0,0,0,81
13439,17492199,17492199,17492321,0,0,0,122
13441,17492331,17492331,17492504,0,0,0,173
13442,17492387,17492387,17492504,0,0,0,117
13443,17492393,17492393,17492505,0,0,0,112
13444,17492426,17492426,17492515,0,0,0,89
13430,17488810,17488810,17492646,0,0,0,3836
13427,17488800,17488800,17492647,0,0,0,3847
13425,17488791,17488791,17492649,0,0,0,3858
13428,17488804,17488804,17492651,0,0,0,3847
13426,17488794,17488794,17492652,0,0,0,3858
13429,17488806,17488806,17492653,0,0,0,3847
13448,17492581,17492581,17492714,0,0,0,133
13440,17492236,17492236,17492719,0,0,0,483
13446,17492512,17492512,17494145,0,0,0,1633
13457,17495465,17495465,17495580,0,0,0,115
13458,17495735,17495735,17495819,0,0,0,84
13456,17495136,17495136,17495861,0,0,0,725
13459,17495849,17495849,17495964,0,0,0,115
13445,17492492,17492492,17496010,0,0,0,3518
13449,17492586,17492586,17496021,0,0,0,3435
13447,17492544,17492544,17496022,0,0,0,3478
13460,17496117,17496117,17496257,0,0,0,140
13461,17496379,17496379,17496489,0,0,0,110
13465,17496431,17496431,17497100,0,0,0,669
13470,17497037,17497037,17497736,0,0,0,699
13474,17498502,17498502,17498618,0,0,0,116
13475,17498710,17498710,17498757,0,0,0,47
13472,17497926,17497926,17498953,0,0,0,1027
13473,17497952,17497952,17498984,0,0,0,1032
13479,17499133,17499133,17499293,0,0,0,160
13483,17499296,17499296,17499370,0,0,0,74
13490,17499981,17499981,17500041,0,0,0,60
13505,17500394,17500394,17500474,0,0,0,80
13503,17500325,17500325,17500491,0,0,0,166
13511,17500748,17500748,17500802,0,0,0,54
13508,17500441,17500441,17501411,0,0,0,970
13507,17500429,17500429,17501466,0,0,0,1037
13509,17500455,17500455,17501469,0,0,0,1014
13510,17500477,17500477,17501485,0,0,0,1008
13506,17500405,17500405,17502166,0,0,0,1761
13504,17500369,17500369,17502312,0,0,0,1943
13520,17501946,17501946,17502362,0,0,0,416
13512,17501382,17501382,17502551,0,0,0,1169
13513,17501411,17501411,17502646,0,0,0,1235
13516,17501443,17501443,17502852,0,0,0,1409
13489,17499767,17499767,17502928,0,0,0,3161
13514,17501418,17501418,17503043,0,0,0,1625
13515,17501432,17501432,17503046,0,0,0,1614
13517,17501466,17501466,17503209,0,0,0,1743
13518,17501513,17501513,17503231,0,0,0,1718
13519,17501518,17501518,17503236,0,0,0,1718
13521,17502730,17502730,17503252,0,0,0,522
13522,17503248,17503248,17503347,0,0,0,99
13523,17503357,17503357,17503464,0,0,0,107
13497,17500213,17500213,17503468,0,0,0,3255
13527,17503391,17503391,17503499,0,0,0,108
13530,17503404,17503404,17503501,0,0,0,97
13533,17503498,17503498,17503589,0,0,0,91
13532,17503497,17503497,17504458,0,0,0,961
13469,17496947,17496947,17505090,0,0,0,8143
13417,17487312,17487312,17505135,0,0,0,17823
13536,17505357,17505357,17505760,0,0,0,403
13464,17496427,17496427,17506154,0,0,0,9727
13529,17503401,17503401,17506689,0,0,0,3288
13535,17505285,17505285,17506738,0,0,0,1453
13528,17503393,17503393,17506801,0,0,0,3408
13531,17503410,17503410,17506840,0,0,0,3430
13541,17506792,17506792,17506906,0,0,0,114
13542,17506801,17506801,17506921,0,0,0,120
13539,17506394,17506394,17507648,0,0,0,1254
13524,17503381,17503381,17508100,0,0,0,4719
13525,17503385,17503385,17508128,0,0,0,4743
13526,17503390,17503390,17508179,0,0,0,4789
13540,17506786,17506786,17508217,0,0,0,1431
13544,17506861,17506861,17508238,0,0,0,1377
13545,17506889,17506889,17508259,0,0,0,1370
13555,17510113,17510113,17510288,0,0,0,175
13560,17510606,17510606,17510721,0,0,0,115
13561,17510835,17510835,17510909,0,0,0,74
13562,17511027,17511027,17511131,0,0,0,104
13543,17506829,17506829,17511633,0,0,0,4804
13567,17517984,17517984,17518089,0,0,0,105
13568,17518080,17518080,17518240,0,0,0,160
13534,17503962,17503962,17518365,0,0,0,14403
13569,17518412,17518412,17518589,0,0,0,177
13570,17521704,17521704,17521777,0,0,0,73
13571,17521794,17521794,17521898,0,0,0,104
13572,17522190,17522190,17522263,0,0,0,73
13573,17522336,17522336,17522549,0,0,0,213
13574,17522639,17522639,17522851,0,0,0,212
13576,17522960,17522960,17523027,0,0,0,67
13391,17480151,17480151,17523616,0,0,0,43465
13392,17480266,17480266,17523824,0,0,0,43558
13577,17523975,17523975,17524087,0,0,0,112
13476,17498920,17498920,17528346,0,0,0,29426
13462,17496420,17496420,17529225,0,0,0,32805
13466,17496433,17496433,17529263,0,0,0,32830
13467,17496876,17496876,17529323,0,0,0,32447
13468,17496905,17496905,17529377,0,0,0,32472
13471,17497059,17497059,17529446,0,0,0,32387
13537,17505753,17505753,17529469,0,0,0,23716
13546,17508076,17508076,17529833,0,0,0,21757
13587,17530458,17530458,17530609,0,0,0,151
13588,17530583,17530583,17530775,0,0,0,192
13484,17499569,17499569,17531087,0,0,0,31518
13453,17492651,17492651,17531221,0,0,0,38570
13579,17527425,17527425,17531313,0,0,0,3888
13589,17531226,17531226,17531528,0,0,0,302
13454,17492655,17492655,17531693,0,0,0,39038
13482,17499221,17499221,17531766,0,0,0,32545
13451,17492619,17492619,17531871,0,0,0,39252
13496,17500212,17500212,17532612,0,0,0,32400
13498,17500220,17500220,17532620,0,0,0,32400
13499,17500225,17500225,17532625,0,0,0,32400
13500,17500231,17500231,17532631,0,0,0,32400
13455,17492659,17492659,17532864,0,0,0,40205
13590,17533201,17533201,17533336,0,0,0,135
13452,17492644,17492644,17533577,0,0,0,40933
13593,17535391,17535391,17535568,0,0,0,177
13594,17535652,17535652,17535821,0,0,0,169
13595,17535797,17535797,17536235,0,0,0,438
13596,17536325,17536325,17536471,0,0,0,146
13597,17536792,17536792,17536938,0,0,0,146
13598,17537127,17537127,17537231,0,0,0,104
13599,17537419,17537419,17537636,0,0,0,217
13600,17538239,17538239,17538375,0,0,0,136
13601,17538529,17538529,17538664,0,0,0,135
13602,17538830,17538830,17538965,0,0,0,135
13603,17539169,17539169,17539293,0,0,0,124
13581,17529227,17529227,17540744,0,0,0,11517
13583,17529310,17529310,17540803,0,0,0,11493
13477,17499044,17499044,17541197,0,0,0,42153
13450,17492616,17492616,17543016,0,0,0,50400
13563,17512359,17512359,17544759,0,0,0,32400
13564,17512375,17512375,17544775,0,0,0,32400
13565,17512396,17512396,17544796,0,0,0,32400
13566,17512403,17512403,17544803,0,0,0,32400
13592,17534944,17534944,17545825,0,0,0,10881
13551,17508201,17508201,17547740,0,0,0,39539
13549,17508150,17508150,17548081,0,0,0,39931
13547,17508093,17508093,17548202,0,0,0,40109
13548,17508111,17508111,17548353,0,0,0,40242
13550,17508176,17508176,17548521,0,0,0,40345
13585,17529619,17529619,17549025,0,0,0,19406
13485,17499598,17499598,17551234,0,0,0,51636
13491,17500064,17500064,17551715,0,0,0,51651
13487,17499670,17499670,17552146,0,0,0,52476
13486,17499630,17499630,17552390,0,0,0,52760
13463,17496423,17496423,17553592,0,0,0,57169
13418,17487414,17487414,17554552,0,0,0,67138
13488,17499703,17499703,17554691,0,0,0,54988
13575,17522894,17522894,17555692,0,0,0,32798
13492,17500100,17500100,17555801,0,0,0,55701
13493,17500135,17500135,17556279,0,0,0,56144
13591,17534863,17534863,17556603,0,0,0,21740
13501,17500235,17500235,17557532,0,0,0,57297
13494,17500163,17500163,17557538,0,0,0,57375
13502,17500265,17500265,17558087,0,0,0,57822
13552,17508220,17508220,17558620,0,0,0,50400
13495,17500192,17500192,17558975,0,0,0,58783
13584,17529334,17529334,17559574,0,0,0,30240
13604,17539357,17539357,17560957,0,0,0,21600
13605,17539426,17539426,17561026,0,0,0,21600
13578,17524048,17524048,17561687,0,0,0,37639
13478,17499082,17499082,17561821,0,0,0,62739
13480,17499141,17499141,17563226,0,0,0,64085
13481,17499191,17499191,17564087,0,0,0,64896
13608,17563881,17563881,17567360,0,0,0,3479
13610,17568891,17568891,17568987,0,0,0,96
13611,17568925,17568925,17569036,0,0,0,111
13612,17569181,17569181,17569255,0,0,0,74
13613,17569334,17569334,17569404,0,0,0,70
13615,17569427,17569427,17569500,0,0,0,73
13616,17569589,17569589,17569693,0,0,0,104
13617,17569756,17569756,17569964,0,0,0,208
13222,17426404,17426404,17575378,0,0,0,148974
13148,17403975,17403975,17576775,0,0,0,172800
13621,17577026,17577026,17580477,0,0,0,3451
13609,17567803,17567803,17581749,0,0,0,13946
13629,17582634,17582634,17582758,0,0,0,124
13586,17529976,17529976,17582807,0,0,0,52831
13632,17583068,17583068,17583223,0,0,0,155
13416,17487022,17487022,17583254,0,0,0,96232
13623,17581135,17581135,17584255,0,0,0,3120
13620,17576996,17576996,17584417,0,0,0,7421
13637,17585968,17585968,17586075,0,0,0,107
13638,17586057,17586057,17586146,0,0,0,89
13633,17583161,17583161,17586263,0,0,0,3102
13645,17586570,17586570,17586636,0,0,0,66
13627,17581369,17581369,17588108,0,0,0,6739
13640,17586112,17586112,17588757,0,0,0,2645
13649,17586645,17586645,17589167,0,0,0,2522
13636,17583802,17583802,17590789,0,0,0,6987
13619,17576901,17576901,17591301,0,0,0,14400
13660,17591330,17591330,17591428,0,0,0,98
13664,17592579,17592579,17592651,0,0,0,72
13582,17529274,17529274,17593021,0,0,0,63747
13670,17593284,17593284,17593358,0,0,0,74
13606,17560717,17560717,17593814,0,0,0,33097
13671,17593857,17593857,17593931,0,0,0,74
13669,17592961,17592961,17594018,0,0,0,1057
13673,17594110,17594110,17594183,0,0,0,73
13635,17583657,17583657,17594340,0,0,0,10683
13674,17594451,17594451,17594556,0,0,0,105
13672,17593945,17593945,17594732,0,0,0,787
13634,17583493,17583493,17594766,0,0,0,11273
13675,17594702,17594702,17594771,0,0,0,69
13631,17583001,17583001,17595029,0,0,0,12028
13676,17594943,17594943,17595055,0,0,0,112
13650,17586697,17586697,17595129,0,0,0,8432
13677,17595230,17595230,17595303,0,0,0,73
13682,17595829,17595829,17595933,0,0,0,104
13580,17529189,17529189,17599488,0,0,0,70299
13715,17600139,17600139,17600279,0,0,0,140
13720,17604640,17604640,17604786,0,0,0,146
13721,17605110,17605110,17605257,0,0,0,147
13722,17605393,17605393,17605498,0,0,0,105
13723,17605819,17605819,17605988,0,0,0,169
13724,17606386,17606386,17606533,0,0,0,147
13725,17606747,17606747,17606887,0,0,0,140
13726,17607056,17607056,17607202,0,0,0,146
13639,17586078,17586078,17608496,0,0,0,22418
13614,17569376,17569376,17609116,0,0,0,39740
13659,17591313,17591313,17609313,0,0,0,18000
13661,17591336,17591336,17609336,0,0,0,18000
13662,17591342,17591342,17609342,0,0,0,18000
13630,17582872,17582872,17609638,0,0,0,26766
13728,17609596,17609596,17609766,0,0,0,170
13663,17591773,17591773,17609773,0,0,0,18000
13729,17609765,17609765,17609920,0,0,0,155
13730,17609945,17609945,17610134,0,0,0,189
13731,17610194,17610194,17610340,0,0,0,146
13607,17562583,17562583,17610435,0,0,0,47852
13732,17610604,17610604,17610717,0,0,0,113
13695,17596831,17596831,17610762,0,0,0,13931
13665,17592805,17592805,17610805,0,0,0,18000
13666,17592817,17592817,17610817,0,0,0,18000
13667,17592822,17592822,17610822,0,0,0,18000
13668,17592827,17592827,17610827,0,0,0,18000
13656,17586997,17586997,17610880,0,0,0,23883
13734,17611148,17611148,17611325,0,0,0,177
13696,17596852,17596852,17611414,0,0,0,14562
13735,17611772,17611772,17612372,0,0,0,600
13678,17595403,17595403,17613403,0,0,0,18000
13679,17595434,17595434,17613434,0,0,0,18000
13680,17595441,17595441,17613441,0,0,0,18000
13681,17595448,17595448,17613448,0,0,0,18000
13727,17608930,17608930,17614507,0,0,0,5577
13657,17587035,17587035,17615052,0,0,0,28017
13709,17597596,17597596,17615560,0,0,0,17964
13736,17612975,17612975,17619876,0,0,0,6901
13628,17581556,17581556,17622189,0,0,0,40633
13740,17623051,17623051,17623651,0,0,0,600
13741,17623708,17623708,17623949,0,0,0,241
13742,17624279,17624279,17624662,0,0,0,383
13538,17506361,17506361,17624940,0,0,0,118579
13743,17624752,17624752,17625352,0,0,0,600
13739,17622582,17622582,17626195,0,0,0,3613
13744,17626723,17626723,17627323,0,0,0,600
13745,17629012,17629012,17629592,0,0,0,580
13746,17629564,17629564,17629803,0,0,0,239
13747,17630003,17630003,17630603,0,0,0,600
13705,17597317,17597317,17633317,0,0,0,36000
13706,17597324,17597324,17633324,0,0,0,36000
13707,17597331,17597331,17633331,0,0,0,36000
13708,17597337,17597337,17633337,0,0,0,36000
13710,17598492,17598492,17634492,0,0,0,36000
13711,17598498,17598498,17634498,0,0,0,36000
13712,17598504,17598504,17634504,0,0,0,36000
13713,17598509,17598509,17634509,0,0,0,36000
13641,17586378,17586378,17634791,0,0,0,48413
13554,17510110,17510110,17638010,0,0,0,127900
13652,17586894,17586894,17638644,0,0,0,51750
13655,17586972,17586972,17638731,0,0,0,51759
13654,17586942,17586942,17638752,0,0,0,51810
13622,17581089,17581089,17638970,0,0,0,57881
13653,17586929,17586929,17639012,0,0,0,52083
13626,17581226,17581226,17639685,0,0,0,58459
13748,17640588,17640588,17640703,0,0,0,115
13749,17640923,17640923,17641131,0,0,0,208
13750,17641497,17641497,17641655,0,0,0,158
13751,17642052,17642052,17642303,0,0,0,251
13752,17642337,17642337,17642509,0,0,0,172
13714,17599543,17599543,17642774,0,0,0,43231
13753,17642753,17642753,17642869,0,0,0,116
13754,17642952,17642952,17643068,0,0,0,116
13755,17643357,17643357,17643472,0,0,0,115
13558,17510127,17510127,17643667,0,0,0,133540
13756,17643611,17643611,17643771,0,0,0,160
13716,17600648,17600648,17644121,0,0,0,43473
13717,17600684,17600684,17644154,0,0,0,43470
13718,17600704,17600704,17644236,0,0,0,43532
13719,17600820,17600820,17644248,0,0,0,43428
13757,17644906,17644906,17645054,0,0,0,148
13758,17645154,17645154,17645300,0,0,0,146
13759,17645437,17645437,17647237,0,0,0,1800
13737,17614558,17614558,17647473,0,0,0,32915
13118,17400317,17400317,17652917,0,0,0,252600
13119,17400330,17400330,17652930,0,0,0,252600
13120,17400438,17400438,17653038,0,0,0,252600
13121,17400475,17400475,17653075,0,0,0,252600
13644,17586542,17586542,17653341,0,0,0,66799
13643,17586501,17586501,17653404,0,0,0,66903
13647,17586579,17586579,17653447,0,0,0,66868
13642,17586456,17586456,17653570,0,0,0,67114
13733,17610765,17610765,17654207,0,0,0,43442
13761,17654110,17654110,17654287,0,0,0,177
13648,17586607,17586607,17654761,0,0,0,68154
13646,17586572,17586572,17655165,0,0,0,68593
13762,17654749,17654749,17655373,0,0,0,624
13763,17655660,17655660,17655868,0,0,0,208
13414,17486994,17486994,17656291,0,0,0,169297
13415,17487007,17487007,17656394,0,0,0,169387
13767,17657726,17657726,17657841,0,0,0,115
13738,17618939,17618939,17659584,0,0,0,40645
13765,17656313,17656313,17660403,0,0,0,4090
13785,17663042,17663042,17663155,0,0,0,113
13768,17657902,17657902,17663721,0,0,0,5819
13556,17510118,17510118,17663746,0,0,0,153628
13786,17663366,17663366,17664008,0,0,0,642
13787,17663366,17663366,17664008,0,0,0,642
13788,17663367,17663367,17664009,0,0,0,642
13789,17663367,17663367,17664009,0,0,0,642
13790,17663367,17663367,17664009,0,0,0,642
13796,17663369,17663369,17664011,0,0,0,642
13791,17663367,17663367,17664020,0,0,0,653
13792,17663368,17663368,17664021,0,0,0,653
13793,17663368,17663368,17664021,0,0,0,653
13794,17663368,17663368,17664021,0,0,0,653
13795,17663368,17663368,17664021,0,0,0,653
13797,17663369,17663369,17664022,0,0,0,653
13798,17663369,17663369,17664022,0,0,0,653
13799,17663370,17663370,17664023,0,0,0,653
13800,17663370,17663370,17664023,0,0,0,653
13801,17663370,17663370,17664023,0,0,0,653
13802,17663370,17663370,17664023,0,0,0,653
13803,17663370,17663370,17664023,0,0,0,653
13804,17663371,17663371,17664024,0,0,0,653
13805,17663371,17663371,17664024,0,0,0,653
13780,17661162,17661162,17664353,0,0,0,3191
13772,17658184,17658184,17664973,0,0,0,6789
13769,17657937,17657937,17665461,0,0,0,7524
13770,17658045,17658045,17665625,0,0,0,7580
13784,17662007,17662007,17666016,0,0,0,4009
13858,17666131,17666131,17666289,0,0,0,158
13771,17658159,17658159,17666685,0,0,0,8526
13782,17661329,17661329,17673093,0,0,0,11764
13205,17422727,17422727,17675327,0,0,0,252600
13206,17422757,17422757,17675357,0,0,0,252600
13207,17422786,17422786,17675386,0,0,0,252600
13208,17422816,17422816,17675416,0,0,0,252600
13760,17648825,17648825,17675888,0,0,0,27063
13863,17676101,17676101,17676175,0,0,0,74
13864,17676178,17676178,17676397,0,0,0,219
13865,17676223,17676223,17676407,0,0,0,184
13866,17676471,17676471,17676657,0,0,0,186
13867,17677407,17677407,17677841,0,0,0,434
13781,17661299,17661299,17678157,0,0,0,16858
13875,17682163,17682163,17682327,0,0,0,164
13876,17682230,17682230,17682332,0,0,0,102
13766,17656982,17656982,17685435,0,0,0,28453
13764,17655771,17655771,17686849,0,0,0,31078
13877,17682320,17682320,17689054,0,0,0,6734
13878,17682351,17682351,17692354,0,0,0,10003
13883,17694356,17694356,17694533,0,0,0,177
13884,17694526,17694526,17694738,0,0,0,212
13887,17695086,17695086,17695324,0,0,0,238
13888,17695368,17695368,17695514,0,0,0,146
13776,17660016,17660016,17696016,0,0,0,36000
13777,17660023,17660023,17696023,0,0,0,36000
13778,17660029,17660029,17696029,0,0,0,36000
13779,17660035,17660035,17696035,0,0,0,36000
13889,17695573,17695573,17696104,0,0,0,531
13890,17696076,17696076,17696357,0,0,0,281
13891,17696372,17696372,17696518,0,0,0,146
13892,17696530,17696530,17696937,0,0,0,407
13893,17696950,17696950,17697302,0,0,0,352
13894,17697314,17697314,17697522,0,0,0,208
13895,17697526,17697526,17698126,0,0,0,600
13896,17698282,17698282,17698653,0,0,0,371
13897,17698706,17698706,17699319,0,0,0,613
13618,17569959,17569959,17699559,0,0,0,129600
13862,17675961,17675961,17702112,0,0,0,26151
13898,17699282,17699282,17702882,0,0,0,3600
13899,17702558,17702558,17705029,0,0,0,2471
13553,17510104,17510104,17705252,0,0,0,195148
13901,17705660,17705660,17706823,0,0,0,1163
13873,17681043,17681043,17707162,0,0,0,26119
13902,17706928,17706928,17707373,0,0,0,445
13874,17681397,17681397,17707459,0,0,0,26062
13903,17707500,17707500,17708040,0,0,0,540
13911,17708481,17708481,17708594,0,0,0,113
13557,17510124,17510124,17708953,0,0,0,198829
13915,17708728,17708728,17709354,0,0,0,626
13908,17708003,17708003,17709370,0,0,0,1367
13921,17709313,17709313,17709374,0,0,0,61
13922,17709336,17709336,17709819,0,0,0,483
13913,17708634,17708634,17710168,0,0,0,1534
13904,17707641,17707641,17710448,0,0,0,2807
13923,17710209,17710209,17710612,0,0,0,403
13924,17710895,17710895,17711030,0,0,0,135
13918,17708913,17708913,17711153,0,0,0,2240
13917,17708859,17708859,17711294,0,0,0,2435
13916,17708797,17708797,17711564,0,0,0,2767
13905,17707712,17707712,17711650,0,0,0,3938
13910,17708090,17708090,17711845,0,0,0,3755
13906,17707902,17707902,17711852,0,0,0,3950
13925,17711278,17711278,17711942,0,0,0,664
13932,17711991,17711991,17712113,0,0,0,122
13936,17712690,17712690,17712794,0,0,0,104
13920,17709033,17709033,17712906,0,0,0,3873
13559,17510249,17510249,17712934,0,0,0,202685
13919,17708974,17708974,17712977,0,0,0,4003
13933,17712511,17712511,17713031,0,0,0,520
13879,17686556,17686556,17713100,0,0,0,26544
13912,17708549,17708549,17713235,0,0,0,4686
13914,17708725,17708725,17713343,0,0,0,4618
13939,17712995,17712995,17713412,0,0,0,417
13941,17713370,17713370,17713490,0,0,0,120
13816,17664086,17664086,17713596,0,0,0,49510
13942,17713447,17713447,17713642,0,0,0,195
13811,17664085,17664085,17713841,0,0,0,49756
13943,17713610,17713610,17713971,0,0,0,361
13944,17713934,17713934,17714082,0,0,0,148
13946,17714794,17714794,17715153,0,0,0,359
13817,17664086,17664086,17715234,0,0,0,51148
13848,17664092,17664092,17715552,0,0,0,51460
13869,17679976,17679976,17715976,0,0,0,36000
13870,17679981,17679981,17715981,0,0,0,36000
13871,17679986,17679986,17715986,0,0,0,36000
13872,17679991,17679991,17715991,0,0,0,36000
13855,17664093,17664093,17716084,0,0,0,51991
13849,17664092,17664092,17716237,0,0,0,52145
13841,17664091,17664091,17716298,0,0,0,52207
13850,17664092,17664092,17716747,0,0,0,52655
13842,17664091,17664091,17716850,0,0,0,52759
13909,17708013,17708013,17717076,0,0,0,9063
13945,17714045,17714045,17717645,0,0,0,3600
13851,17664092,17664092,17718196,0,0,0,54104
13852,17664092,17664092,17718542,0,0,0,54450
13947,17715096,17715096,17718696,0,0,0,3600
13843,17664091,17664091,17720223,0,0,0,56132
13844,17664091,17664091,17720223,0,0,0,56132
13856,17664093,17664093,17720588,0,0,0,56495
13845,17664091,17664091,17720628,0,0,0,56537
13853,17664092,17664092,17721094,0,0,0,57002
13854,17664092,17664092,17721447,0,0,0,57355
13948,17721407,17721407,17721926,0,0,0,519
13827,17664089,17664089,17721991,0,0,0,57902
13907,17707953,17707953,17722123,0,0,0,14170
13949,17721922,17721922,17722251,0,0,0,329
13824,17664088,17664088,17722457,0,0,0,58369
13658,17587074,17587074,17722865,0,0,0,135791
13812,17664085,17664085,17723036,0,0,0,58951
13950,17722489,17722489,17723038,0,0,0,549
13951,17723087,17723087,17723202,0,0,0,115
13952,17723285,17723285,17723579,0,0,0,294
13807,17664078,17664078,17723673,0,0,0,59595
13818,17664086,17664086,17723954,0,0,0,59868
13834,17664090,17664090,17724011,0,0,0,59921
13828,17664089,17664089,17724055,0,0,0,59966
13829,17664089,17664089,17724314,0,0,0,60225
13846,17664091,17664091,17724389,0,0,0,60298
13808,17664084,17664084,17725458,0,0,0,61374
13835,17664090,17664090,17726811,0,0,0,62721
13820,17664087,17664087,17726850,0,0,0,62763
13953,17723536,17723536,17727136,0,0,0,3600
13836,17664090,17664090,17727470,0,0,0,63380
13825,17664088,17664088,17727572,0,0,0,63484
13830,17664089,17664089,17727883,0,0,0,63794
13813,17664085,17664085,17727983,0,0,0,63898
13809,17664084,17664084,17728296,0,0,0,64212
13837,17664090,17664090,17728934,0,0,0,64844
13900,17705075,17705075,17730869,0,0,0,25794
13810,17664084,17664084,17731928,0,0,0,67844
13868,17677718,17677718,17731980,0,0,0,54262
13814,17664085,17664085,17733503,0,0,0,69418
13683,17596045,17596045,17733592,0,0,0,137547
13806,17663522,17663522,17734149,0,0,0,70627
13838,17664090,17664090,17735103,0,0,0,71013
13882,17692207,17692207,17735642,0,0,0,43435
13881,17692176,17692176,17735646,0,0,0,43470
13847,17664091,17664091,17735972,0,0,0,71881
13839,17664090,17664090,17736336,0,0,0,72246
13840,17664090,17664090,17737282,0,0,0,73192
13885,17694921,17694921,17738354,0,0,0,43433
13886,17694934,17694934,17738393,0,0,0,43459
13831,17664089,17664089,17738468,0,0,0,74379
13821,17664087,17664087,17738543,0,0,0,74456
13832,17664089,17664089,17739052,0,0,0,74963
13833,17664089,17664089,17740030,0,0,0,75941
13815,17664085,17664085,17741276,0,0,0,77191
13822,17664087,17664087,17742723,0,0,0,78636
13826,17664088,17664088,17743014,0,0,0,78926
13937,17712746,17712746,17743641,0,0,0,30895
13823,17664087,17664087,17743988,0,0,0,79901
13938,17712797,17712797,17744449,0,0,0,31652
13819,17664086,17664086,17745500,0,0,0,81414
13774,17658743,17658743,17754817,0,0,0,96074
13954,17730923,17730923,17755635,0,0,0,24712
13931,17711763,17711763,17756439,0,0,0,44676
13935,17712596,17712596,17756968,0,0,0,44372
13934,17712554,17712554,17757525,0,0,0,44971
13928,17711647,17711647,17758774,0,0,0,47127
13927,17711638,17711638,17759043,0,0,0,47405
13926,17711592,17711592,17759444,0,0,0,47852
13930,17711727,17711727,17759448,0,0,0,47721
13929,17711694,17711694,17759902,0,0,0,48208
13959,17764322,17764322,17764382,0,0,0,60
13960,17764384,17764384,17764444,0,0,0,60
13956,17742362,17742362,17769022,0,0,0,26660
13957,17742677,17742677,17769170,0,0,0,26493
13958,17755771,17755771,17773853,0,0,0,18082
13965,17779575,17779575,17779649,0,0,0,74
13966,17779625,17779625,17779729,0,0,0,104
13967,17779732,17779732,17779888,0,0,0,156
13968,17779896,17779896,17780042,0,0,0,146
13940,17713105,17713105,17780079,0,0,0,66974
13969,17780632,17780632,17780809,0,0,0,177
13970,17783238,17783238,17783409,0,0,0,171
13971,17783526,17783526,17783704,0,0,0,178
13972,17783751,17783751,17783929,0,0,0,178
13973,17784135,17784135,17784323,0,0,0,188
13974,17784268,17784268,17784478,0,0,0,210
13975,17784426,17784426,17784603,0,0,0,177
13976,17784646,17784646,17784865,0,0,0,219
13977,17784825,17784825,17785026,0,0,0,201
13978,17785069,17785069,17785271,0,0,0,202
13979,17785356,17785356,17785555,0,0,0,199
13980,17785498,17785498,17785582,0,0,0,84
13981,17785581,17785581,17787027,0,0,0,1446
13964,17773905,17773905,17792121,0,0,0,18216
13783,17661459,17661459,17807589,0,0,0,146130
13861,17666882,17666882,17814572,0,0,0,147690
13983,17792118,17792118,17821848,0,0,0,29730
13955,17732456,17732456,17829990,0,0,0,97534
13963,17766895,17766895,17830592,0,0,0,63697
13985,17831118,17831118,17831222,0,0,0,104
13986,17831449,17831449,17831525,0,0,0,76
13987,17831514,17831514,17831587,0,0,0,73
13984,17822016,17822016,17835621,0,0,0,13605
13961,17765876,17765876,17836049,0,0,0,70173
13962,17766626,17766626,17836156,0,0,0,69530
13651,17586854,17586854,17839454,0,0,0,252600
13624,17581167,17581167,17840367,0,0,0,259200
13625,17581199,17581199,17840399,0,0,0,259200
13686,17596219,17596219,17842608,0,0,0,246389
13988,17831621,17831621,17848202,0,0,0,16581
13992,17849142,17849142,17849252,0,0,0,110
13994,17851641,17851641,17851740,0,0,0,99
13995,17851665,17851665,17851764,0,0,0,99
13996,17851665,17851665,17851764,0,0,0,99
13997,17851688,17851688,17851798,0,0,0,110
13998,17851711,17851711,17851821,0,0,0,110
13999,17851731,17851731,17851830,0,0,0,99
14000,17851761,17851761,17851860,0,0,0,99
14001,17851777,17851777,17851876,0,0,0,99
14002,17851792,17851792,17851891,0,0,0,99
14003,17851792,17851792,17851891,0,0,0,99
14004,17851805,17851805,17851904,0,0,0,99
14005,17851817,17851817,17851916,0,0,0,99
14006,17851831,17851831,17851930,0,0,0,99
14007,17851847,17851847,17851951,0,0,0,104
14008,17851861,17851861,17851965,0,0,0,104
14009,17851878,17851878,17851982,0,0,0,104
14010,17851878,17851878,17851982,0,0,0,104
14011,17851880,17851880,17851984,0,0,0,104
14014,17851938,17851938,17852009,0,0,0,71
14012,17851919,17851919,17852023,0,0,0,104
14013,17851931,17851931,17852035,0,0,0,104
14015,17851951,17851951,17852050,0,0,0,99
14016,17852006,17852006,17852097,0,0,0,91
14019,17852050,17852050,17852119,0,0,0,69
14017,17852018,17852018,17852120,0,0,0,102
14018,17852043,17852043,17852152,0,0,0,109
14020,17852064,17852064,17852170,0,0,0,106
14021,17852068,17852068,17852174,0,0,0,106
14022,17852068,17852068,17852174,0,0,0,106
14023,17852107,17852107,17852219,0,0,0,112
14024,17852146,17852146,17852251,0,0,0,105
14025,17852180,17852180,17852281,0,0,0,101
14026,17852217,17852217,17852316,0,0,0,99
14027,17852248,17852248,17852346,0,0,0,98
14028,17852282,17852282,17852382,0,0,0,100
14029,17852294,17852294,17852393,0,0,0,99
14030,17852311,17852311,17852410,0,0,0,99
14031,17852316,17852316,17852415,0,0,0,99
14032,17852330,17852330,17852429,0,0,0,99
14033,17852346,17852346,17852445,0,0,0,99
14034,17852364,17852364,17852463,0,0,0,99
14035,17852382,17852382,17852481,0,0,0,99
14036,17852414,17852414,17852513,0,0,0,99
14037,17852438,17852438,17852537,0,0,0,99
14039,17852510,17852510,17852585,0,0,0,75
14038,17852480,17852480,17852588,0,0,0,108
14040,17852539,17852539,17852654,0,0,0,115
14041,17852591,17852591,17852686,0,0,0,95
14042,17852619,17852619,17852726,0,0,0,107
14076,17853618,17853618,17853717,0,0,0,99
14078,17853638,17853638,17853792,0,0,0,154
14050,17853351,17853351,17853876,0,0,0,525
14095,17853802,17853802,17853911,0,0,0,109
14057,17853423,17853423,17854081,0,0,0,658
14099,17853905,17853905,17854081,0,0,0,176
14100,17854030,17854030,17854204,0,0,0,174
13684,17596072,17596072,17855272,0,0,0,259200
13685,17596143,17596143,17855343,0,0,0,259200
13687,17596414,17596414,17855614,0,0,0,259200
13688,17596475,17596475,17855675,0,0,0,259200
13689,17596489,17596489,17855689,0,0,0,259200
13690,17596520,17596520,17855720,0,0,0,259200
13691,17596655,17596655,17855855,0,0,0,259200
13692,17596697,17596697,17855897,0,0,0,259200
13693,17596703,17596703,17855903,0,0,0,259200
13694,17596734,17596734,17855934,0,0,0,259200
14065,17853505,17853505,17855997,0,0,0,2492
13697,17597008,17597008,17856208,0,0,0,259200
14075,17853608,17853608,17856223,0,0,0,2615
13698,17597039,17597039,17856239,0,0,0,259200
13699,17597045,17597045,17856245,0,0,0,259200
13700,17597079,17597079,17856279,0,0,0,259200
13701,17597238,17597238,17856438,0,0,0,259200
13702,17597272,17597272,17856472,0,0,0,259200
13703,17597279,17597279,17856479,0,0,0,259200
13704,17597309,17597309,17856509,0,0,0,259200
14101,17854147,17854147,17857343,0,0,0,3196
13989,17835611,17835611,17860109,0,0,0,24498
13880,17690216,17690216,17863016,0,0,0,172800
13993,17849252,17849252,17864535,0,0,0,15283
14061,17853464,17853464,17869983,0,0,0,16519
14086,17853710,17853710,17870408,0,0,0,16698
14060,17853454,17853454,17870502,0,0,0,17048
14064,17853495,17853495,17870639,0,0,0,17144
14059,17853443,17853443,17870675,0,0,0,17232
14074,17853597,17853597,17871556,0,0,0,17959
14054,17853392,17853392,17871612,0,0,0,18220
14053,17853382,17853382,17872641,0,0,0,19259
14105,17860122,17860122,17877872,0,0,0,17750
14052,17853372,17853372,17878304,0,0,0,24932
14071,17853567,17853567,17879451,0,0,0,25884
13982,17787011,17787011,17882007,0,0,0,94996
14058,17853433,17853433,17882061,0,0,0,28628
14063,17853485,17853485,17883183,0,0,0,29698
14062,17853474,17853474,17883663,0,0,0,30189
14083,17853679,17853679,17884288,0,0,0,30609
14056,17853413,17853413,17884733,0,0,0,31320
14123,17880737,17880737,17885034,0,0,0,4297
14098,17853822,17853822,17885104,0,0,0,31282
14117,17880584,17880584,17885632,0,0,0,5048
14124,17880752,17880752,17886880,0,0,0,6128
14119,17880627,17880627,17887158,0,0,0,6531
14093,17853781,17853781,17887409,0,0,0,33628
14090,17853751,17853751,17891284,0,0,0,37533
14089,17853740,17853740,17891397,0,0,0,37657
14085,17853700,17853700,17894647,0,0,0,40947
14097,17853812,17853812,17895075,0,0,0,41263
14092,17853771,17853771,17895205,0,0,0,41434
14096,17853802,17853802,17895526,0,0,0,41724
14070,17853556,17853556,17896770,0,0,0,43214
14066,17853515,17853515,17897059,0,0,0,43544
14088,17853730,17853730,17900593,0,0,0,46863
14122,17880688,17880688,17901340,0,0,0,20652
14048,17853331,17853331,17901737,0,0,0,48406
14055,17853402,17853402,17901878,0,0,0,48476
14049,17853341,17853341,17902112,0,0,0,48771
14051,17853362,17853362,17902591,0,0,0,49229
14094,17853792,17853792,17903589,0,0,0,49797
14091,17853761,17853761,17903724,0,0,0,49963
14121,17880676,17880676,17904190,0,0,0,23514
14120,17880657,17880657,17905487,0,0,0,24830
14077,17853628,17853628,17906283,0,0,0,52655
14079,17853638,17853638,17906842,0,0,0,53204
14084,17853689,17853689,17906905,0,0,0,53216
14081,17853659,17853659,17907344,0,0,0,53685
14087,17853720,17853720,17907487,0,0,0,53767
14080,17853648,17853648,17908016,0,0,0,54368
14069,17853546,17853546,17908459,0,0,0,54913
14082,17853669,17853669,17908643,0,0,0,54974
14103,17854442,17854442,17908726,0,0,0,54284
14067,17853526,17853526,17909263,0,0,0,55737
14116,17877877,17877877,17909700,0,0,0,31823
13773,17658729,17658729,17911329,0,0,0,252600
13775,17658754,17658754,17911354,0,0,0,252600
14072,17853577,17853577,17913192,0,0,0,59615
14073,17853587,17853587,17917759,0,0,0,64172
13857,17665968,17665968,17918568,0,0,0,252600
14102,17854343,17854343,17918778,0,0,0,64435
13859,17666220,17666220,17918820,0,0,0,252600
13860,17666250,17666250,17918850,0,0,0,252600
14068,17853536,17853536,17919229,0,0,0,65693
14115,17871356,17871356,17920473,0,0,0,49117
13990,17835819,17835819,17920840,0,0,0,85021
14111,17870779,17870779,17933522,0,0,0,62743
14118,17880613,17880613,17937281,0,0,0,56668
14108,17870637,17870637,17941111,0,0,0,70474
14125,17882407,17882407,17948484,0,0,0,66077
14130,17921904,17921904,17949345,0,0,0,27441
14126,17917634,17917634,17949481,0,0,0,31847
14127,17919719,17919719,17961303,0,0,0,41584
14110,17870684,17870684,17963886,0,0,0,93202
14138,17949365,17949365,17965078,0,0,0,15713
13991,17835958,17835958,17967164,0,0,0,131206
14107,17870631,17870631,17978500,0,0,0,107869
14106,17870628,17870628,17978508,0,0,0,107880
14109,17870640,17870640,17978509,0,0,0,107869
14144,17973715,17973715,17979189,0,0,0,5474
14143,17973495,17973495,17981340,0,0,0,7845
14113,17870909,17870909,17982803,0,0,0,111894
14112,17870831,17870831,17983459,0,0,0,112628
14159,17979372,17979372,17988681,0,0,0,9309
14134,17946003,17946003,17989452,0,0,0,43449
14135,17946024,17946024,17989471,0,0,0,43447
14136,17946048,17946048,17989499,0,0,0,43451
14137,17946072,17946072,17989532,0,0,0,43460
14162,17979727,17979727,17989944,0,0,0,10217
14139,17960287,17960287,17992084,0,0,0,31797
14151,17978366,17978366,18010750,0,0,0,32384
14158,17979239,17979239,18011018,0,0,0,31779
14166,17980794,17980794,18018486,0,0,0,37692
14163,17980381,17980381,18018515,0,0,0,38134
14140,17964110,17964110,18020163,0,0,0,56053
14128,17919786,17919786,18020778,0,0,0,100992
14157,17979125,17979125,18021601,0,0,0,42476
14160,17979425,17979425,18032067,0,0,0,52642
14165,17980671,17980671,18034264,0,0,0,53593
14146,17977693,17977693,18034870,0,0,0,57177
14164,17980477,17980477,18035103,0,0,0,54626
14152,17978523,17978523,18036295,0,0,0,57772
14174,18040202,18040202,18040862,0,0,0,660
14167,18014730,18014730,18041323,0,0,0,26593
14175,18040822,18040822,18044148,0,0,0,3326
14161,17979490,17979490,18044179,0,0,0,64689
14170,18018862,18018862,18044519,0,0,0,25657
14176,18044183,18044183,18045356,0,0,0,1173
14178,18046040,18046040,18046237,0,0,0,197
14179,18046309,18046309,18047268,0,0,0,959
14181,18047971,18047971,18050180,0,0,0,2209
14183,18050138,18050138,18052310,0,0,0,2172
14148,17977924,17977924,18054187,0,0,0,76263
14168,18014767,18014767,18054687,0,0,0,39920
14169,18014782,18014782,18054709,0,0,0,39927
14182,18048127,18048127,18055295,0,0,0,7168
14186,18054650,18054650,18055713,0,0,0,1063
14185,18054631,18054631,18055716,0,0,0,1085
14187,18054671,18054671,18055721,0,0,0,1050
14184,18052464,18052464,18056064,0,0,0,3600
14180,18047618,18047618,18057178,0,0,0,9560
14188,18057991,18057991,18058044,0,0,0,53
14189,18058099,18058099,18058617,0,0,0,518
14191,18058582,18058582,18058786,0,0,0,204
14192,18058916,18058916,18059446,0,0,0,530
14194,18059403,18059403,18059996,0,0,0,593
14156,17979081,17979081,18060910,0,0,0,81829
14195,18060164,18060164,18061139,0,0,0,975
14199,18061676,18061676,18062007,0,0,0,331
14202,18062327,18062327,18063157,0,0,0,830
14201,18061877,18061877,18065989,0,0,0,4112
14196,18060329,18060329,18075901,0,0,0,15572
14177,18044545,18044545,18076323,0,0,0,31778
14114,17870962,17870962,18078245,0,0,0,207283
14147,17977841,17977841,18083685,0,0,0,105844
14149,17977998,17977998,18083939,0,0,0,105941
14200,18061780,18061780,18085486,0,0,0,23706
14197,18061261,18061261,18093082,0,0,0,31821
14141,17965109,17965109,18095887,0,0,0,130778
14131,17925186,17925186,18097986,0,0,0,172800
14210,18099894,18099894,18099954,0,0,0,60
14213,18100224,18100224,18100284,0,0,0,60
14211,18099906,18099906,18101101,0,0,0,1195
14217,18101179,18101179,18102358,0,0,0,1179
14215,18101118,18101118,18102361,0,0,0,1243
14216,18101173,18101173,18102363,0,0,0,1190
14154,17978818,17978818,18102465,0,0,0,123647
14222,18104643,18104643,18104703,0,0,0,60
14173,18022120,18022120,18105172,0,0,0,83052
14043,17852622,17852622,18105222,0,0,0,252600
14044,17852739,17852739,18105339,0,0,0,252600
14045,17852877,17852877,18105477,0,0,0,252600
14046,17852948,17852948,18105548,0,0,0,252600
14047,17853048,17853048,18105648,0,0,0,252600
14223,18105924,18105924,18105984,0,0,0,60
14224,18106043,18106043,18106103,0,0,0,60
14226,18106232,18106232,18106772,0,0,0,540
14104,17857530,17857530,18110130,0,0,0,252600
14153,17978695,17978695,18110538,0,0,0,131843
14198,18061424,18061424,18113595,0,0,0,52171
14155,17978959,17978959,18114118,0,0,0,135159
14229,18115800,18115800,18115853,0,0,0,53
14230,18115859,18115859,18115932,0,0,0,73
14228,18115737,18115737,18115934,0,0,0,197
14232,18116453,18116453,18116503,0,0,0,50
14231,18116024,18116024,18118599,0,0,0,2575
14233,18116480,18116480,18118599,0,0,0,2119
14237,18118861,18118861,18121369,0,0,0,2508
14142,17973461,17973461,18122737,0,0,0,149276
14150,17978111,17978111,18122749,0,0,0,144638
14145,17974014,17974014,18122751,0,0,0,148737
14190,18058415,18058415,18122759,0,0,0,64344
14193,18059145,18059145,18122765,0,0,0,63620
14208,18091320,18091320,18123054,0,0,0,31734
14204,18081790,18081790,18125269,0,0,0,43479
14206,18081848,18081848,18125279,0,0,0,43431
14205,18081825,18081825,18125287,0,0,0,43462
14207,18081887,18081887,18125349,0,0,0,43462
14212,18100093,18100093,18132493,0,0,0,32400
14214,18100367,18100367,18132767,0,0,0,32400
14240,18127783,18127783,18137508,0,0,0,9725
14227,18106910,18106910,18139310,0,0,0,32400
14209,18097921,18097921,18141348,0,0,0,43427
14238,18122490,18122490,18146510,0,0,0,24020
14171,18019030,18019030,18149909,0,0,0,130879
14239,18124895,18124895,18156583,0,0,0,31688
14220,18102339,18102339,18157216,0,0,0,54877
14172,18022053,18022053,18161513,0,0,0,139460
14235,18118633,18118633,18161589,0,0,0,42956
14236,18118841,18118841,18161828,0,0,0,42987
14243,18149204,18149204,18162770,0,0,0,13566
14129,17919787,17919787,18172387,0,0,0,252600
14241,18149116,18149116,18173926,0,0,0,24810
14242,18149138,18149138,18176246,0,0,0,27108
14246,18179050,18179050,18179155,0,0,0,105
14247,18179174,18179174,18179306,0,0,0,132
14244,18149215,18149215,18179566,0,0,0,30351
14132,17933287,17933287,18185887,0,0,0,252600
14133,17933311,17933311,18185911,0,0,0,252600
14253,18186769,18186769,18186844,0,0,0,75
14254,18186833,18186833,18187165,0,0,0,332
14255,18186963,18186963,18187348,0,0,0,385
14256,18187106,18187106,18187534,0,0,0,428
14258,18187646,18187646,18187815,0,0,0,169
14259,18187793,18187793,18188207,0,0,0,414
14270,18205731,18205731,18206207,0,0,0,476
14203,18063116,18063116,18207096,0,0,0,143980
14249,18186089,18186089,18208087,0,0,0,21998
14265,18194996,18208087,18208366,0,0,13091,13370
14266,18195171,18208366,18208667,0,0,13195,13496
14267,18195310,18208667,18208969,0,0,13357,13659
14272,18209872,18209872,18210018,0,0,0,146
14273,18210433,18210433,18210579,0,0,0,146
14245,18149241,18149241,18210659,0,0,0,61418
14274,18210935,18210935,18211095,0,0,0,160
14275,18211102,18211102,18212411,0,0,0,1309
14276,18214908,18214908,18215054,0,0,0,146
14277,18215170,18215170,18215351,0,0,0,181
14269,18199642,18199642,18215776,0,0,0,16134
14278,18215553,18215553,18216226,0,0,0,673
14279,18216385,18216385,18216489,0,0,0,104
14271,18208163,18210659,18225668,0,0,2496,17505
14286,18223902,18225668,18225721,0,0,1766,1819
14287,18224131,18225721,18226795,0,0,1590,2664
14288,18225162,18226795,18227009,0,0,1633,1847
14289,18225462,18227009,18227263,0,0,1547,1801
14290,18225673,18227263,18227595,0,0,1590,1922
14261,18191009,18191009,18234473,0,0,0,43464
14250,18186211,18186211,18235503,0,0,0,49292
14251,18186330,18186330,18236196,0,0,0,49866
14225,18106176,18106176,18239513,0,0,0,133337
14292,18241714,18241714,18241809,0,0,0,95
14293,18241817,18241817,18241964,0,0,0,147
14294,18242005,18242005,18242605,0,0,0,600
14295,18243190,18243190,18243336,0,0,0,146
14296,18243578,18243578,18243724,0,0,0,146
14297,18243738,18243738,18243884,0,0,0,146
14262,18194614,18194614,18245411,0,0,0,50797
14298,18246263,18246263,18246416,0,0,0,153
14263,18194635,18194635,18246525,0,0,0,51890
14299,18246772,18246772,18246905,0,0,0,133
14300,18246993,18246993,18247149,0,0,0,156
14301,18248318,18248318,18248382,0,0,0,64
14302,18248362,18248362,18248507,0,0,0,145
14303,18248463,18248463,18248642,0,0,0,179
14304,18248642,18248642,18252415,0,0,0,3773
14260,18190267,18190267,18253635,0,0,0,63368
14305,18255058,18255058,18255131,0,0,0,73
14306,18255276,18255276,18255380,0,0,0,104
14307,18255501,18255501,18255574,0,0,0,73
14264,18194669,18194669,18258155,0,0,0,63486
14221,18103407,18103407,18263275,0,0,0,159868
14311,18263685,18263685,18263806,0,0,0,121
14252,18186448,18186448,18268740,0,0,0,82292
14257,18187373,18187373,18269892,0,0,0,82519
14218,18102326,18102326,18271207,0,0,0,168881
14219,18102331,18102331,18272307,0,0,0,169976
14322,18287978,18287978,18288440,0,0,0,462
14280,18216734,18216734,18289077,0,0,0,72343
14323,18289885,18289885,18289978,0,0,0,93
14281,18217048,18225668,18293923,0,0,8620,76875
14314,18263851,18263851,18297407,0,0,0,33556
14282,18217190,18235503,18301685,0,0,18313,84495
14325,18302538,18302538,18302642,0,0,0,104
14312,18263808,18263808,18303084,0,0,0,39276
14327,18306572,18306572,18307305,0,0,0,733
14329,18307373,18307373,18307728,0,0,0,355
14330,18307693,18307693,18308257,0,0,0,564
14332,18308227,18308227,18308827,0,0,0,600
14334,18309470,18309470,18309729,0,0,0,259
14335,18311357,18311357,18311957,0,0,0,600
14336,18314354,18314354,18314878,0,0,0,524
14337,18315797,18315797,18316234,0,0,0,437
14338,18316678,18316678,18316836,0,0,0,158
14339,18316976,18316976,18317308,0,0,0,332
14340,18317401,18317401,18317547,0,0,0,146
14341,18318362,18318362,18318508,0,0,0,146
14342,18318675,18318675,18318821,0,0,0,146
14343,18318881,18318881,18319078,0,0,0,197
14308,18255643,18255643,18319543,0,0,0,63900
14344,18319441,18319441,18319598,0,0,0,157
14345,18319827,18319827,18319986,0,0,0,159
14346,18320171,18320171,18320513,0,0,0,342
14347,18321007,18321007,18321150,0,0,0,143
14348,18321143,18321143,18321258,0,0,0,115
14349,18321640,18321640,18322147,0,0,0,507
14350,18323706,18323706,18323852,0,0,0,146
14351,18323970,18323970,18324149,0,0,0,179
14352,18324755,18324755,18325052,0,0,0,297
14353,18325107,18325107,18325366,0,0,0,259
14354,18325370,18325370,18325626,0,0,0,256
14355,18325606,18325606,18325900,0,0,0,294
14356,18326041,18326041,18326190,0,0,0,149
14357,18326224,18326224,18326824,0,0,0,600
14358,18328497,18328497,18329097,0,0,0,600
14321,18281905,18281905,18345412,0,0,0,63507
14309,18263401,18263401,18348646,0,0,0,85245
14310,18263573,18263573,18348838,0,0,0,85265
14313,18263814,18263814,18349029,0,0,0,85215
14315,18263995,18263995,18349248,0,0,0,85253
14316,18264132,18264132,18349386,0,0,0,85254
14317,18264483,18264483,18349723,0,0,0,85240
14318,18264583,18264583,18349865,0,0,0,85282
14319,18264693,18264693,18349944,0,0,0,85251
14320,18264769,18264769,18350020,0,0,0,85251
14248,18180646,18180646,18353446,0,0,0,172800
14285,18219097,18239513,18368229,0,0,20416,149132
14234,18116675,18116675,18369275,0,0,0,252600
14362,18372003,18372003,18372510,0,0,0,507
14363,18374773,18374773,18374866,0,0,0,93
14283,18217937,18235503,18375012,0,0,17566,157075
14364,18376456,18376456,18376516,0,0,0,60
14284,18219043,18236196,18376891,0,0,17153,157848
14366,18377687,18377687,18388487,0,0,0,10800
14367,18377696,18377696,18388496,0,0,0,10800
14368,18378012,18378012,18388812,0,0,0,10800
14372,18393949,18393949,18394177,0,0,0,228
14373,18394254,18394254,18394462,0,0,0,208
14374,18394582,18394582,18395182,0,0,0,600
14375,18399094,18399094,18399693,0,0,0,599
14359,18342693,18342693,18403726,0,0,0,61033
14365,18376727,18376727,18412727,0,0,0,36000
14324,18302407,18302407,18440092,0,0,0,137685
14376,18399688,18399688,18442888,0,0,0,43200
14328,18306967,18306967,18445198,0,0,0,138231
14291,18238999,18238999,18446302,0,0,0,207303
14326,18304627,18304627,18447840,0,0,0,143213
14377,18407883,18407883,18451083,0,0,0,43200
14378,18407891,18407891,18451091,0,0,0,43200
14379,18407897,18407897,18451097,0,0,0,43200
14380,18407904,18407904,18451104,0,0,0,43200
14331,18308029,18308029,18457202,0,0,0,149173
14384,18461212,18461212,18461285,0,0,0,73
14385,18461376,18461376,18461528,0,0,0,152
14381,18410115,18410115,18463791,0,0,0,53676
14387,18462902,18462902,18467233,0,0,0,4331
14268,18195443,18208969,18468169,0,0,13526,272726
14333,18309197,18309197,18469461,0,0,0,160264
14382,18410134,18410134,18474954,0,0,0,64820
14360,18345497,18345497,18483602,0,0,0,138105
14388,18465317,18465317,18486891,0,0,0,21574
14389,18465339,18465339,18486897,0,0,0,21558
14383,18410283,18410283,18493827,0,0,0,83544
14369,18386574,18386574,18519922,0,0,0,133348
14371,18388833,18388833,18521381,0,0,0,132548
14361,18357471,18357471,18530271,0,0,0,172800
14370,18388749,18388749,18548835,0,0,0,160086
14391,18486886,18486886,18551383,0,0,0,64497
14393,18486926,18486926,18552900,0,0,0,65974
14390,18486864,18486864,18553369,0,0,0,66505
14396,18556165,18556165,18556300,0,0,0,135
14392,18486911,18486911,18557727,0,0,0,70816
14409,18562745,18562745,18562819,0,0,0,74
14410,18562822,18562822,18562988,0,0,0,166
14411,18563014,18563014,18563353,0,0,0,339
14412,18563547,18563547,18564054,0,0,0,507
14413,18564913,18564913,18565037,0,0,0,124
14386,18462785,18462785,18565571,0,0,0,102786
14407,18556979,18556979,18600176,0,0,0,43197
14416,18610208,18610208,18610268,0,0,0,60
14418,18610591,18610591,18610651,0,0,0,60
14417,18610399,18610399,18613912,0,0,0,3513
14419,18614945,18614945,18615005,0,0,0,60
14420,18615232,18615232,18615292,0,0,0,60
14421,18615416,18615416,18615725,0,0,0,309
14422,18615698,18615698,18615758,0,0,0,60
14424,18622591,18622591,18622808,0,0,0,217
14425,18624943,18624943,18625003,0,0,0,60
14426,18625185,18625185,18625245,0,0,0,60
14427,18625328,18625328,18625388,0,0,0,60
14428,18625799,18625799,18625859,0,0,0,60
14429,18626172,18626172,18626232,0,0,0,60
14430,18626627,18626627,18626747,0,0,0,120
14431,18627164,18627164,18627284,0,0,0,120
14432,18627732,18627732,18627852,0,0,0,120
14433,18628047,18628047,18628162,0,0,0,115
14434,18628409,18628409,18628529,0,0,0,120
14394,18537235,18537235,18629811,0,0,0,92576
14436,18629470,18629470,18630683,0,0,0,1213
14438,18631009,18631009,18631164,0,0,0,155
14439,18631049,18631049,18631169,0,0,0,120
14440,18631344,18631344,18631464,0,0,0,120
14442,18631955,18631955,18632062,0,0,0,107
14443,18634923,18634923,18635043,0,0,0,120
14444,18635857,18635857,18635977,0,0,0,120
14397,18556383,18556383,18641627,0,0,0,85244
14398,18556417,18556417,18641663,0,0,0,85246
14399,18556454,18556454,18641669,0,0,0,85215
14400,18556485,18556485,18641727,0,0,0,85242
14401,18556522,18556522,18641771,0,0,0,85249
14403,18556554,18556554,18641814,0,0,0,85260
14404,18556664,18556664,18641929,0,0,0,85265
14405,18556721,18556721,18641982,0,0,0,85261
14406,18556762,18556762,18642022,0,0,0,85260
14414,18600237,18600237,18656970,0,0,0,56733
14415,18607430,18607430,18693830,0,0,0,86400
14437,18630383,18630383,18695874,0,0,0,65491
14445,18694234,18694234,18695962,0,0,0,1728
14447,18701043,18701043,18704643,0,0,0,3600
14402,18556548,18556548,18711249,0,0,0,154701
14449,18710202,18710202,18713802,0,0,0,3600
14453,18713603,18713603,18714203,0,0,0,600
14454,18713604,18713604,18714204,0,0,0,600
14455,18713604,18713604,18714204,0,0,0,600
14456,18713604,18713604,18714204,0,0,0,600
14457,18713604,18713604,18714204,0,0,0,600
14458,18713604,18713604,18714204,0,0,0,600
14459,18713635,18713635,18714235,0,0,0,600
14460,18713636,18713636,18714236,0,0,0,600
14461,18713636,18713636,18714236,0,0,0,600
14462,18713636,18713636,18714236,0,0,0,600
14463,18713636,18713636,18714236,0,0,0,600
14464,18713637,18713637,18714237,0,0,0,600
14465,18713637,18713637,18714237,0,0,0,600
14466,18713637,18713637,18714237,0,0,0,600
14467,18713638,18713638,18714238,0,0,0,600
14468,18713638,18713638,18714238,0,0,0,600
14469,18713638,18713638,18714238,0,0,0,600
14470,18713638,18713638,18714238,0,0,0,600
14471,18713639,18713639,18714239,0,0,0,600
14472,18713639,18713639,18714239,0,0,0,600
14473,18713639,18713639,18714239,0,0,0,600
14474,18713639,18713639,18714239,0,0,0,600
14475,18713640,18713640,18714240,0,0,0,600
14476,18713640,18713640,18714240,0,0,0,600
14477,18713640,18713640,18714240,0,0,0,600
14478,18713640,18713640,18714240,0,0,0,600
14479,18713641,18713641,18714241,0,0,0,600
14480,18713641,18713641,18714241,0,0,0,600
14481,18713641,18713641,18714241,0,0,0,600
14482,18713641,18713641,18714241,0,0,0,600
14483,18713641,18713641,18714241,0,0,0,600
14484,18713642,18713642,18714242,0,0,0,600
14485,18715450,18715450,18715480,0,0,0,30
14487,18717262,18717262,18717282,0,0,0,20
14408,18557445,18557445,18717568,0,0,0,160123
14446,18695876,18695876,18717805,0,0,0,21929
14451,18713065,18713065,18720714,0,0,0,7649
14491,18721163,18721163,18721281,0,0,0,118
14492,18721845,18721845,18723840,0,0,0,1995
14395,18555959,18555959,18728759,0,0,0,172800
14452,18713264,18713264,18732595,0,0,0,19331
14486,18715692,18715692,18734474,0,0,0,18782
14488,18717480,18717480,18739398,0,0,0,21918
14490,18718668,18718668,18740238,0,0,0,21570
14489,18718652,18718652,18740350,0,0,0,21698
14499,18741497,18741497,18741736,0,0,0,239
14500,18741713,18741713,18741766,0,0,0,53
14501,18742294,18742294,18742411,0,0,0,117
14502,18742357,18742357,18742462,0,0,0,105
14503,18742474,18742474,18742602,0,0,0,128
14450,18712536,18712536,18748536,0,0,0,36000
14435,18629246,18629246,18762306,0,0,0,133060
14506,18781181,18781181,18783215,0,0,0,2034
14507,18784591,18784591,18784706,0,0,0,115
14525,18784909,18784909,18785098,0,0,0,189
14508,18784902,18784902,18785102,0,0,0,200
14509,18784903,18784903,18785103,0,0,0,200
14510,18784903,18784903,18785103,0,0,0,200
14511,18784903,18784903,18785103,0,0,0,200
14521,18784908,18784908,18785103,0,0,0,195
14522,18784908,18784908,18785125,0,0,0,217
14516,18784907,18784907,18785144,0,0,0,237
14517,18784907,18784907,18785144,0,0,0,237
14518,18784907,18784907,18785144,0,0,0,237
14519,18784907,18784907,18785144,0,0,0,237
14524,18784908,18784908,18785150,0,0,0,242
14526,18784909,18784909,18785151,0,0,0,242
14527,18784909,18784909,18785151,0,0,0,242
14520,18784907,18784907,18785155,0,0,0,248
14523,18784908,18784908,18785156,0,0,0,248
14512,18784903,18784903,18785157,0,0,0,254
14513,18784903,18784903,18785157,0,0,0,254
14514,18784903,18784903,18785157,0,0,0,254
14515,18784903,18784903,18785157,0,0,0,254
14529,18787440,18787440,18787664,0,0,0,224
14534,18787693,18787693,18787869,0,0,0,176
14541,18787904,18787904,18788132,0,0,0,228
14542,18788157,18788157,18789894,0,0,0,1737
14543,18790532,18790532,18790684,0,0,0,152
14448,18707887,18707887,18790732,0,0,0,82845
14547,18792236,18792236,18798892,0,0,0,6656
14548,18792360,18792360,18798892,0,0,0,6532
14539,18787786,18787786,18808464,0,0,0,20678
14540,18787804,18787804,18808532,0,0,0,20728
14537,18787747,18787747,18808812,0,0,0,21065
14538,18787761,18787761,18808879,0,0,0,21118
14535,18787712,18787712,18811941,0,0,0,24229
14536,18787728,18787728,18812041,0,0,0,24313
14533,18787538,18787538,18814138,0,0,0,26600
14532,18787522,18787522,18814315,0,0,0,26793
14530,18787474,18787474,18814357,0,0,0,26883
14531,18787496,18787496,18814357,0,0,0,26861
14496,18730262,18730262,18815587,0,0,0,85325
14528,18787396,18787396,18817530,0,0,0,30134
14545,18790647,18790647,18820980,0,0,0,30333
14549,18808422,18808422,18829016,0,0,0,20594
14550,18808493,18808493,18829078,0,0,0,20585
14551,18808773,18808773,18829707,0,0,0,20934
14553,18811904,18811904,18835997,0,0,0,24093
14554,18811966,18811966,18836099,0,0,0,24133
14555,18814095,18814095,18840384,0,0,0,26289
14556,18814267,18814267,18840740,0,0,0,26473
14557,18814274,18814274,18840908,0,0,0,26634
14558,18814277,18814277,18841139,0,0,0,26862
14559,18817490,18817490,18847583,0,0,0,30093
14561,18820937,18820937,18850932,0,0,0,29995
14552,18808838,18808838,18852038,0,0,0,43200
14493,18722864,18722864,18853682,0,0,0,130818
14504,18776392,18776392,18862792,0,0,0,86400
14495,18726348,18726348,18867472,0,0,0,141124
14546,18790703,18790703,18867511,0,0,0,76808
14497,18730347,18730347,18867996,0,0,0,137649
14544,18790621,18790621,18868871,0,0,0,78250
14562,18868313,18868313,18879113,0,0,0,10800
14423,18621707,18621707,18880907,0,0,0,259200
14566,18881968,18881968,18882117,0,0,0,149
14498,18730518,18730518,18890674,0,0,0,160156
14560,18818631,18818631,18890846,0,0,0,72215
14568,18891418,18891418,18891458,0,0,0,40
14505,18779277,18779277,18917879,0,0,0,138602
14570,18942640,18942640,18942786,0,0,0,146
14563,18871673,18871673,18946774,0,0,0,75101
14564,18871696,18871696,18949880,0,0,0,78184
14567,18883152,18883152,18976140,0,0,0,92988
14441,18631390,18631390,18976990,0,0,0,345600
14572,18944825,18944825,18999875,0,0,0,55050
14575,19000917,19000917,19001370,0,0,0,453
14565,18879533,18879533,19001674,0,0,0,122141
14494,18724201,18724201,19001681,0,0,0,277480
14576,19001896,19001896,19002290,0,0,0,394
14577,19003545,19003545,19003698,0,0,0,153
14578,19003714,19003714,19004148,0,0,0,434
14579,19006528,19006528,19007254,0,0,0,726
14581,19008851,19008851,19008973,0,0,0,122
14582,19009162,19009162,19009534,0,0,0,372
14583,19010036,19010036,19010438,0,0,0,402
14569,18894225,18894225,19053980,0,0,0,159755
14586,19048947,19048947,19056553,0,0,0,7606
14587,19062222,19062222,19064246,0,0,0,2024
14573,18959256,18959256,19111729,0,0,0,152473
14571,18944602,18944602,19117402,0,0,0,172800
14574,18976896,18976896,19146605,0,0,0,169709
14594,19198364,19198364,19201976,0,0,0,3612
14595,19203670,19203670,19207313,0,0,0,3643
14598,19209652,19209652,19209762,0,0,0,110
14600,19209726,19209726,19209799,0,0,0,73
14599,19209700,19209700,19209976,0,0,0,276
14597,19209512,19209512,19209988,0,0,0,476
14593,19155378,19155378,19210373,0,0,0,54995
14589,19140510,19140510,19210627,0,0,0,70117
14590,19141050,19141050,19210787,0,0,0,69737
14588,19139308,19139308,19210848,0,0,0,71540
14596,19207799,19207799,19211346,0,0,0,3547
14611,19213679,19213679,19213743,0,0,0,64
14612,19213772,19213772,19213918,0,0,0,146
14615,19214781,19214781,19214885,0,0,0,104
14605,19211575,19211575,19215109,0,0,0,3534
14616,19215283,19215283,19215449,0,0,0,166
14617,19215897,19215897,19216001,0,0,0,104
14619,19216531,19216531,19216624,0,0,0,93
14620,19216807,19216807,19216927,0,0,0,120
14621,19216933,19216933,19217068,0,0,0,135
14622,19217034,19217034,19217835,0,0,0,801
14623,19217330,19217330,19217861,0,0,0,531
14624,19217670,19217670,19218416,0,0,0,746
14625,19218363,19218363,19218709,0,0,0,346
14628,19218868,19218868,19218941,0,0,0,73
14629,19218991,19218991,19219075,0,0,0,84
14631,19219104,19219104,19219189,0,0,0,85
14618,19215964,19215964,19219425,0,0,0,3461
14634,19219540,19219540,19219763,0,0,0,223
14627,19218836,19218836,19220364,0,0,0,1528
14626,19218462,19218462,19220372,0,0,0,1910
14636,19220314,19220314,19220520,0,0,0,206
14639,19221430,19221430,19224986,0,0,0,3556
14646,19226665,19226665,19226835,0,0,0,170
14650,19227935,19227935,19228012,0,0,0,77
14651,19227936,19227936,19228013,0,0,0,77
14652,19227936,19227936,19228013,0,0,0,77
14653,19227936,19227936,19228013,0,0,0,77
14654,19227936,19227936,19228013,0,0,0,77
14655,19227936,19227936,19228013,0,0,0,77
14656,19227936,19227936,19228013,0,0,0,77
14657,19227936,19227936,19228013,0,0,0,77
14658,19227937,19227937,19228047,0,0,0,110
14659,19227937,19227937,19228047,0,0,0,110
14660,19227937,19227937,19228078,0,0,0,141
14661,19227937,19227937,19228078,0,0,0,141
14662,19227937,19227937,19228078,0,0,0,141
14663,19228147,19228147,19228223,0,0,0,76
14664,19228147,19228147,19228223,0,0,0,76
14665,19228147,19228147,19228223,0,0,0,76
14666,19228147,19228147,19228223,0,0,0,76
14667,19228147,19228147,19228223,0,0,0,76
14668,19228148,19228148,19228224,0,0,0,76
14669,19228148,19228148,19228224,0,0,0,76
14670,19228148,19228148,19228224,0,0,0,76
14671,19228148,19228148,19228257,0,0,0,109
14672,19228148,19228148,19228268,0,0,0,120
14673,19228148,19228148,19228291,0,0,0,143
14674,19228148,19228148,19228291,0,0,0,143
14675,19228149,19228149,19228323,0,0,0,174
14644,19225026,19225026,19228655,0,0,0,3629
14676,19228612,19228612,19228692,0,0,0,80
14647,19226904,19226904,19229312,0,0,0,2408
14677,19229538,19229538,19229614,0,0,0,76
14678,19229539,19229539,19229615,0,0,0,76
14679,19229539,19229539,19229615,0,0,0,76
14680,19229539,19229539,19229615,0,0,0,76
14681,19229539,19229539,19229615,0,0,0,76
14682,19229539,19229539,19229615,0,0,0,76
14683,19229539,19229539,19229615,0,0,0,76
14684,19229539,19229539,19229615,0,0,0,76
14685,19229540,19229540,19229649,0,0,0,109
14686,19229540,19229540,19229660,0,0,0,120
14687,19229540,19229540,19229682,0,0,0,142
14688,19229540,19229540,19229682,0,0,0,142
14689,19229540,19229540,19229714,0,0,0,174
14691,19229768,19229768,19229809,0,0,0,41
14690,19229762,19229762,19229820,0,0,0,58
14692,19229768,19229768,19229842,0,0,0,74
14693,19229768,19229768,19229842,0,0,0,74
14694,19229768,19229768,19229842,0,0,0,74
14695,19229769,19229769,19229874,0,0,0,105
14696,19229769,19229769,19229874,0,0,0,105
14697,19230009,19230009,19230166,0,0,0,157
14698,19230009,19230009,19230166,0,0,0,157
14699,19230009,19230009,19230239,0,0,0,230
14648,19226914,19226914,19230331,0,0,0,3417
14700,19230010,19230010,19230333,0,0,0,323
14637,19220400,19220400,19230353,0,0,0,9953
14649,19226924,19226924,19230353,0,0,0,3429
14704,19230293,19230293,19230392,0,0,0,99
14701,19230010,19230010,19230467,0,0,0,457
14702,19230010,19230010,19230602,0,0,0,592
14703,19230010,19230010,19230610,0,0,0,600
14706,19230750,19230750,19231464,0,0,0,714
14705,19230373,19230373,19231516,0,0,0,1143
14711,19231923,19231923,19232075,0,0,0,152
14591,19147181,19147181,19232366,0,0,0,85185
14715,19232700,19232700,19232773,0,0,0,73
14584,19010892,19010892,19232829,0,0,0,221937
14585,19011569,19011569,19233179,0,0,0,221610
14580,19008123,19008123,19233231,0,0,0,225108
14713,19231943,19231943,19233915,0,0,0,1972
14717,19234294,19234294,19234351,0,0,0,57
14718,19234294,19234294,19234373,0,0,0,79
14720,19234310,19234310,19234394,0,0,0,84
14719,19234294,19234294,19234404,0,0,0,110
14707,19231180,19231180,19234724,0,0,0,3544
14709,19231282,19231282,19236530,0,0,0,5248
14722,19236953,19236953,19237053,0,0,0,100
14714,19232195,19232195,19237089,0,0,0,4894
14724,19237134,19237134,19237249,0,0,0,115
14708,19231217,19231217,19237543,0,0,0,6326
14725,19237574,19237574,19237656,0,0,0,82
14726,19237901,19237901,19238027,0,0,0,126
14721,19234789,19234789,19238425,0,0,0,3636
14723,19236980,19236980,19241081,0,0,0,4101
14730,19241888,19241888,19241960,0,0,0,72
14731,19242035,19242035,19242100,0,0,0,65
14732,19242061,19242061,19242139,0,0,0,78
14733,19242099,19242099,19242171,0,0,0,72
14728,19238512,19238512,19242214,0,0,0,3702
14734,19242187,19242187,19242280,0,0,0,93
14735,19242213,19242213,19242287,0,0,0,74
14635,19220253,19220253,19245022,0,0,0,24769
14638,19220653,19220653,19245979,0,0,0,25326
14736,19242928,19242928,19246707,0,0,0,3779
14633,19219536,19219536,19249663,0,0,0,30127
14738,19247294,19249663,19253362,0,0,2369,6068
14739,19251195,19251195,19255020,0,0,0,3825
14712,19231932,19231932,19255208,0,0,0,23276
14727,19238345,19238345,19255338,0,0,0,16993
14740,19252957,19252957,19256301,0,0,0,3344
14742,19257051,19257051,19257233,0,0,0,182
14741,19255060,19255060,19258903,0,0,0,3843
14743,19259255,19259255,19263072,0,0,0,3817
14645,19226023,19245022,19269192,0,0,18999,43169
14641,19223914,19223914,19277275,0,0,0,53361
14640,19223304,19223304,19278357,0,0,0,55053
14632,19219126,19219126,19282679,0,0,0,63553
14642,19224097,19224097,19284746,0,0,0,60649
14744,19283427,19283427,19287398,0,0,0,3971
14745,19287541,19287541,19291432,0,0,0,3891
14737,19246820,19249663,19292863,0,0,2843,46043
14729,19240715,19240715,19295752,0,0,0,55037
14746,19292814,19292814,19296686,0,0,0,3872
14607,19212002,19212002,19296831,0,0,0,84829
14608,19212097,19212097,19296831,0,0,0,84734
14606,19211913,19211913,19297781,0,0,0,85868
14752,19299459,19299459,19300101,0,0,0,642
14749,19296831,19296831,19300678,0,0,0,3847
14753,19300678,19300678,19300782,0,0,0,104
14754,19301108,19301108,19302126,0,0,0,1018
14758,19302514,19302514,19302642,0,0,0,128
14759,19302873,19302873,19302977,0,0,0,104
14760,19303021,19303021,19303167,0,0,0,146
14761,19303131,19303131,19303277,0,0,0,146
14762,19303663,19303663,19303767,0,0,0,104
14643,19224934,19224934,19303783,0,0,0,78849
14756,19301186,19301186,19304619,0,0,0,3433
14763,19304052,19304052,19304655,0,0,0,603
14764,19304828,19304828,19304974,0,0,0,146
14601,19210039,19210039,19305363,0,0,0,95324
14765,19305383,19305383,19305462,0,0,0,79
14766,19305389,19305389,19305482,0,0,0,93
14767,19305423,19305423,19305493,0,0,0,70
14768,19305429,19305429,19305517,0,0,0,88
14769,19305429,19305429,19305548,0,0,0,119
14770,19305429,19305429,19305548,0,0,0,119
14771,19305429,19305429,19305548,0,0,0,119
14772,19305446,19305446,19305592,0,0,0,146
14773,19305518,19305518,19305619,0,0,0,101
14774,19305628,19305628,19305774,0,0,0,146
14775,19305847,19305847,19305932,0,0,0,85
14776,19305855,19305855,19305961,0,0,0,106
14777,19306015,19306015,19306141,0,0,0,126
14778,19306715,19306715,19306763,0,0,0,48
14780,19306721,19306721,19306795,0,0,0,74
14781,19306721,19306721,19306795,0,0,0,74
14782,19306721,19306721,19306795,0,0,0,74
14783,19306722,19306722,19306796,0,0,0,74
14779,19306720,19306720,19306847,0,0,0,127
14784,19306722,19306722,19306849,0,0,0,127
14785,19306722,19306722,19306849,0,0,0,127
14786,19306899,19306899,19307026,0,0,0,127
14787,19306969,19306969,19307075,0,0,0,106
14755,19301120,19301120,19307885,0,0,0,6765
14788,19307870,19307870,19307987,0,0,0,117
14747,19295292,19295292,19308013,0,0,0,12721
14604,19210080,19210080,19308617,0,0,0,98537
14603,19210061,19210061,19310073,0,0,0,100012
14602,19210049,19210049,19310083,0,0,0,100034
14789,19308024,19308024,19310400,0,0,0,2376
14792,19310073,19310073,19310542,0,0,0,469
14791,19310063,19310063,19310543,0,0,0,480
14793,19310085,19310085,19310543,0,0,0,458
14794,19310094,19310094,19310552,0,0,0,458
14790,19310050,19310050,19310553,0,0,0,503
14795,19310125,19310125,19310553,0,0,0,428
14797,19310446,19310446,19310697,0,0,0,251
14804,19310937,19310937,19312090,0,0,0,1153
14806,19312047,19312047,19312120,0,0,0,73
14808,19312284,19312284,19312368,0,0,0,84
14802,19310815,19310815,19312472,0,0,0,1657
14799,19310794,19310794,19312473,0,0,0,1679
14803,19310818,19310818,19312475,0,0,0,1657
14805,19311276,19311276,19312476,0,0,0,1200
14800,19310798,19310798,19312477,0,0,0,1679
14798,19310788,19310788,19312478,0,0,0,1690
14801,19310802,19310802,19312481,0,0,0,1679
14809,19312715,19312715,19312819,0,0,0,104
14810,19312825,19312825,19312938,0,0,0,113
14811,19312837,19312837,19312939,0,0,0,102
14813,19312990,19312990,19313063,0,0,0,73
14815,19313279,19313279,19313361,0,0,0,82
14816,19313345,19313345,19313412,0,0,0,67
14825,19313359,19313359,19313428,0,0,0,69
14817,19313351,19313351,19313432,0,0,0,81
14818,19313351,19313351,19313432,0,0,0,81
14834,19313390,19313390,19313441,0,0,0,51
14819,19313351,19313351,19313454,0,0,0,103
14820,19313351,19313351,19313454,0,0,0,103
14821,19313352,19313352,19313455,0,0,0,103
14822,19313352,19313352,19313455,0,0,0,103
14823,19313352,19313352,19313455,0,0,0,103
14826,19313359,19313359,19313462,0,0,0,103
14827,19313359,19313359,19313462,0,0,0,103
14828,19313360,19313360,19313463,0,0,0,103
14829,19313360,19313360,19313463,0,0,0,103
14830,19313360,19313360,19313463,0,0,0,103
14824,19313352,19313352,19313465,0,0,0,113
14831,19313360,19313360,19313480,0,0,0,120
14833,19313360,19313463,19313548,0,0,103,188
14832,19313360,19313455,19313575,0,0,95,215
14835,19313462,19313462,19313575,0,0,0,113
14836,19313520,19313520,19313629,0,0,0,109
14837,19313637,19313637,19313744,0,0,0,107
14838,19313784,19313784,19313891,0,0,0,107
14839,19314212,19314212,19314320,0,0,0,108
14840,19314359,19314359,19314558,0,0,0,199
14807,19312137,19312137,19314585,0,0,0,2448
14841,19314532,19314532,19314855,0,0,0,323
14842,19314952,19314952,19315388,0,0,0,436
14843,19315506,19315506,19315579,0,0,0,73
14847,19315513,19315513,19315602,0,0,0,89
14850,19315514,19315514,19315623,0,0,0,109
14844,19315512,19315512,19315632,0,0,0,120
14845,19315512,19315512,19315632,0,0,0,120
14846,19315512,19315512,19315632,0,0,0,120
14848,19315513,19315513,19315633,0,0,0,120
14849,19315513,19315513,19315633,0,0,0,120
14852,19315886,19315886,19315959,0,0,0,73
14630,19219040,19219040,19315977,0,0,0,96937
14851,19315514,19315623,19316046,0,0,109,532
14854,19316691,19316691,19316764,0,0,0,73
14855,19316697,19316697,19316786,0,0,0,89
14856,19316697,19316697,19316786,0,0,0,89
14857,19316698,19316698,19316787,0,0,0,89
14862,19316699,19316699,19316807,0,0,0,108
14858,19316698,19316698,19316818,0,0,0,120
14859,19316698,19316698,19316818,0,0,0,120
14860,19316698,19316698,19316818,0,0,0,120
14861,19316698,19316698,19316818,0,0,0,120
14863,19316851,19316851,19316903,0,0,0,52
14865,19316858,19316858,19316926,0,0,0,68
14864,19316857,19316857,19316970,0,0,0,113
14866,19316858,19316858,19316971,0,0,0,113
14867,19316858,19316858,19316971,0,0,0,113
14868,19316858,19316858,19316971,0,0,0,113
14869,19316859,19316859,19316980,0,0,0,121
14870,19316859,19316859,19316980,0,0,0,121
14872,19316987,19316987,19317093,0,0,0,106
14873,19316992,19316992,19317098,0,0,0,106
14871,19316981,19316981,19317099,0,0,0,118
14874,19317098,19317098,19317171,0,0,0,73
14877,19317105,19317105,19317198,0,0,0,93
14882,19317106,19317106,19317200,0,0,0,94
14875,19317104,19317104,19317228,0,0,0,124
14876,19317104,19317104,19317228,0,0,0,124
14878,19317105,19317105,19317229,0,0,0,124
14879,19317105,19317105,19317229,0,0,0,124
14880,19317105,19317105,19317229,0,0,0,124
14881,19317105,19317105,19317229,0,0,0,124
14796,19310357,19310357,19317440,0,0,0,7083
14812,19312898,19312898,19318805,0,0,0,5907
14814,19313150,19313150,19318816,0,0,0,5666
14886,19318782,19318782,19318873,0,0,0,91
14887,19318784,19318784,19318886,0,0,0,102
14888,19318794,19318794,19318916,0,0,0,122
14889,19318799,19318799,19318921,0,0,0,122
14890,19318803,19318803,19318925,0,0,0,122
14892,19318840,19318840,19319024,0,0,0,184
14899,19319412,19319412,19319471,0,0,0,59
14900,19319435,19319435,19319505,0,0,0,70
14905,19319436,19319436,19319517,0,0,0,81
14917,19319438,19319438,19319519,0,0,0,81
14924,19319439,19319439,19319520,0,0,0,81
14934,19319463,19319463,19319534,0,0,0,71
14901,19319435,19319435,19319538,0,0,0,103
14902,19319435,19319435,19319538,0,0,0,103
14906,19319436,19319436,19319539,0,0,0,103
14918,19319438,19319438,19319541,0,0,0,103
14907,19319436,19319436,19319550,0,0,0,114
14908,19319436,19319436,19319550,0,0,0,114
14911,19319437,19319437,19319551,0,0,0,114
14912,19319437,19319437,19319551,0,0,0,114
14919,19319438,19319438,19319552,0,0,0,114
14920,19319438,19319438,19319552,0,0,0,114
14925,19319439,19319439,19319553,0,0,0,114
14926,19319439,19319439,19319553,0,0,0,114
14904,19319435,19319435,19319555,0,0,0,120
14930,19319462,19319462,19319555,0,0,0,93
14903,19319435,19319435,19319560,0,0,0,125
14909,19319436,19319436,19319561,0,0,0,125
14910,19319436,19319436,19319577,0,0,0,141
14913,19319437,19319437,19319587,0,0,0,150
14937,19319464,19319505,19319623,0,0,41,159
14941,19319465,19319539,19319630,0,0,74,165
14942,19319465,19319551,19319631,0,0,86,166
14935,19319463,19319541,19319643,0,0,78,180
14943,19319465,19319560,19319645,0,0,95,180
14929,19319461,19319538,19319647,0,0,77,186
14931,19319462,19319534,19319652,0,0,72,190
14938,19319464,19319550,19319652,0,0,86,188
14914,19319437,19319555,19319665,0,0,118,228
14922,19319438,19319555,19319668,0,0,117,230
14932,19319462,19319560,19319669,0,0,98,207
14927,19319439,19319560,19319672,0,0,121,233
14928,19319439,19319577,19319677,0,0,138,238
14921,19319438,19319553,19319678,0,0,115,240
14915,19319437,19319555,19319679,0,0,118,242
14936,19319463,19319587,19319710,0,0,124,247
14944,19319465,19319647,19319770,0,0,182,305
14939,19319464,19319668,19319796,0,0,204,332
14916,19319437,19319677,19319833,0,0,240,396
14923,19319438,19319770,19319893,0,0,332,455
14933,19319462,19319833,19319990,0,0,371,528
14940,19319464,19319893,19320018,0,0,429,554
14592,19155213,19155213,19328013,0,0,0,172800
14891,19318819,19318819,19328432,0,0,0,9613
14883,19317964,19317964,19329528,0,0,0,11564
14884,19317989,19317989,19329575,0,0,0,11586
14885,19318016,19318016,19329686,0,0,0,11670
14897,19319248,19319248,19337001,0,0,0,17753
14953,19340795,19340795,19340922,0,0,0,127
14954,19340901,19340901,19341123,0,0,0,222
14955,19345992,19345992,19346468,0,0,0,476
14751,19296979,19296979,19348083,0,0,0,51104
14949,19326338,19326338,19352122,0,0,0,25784
14893,19318863,19318863,19356050,0,0,0,37187
14757,19301295,19301295,19356415,0,0,0,55120
14894,19318887,19318887,19362087,0,0,0,43200
14895,19318985,19318985,19362185,0,0,0,43200
14896,19319027,19319027,19362227,0,0,0,43200
14898,19319265,19319265,19362465,0,0,0,43200
14716,19233686,19246707,19379089,0,0,13021,145403
14950,19326815,19326815,19385111,0,0,0,58296
14958,19384898,19384898,19385432,0,0,0,534
14959,19385483,19385483,19385634,0,0,0,151
14961,19385564,19385564,19387291,0,0,0,1727
14965,19389425,19389425,19389546,0,0,0,121
14963,19387391,19387391,19389704,0,0,0,2313
14967,19391171,19391171,19391286,0,0,0,115
14962,19385605,19385605,19391888,0,0,0,6283
14966,19389709,19389709,19392806,0,0,0,3097
14973,19392784,19392784,19392868,0,0,0,84
14974,19392834,19392834,19392918,0,0,0,84
14976,19393062,19393062,19393170,0,0,0,108
14978,19393215,19393215,19393274,0,0,0,59
14972,19392781,19392781,19393278,0,0,0,497
14977,19393214,19393214,19393360,0,0,0,146
14979,19393278,19393278,19393365,0,0,0,87
14982,19394045,19394045,19394339,0,0,0,294
14981,19393645,19393645,19394714,0,0,0,1069
14983,19394313,19394313,19394833,0,0,0,520
14987,19394962,19394962,19395416,0,0,0,454
14988,19395388,19395388,19395533,0,0,0,145
14989,19395512,19395512,19395683,0,0,0,171
14991,19395968,19395968,19396037,0,0,0,69
14992,19396041,19396041,19396112,0,0,0,71
14993,19396140,19396140,19396210,0,0,0,70
14994,19396255,19396255,19396302,0,0,0,47
14995,19396636,19396636,19397125,0,0,0,489
14997,19397124,19397124,19397239,0,0,0,115
14986,19394818,19394818,19397509,0,0,0,2691
15002,19399133,19399133,19399249,0,0,0,116
15003,19401618,19401618,19402080,0,0,0,462
15004,19402386,19402386,19402632,0,0,0,246
15005,19402940,19402940,19403024,0,0,0,84
15006,19403044,19403044,19403127,0,0,0,83
15007,19403080,19403080,19403307,0,0,0,227
15008,19403254,19403254,19403349,0,0,0,95
15009,19403398,19403398,19403500,0,0,0,102
15010,19403436,19403436,19403684,0,0,0,248
15011,19403570,19403570,19403811,0,0,0,241
15012,19403803,19403803,19403950,0,0,0,147
14748,19295694,19295694,19403994,0,0,0,108300
15015,19404009,19404009,19404407,0,0,0,398
15014,19403975,19403975,19404484,0,0,0,509
14960,19385497,19385497,19405551,0,0,0,20054
15013,19403957,19403957,19405653,0,0,0,1696
14710,19231361,19245979,19405727,0,0,14618,174366
15016,19404111,19404111,19405841,0,0,0,1730
15021,19405871,19405871,19406017,0,0,0,146
15018,19404460,19404460,19406051,0,0,0,1591
15020,19405681,19405681,19406086,0,0,0,405
15017,19404443,19404443,19406109,0,0,0,1666
15022,19406472,19406472,19406971,0,0,0,499
15023,19406748,19406748,19407048,0,0,0,300
15024,19407496,19407496,19407642,0,0,0,146
15025,19407807,19407807,19407911,0,0,0,104
14984,19394687,19394687,19407968,0,0,0,13281
14956,19346487,19346487,19408153,0,0,0,61666
15026,19408190,19408190,19408486,0,0,0,296
15028,19408519,19408519,19408602,0,0,0,83
14985,19394799,19394799,19408636,0,0,0,13837
15027,19408207,19408207,19408665,0,0,0,458
15031,19408572,19408572,19408674,0,0,0,102
15030,19408546,19408546,19408681,0,0,0,135
14996,19396670,19396670,19409366,0,0,0,12696
14999,19397314,19397314,19409367,0,0,0,12053
15033,19408769,19408769,19409831,0,0,0,1062
15042,19409889,19409889,19409936,0,0,0,47
15048,19409890,19409890,19409994,0,0,0,104
15032,19408766,19408766,19409995,0,0,0,1229
15034,19408783,19408783,19410010,0,0,0,1227
15035,19408821,19408821,19410050,0,0,0,1229
15036,19408947,19408947,19410080,0,0,0,1133
15049,19409891,19409994,19410137,0,0,103,246
15043,19409890,19409890,19410490,0,0,0,600
15044,19409890,19409890,19410490,0,0,0,600
15045,19409890,19409890,19410490,0,0,0,600
15046,19409890,19409890,19410490,0,0,0,600
15047,19409890,19409890,19410490,0,0,0,600
15040,19409869,19409869,19410712,0,0,0,843
15039,19409371,19409371,19410771,0,0,0,1400
15050,19409891,19410712,19410834,0,0,821,943
14964,19389153,19389153,19410890,0,0,0,21737
15055,19410064,19410064,19411264,0,0,0,1200
15107,19411583,19411583,19411802,0,0,0,219
15109,19411801,19411801,19411848,0,0,0,47
15057,19410347,19410347,19411898,0,0,0,1551
15108,19411794,19411794,19411898,0,0,0,104
15059,19410348,19410348,19411899,0,0,0,1551
15060,19410348,19410348,19411899,0,0,0,1551
15061,19410348,19410348,19411899,0,0,0,1551
15063,19410349,19410349,19411900,0,0,0,1551
15068,19410350,19410350,19411901,0,0,0,1551
15069,19410350,19410350,19411901,0,0,0,1551
15056,19410341,19410341,19411908,0,0,0,1567
15058,19410347,19410347,19411910,0,0,0,1563
15062,19410348,19410348,19411911,0,0,0,1563
15064,19410349,19410349,19411912,0,0,0,1563
15065,19410349,19410349,19411912,0,0,0,1563
15066,19410349,19410349,19411912,0,0,0,1563
15067,19410349,19410349,19411912,0,0,0,1563
15070,19410350,19410350,19411913,0,0,0,1563
15071,19410350,19410350,19411913,0,0,0,1563
15072,19410351,19410351,19411914,0,0,0,1563
15073,19410351,19410351,19411914,0,0,0,1563
15074,19410351,19410351,19411914,0,0,0,1563
15075,19410352,19410352,19411915,0,0,0,1563
15076,19410352,19410352,19411915,0,0,0,1563
15077,19410352,19410352,19411915,0,0,0,1563
15078,19410352,19410352,19411915,0,0,0,1563
15079,19410352,19410352,19411915,0,0,0,1563
15080,19410352,19410352,19411915,0,0,0,1563
15081,19410352,19410352,19411915,0,0,0,1563
15082,19410353,19410353,19411916,0,0,0,1563
15083,19410353,19410353,19411916,0,0,0,1563
15084,19410353,19410353,19411916,0,0,0,1563
15085,19410353,19410353,19411916,0,0,0,1563
15086,19410353,19410353,19411916,0,0,0,1563
15087,19410353,19410353,19411916,0,0,0,1563
15088,19410353,19410353,19411916,0,0,0,1563
15089,19410354,19410354,19411917,0,0,0,1563
15090,19410354,19410354,19411917,0,0,0,1563
15091,19410354,19410354,19411917,0,0,0,1563
15092,19410354,19410354,19411917,0,0,0,1563
15093,19410354,19410354,19411917,0,0,0,1563
15094,19410354,19410354,19411917,0,0,0,1563
15095,19410354,19410354,19411917,0,0,0,1563
15096,19410355,19410355,19411918,0,0,0,1563
15097,19410355,19410355,19411918,0,0,0,1563
15098,19410355,19410355,19411918,0,0,0,1563
15099,19410355,19410355,19411918,0,0,0,1563
15100,19410355,19410355,19411918,0,0,0,1563
15101,19410355,19410355,19411918,0,0,0,1563
15102,19410355,19410355,19411918,0,0,0,1563
15103,19410356,19410356,19411919,0,0,0,1563
15104,19410356,19410356,19411919,0,0,0,1563
15110,19411886,19411886,19411988,0,0,0,102
15111,19411903,19411903,19412003,0,0,0,100
15114,19411957,19411957,19412032,0,0,0,75
15112,19411929,19411929,19412037,0,0,0,108
15113,19411948,19411948,19412070,0,0,0,122
15115,19411970,19411970,19412121,0,0,0,151
15116,19412372,19412372,19412474,0,0,0,102
15117,19412378,19412378,19412501,0,0,0,123
15118,19412378,19412378,19412512,0,0,0,134
15119,19412379,19412379,19412513,0,0,0,134
15120,19412379,19412379,19412513,0,0,0,134
15123,19412380,19412380,19412546,0,0,0,166
15121,19412379,19412379,19412555,0,0,0,176
15122,19412379,19412379,19412555,0,0,0,176
15124,19412380,19412555,19412726,0,0,175,346
14968,19392405,19392405,19412819,0,0,0,20414
14980,19393454,19393454,19412819,0,0,0,19365
14975,19393058,19393058,19412823,0,0,0,19765
14990,19395652,19395652,19412966,0,0,0,17314
15019,19405647,19405647,19414804,0,0,0,9157
15106,19410796,19410796,19415347,0,0,0,4551
14948,19320086,19320086,19415718,0,0,0,95632
15037,19409017,19409017,19415946,0,0,0,6929
15135,19427166,19427166,19427281,0,0,0,115
15105,19410775,19410775,19437373,0,0,0,26598
15137,19437547,19437547,19437665,0,0,0,118
14750,19296858,19296858,19449327,0,0,0,152469
14969,19392418,19392418,19454036,0,0,0,61618
14970,19392426,19392426,19459196,0,0,0,66770
14609,19212901,19212901,19465501,0,0,0,252600
14610,19212932,19212932,19465532,0,0,0,252600
14613,19214108,19214108,19466708,0,0,0,252600
14614,19214301,19214301,19466901,0,0,0,252600
14971,19392438,19392438,19467511,0,0,0,75073
15054,19410035,19410035,19469126,0,0,0,59091
15052,19409982,19409982,19469216,0,0,0,59234
15053,19410009,19410009,19469221,0,0,0,59212
15192,19470687,19470687,19471201,0,0,0,514
15193,19470801,19470801,19471238,0,0,0,437
15195,19470948,19470948,19471415,0,0,0,467
15196,19471384,19471384,19471872,0,0,0,488
15197,19471390,19471390,19471878,0,0,0,488
15190,19470285,19470285,19471882,0,0,0,1597
15191,19470302,19470302,19471962,0,0,0,1660
15194,19470878,19470878,19472036,0,0,0,1158
15001,19397347,19397347,19472047,0,0,0,74700
15051,19409958,19409958,19472054,0,0,0,62096
14998,19397271,19397271,19472057,0,0,0,74786
15000,19397335,19397335,19472057,0,0,0,74722
15038,19409331,19409331,19472058,0,0,0,62727
15041,19409869,19409869,19472067,0,0,0,62198
15198,19472221,19472221,19473421,0,0,0,1200
15210,19473716,19473716,19473786,0,0,0,70
15213,19474740,19474740,19474830,0,0,0,90
15214,19474740,19474740,19474830,0,0,0,90
15208,19473533,19473533,19474840,0,0,0,1307
15215,19474740,19474740,19474863,0,0,0,123
15216,19474741,19474741,19474864,0,0,0,123
15217,19474741,19474741,19474875,0,0,0,134
15219,19474741,19474741,19474886,0,0,0,145
15218,19474741,19474741,19474906,0,0,0,165
15222,19474872,19474872,19475016,0,0,0,144
15220,19474742,19474906,19475025,0,0,164,283
15225,19475326,19475326,19475445,0,0,0,119
15223,19475218,19475218,19475548,0,0,0,330
15224,19475224,19475224,19475724,0,0,0,500
15227,19476026,19476026,19476145,0,0,0,119
15226,19475775,19475775,19476237,0,0,0,462
15228,19476373,19476373,19476457,0,0,0,84
15230,19476564,19476564,19476705,0,0,0,141
15229,19476457,19476457,19476862,0,0,0,405
15231,19477400,19477400,19477557,0,0,0,157
15233,19477406,19477406,19477586,0,0,0,180
15232,19477405,19477405,19477601,0,0,0,196
15234,19477406,19477406,19477602,0,0,0,196
15235,19477406,19477406,19477634,0,0,0,228
15236,19477406,19477406,19477634,0,0,0,228
15237,19477407,19477407,19477635,0,0,0,228
15238,19477407,19477634,19477746,0,0,227,339
15240,19478281,19478281,19478525,0,0,0,244
15241,19478609,19478609,19478793,0,0,0,184
15242,19478686,19478686,19478938,0,0,0,252
15243,19478686,19478686,19478991,0,0,0,305
15244,19478687,19478687,19478992,0,0,0,305
15245,19478687,19478687,19478992,0,0,0,305
15248,19478687,19478687,19479033,0,0,0,346
15246,19478687,19478687,19479045,0,0,0,358
15247,19478687,19478687,19479045,0,0,0,358
15251,19478777,19478777,19479131,0,0,0,354
15252,19478783,19478783,19479160,0,0,0,377
15253,19478783,19478783,19479160,0,0,0,377
15254,19478783,19478783,19479191,0,0,0,408
15261,19479115,19479115,19479202,0,0,0,87
15255,19478783,19478783,19479234,0,0,0,451
15256,19478784,19478784,19479255,0,0,0,471
15262,19479204,19479204,19479278,0,0,0,74
15260,19479047,19479047,19479368,0,0,0,321
15263,19479267,19479267,19479374,0,0,0,107
15249,19478687,19479255,19479412,0,0,568,725
15257,19478784,19479033,19479478,0,0,249,694
15258,19478784,19479412,19479651,0,0,628,867
15264,19479427,19479427,19479862,0,0,0,435
15189,19469983,19469983,19480783,0,0,0,10800
15128,19417814,19417814,19481398,0,0,0,63584
15266,19482263,19482263,19482476,0,0,0,213
15267,19482330,19482330,19482645,0,0,0,315
15268,19482592,19482592,19482673,0,0,0,81
15270,19482703,19482703,19482773,0,0,0,70
15269,19482645,19482645,19482971,0,0,0,326
15272,19483092,19483092,19483170,0,0,0,78
15271,19483053,19483053,19483227,0,0,0,174
15273,19483278,19483278,19483572,0,0,0,294
15275,19483749,19483749,19483827,0,0,0,78
15281,19483756,19483756,19483845,0,0,0,89
15276,19483755,19483755,19483854,0,0,0,99
15277,19483755,19483755,19483854,0,0,0,99
15278,19483755,19483755,19483868,0,0,0,113
15279,19483755,19483755,19483868,0,0,0,113
15280,19483756,19483756,19483869,0,0,0,113
15291,19483804,19483804,19483872,0,0,0,68
15282,19483794,19483794,19483878,0,0,0,84
15287,19483800,19483800,19483887,0,0,0,87
15283,19483794,19483794,19483911,0,0,0,117
15284,19483794,19483794,19483911,0,0,0,117
15285,19483794,19483794,19483911,0,0,0,117
15286,19483794,19483794,19483911,0,0,0,117
15292,19483816,19483816,19483926,0,0,0,110
15293,19483816,19483816,19483937,0,0,0,121
15288,19483801,19483845,19483953,0,0,44,152
15295,19483817,19483817,19483954,0,0,0,137
15294,19483817,19483817,19483969,0,0,0,152
15299,19483822,19483822,19483980,0,0,0,158
15300,19483822,19483822,19483992,0,0,0,170
15301,19483822,19483822,19484020,0,0,0,198
15296,19483817,19483868,19484026,0,0,51,209
15297,19483817,19483869,19484049,0,0,52,232
15306,19483832,19483832,19484064,0,0,0,232
15302,19483822,19483887,19484085,0,0,65,263
15307,19483832,19483832,19484086,0,0,0,254
15303,19483822,19483868,19484100,0,0,46,278
15298,19483818,19483953,19484134,0,0,135,316
15308,19483833,19483854,19484139,0,0,21,306
15309,19483833,19483887,19484139,0,0,54,306
15304,19483822,19483937,19484158,0,0,115,336
15310,19483833,19483911,19484217,0,0,78,384
15313,19484285,19484285,19484366,0,0,0,81
15305,19483823,19484134,19484370,0,0,311,547
15312,19483834,19484139,19484372,0,0,305,538
15311,19483833,19484026,19484373,0,0,193,540
15289,19483801,19484372,19484481,0,0,571,680
15133,19422298,19422298,19484543,0,0,0,62245
15132,19422261,19422261,19484608,0,0,0,62347
15134,19422345,19422345,19484743,0,0,0,62398
15314,19484697,19484697,19484786,0,0,0,89
14946,19320072,19320072,19484840,0,0,0,164768
15315,19484787,19484787,19484992,0,0,0,205
15316,19485015,19485015,19485128,0,0,0,113
15317,19485069,19485069,19485148,0,0,0,79
15140,19440132,19440132,19485387,0,0,0,45255
15139,19440126,19440126,19485766,0,0,0,45640
15141,19440132,19440132,19485903,0,0,0,45771
15142,19440132,19440132,19486110,0,0,0,45978
15221,19474742,19484743,19486543,0,0,10001,11801
15239,19477407,19486543,19486731,0,0,9136,9324
15250,19478687,19486731,19486999,0,0,8044,8312
15209,19473617,19473617,19487177,0,0,0,13560
15259,19478784,19486999,19487437,0,0,8215,8653
15143,19440133,19440133,19487961,0,0,0,47828
14947,19320077,19320077,19488087,0,0,0,168010
15318,19485489,19488087,19488200,0,0,2598,2711
15319,19485710,19488200,19488308,0,0,2490,2598
15320,19486063,19488308,19488652,0,0,2245,2589
15321,19487596,19488652,19488849,0,0,1056,1253
15290,19483801,19487437,19489237,0,0,3636,5436
15265,19479809,19479809,19490609,0,0,0,10800
15125,19413342,19413342,19491438,0,0,0,78096
14945,19320059,19320059,19492791,0,0,0,172732
15131,19421331,19421331,19492955,0,0,0,71624
15326,19493866,19493866,19493993,0,0,0,127
15173,19440139,19440139,19494449,0,0,0,54310
15029,19408540,19408540,19494940,0,0,0,86400
15174,19440139,19440139,19495747,0,0,0,55608
15175,19440139,19440139,19495747,0,0,0,55608
15166,19440138,19440138,19495934,0,0,0,55796
15180,19440140,19440140,19496009,0,0,0,55869
15176,19440139,19440139,19496112,0,0,0,55973
15333,19495980,19495980,19496130,0,0,0,150
15167,19440138,19440138,19496196,0,0,0,56058
15334,19496078,19496130,19496285,0,0,52,207
15322,19492747,19492747,19496382,0,0,0,3635
15330,19495076,19495076,19496394,0,0,0,1318
15323,19492877,19492877,19496416,0,0,0,3539
15177,19440139,19440139,19496418,0,0,0,56279
15324,19492923,19492923,19496455,0,0,0,3532
15325,19492977,19492977,19496461,0,0,0,3484
15338,19496388,19496388,19496544,0,0,0,156
15186,19440141,19440141,19496924,0,0,0,56783
15342,19496761,19496761,19496969,0,0,0,208
15181,19440140,19440140,19496983,0,0,0,56843
15182,19440140,19440140,19496983,0,0,0,56843
15183,19440140,19440140,19497118,0,0,0,56978
15343,19496979,19496979,19497138,0,0,0,159
15187,19440141,19440141,19497551,0,0,0,57410
15184,19440140,19440140,19497612,0,0,0,57472
14951,19326846,19326846,19497752,0,0,0,170906
15188,19440141,19440141,19497858,0,0,0,57717
15127,19417005,19417005,19498159,0,0,0,81154
15344,19497637,19497637,19498181,0,0,0,544
15345,19498192,19498192,19498318,0,0,0,126
15346,19498207,19498207,19498343,0,0,0,136
15347,19498218,19498218,19498397,0,0,0,179
15349,19498228,19498397,19498515,0,0,169,287
15348,19498222,19498343,19498795,0,0,121,573
14952,19328542,19328542,19501342,0,0,0,172800
15147,19440134,19440134,19502734,0,0,0,62600
15159,19440137,19440137,19502885,0,0,0,62748
15160,19440137,19440137,19503237,0,0,0,63100
15148,19440134,19440134,19503400,0,0,0,63266
15151,19440135,19440135,19503463,0,0,0,63328
15152,19440135,19440135,19503580,0,0,0,63445
15178,19440139,19440139,19503847,0,0,0,63708
15161,19440137,19440137,19503887,0,0,0,63750
15153,19440135,19440135,19503958,0,0,0,63823
15156,19440136,19440136,19503990,0,0,0,63854
15129,19417852,19417852,19504252,0,0,0,86400
15352,19504101,19504101,19504380,0,0,0,279
15355,19504262,19504262,19504400,0,0,0,138
15185,19440140,19440140,19504442,0,0,0,64302
15356,19504288,19504380,19504475,0,0,92,187
15168,19440138,19440138,19504922,0,0,0,64784
15149,19440134,19440134,19505104,0,0,0,64970
15358,19505354,19505354,19505485,0,0,0,131
15359,19505378,19505378,19505630,0,0,0,252
15179,19440139,19440139,19505751,0,0,0,65612
15360,19505841,19505841,19506012,0,0,0,171
15353,19504167,19504252,19506052,0,0,85,1885
15361,19506056,19506056,19506151,0,0,0,95
15362,19506301,19506301,19506374,0,0,0,73
15363,19506447,19506447,19506517,0,0,0,70
15364,19506512,19506512,19506570,0,0,0,58
15354,19504230,19506052,19507852,0,0,1822,3622
14957,19348104,19348104,19508041,0,0,0,159937
15365,19506575,19506575,19508243,0,0,0,1668
15369,19508200,19508200,19508283,0,0,0,83
15370,19508281,19508281,19508354,0,0,0,73
15357,19504304,19507852,19508452,0,0,3548,4148
15274,19483513,19483513,19508546,0,0,0,25033
15366,19507774,19507774,19509574,0,0,0,1800
15367,19507787,19507787,19509587,0,0,0,1800
15371,19509776,19509776,19509882,0,0,0,106
15372,19509828,19509828,19509989,0,0,0,161
15373,19509937,19509937,19510136,0,0,0,199
15374,19510133,19510133,19510366,0,0,0,233
15375,19510551,19510551,19510604,0,0,0,53
15376,19510603,19510603,19511002,0,0,0,399
15377,19510993,19510993,19512611,0,0,0,1618
15212,19473850,19473850,19513337,0,0,0,39487
15211,19473743,19473743,19513750,0,0,0,40007
15379,19514648,19514648,19517247,0,0,0,2599
15380,19517191,19517191,19517762,0,0,0,571
15378,19514468,19514468,19519077,0,0,0,4609
15154,19440135,19440135,19519138,0,0,0,79003
15331,19495098,19495098,19519395,0,0,0,24297
15144,19440133,19440133,19519612,0,0,0,79479
15157,19440136,19440136,19519863,0,0,0,79727
15162,19440137,19440137,19519980,0,0,0,79843
15145,19440133,19440133,19520122,0,0,0,79989
15146,19440133,19440133,19520122,0,0,0,79989
15155,19440135,19440135,19520238,0,0,0,80103
15350,19499426,19499426,19520514,0,0,0,21088
15163,19440137,19440137,19520740,0,0,0,80603
15150,19440134,19440134,19520790,0,0,0,80656
15158,19440136,19440136,19520823,0,0,0,80687
15169,19440138,19440138,19520974,0,0,0,80836
15164,19440137,19440137,19521051,0,0,0,80914
15170,19440138,19440138,19521177,0,0,0,81039
15171,19440138,19440138,19521726,0,0,0,81588
15165,19440137,19440137,19521798,0,0,0,81661
15172,19440138,19440138,19523227,0,0,0,83089
14853,19316022,19316022,19527010,0,0,0,210988
15382,19528537,19528537,19528716,0,0,0,179
15383,19528645,19528645,19528835,0,0,0,190
15384,19528714,19528714,19539657,0,0,0,10943
15385,19554378,19554378,19555274,0,0,0,896
15386,19555733,19555733,19555893,0,0,0,160
15387,19555754,19555754,19555922,0,0,0,168
15391,19556594,19556594,19556794,0,0,0,200
15392,19556794,19556794,19556952,0,0,0,158
15393,19556871,19556871,19557151,0,0,0,280
15388,19556182,19556182,19557200,0,0,0,1018
15394,19557235,19557235,19557370,0,0,0,135
15397,19557463,19557463,19557661,0,0,0,198
15405,19557740,19557740,19557845,0,0,0,105
15398,19557463,19557661,19558004,0,0,198,541
15399,19557463,19558004,19558205,0,0,541,742
15407,19558122,19558122,19558234,0,0,0,112
15408,19558223,19558223,19558338,0,0,0,115
15409,19558370,19558370,19558474,0,0,0,104
15396,19557461,19557461,19558683,0,0,0,1222
15400,19557463,19558205,19559075,0,0,742,1612
15410,19558541,19558541,19559168,0,0,0,627
15402,19557497,19559075,19559306,0,0,1578,1809
15412,19559312,19559312,19559379,0,0,0,67
15401,19557464,19558683,19559380,0,0,1219,1916
15403,19557509,19559075,19559422,0,0,1566,1913
15413,19559481,19559481,19559568,0,0,0,87
15414,19559579,19559579,19559815,0,0,0,236
15416,19559901,19559901,19560111,0,0,0,210
15411,19558631,19559380,19560211,0,0,749,1580
15404,19557522,19560211,19562011,0,0,2689,4489
15419,19562148,19562148,19562279,0,0,0,131
15389,19556398,19556398,19564024,0,0,0,7626
15390,19556406,19556406,19564194,0,0,0,7788
15422,19564570,19564570,19564654,0,0,0,84
15423,19564721,19564721,19564797,0,0,0,76
15428,19564930,19564930,19565049,0,0,0,119
15429,19565017,19565017,19565101,0,0,0,84
15432,19565519,19565519,19565675,0,0,0,156
15415,19559695,19559695,19565772,0,0,0,6077
15433,19565805,19565805,19565911,0,0,0,106
15434,19565867,19565867,19565983,0,0,0,116
15435,19566051,19566051,19566167,0,0,0,116
15436,19566833,19566833,19566958,0,0,0,125
15437,19567021,19567021,19567109,0,0,0,88
15439,19567297,19567297,19567386,0,0,0,89
15440,19567408,19567408,19567766,0,0,0,358
15417,19560661,19562011,19568211,0,0,1350,7550
15442,19570668,19570668,19571067,0,0,0,399
15418,19561198,19561198,19571998,0,0,0,10800
15441,19570592,19570592,19572146,0,0,0,1554
15444,19571638,19571638,19572254,0,0,0,616
15199,19473071,19473071,19572365,0,0,0,99294
15443,19571397,19571397,19572420,0,0,0,1023
15445,19572516,19572516,19572625,0,0,0,109
15446,19572723,19572723,19572818,0,0,0,95
15448,19572838,19572838,19572948,0,0,0,110
15447,19572769,19572769,19573037,0,0,0,268
15449,19572953,19572953,19573062,0,0,0,109
15451,19573041,19573041,19573150,0,0,0,109
15452,19573154,19573154,19573263,0,0,0,109
15453,19573348,19573348,19573418,0,0,0,70
15454,19573440,19573440,19573510,0,0,0,70
15455,19573542,19573542,19573611,0,0,0,69
15456,19573621,19573621,19573733,0,0,0,112
15450,19572965,19572965,19573930,0,0,0,965
15457,19573685,19573685,19573946,0,0,0,261
15460,19573988,19573988,19574609,0,0,0,621
15459,19573957,19573957,19574672,0,0,0,715
15461,19574419,19574419,19574701,0,0,0,282
15462,19574634,19574634,19574712,0,0,0,78
15464,19574792,19574792,19574897,0,0,0,105
15465,19574880,19574880,19575063,0,0,0,183
15463,19574747,19574747,19576110,0,0,0,1363
15467,19575773,19575773,19576492,0,0,0,719
15468,19575920,19575920,19576545,0,0,0,625
15340,19496417,19496417,19578142,0,0,0,81725
15341,19496431,19496431,19578167,0,0,0,81736
15332,19495099,19495099,19578725,0,0,0,83626
15470,19578722,19578722,19578853,0,0,0,131
15471,19579065,19579065,19579285,0,0,0,220
15336,19496351,19496351,19579763,0,0,0,83412
15335,19496339,19496339,19579773,0,0,0,83434
15337,19496369,19496369,19579781,0,0,0,83412
15339,19496406,19496406,19579818,0,0,0,83412
15472,19579351,19579351,19579941,0,0,0,590
15473,19579666,19579666,19580194,0,0,0,528
15424,19564847,19564847,19580341,0,0,0,15494
15426,19564887,19564887,19580366,0,0,0,15479
15427,19564913,19564913,19580371,0,0,0,15458
15430,19565056,19565056,19580389,0,0,0,15333
15431,19565111,19565111,19580402,0,0,0,15291
15487,19580640,19580640,19580843,0,0,0,203
15486,19580370,19580370,19580876,0,0,0,506
15491,19581726,19581726,19581855,0,0,0,129
15492,19581726,19581855,19582228,0,0,129,502
15488,19580866,19580866,19583282,0,0,0,2416
15207,19473292,19473292,19583323,0,0,0,110031
15493,19581726,19582228,19584028,0,0,502,2302
15498,19583158,19583158,19584057,0,0,0,899
15458,19573912,19573912,19584712,0,0,0,10800
15425,19564859,19564859,19585529,0,0,0,20670
15494,19581727,19584028,19585828,0,0,2301,4101
15503,19586526,19586526,19586631,0,0,0,105
15495,19581727,19585828,19587628,0,0,4101,5901
15496,19581727,19587628,19587746,0,0,5901,6019
15395,19557257,19557257,19588445,0,0,0,31188
15466,19575291,19575291,19596614,0,0,0,21323
15505,19592628,19592628,19599571,0,0,0,6943
15483,19580332,19580332,19600424,0,0,0,20092
15484,19580348,19580348,19600480,0,0,0,20132
15485,19580355,19580355,19600685,0,0,0,20330
15508,19599362,19599362,19600800,0,0,0,1438
15481,19580307,19580307,19600914,0,0,0,20607
15480,19580297,19580297,19601015,0,0,0,20718
15482,19580321,19580321,19601332,0,0,0,21011
15205,19473285,19473285,19601770,0,0,0,128485
15490,19581331,19581331,19602126,0,0,0,20795
15420,19562237,19562237,19603286,0,0,0,41049
15499,19583359,19583359,19604806,0,0,0,21447
15201,19473140,19473140,19615793,0,0,0,142653
15489,19581009,19581009,19617009,0,0,0,36000
15381,19517642,19517642,19625942,0,0,0,108300
15203,19473201,19473201,19637040,0,0,0,163839
15438,19567075,19567075,19644028,0,0,0,76953
15512,19600973,19600973,19644345,0,0,0,43372
15516,19601604,19601604,19644993,0,0,0,43389
15517,19601908,19601908,19645275,0,0,0,43367
15518,19601916,19602126,19645504,0,0,210,43588
15136,19437371,19437371,19667131,0,0,0,229760
15204,19473283,19473283,19671287,0,0,0,198004
15202,19473173,19473173,19671332,0,0,0,198159
15206,19473289,19473289,19671605,0,0,0,198316
15200,19473102,19473102,19672418,0,0,0,199316
15351,19501529,19501529,19672752,0,0,0,171223
15509,19600874,19672752,19672884,0,0,71878,72010
15510,19600956,19672884,19673145,0,0,71928,72189
15511,19600968,19673145,19674945,0,0,72177,73977
15126,19416808,19416808,19676008,0,0,0,259200
15513,19601009,19674945,19676745,0,0,73936,75736
15514,19601031,19676745,19677006,0,0,75714,75975
15130,19417883,19417883,19677083,0,0,0,259200
15515,19601043,19677006,19677606,0,0,75963,76563
15507,19592852,19600800,19680219,0,0,7948,87367
15519,19677964,19677964,19681342,0,0,0,3378
15138,19437961,19437961,19697161,0,0,0,259200
15501,19583958,19587746,19720399,0,0,3788,136441
15478,19579845,19579845,19727063,0,0,0,147218
15500,19583936,19583936,19727781,0,0,0,143845
15523,19734669,19734669,19734901,0,0,0,232
15421,19562503,19562503,19735303,0,0,0,172800
15479,19579862,19579862,19737980,0,0,0,158118
15522,19734578,19734578,19746287,0,0,0,11709
15521,19734545,19734545,19746607,0,0,0,12062
15327,19494609,19494609,19747209,0,0,0,252600
15328,19494629,19494629,19747229,0,0,0,252600
15329,19494643,19494643,19747243,0,0,0,252600
15475,19579812,19579812,19747874,0,0,0,168062
15502,19583972,19587746,19747944,0,0,3774,163972
15477,19579833,19579833,19750338,0,0,0,170505
15497,19582392,19582392,19755125,0,0,0,172733
15504,19586682,19586682,19759440,0,0,0,172758
15368,19507850,19507850,19767050,0,0,0,259200
15406,19557945,19557945,19768632,0,0,0,210687
15469,19576511,19576511,19770726,0,0,0,194215
15520,19693669,19693669,19770806,0,0,0,77137
15476,19579822,19579822,19774982,0,0,0,195160
15529,19775898,19775898,19799280,0,0,0,23382
15531,19785770,19785770,19802802,0,0,0,17032
15528,19775623,19775623,19811711,0,0,0,36088
15474,19579803,19579803,19813373,0,0,0,233570
15539,19813391,19813391,19815151,0,0,0,1760
15543,19816418,19816418,19816524,0,0,0,106
15544,19816435,19816435,19816549,0,0,0,114
15546,19816738,19816738,19817048,0,0,0,310
15545,19816731,19816731,19817053,0,0,0,322
15547,19816766,19816766,19817130,0,0,0,364
15548,19817533,19817533,19817593,0,0,0,60
15526,19774408,19774408,19817773,0,0,0,43365
15549,19817791,19817791,19817892,0,0,0,101
15550,19817816,19817816,19817925,0,0,0,109
15551,19817841,19817841,19817983,0,0,0,142
15553,19818040,19818040,19818218,0,0,0,178
15552,19817940,19817940,19818265,0,0,0,325
15554,19818359,19818359,19818526,0,0,0,167
15527,19775183,19775183,19818531,0,0,0,43348
15556,19818442,19818442,19818535,0,0,0,93
15555,19818395,19818531,19820272,0,0,136,1877
15564,19820828,19820828,19820949,0,0,0,121
15574,19823695,19823695,19823789,0,0,0,94
15571,19822762,19822762,19826362,0,0,0,3600
15586,19830626,19830626,19831119,0,0,0,493
15558,19818691,19818691,19833142,0,0,0,14451
15587,19833330,19833330,19833408,0,0,0,78
15588,19833443,19833443,19833552,0,0,0,109
15557,19818535,19818535,19833866,0,0,0,15331
15591,19833884,19833884,19834100,0,0,0,216
15590,19833725,19833725,19834786,0,0,0,1061
15592,19834177,19834177,19835159,0,0,0,982
15589,19833637,19833637,19835182,0,0,0,1545
15593,19835277,19835277,19835499,0,0,0,222
15594,19835578,19835578,19835895,0,0,0,317
15595,19835944,19835944,19836146,0,0,0,202
15596,19836239,19836239,19836578,0,0,0,339
15597,19836888,19836888,19837112,0,0,0,224
15598,19837173,19837173,19837243,0,0,0,70
15530,19776168,19776168,19837338,0,0,0,61170
15599,19837322,19837322,19837662,0,0,0,340
15600,19837604,19837604,19837711,0,0,0,107
15602,19838503,19838503,19838652,0,0,0,149
15581,19825008,19825008,19838929,0,0,0,13921
15605,19840920,19840920,19840967,0,0,0,47
15606,19840992,19840992,19842242,0,0,0,1250
15541,19815264,19815264,19842349,0,0,0,27085
15609,19842555,19842555,19842675,0,0,0,120
15610,19842777,19842777,19842866,0,0,0,89
15603,19838635,19838635,19842910,0,0,0,4275
15604,19839621,19839621,19842979,0,0,0,3358
15612,19842958,19842958,19843043,0,0,0,85
15540,19815228,19815228,19843332,0,0,0,28104
15538,19813352,19813352,19843355,0,0,0,30003
15608,19842470,19842470,19843758,0,0,0,1288
15584,19829980,19843355,19843945,0,0,13375,13965
15621,19844046,19844046,19844178,0,0,0,132
15585,19830602,19843945,19844534,0,0,13343,13932
15559,19818790,19818790,19854790,0,0,0,36000
15623,19844910,19854790,19854874,0,0,9880,9964
15506,19592741,19599571,19858771,0,0,6830,266030
15569,19821734,19821734,19858826,0,0,0,37092
15570,19821745,19821745,19859455,0,0,0,37710
15579,19824706,19858771,19862337,0,0,34065,37631
15580,19824763,19862337,19862511,0,0,37574,37748
15611,19842935,19842935,19864555,0,0,0,21620
15613,19842984,19842984,19864592,0,0,0,21608
15620,19843563,19843563,19865222,0,0,0,21659
15607,19841775,19862511,19866029,0,0,20736,24254
15625,19845261,19866029,19866426,0,0,20768,21165
15572,19823539,19823539,19866889,0,0,0,43350
15573,19823581,19823581,19866962,0,0,0,43381
15576,19824487,19824487,19877759,0,0,0,53272
15575,19824348,19824348,19877955,0,0,0,53607
15619,19843324,19844534,19881607,0,0,1210,38283
15578,19824568,19826362,19888339,0,0,1794,63771
15525,19773438,19773438,19889529,0,0,0,116091
15601,19837765,19837765,19892773,0,0,0,55008
15631,19901658,19901658,19902695,0,0,0,1037
15634,19904364,19904364,19904464,0,0,0,100
15635,19904818,19904818,19904890,0,0,0,72
15637,19905211,19905211,19905307,0,0,0,96
15617,19843314,19843314,19905520,0,0,0,62206
15628,19899791,19899791,19905525,0,0,0,5734
15638,19905464,19905525,19905950,0,0,61,486
15636,19905124,19905124,19906174,0,0,0,1050
15618,19843320,19844534,19906718,0,0,1214,63398
15614,19843283,19844534,19906762,0,0,1251,63479
15645,19905955,19906718,19906784,0,0,763,829
15650,19906681,19906718,19906837,0,0,37,156
15647,19906112,19906718,19906918,0,0,606,806
15649,19906518,19906718,19906929,0,0,200,411
15651,19906783,19906783,19906986,0,0,0,203
15648,19906254,19906254,19907276,0,0,0,1022
15652,19907100,19907100,19907307,0,0,0,207
15653,19907513,19907513,19907839,0,0,0,326
15654,19907919,19907919,19908278,0,0,0,359
15632,19902478,19905520,19908393,0,0,3042,5915
15615,19843292,19854790,19909812,0,0,11498,66520
15642,19905508,19909812,19910321,0,0,4304,4813
15655,19908164,19908164,19910781,0,0,0,2617
15624,19844978,19854874,19911913,0,0,9896,66935
15658,19911305,19911305,19912351,0,0,0,1046
15577,19824530,19826362,19912762,0,0,1832,88232
15662,19914333,19914333,19914646,0,0,0,313
15663,19915297,19915297,19915659,0,0,0,362
15664,19915975,19915975,19916292,0,0,0,317
15665,19916373,19916373,19916465,0,0,0,92
15666,19916703,19916703,19916792,0,0,0,89
15560,19819617,19820272,19918242,0,0,655,98625
15669,19919960,19919960,19920097,0,0,0,137
15670,19920101,19920101,19920278,0,0,0,177
15616,19843306,19858771,19920977,0,0,15465,77671
15672,19920933,19920933,19921981,0,0,0,1048
15674,19922188,19922188,19922296,0,0,0,108
15673,19921215,19921215,19922778,0,0,0,1563
15678,19922750,19922778,19922852,0,0,28,102
15677,19922619,19922778,19922869,0,0,159,250
15679,19922856,19922856,19922929,0,0,0,73
15680,19922982,19922982,19923088,0,0,0,106
15681,19923089,19923089,19923186,0,0,0,97
15683,19923206,19923206,19923306,0,0,0,100
15682,19923196,19923196,19923307,0,0,0,111
15684,19924005,19924005,19924137,0,0,0,132
15685,19924089,19924089,19924162,0,0,0,73
15686,19924239,19924239,19924333,0,0,0,94
15687,19924245,19924245,19924359,0,0,0,114
15689,19924318,19924318,19924399,0,0,0,81
15690,19924366,19924366,19924436,0,0,0,70
15691,19924550,19924550,19924639,0,0,0,89
15692,19924764,19924764,19924829,0,0,0,65
15693,19924771,19924771,19924847,0,0,0,76
15695,19924914,19924914,19924994,0,0,0,80
15698,19925680,19925680,19925753,0,0,0,73
15699,19925758,19925758,19925832,0,0,0,74
15671,19920777,19920777,19925963,0,0,0,5186
15676,19922507,19922507,19925979,0,0,0,3472
15700,19925905,19925905,19926013,0,0,0,108
15675,19922253,19922253,19926240,0,0,0,3987
15701,19926145,19926145,19926805,0,0,0,660
15703,19926857,19926857,19927716,0,0,0,859
15715,19928069,19928069,19928164,0,0,0,95
15707,19927929,19927929,19928165,0,0,0,236
15716,19928222,19928222,19928368,0,0,0,146
15566,19821341,19821341,19932786,0,0,0,111445
15747,19934288,19934288,19934366,0,0,0,78
15748,19934405,19934405,19934452,0,0,0,47
15667,19917547,19918242,19936242,0,0,695,18695
15719,19930910,19930910,19936659,0,0,0,5749
15720,19930929,19936242,19938195,0,0,5313,7266
15535,19786262,19786262,19942768,0,0,0,156506
15721,19930934,19936659,19943514,0,0,5725,12580
15722,19930948,19938195,19943665,0,0,7247,12717
15702,19926838,19926838,19944838,0,0,0,18000
15524,19773415,19773415,19946215,0,0,0,172800
15723,19930955,19943514,19949336,0,0,12559,18381
15717,19928355,19928355,19949913,0,0,0,21558
15728,19931574,19946215,19949968,0,0,14641,18394
15726,19931016,19944838,19950416,0,0,13822,19400
15724,19930962,19943665,19950427,0,0,12703,19465
15727,19931023,19946215,19950567,0,0,15192,19544
15567,19821689,19821689,19951289,0,0,0,129600
15568,19821701,19821701,19951301,0,0,0,129600
15725,19930968,19944838,19951371,0,0,13870,20403
15729,19931591,19946215,19951953,0,0,14624,20362
15733,19931616,19950416,19952032,0,0,18800,20416
15743,19932005,19952032,19952955,0,0,20027,20950
15744,19932010,19952955,19953593,0,0,20945,21583
15738,19931964,19951301,19953753,0,0,19337,21789
15742,19932001,19951953,19953830,0,0,19952,21829
15740,19931981,19951301,19954668,0,0,19320,22687
15731,19931603,19949913,19954726,0,0,18310,23123
15730,19931598,19949336,19954806,0,0,17738,23208
15737,19931944,19951289,19955213,0,0,19345,23269
15732,19931610,19949968,19955578,0,0,18358,23968
15734,19931624,19950427,19955932,0,0,18803,24308
15745,19932017,19953593,19956490,0,0,21576,24473
15735,19931649,19950567,19956742,0,0,18918,25093
15536,19786422,19786422,19956805,0,0,0,170383
15714,19927968,19956805,19956916,0,0,28837,28948
15736,19931656,19951289,19956982,0,0,19633,25326
15741,19931992,19951371,19960176,0,0,19379,28184
15739,19931975,19951301,19960194,0,0,19326,28219
15706,19927921,19960176,19960311,0,0,32255,32390
15713,19927963,19960311,19960424,0,0,32348,32461
15656,19910762,19932786,19961084,0,0,22024,50322
15705,19927916,19961084,19961212,0,0,33168,33296
15708,19927934,19961212,19961586,0,0,33278,33652
15709,19927940,19961586,19961741,0,0,33646,33801
15712,19927958,19961741,19961862,0,0,33783,33904
15542,19815399,19815399,19964289,0,0,0,148890
15643,19905526,19905950,19971443,0,0,424,65917
15646,19906021,19912762,19978485,0,0,6741,72464
15630,19900671,19900671,19982587,0,0,0,81916
15752,19985383,19985383,19985466,0,0,0,83
15668,19919690,19920977,19985621,0,0,1287,65931
15753,19985669,19985669,19985777,0,0,0,108
15754,19986166,19986166,19986245,0,0,0,79
15757,19990377,19990377,19990491,0,0,0,114
15758,19990422,19990422,19990509,0,0,0,87
15764,19990437,19990437,19990519,0,0,0,82
15759,19990423,19990423,19990537,0,0,0,114
15760,19990423,19990423,19990537,0,0,0,114
15761,19990423,19990423,19990537,0,0,0,114
15765,19990437,19990437,19990546,0,0,0,109
15762,19990424,19990424,19990549,0,0,0,125
15769,19990463,19990463,19990588,0,0,0,125
15766,19990438,19990491,19990600,0,0,53,162
15770,19990469,19990519,19990627,0,0,50,158
15771,19990469,19990537,19990645,0,0,68,176
15767,19990438,19990537,19990646,0,0,99,208
15768,19990438,19990549,19990658,0,0,111,220
15784,19990521,19990546,19990699,0,0,25,178
15776,19990488,19990491,19990717,0,0,3,229
15785,19990521,19990588,19990776,0,0,67,255
15777,19990488,19990537,19990785,0,0,49,297
15772,19990469,19990646,19990799,0,0,177,330
15774,19990470,19990658,19990811,0,0,188,341
15786,19990522,19990645,19990833,0,0,123,311
15778,19990488,19990600,19990871,0,0,112,383
15787,19990522,19990799,19990982,0,0,277,460
15779,19990488,19990785,19991056,0,0,297,568
15780,19990488,19990811,19991113,0,0,323,625
15788,19990522,19990982,19991188,0,0,460,666
15793,19990817,19991113,19991200,0,0,296,383
15622,19844187,19844187,19991314,0,0,0,147127
15763,19990424,19991200,19991325,0,0,776,901
15773,19990470,19991325,19991433,0,0,855,963
15781,19990489,19991433,19991749,0,0,944,1260
15789,19990522,19991749,19991967,0,0,1227,1445
15795,19991470,19991967,19992040,0,0,497,570
15794,19991256,19991967,19992073,0,0,711,817
15796,19991677,19992040,19992113,0,0,363,436
15797,19992133,19992133,19992181,0,0,0,48
15798,19992139,19992139,19992213,0,0,0,74
15799,19992139,19992139,19992213,0,0,0,74
15800,19992140,19992140,19992256,0,0,0,116
15801,19992140,19992140,19992256,0,0,0,116
15802,19992140,19992256,19992372,0,0,116,232
15806,19992440,19992440,19992555,0,0,0,115
15807,19992601,19992601,19992706,0,0,0,105
15812,19992719,19992719,19992853,0,0,0,134
15816,19992730,19992730,19992853,0,0,0,123
15808,19992707,19992707,19992984,0,0,0,277
15815,19992725,19992853,19992987,0,0,128,262
15756,19986916,19986916,19994552,0,0,0,7636
15830,19995112,19995112,19995258,0,0,0,146
15627,19845673,19877759,19996115,0,0,32086,150442
15775,19990470,19996115,19996209,0,0,5645,5739
15811,19992719,19996115,19996218,0,0,3396,3499
15819,19992742,19996218,19996420,0,0,3476,3678
15782,19990489,19996209,19996528,0,0,5720,6039
15821,19992753,19996420,19996541,0,0,3667,3788
15790,19990523,19996528,19996639,0,0,6005,6116
15831,19996476,19996541,19996645,0,0,65,169
15803,19992140,19996639,19996755,0,0,4499,4615
15832,19996643,19996645,19996761,0,0,2,118
15823,19992900,19992984,19996805,0,0,84,3905
15833,19996732,19996732,19996842,0,0,0,110
15809,19992707,19996755,19997052,0,0,4048,4345
15834,19997005,19997005,19997140,0,0,0,135
15813,19992719,19997052,19997166,0,0,4333,4447
15817,19992730,19997166,19997249,0,0,4436,4519
15835,19997173,19997173,19997280,0,0,0,107
15837,19997284,19997284,19997388,0,0,0,104
15838,19997408,19997408,19997562,0,0,0,154
15839,19997613,19997613,19997728,0,0,0,115
15749,19934568,19954668,19997792,0,0,20100,63224
15746,19933054,19953830,19998953,0,0,20776,65899
15841,19999687,19999687,19999760,0,0,0,73
15842,19999829,19999829,19999902,0,0,0,73
15843,19999955,19999955,20000056,0,0,0,101
15845,20001610,20001610,20001757,0,0,0,147
15824,19993014,19993014,20002139,0,0,0,9125
15847,20002163,20002163,20002270,0,0,0,107
15849,20002494,20002494,20002565,0,0,0,71
15829,19994519,19994519,20002910,0,0,0,8391
15840,19999216,19999216,20003038,0,0,0,3822
15852,20004316,20004316,20004474,0,0,0,158
15853,20004562,20004562,20004678,0,0,0,116
15854,20004757,20004757,20004892,0,0,0,135
15836,19997187,19997187,20005251,0,0,0,8064
15641,19905493,19905950,20005839,0,0,457,100346
15639,19905474,19905950,20005850,0,0,476,100376
15856,20006333,20006333,20006433,0,0,0,100
15857,20006799,20006799,20006895,0,0,0,96
15858,20007912,20007912,20007982,0,0,0,70
15859,20008132,20008132,20008243,0,0,0,111
15860,20008247,20008247,20008318,0,0,0,71
15862,20008382,20008382,20008471,0,0,0,89
15861,20008366,20008366,20008477,0,0,0,111
15863,20008568,20008568,20008668,0,0,0,100
15864,20008577,20008577,20008750,0,0,0,173
15865,20008677,20008677,20008828,0,0,0,151
15866,20008870,20008870,20008981,0,0,0,111
15867,20008943,20008943,20009103,0,0,0,160
15851,20003276,20003276,20009180,0,0,0,5904
15791,19990523,20009180,20009413,0,0,18657,18890
15868,20009345,20009345,20009413,0,0,0,68
15804,19992141,20009413,20009518,0,0,17272,17377
15869,20009438,20009438,20009552,0,0,0,114
15850,20003254,20003254,20009634,0,0,0,6380
15870,20009475,20009475,20009657,0,0,0,182
15810,19992708,20009518,20009665,0,0,16810,16957
15871,20009535,20009535,20009741,0,0,0,206
15814,19992720,20009665,20009758,0,0,16945,17038
15872,20009622,20009634,20009798,0,0,12,176
15818,19992730,20009758,20009873,0,0,17028,17143
15820,19992743,20009873,20009966,0,0,17130,17223
15822,19992753,20009966,20010129,0,0,17213,17376
15873,20009784,20009784,20010188,0,0,0,404
15874,20010038,20010038,20010203,0,0,0,165
15875,20010066,20010066,20010234,0,0,0,168
15825,19993938,20010129,20010264,0,0,16191,16326
15826,19994006,20010264,20010590,0,0,16258,16584
15827,19994394,20010590,20010816,0,0,16196,16422
15828,19994403,20010816,20011044,0,0,16413,16641
15846,20002132,20011044,20011185,0,0,8912,9053
15877,20011274,20011274,20011427,0,0,0,153
15878,20011289,20011289,20011470,0,0,0,181
15882,20011592,20011592,20011723,0,0,0,131
15883,20011684,20011684,20011800,0,0,0,116
15885,20011709,20011709,20011847,0,0,0,138
15884,20011693,20011693,20011884,0,0,0,191
15718,19928436,19928436,20011959,0,0,0,83523
15886,20011711,20011711,20012044,0,0,0,333
15887,20011774,20011774,20012083,0,0,0,309
15876,20010187,20010187,20012256,0,0,0,2069
15894,20012265,20012265,20012400,0,0,0,135
15895,20012277,20012277,20012454,0,0,0,177
15892,20012058,20012058,20012898,0,0,0,840
15889,20011947,20011947,20013140,0,0,0,1193
15888,20011816,20011816,20013206,0,0,0,1390
15640,19905483,19906762,20013253,0,0,1279,107770
15890,20011970,20012898,20013792,0,0,928,1822
15899,20013166,20013792,20013895,0,0,626,729
15903,20013412,20013895,20014007,0,0,483,595
15902,20013398,20013895,20014061,0,0,497,663
15904,20013752,20014007,20014122,0,0,255,370
15905,20013768,20014061,20014238,0,0,293,470
15907,20014291,20014291,20014450,0,0,0,159
15898,20013104,20013792,20014903,0,0,688,1799
15848,20002194,20002194,20015897,0,0,0,13703
15909,20014811,20014903,20016053,0,0,92,1242
15893,20012081,20012081,20016137,0,0,0,4056
15911,20015177,20016137,20016190,0,0,960,1013
15644,19905849,19910321,20016292,0,0,4472,110443
15910,20015175,20016137,20016305,0,0,962,1130
15917,20016104,20016104,20016320,0,0,0,216
15912,20015441,20016190,20016365,0,0,749,924
15913,20015456,20016305,20016469,0,0,849,1013
15914,20015886,20016320,20016471,0,0,434,585
15915,20015903,20016365,20016505,0,0,462,602
15921,20016300,20016471,20016609,0,0,171,309
15920,20016288,20016469,20016629,0,0,181,341
15922,20016392,20016505,20016871,0,0,113,479
15891,20012019,20013140,20017236,0,0,1121,5217
15923,20016734,20016871,20017613,0,0,137,879
15925,20017584,20017613,20018410,0,0,29,826
15926,20017609,20018410,20018702,0,0,801,1093
15928,20017651,20018702,20019530,0,0,1051,1879
15949,20018595,20019530,20020238,0,0,935,1643
15633,19903701,19942768,20025576,0,0,39067,121875
15855,20005297,20005297,20026134,0,0,0,20837
15939,20017795,20026134,20026251,0,0,8339,8456
15940,20017796,20026251,20026368,0,0,8455,8572
15941,20017797,20026368,20026485,0,0,8571,8688
15942,20017798,20026485,20026602,0,0,8687,8804
15943,20017798,20026602,20026719,0,0,8804,8921
15951,20019262,20026719,20026852,0,0,7457,7590
15952,20019263,20026852,20026985,0,0,7589,7722
15953,20019264,20026985,20027118,0,0,7721,7854
15954,20019264,20027118,20027251,0,0,7854,7987
15955,20019265,20027251,20027384,0,0,7986,8119
15956,20019266,20027384,20027517,0,0,8118,8251
15626,19845648,19866426,20032187,0,0,20778,186539
15958,20036133,20036133,20036259,0,0,0,126
15959,20036379,20036379,20036486,0,0,0,107
15960,20036488,20036488,20036620,0,0,0,132
15961,20036488,20036620,20036752,0,0,132,264
15962,20036489,20036752,20036884,0,0,263,395
15963,20036489,20036884,20037016,0,0,395,527
15964,20036489,20037016,20037148,0,0,527,659
15965,20036489,20037148,20037280,0,0,659,791
15966,20036489,20037280,20037412,0,0,791,923
15967,20036489,20037412,20037506,0,0,923,1017
15968,20036489,20037506,20037653,0,0,1017,1164
15969,20036491,20037653,20037747,0,0,1162,1256
15970,20037117,20037747,20037879,0,0,630,762
15971,20037117,20037879,20038011,0,0,762,894
15972,20037117,20038011,20038143,0,0,894,1026
15973,20037117,20038143,20038275,0,0,1026,1158
15974,20037117,20038275,20038407,0,0,1158,1290
15975,20037117,20038407,20038539,0,0,1290,1422
15976,20037118,20038539,20038671,0,0,1421,1553
15977,20037118,20038671,20038765,0,0,1553,1647
15978,20037118,20038765,20038859,0,0,1647,1741
15979,20037118,20038859,20038953,0,0,1741,1835
15980,20037118,20038953,20039047,0,0,1835,1929
15981,20037118,20039047,20039141,0,0,1929,2023
15982,20037118,20039141,20039277,0,0,2023,2159
15983,20037119,20039277,20039371,0,0,2158,2252
15984,20037119,20039371,20039504,0,0,2252,2385
15985,20037119,20039504,20039637,0,0,2385,2518
15986,20037119,20039637,20039770,0,0,2518,2651
15987,20037119,20039770,20039903,0,0,2651,2784
15988,20037119,20039903,20040036,0,0,2784,2917
15989,20037119,20040036,20040169,0,0,2917,3050
15532,19785907,19785907,20045107,0,0,0,259200
15533,19785956,19785956,20045156,0,0,0,259200
15534,19785993,19785993,20045193,0,0,0,259200
15924,20017534,20045107,20045205,0,0,27573,27671
15927,20017618,20045107,20045213,0,0,27489,27595
15929,20017665,20045107,20045226,0,0,27442,27561
15930,20017666,20045156,20045263,0,0,27490,27597
15932,20017667,20045156,20045274,0,0,27489,27607
15931,20017666,20045156,20045278,0,0,27490,27612
15934,20017695,20045193,20045299,0,0,27498,27604
15933,20017668,20045193,20045311,0,0,27525,27643
15935,20017696,20045213,20045319,0,0,27517,27623
15937,20017698,20045278,20045356,0,0,27580,27658
15936,20017697,20045263,20045370,0,0,27566,27673
15938,20017699,20045299,20045406,0,0,27600,27707
15944,20018429,20045319,20045434,0,0,26890,27005
15945,20018431,20045356,20045493,0,0,26925,27062
15947,20018436,20045406,20045499,0,0,26970,27063
15946,20018434,20045370,20045504,0,0,26936,27070
15948,20018439,20045434,20045557,0,0,26995,27118
15537,19786585,19786585,20045785,0,0,0,259200
15561,19820116,20045557,20045890,0,0,225441,225774
15562,19820430,20045890,20046141,0,0,225460,225711
15563,19820679,20046141,20046261,0,0,225462,225582
15565,19821180,20046261,20046861,0,0,225081,225681
15916,20016038,20016038,20047545,0,0,0,31507
15704,19927679,20046861,20048661,0,0,119182,120982
15710,19927946,20048661,20050461,0,0,120715,122515
15711,19927953,20050461,20052261,0,0,122508,124308
15783,19990489,20052261,20052397,0,0,61772,61908
15792,19990523,20052397,20052997,0,0,61874,62474
15805,19992141,20052997,20053597,0,0,60856,61456
15844,20001483,20053597,20053716,0,0,52114,52233
15950,20018721,20026134,20062088,0,0,7413,43367
15957,20019887,20026134,20062088,0,0,6247,42201
15990,20074534,20074534,20074678,0,0,0,144
15991,20074877,20074877,20074913,0,0,0,36
15992,20074921,20074921,20074994,0,0,0,73
15993,20075129,20075129,20075274,0,0,0,145
15994,20075223,20075223,20075341,0,0,0,118
16007,20075227,20075227,20075343,0,0,0,116
15995,20075224,20075224,20075352,0,0,0,128
16000,20075225,20075225,20075353,0,0,0,128
16008,20075227,20075227,20075358,0,0,0,131
16009,20075227,20075227,20075367,0,0,0,140
16010,20075227,20075227,20075367,0,0,0,140
15996,20075224,20075224,20075383,0,0,0,159
15997,20075224,20075224,20075383,0,0,0,159
15998,20075224,20075224,20075383,0,0,0,159
15999,20075224,20075224,20075383,0,0,0,159
16001,20075225,20075225,20075384,0,0,0,159
16002,20075225,20075225,20075384,0,0,0,159
16003,20075226,20075226,20075385,0,0,0,159
16004,20075226,20075226,20075385,0,0,0,159
16005,20075226,20075226,20075385,0,0,0,159
16006,20075226,20075226,20075385,0,0,0,159
16011,20075228,20075228,20075390,0,0,0,162
16012,20075228,20075228,20075390,0,0,0,162
16013,20075228,20075228,20075390,0,0,0,162
16014,20076801,20076801,20076891,0,0,0,90
16015,20077139,20077139,20077234,0,0,0,95
16017,20077250,20077250,20077354,0,0,0,104
16016,20077244,20077244,20077606,0,0,0,362
16021,20079085,20079085,20079246,0,0,0,161
16020,20079068,20079068,20079251,0,0,0,183
16022,20079297,20079297,20079447,0,0,0,150
16023,20079311,20079311,20079471,0,0,0,160
16025,20079716,20079716,20079864,0,0,0,148
16024,20079550,20079550,20079874,0,0,0,324
16026,20079731,20079731,20079900,0,0,0,169
16027,20080323,20080323,20080416,0,0,0,93
16028,20080772,20080772,20080875,0,0,0,103
16029,20080794,20080794,20080906,0,0,0,112
16030,20081071,20081071,20081208,0,0,0,137
16031,20081083,20081083,20081209,0,0,0,126
16033,20081364,20081364,20081506,0,0,0,142
16034,20081380,20081380,20081507,0,0,0,127
16036,20081797,20081797,20081906,0,0,0,109
16037,20081814,20081814,20081931,0,0,0,117
16039,20082083,20082083,20082198,0,0,0,115
16040,20082098,20082098,20082210,0,0,0,112
16041,20082155,20082155,20082259,0,0,0,104
16042,20082274,20082274,20082400,0,0,0,126
16043,20082342,20082342,20082478,0,0,0,136
16044,20082356,20082356,20082481,0,0,0,125
16045,20082789,20082789,20082913,0,0,0,124
16046,20082803,20082803,20082915,0,0,0,112
16019,20078070,20078070,20082931,0,0,0,4861
16018,20077928,20077928,20082962,0,0,0,5034
16049,20082962,20082962,20083074,0,0,0,112
16048,20082939,20082939,20083124,0,0,0,185
16050,20083094,20083094,20083201,0,0,0,107
16047,20082912,20082912,20083214,0,0,0,302
16051,20083119,20083119,20083288,0,0,0,169
16052,20083203,20083203,20083374,0,0,0,171
16054,20083310,20083310,20083427,0,0,0,117
16053,20083304,20083304,20083451,0,0,0,147
16055,20083327,20083327,20083463,0,0,0,136
15657,19910778,19910778,20083526,0,0,0,172748
16038,20082046,20082046,20083563,0,0,0,1517
16059,20083605,20083605,20083771,0,0,0,166
16058,20083593,20083593,20083781,0,0,0,188
16060,20087425,20087425,20087758,0,0,0,333
16061,20088079,20088079,20088138,0,0,0,59
16063,20088515,20088515,20088852,0,0,0,337
16065,20089040,20089040,20089179,0,0,0,139
16064,20089027,20089027,20089188,0,0,0,161
16066,20089528,20089528,20089675,0,0,0,147
16067,20089544,20089544,20089707,0,0,0,163
16068,20089854,20089854,20090181,0,0,0,327
16069,20090104,20090104,20090254,0,0,0,150
16070,20090118,20090118,20090277,0,0,0,159
16057,20083523,20083523,20090846,0,0,0,7323
16056,20083504,20083504,20090882,0,0,0,7378
16073,20090856,20090856,20090955,0,0,0,99
16071,20090533,20090533,20091206,0,0,0,673
16075,20092794,20092794,20092929,0,0,0,135
15879,20011310,20011310,20093767,0,0,0,82457
16078,20093823,20093823,20093958,0,0,0,135
16079,20094044,20094044,20094204,0,0,0,160
16080,20094063,20094063,20094233,0,0,0,170
16082,20094343,20094343,20094394,0,0,0,51
16081,20094286,20094286,20094426,0,0,0,140
16083,20094363,20094363,20094542,0,0,0,179
16084,20094423,20094423,20094595,0,0,0,172
16085,20094491,20094491,20094668,0,0,0,177
16086,20094551,20094551,20094728,0,0,0,177
16087,20094615,20094615,20094786,0,0,0,171
16088,20094675,20094675,20094846,0,0,0,171
16089,20094739,20094739,20094906,0,0,0,167
16091,20094853,20094853,20094938,0,0,0,85
15582,19828326,19842349,20094949,0,0,14023,266623
16090,20094798,20094798,20094978,0,0,0,180
16092,20094919,20094919,20095059,0,0,0,140
16093,20094986,20094986,20095152,0,0,0,166
16077,20093501,20093501,20095540,0,0,0,2039
16094,20095593,20095593,20095931,0,0,0,338
15583,19828337,19843332,20095932,0,0,14995,267595
16062,20088159,20088159,20096593,0,0,0,8434
16095,20096767,20096767,20096830,0,0,0,63
16097,20097843,20097843,20097987,0,0,0,144
16098,20097902,20097902,20098069,0,0,0,167
16099,20097946,20097946,20098094,0,0,0,148
16101,20098057,20098057,20098198,0,0,0,141
16100,20098013,20098013,20098199,0,0,0,186
16102,20098109,20098109,20098246,0,0,0,137
16103,20098160,20098160,20098297,0,0,0,137
16104,20098213,20098213,20098374,0,0,0,161
16105,20098264,20098264,20098427,0,0,0,163
16106,20098320,20098320,20098475,0,0,0,155
16107,20098365,20098365,20098530,0,0,0,165
16108,20098417,20098417,20098567,0,0,0,150
16109,20098431,20098431,20098601,0,0,0,170
16113,20098887,20098887,20099036,0,0,0,149
16114,20098902,20098902,20099059,0,0,0,157
16115,20098959,20098959,20099116,0,0,0,157
16116,20099080,20099080,20099236,0,0,0,156
16118,20099128,20099128,20099280,0,0,0,152
16119,20099344,20099344,20099441,0,0,0,97
16120,20099381,20099381,20099469,0,0,0,88
16121,20099551,20099551,20099677,0,0,0,126
16122,20099563,20099563,20099678,0,0,0,115
16125,20099635,20099635,20099745,0,0,0,110
16124,20099633,20099633,20099754,0,0,0,121
16126,20099636,20099636,20099757,0,0,0,121
16123,20099598,20099598,20099778,0,0,0,180
16127,20099768,20099768,20099925,0,0,0,157
15880,20011337,20025576,20100024,0,0,14239,88687
16128,20099880,20099880,20100039,0,0,0,159
16129,20099986,20099986,20100136,0,0,0,150
16130,20100034,20100034,20100193,0,0,0,159
16132,20100120,20100120,20100225,0,0,0,105
16131,20100102,20100102,20100271,0,0,0,169
16133,20100153,20100153,20100278,0,0,0,125
16134,20100154,20100154,20100279,0,0,0,125
16135,20100160,20100160,20100327,0,0,0,167
15897,20012905,20013206,20100376,0,0,301,87471
15919,20016139,20016629,20100587,0,0,490,84448
15901,20013195,20013792,20100700,0,0,597,87505
16137,20101391,20101391,20101740,0,0,0,349
16138,20101830,20101830,20102168,0,0,0,338
16111,20098465,20098465,20102393,0,0,0,3928
15906,20014027,20014027,20102519,0,0,0,88492
16140,20102554,20102554,20102645,0,0,0,91
16139,20102507,20102507,20102663,0,0,0,156
16141,20102578,20102578,20102830,0,0,0,252
16142,20102653,20102653,20103022,0,0,0,369
16143,20102710,20102710,20103085,0,0,0,375
16144,20102777,20102777,20103145,0,0,0,368
16145,20103039,20103039,20103421,0,0,0,382
16146,20103084,20103084,20103424,0,0,0,340
16147,20103162,20103162,20103528,0,0,0,366
16150,20103356,20103356,20103531,0,0,0,175
16148,20103198,20103198,20103558,0,0,0,360
16110,20098456,20098456,20103584,0,0,0,5128
16149,20103223,20103223,20103597,0,0,0,374
16154,20103607,20103607,20103706,0,0,0,99
16151,20103380,20103380,20103742,0,0,0,362
16152,20103480,20103480,20103842,0,0,0,362
16155,20103743,20103743,20103842,0,0,0,99
16158,20103829,20103829,20103917,0,0,0,88
16153,20103565,20103565,20103923,0,0,0,358
15908,20014486,20014486,20104038,0,0,0,89552
16156,20103774,20103774,20104149,0,0,0,375
16157,20103820,20103820,20104188,0,0,0,368
16160,20103929,20103929,20104197,0,0,0,268
16159,20103838,20103838,20104228,0,0,0,390
16162,20104219,20104219,20104312,0,0,0,93
16167,20105484,20105484,20105643,0,0,0,159
15881,20011442,20032187,20106606,0,0,20745,95164
16164,20104337,20104337,20111722,0,0,0,7385
16072,20090832,20090832,20112057,0,0,0,21225
15629,19900593,19900593,20112385,0,0,0,211792
16074,20091028,20091028,20112780,0,0,0,21752
16175,20113492,20113492,20113596,0,0,0,104
16176,20114427,20114427,20114562,0,0,0,135
16177,20114755,20114755,20114885,0,0,0,130
16178,20114894,20114894,20115020,0,0,0,126
16179,20115056,20115056,20115181,0,0,0,125
16180,20115142,20115142,20115292,0,0,0,150
16181,20115528,20115528,20115675,0,0,0,147
16182,20115796,20115796,20115942,0,0,0,146
16183,20116230,20116230,20116357,0,0,0,127
16184,20117447,20117447,20117585,0,0,0,138
16186,20117631,20117631,20117756,0,0,0,125
16187,20118207,20118207,20118353,0,0,0,146
16188,20118437,20118437,20118584,0,0,0,147
16189,20121575,20121575,20121650,0,0,0,75
16190,20121628,20121628,20121743,0,0,0,115
16191,20121776,20121776,20121922,0,0,0,146
16192,20122017,20122017,20122617,0,0,0,600
16096,20096993,20096993,20123260,0,0,0,26267
16193,20123509,20123509,20124109,0,0,0,600
16032,20081215,20081215,20125885,0,0,0,44670
15751,19936913,19954806,20127606,0,0,17893,190693
15918,20016128,20017236,20127704,0,0,1108,111576
15750,19936803,19971443,20132972,0,0,34640,196169
16169,20108227,20108227,20150692,0,0,0,42465
16170,20108331,20108331,20150765,0,0,0,42434
16197,20156570,20156570,20156920,0,0,0,350
16198,20156985,20156985,20157125,0,0,0,140
16199,20157231,20157231,20157340,0,0,0,109
16201,20157488,20157488,20157623,0,0,0,135
16203,20157660,20157660,20157769,0,0,0,109
15755,19986482,19986482,20159282,0,0,0,172800
16204,20159393,20159393,20159955,0,0,0,562
16206,20160559,20160559,20160710,0,0,0,151
16209,20162949,20162949,20163079,0,0,0,130
16210,20163272,20163272,20163350,0,0,0,78
16205,20159971,20159971,20163589,0,0,0,3618
16211,20163584,20163584,20163699,0,0,0,115
15659,19911864,19911864,20163864,0,0,0,252000
15660,19911897,19911897,20163897,0,0,0,252000
15661,19911906,19911906,20163906,0,0,0,252000
16213,20163795,20163795,20163919,0,0,0,124
16214,20163981,20163981,20164087,0,0,0,106
16215,20164216,20164216,20164326,0,0,0,110
16216,20164293,20164293,20164433,0,0,0,140
16217,20164462,20164462,20164540,0,0,0,78
16218,20164907,20164907,20164985,0,0,0,78
16220,20165355,20165355,20165458,0,0,0,103
16221,20165845,20165845,20165934,0,0,0,89
16222,20165992,20165992,20166065,0,0,0,73
16223,20166098,20166098,20166177,0,0,0,79
16224,20166216,20166216,20166296,0,0,0,80
16225,20166248,20166248,20166331,0,0,0,83
16163,20104333,20104333,20166602,0,0,0,62269
16166,20104370,20104370,20166603,0,0,0,62233
16165,20104349,20104349,20166607,0,0,0,62258
16228,20166806,20166806,20167045,0,0,0,239
16227,20166360,20166360,20168040,0,0,0,1680
16226,20166352,20166352,20168044,0,0,0,1692
16232,20170431,20170431,20170526,0,0,0,95
16233,20170483,20170483,20170536,0,0,0,53
16234,20170696,20170696,20170935,0,0,0,239
16235,20171595,20171595,20171833,0,0,0,238
16236,20171991,20171991,20172226,0,0,0,235
16112,20098631,20098631,20172249,0,0,0,73618
16240,20172433,20172433,20172499,0,0,0,66
15900,20013170,20016292,20172543,0,0,3122,159373
16244,20172514,20172514,20172592,0,0,0,78
15896,20012885,20013253,20172763,0,0,368,159878
16245,20172694,20172694,20172783,0,0,0,89
16117,20099122,20099122,20172828,0,0,0,73706
16241,20172464,20172464,20173029,0,0,0,565
16242,20172478,20172478,20173054,0,0,0,576
16247,20172830,20172830,20173055,0,0,0,225
16246,20172821,20172821,20173057,0,0,0,236
16243,20172501,20172501,20173099,0,0,0,598
16248,20172855,20172855,20173102,0,0,0,247
16249,20172939,20173029,20173261,0,0,90,322
16237,20172375,20172375,20173379,0,0,0,1004
16238,20172390,20172390,20173394,0,0,0,1004
16239,20172404,20172404,20173419,0,0,0,1015
16230,20170024,20170024,20173966,0,0,0,3942
16229,20168973,20168973,20174031,0,0,0,5058
16231,20170232,20170232,20174032,0,0,0,3800
16251,20173020,20173029,20174394,0,0,9,1374
16266,20173827,20174394,20174480,0,0,567,653
16208,20162458,20162458,20174723,0,0,0,12265
16279,20174712,20174723,20174842,0,0,11,130
16282,20174910,20174910,20175020,0,0,0,110
16219,20165254,20165254,20175040,0,0,0,9786
16284,20175245,20175245,20175358,0,0,0,113
16285,20175310,20175310,20175369,0,0,0,59
16286,20175369,20175369,20175467,0,0,0,98
16287,20175409,20175409,20175513,0,0,0,104
16289,20175851,20175851,20175929,0,0,0,78
16291,20175981,20175981,20176082,0,0,0,101
16288,20175607,20175607,20176207,0,0,0,600
16292,20176265,20176265,20176381,0,0,0,116
16293,20176344,20176344,20176392,0,0,0,48
16262,20173632,20173632,20176607,0,0,0,2975
16263,20173708,20173708,20176672,0,0,0,2964
16261,20173547,20173547,20176849,0,0,0,3302
16264,20173758,20174032,20177006,0,0,274,3248
16267,20173900,20174394,20177377,0,0,494,3477
16268,20173986,20174480,20177460,0,0,494,3474
16076,20093223,20093223,20177752,0,0,0,84529
16276,20174470,20177752,20178004,0,0,3282,3534
16269,20174063,20175040,20178015,0,0,977,3952
16273,20174186,20174186,20178018,0,0,0,3832
16271,20174113,20176672,20179645,0,0,2559,5532
16272,20174169,20176849,20179822,0,0,2680,5653
16274,20174296,20177006,20179976,0,0,2710,5680
16290,20175942,20179822,20180042,0,0,3880,4100
16294,20176397,20180042,20180283,0,0,3645,3886
16270,20174096,20176607,20180300,0,0,2511,6204
16295,20177260,20180283,20180387,0,0,3023,3127
16275,20174341,20177377,20180404,0,0,3036,6063
16296,20177586,20180300,20180427,0,0,2714,2841
16297,20177702,20180387,20180505,0,0,2685,2803
16298,20177848,20180427,20180543,0,0,2579,2695
16300,20178387,20180543,20180594,0,0,2156,2207
16299,20178170,20180505,20180621,0,0,2335,2451
16280,20174794,20177752,20180775,0,0,2958,5981
16212,20163732,20163732,20180948,0,0,0,17216
16281,20174909,20178004,20181030,0,0,3095,6121
16305,20182037,20182037,20182084,0,0,0,47
16304,20181995,20181995,20182090,0,0,0,95
16306,20182086,20182086,20182252,0,0,0,166
16307,20182260,20182260,20182349,0,0,0,89
16303,20181887,20181887,20182487,0,0,0,600
16308,20182570,20182570,20182759,0,0,0,189
16310,20182939,20182939,20183539,0,0,0,600
16312,20183736,20183736,20183814,0,0,0,78
16313,20183928,20183928,20183974,0,0,0,46
16314,20184056,20184056,20184151,0,0,0,95
16316,20184180,20184180,20184275,0,0,0,95
16317,20184408,20184408,20184519,0,0,0,111
16315,20184151,20184151,20184647,0,0,0,496
16319,20184574,20184574,20184736,0,0,0,162
16320,20184580,20184580,20184753,0,0,0,173
16321,20184580,20184580,20184769,0,0,0,189
16322,20184580,20184580,20184769,0,0,0,189
16323,20184581,20184581,20184770,0,0,0,189
16324,20184581,20184647,20184862,0,0,66,281
16325,20184581,20184736,20184951,0,0,155,370
16326,20184582,20184753,20184968,0,0,171,386
16327,20184582,20184769,20184984,0,0,187,402
16328,20184582,20184769,20185005,0,0,187,423
16329,20184582,20184770,20185006,0,0,188,424
16330,20184583,20184862,20185098,0,0,279,515
16332,20184583,20184968,20185113,0,0,385,530
16331,20184583,20184951,20185120,0,0,368,537
16333,20184583,20184984,20185133,0,0,401,550
16334,20184584,20185005,20185201,0,0,421,617
16335,20184585,20185006,20185202,0,0,421,617
16338,20184928,20185098,20185629,0,0,170,701
16339,20184928,20185113,20185655,0,0,185,727
16341,20184929,20185133,20185675,0,0,204,746
16340,20184928,20185120,20185684,0,0,192,756
16352,20185255,20185255,20185720,0,0,0,465
16342,20184929,20185201,20185754,0,0,272,825
16343,20184929,20185202,20185755,0,0,273,826
16353,20185261,20185720,20186181,0,0,459,920
16344,20184929,20185629,20186182,0,0,700,1253
16345,20184929,20185655,20186208,0,0,726,1279
16347,20184930,20185684,20186237,0,0,754,1307
16346,20184929,20185675,20186239,0,0,746,1310
16349,20184930,20185755,20186283,0,0,825,1353
16348,20184930,20185754,20186318,0,0,824,1388
16359,20186322,20186322,20186401,0,0,0,79
16360,20186504,20186504,20186551,0,0,0,47
16355,20185262,20186208,20186691,0,0,946,1429
16354,20185261,20186181,20186695,0,0,920,1434
16350,20184930,20186182,20186710,0,0,1252,1780
16356,20185262,20186208,20186722,0,0,946,1460
16361,20186610,20186610,20186730,0,0,0,120
16357,20185262,20186237,20186751,0,0,975,1489
16358,20185262,20186237,20186793,0,0,975,1531
16362,20186684,20186684,20187010,0,0,0,326
16363,20187242,20187242,20187355,0,0,0,113
16365,20187553,20187553,20187631,0,0,0,78
16367,20187886,20187886,20187995,0,0,0,109
16207,20162261,20162261,20188283,0,0,0,26022
16161,20104030,20104030,20188915,0,0,0,84885
16370,20189473,20189473,20189551,0,0,0,78
16371,20189591,20189591,20189638,0,0,0,47
16372,20189691,20189691,20189886,0,0,0,195
16373,20190685,20190685,20190764,0,0,0,79
16374,20190968,20190968,20191046,0,0,0,78
16376,20191644,20191644,20191722,0,0,0,78
16369,20188693,20188693,20191778,0,0,0,3085
16377,20191830,20191830,20191907,0,0,0,77
16381,20191921,20191921,20192068,0,0,0,147
16382,20192031,20192031,20192116,0,0,0,85
16383,20192068,20192068,20192170,0,0,0,102
16384,20192126,20192126,20192200,0,0,0,74
16385,20192148,20192148,20192226,0,0,0,78
16283,20174977,20178015,20192389,0,0,3038,17412
16393,20192450,20192450,20192497,0,0,0,47
16388,20192285,20192389,20192519,0,0,104,234
16394,20192525,20192525,20192679,0,0,0,154
16387,20192271,20192271,20192737,0,0,0,466
16400,20192632,20192632,20192865,0,0,0,233
15688,19924291,19942768,20195368,0,0,18477,271077
16318,20184503,20195368,20195515,0,0,10865,11012
16336,20184654,20195515,20195663,0,0,10861,11009
16337,20184776,20195663,20195859,0,0,10887,11083
16278,20174706,20177460,20195890,0,0,2754,21184
16351,20185012,20195859,20196013,0,0,10847,11001
16364,20187313,20195890,20196071,0,0,8577,8758
16309,20182674,20192737,20196539,0,0,10063,13865
16368,20188060,20196013,20196613,0,0,7953,8553
16406,20194843,20196071,20197391,0,0,1228,2548
16195,20156497,20156497,20198896,0,0,0,42399
16196,20156512,20156512,20199008,0,0,0,42496
16375,20191543,20199008,20199367,0,0,7465,7824
16378,20191836,20199367,20199495,0,0,7531,7659
16379,20191837,20199495,20199619,0,0,7658,7782
16380,20191839,20199619,20199760,0,0,7780,7921
16194,20156456,20156456,20199836,0,0,0,43380
16386,20192256,20199760,20199858,0,0,7504,7602
16200,20157467,20157467,20199906,0,0,0,42439
16202,20157509,20157509,20199948,0,0,0,42439
16389,20192310,20199858,20199955,0,0,7548,7645
16390,20192312,20199906,20200045,0,0,7594,7733
16391,20192314,20199948,20200072,0,0,7634,7758
16392,20192316,20199955,20200106,0,0,7639,7790
16395,20192535,20200045,20200165,0,0,7510,7630
16396,20192538,20200072,20200198,0,0,7534,7660
16397,20192539,20200106,20200232,0,0,7567,7693
16398,20192540,20200165,20200261,0,0,7625,7721
16399,20192541,20200198,20200294,0,0,7657,7753
16401,20193268,20200232,20200338,0,0,6964,7070
16302,20181331,20196613,20200373,0,0,15282,19042
16402,20193269,20200261,20200398,0,0,6992,7129
16403,20193270,20200294,20200424,0,0,7024,7154
16404,20193271,20200338,20200437,0,0,7067,7166
16405,20193272,20200373,20200502,0,0,7101,7230
16407,20196007,20200398,20200517,0,0,4391,4510
16408,20196059,20200424,20200547,0,0,4365,4488
16409,20196060,20200437,20200560,0,0,4377,4500
16410,20196061,20200502,20200612,0,0,4441,4551
16411,20196063,20200517,20200636,0,0,4454,4573
16412,20196343,20200547,20200860,0,0,4204,4517
16413,20196344,20200560,20200864,0,0,4216,4520
16414,20196346,20200612,20200927,0,0,4266,4581
16415,20196347,20200636,20200951,0,0,4289,4604
16416,20196348,20200860,20201130,0,0,4512,4782
16417,20197545,20200864,20201218,0,0,3319,3673
16418,20197546,20200927,20201239,0,0,3381,3693
16419,20197547,20200951,20201272,0,0,3404,3725
16420,20197563,20201130,20201451,0,0,3567,3888
16424,20201183,20201272,20201459,0,0,89,276
16421,20197564,20201218,20201561,0,0,3654,3997
16422,20197566,20201239,20201613,0,0,3673,4047
16426,20201711,20201711,20201771,0,0,0,60
16425,20201491,20201491,20201782,0,0,0,291
16428,20202179,20202179,20202323,0,0,0,144
16429,20202180,20202323,20202467,0,0,143,287
16423,20199675,20201272,20202553,0,0,1597,2878
16430,20202181,20202467,20202611,0,0,286,430
16311,20183627,20198896,20202677,0,0,15269,19050
16431,20202182,20202553,20202697,0,0,371,515
16432,20202182,20202611,20202755,0,0,429,573
16433,20202329,20202677,20202814,0,0,348,485
16434,20202330,20202677,20202834,0,0,347,504
16435,20202331,20202677,20202834,0,0,346,503
16436,20202332,20202697,20202854,0,0,365,522
16437,20202333,20202755,20202912,0,0,422,579
16438,20203211,20203211,20203270,0,0,0,59
16427,20201802,20201802,20203271,0,0,0,1469
16439,20203282,20203282,20205142,0,0,0,1860
16366,20187684,20187684,20208715,0,0,0,21031
15694,19924900,19956490,20209090,0,0,31590,284190
15696,19924933,19956805,20209405,0,0,31872,284472
15697,19924958,19956805,20209405,0,0,31847,284447
16440,20205822,20205822,20210461,0,0,0,4639
16035,20081712,20081712,20211356,0,0,0,129644
16441,20211177,20211177,20213454,0,0,0,2277
16442,20249488,20249488,20252209,0,0,0,2721
16443,20252946,20252946,20253144,0,0,0,198
16444,20253280,20253280,20255942,0,0,0,2662
16445,20256078,20256078,20258097,0,0,0,2019
16451,20258076,20258076,20259578,0,0,0,1502
16453,20269402,20269402,20269519,0,0,0,117
16454,20269874,20269874,20269989,0,0,0,115
16455,20270034,20270034,20270165,0,0,0,131
16456,20270133,20270133,20270282,0,0,0,149
16457,20270371,20270371,20271812,0,0,0,1441
16458,20271756,20271756,20271889,0,0,0,133
16460,20272129,20272129,20272261,0,0,0,132
16461,20272329,20272329,20272418,0,0,0,89
16459,20272114,20272114,20272813,0,0,0,699
16462,20272795,20272795,20272884,0,0,0,89
16463,20272909,20272909,20273009,0,0,0,100
16136,20100292,20100292,20273092,0,0,0,172800
16466,20273609,20273609,20273699,0,0,0,90
16465,20273100,20273100,20273753,0,0,0,653
16464,20272961,20272961,20273765,0,0,0,804
16467,20273737,20273737,20273798,0,0,0,61
16468,20273805,20273805,20273872,0,0,0,67
16470,20274042,20274042,20274135,0,0,0,93
16469,20274004,20274004,20274202,0,0,0,198
16471,20274214,20274214,20274281,0,0,0,67
16473,20274754,20274754,20274843,0,0,0,89
16474,20274841,20274841,20274930,0,0,0,89
16475,20274998,20274998,20275074,0,0,0,76
16476,20275067,20275067,20275157,0,0,0,90
16477,20275298,20275298,20275394,0,0,0,96
16478,20275512,20275512,20275607,0,0,0,95
16479,20275689,20275689,20275778,0,0,0,89
16480,20275781,20275781,20275890,0,0,0,109
16481,20276477,20276477,20276566,0,0,0,89
16482,20276688,20276688,20276782,0,0,0,94
16483,20276930,20276930,20277025,0,0,0,95
16484,20277254,20277254,20277348,0,0,0,94
16485,20277346,20277346,20277436,0,0,0,90
16486,20277735,20277735,20277829,0,0,0,94
16487,20278103,20278103,20278192,0,0,0,89
16488,20278364,20278364,20278459,0,0,0,95
16489,20278505,20278505,20278600,0,0,0,95
16490,20278689,20278689,20278783,0,0,0,94
16491,20278789,20278789,20278856,0,0,0,67
16492,20278995,20278995,20279089,0,0,0,94
16493,20279462,20279462,20279556,0,0,0,94
16494,20279511,20279511,20279605,0,0,0,94
16495,20279620,20279620,20279715,0,0,0,95
16496,20279749,20279749,20279816,0,0,0,67
16452,20261951,20261951,20287832,0,0,0,25881
16446,20256963,20256963,20299392,0,0,0,42429
16447,20256974,20256974,20299392,0,0,0,42418
16448,20256987,20256987,20299426,0,0,0,42439
16449,20257002,20257002,20299441,0,0,0,42439
16450,20257571,20257571,20300010,0,0,0,42439
16258,20173411,20173411,20308998,0,0,0,135587
16174,20111583,20111583,20309011,0,0,0,197428
16173,20111444,20111444,20327541,0,0,0,216097
16185,20117527,20117527,20328709,0,0,0,211182
16256,20173387,20173387,20330492,0,0,0,157105
16472,20274350,20274350,20336682,0,0,0,62332
16265,20173811,20173811,20341583,0,0,0,167772
16500,20341679,20341679,20341797,0,0,0,118
16501,20341811,20341811,20342580,0,0,0,769
16260,20173431,20180948,20342811,0,0,7517,169380
16502,20342569,20342569,20343270,0,0,0,701
16503,20342670,20342670,20343278,0,0,0,608
16504,20343278,20343278,20344111,0,0,0,833
16505,20343328,20343328,20344120,0,0,0,792
16507,20344262,20344262,20345071,0,0,0,809
16506,20344191,20344191,20345084,0,0,0,893
16508,20346375,20346375,20346446,0,0,0,71
16497,20333273,20333273,20347633,0,0,0,14360
16498,20333357,20333357,20348046,0,0,0,14689
16509,20346447,20346447,20348247,0,0,0,1800
16510,20346457,20346457,20348257,0,0,0,1800
16499,20333512,20333512,20348492,0,0,0,14980
16171,20110792,20110792,20352609,0,0,0,241817
16514,20351883,20351883,20352734,0,0,0,851
16515,20352746,20352746,20353493,0,0,0,747
16516,20353491,20353491,20354339,0,0,0,848
16517,20354376,20354376,20355100,0,0,0,724
16518,20355135,20355135,20355945,0,0,0,810
16520,20356044,20356044,20356803,0,0,0,759
16519,20355950,20355950,20356824,0,0,0,874
16521,20356797,20356797,20357808,0,0,0,1011
16522,20361156,20361156,20361273,0,0,0,117
16523,20361223,20361223,20361338,0,0,0,115
16524,20361293,20361293,20361400,0,0,0,107
16525,20361362,20361362,20361457,0,0,0,95
16526,20361572,20361572,20361700,0,0,0,128
16527,20361636,20361636,20361773,0,0,0,137
16168,20106401,20106401,20365601,0,0,0,259200
16172,20111249,20111249,20370449,0,0,0,259200
16528,20371859,20371859,20371932,0,0,0,73
16254,20173213,20173213,20380598,0,0,0,207385
16252,20173195,20173195,20387017,0,0,0,213822
16513,20349378,20349378,20387928,0,0,0,38550
16253,20173204,20173204,20392924,0,0,0,219720
16532,20417353,20417353,20417453,0,0,0,100
16534,20417484,20417484,20417652,0,0,0,168
16535,20417607,20417607,20417687,0,0,0,80
16533,20417408,20417408,20417839,0,0,0,431
16536,20417890,20417890,20418014,0,0,0,124
16537,20418180,20418180,20418228,0,0,0,48
16511,20349194,20349194,20419171,0,0,0,69977
16540,20419145,20419145,20419212,0,0,0,67
16512,20349324,20349324,20419271,0,0,0,69947
16539,20419134,20419134,20419352,0,0,0,218
16541,20419154,20419154,20419366,0,0,0,212
16542,20419216,20419216,20419377,0,0,0,161
16543,20419312,20419312,20420799,0,0,0,1487
16544,20419332,20419332,20420822,0,0,0,1490
16545,20419357,20419357,20420846,0,0,0,1489
16277,20174661,20201613,20421782,0,0,26952,247121
16551,20422351,20422351,20422702,0,0,0,351
16553,20427140,20427140,20427244,0,0,0,104
16554,20427246,20427246,20427364,0,0,0,118
16550,20421966,20421966,20427982,0,0,0,6016
16556,20429333,20429333,20429468,0,0,0,135
16529,20373858,20373858,20429854,0,0,0,55996
16552,20423318,20423318,20429966,0,0,0,6648
16548,20420778,20420778,20430885,0,0,0,10107
16547,20420757,20420757,20431051,0,0,0,10294
16562,20431006,20431006,20431066,0,0,0,60
16549,20420800,20420800,20431071,0,0,0,10271
16250,20172950,20172950,20432083,0,0,0,259133
16255,20173376,20173376,20432576,0,0,0,259200
16257,20173396,20173396,20432596,0,0,0,259200
16259,20173420,20173420,20432620,0,0,0,259200
16565,20434120,20434120,20434240,0,0,0,120
16555,20427418,20427418,20436168,0,0,0,8750
16563,20431221,20431221,20437001,0,0,0,5780
16569,20436995,20436995,20437237,0,0,0,242
16557,20430018,20430018,20438067,0,0,0,8049
16572,20438925,20438925,20438989,0,0,0,64
16573,20439122,20439122,20439200,0,0,0,78
16574,20439217,20439217,20439287,0,0,0,70
16575,20439249,20439249,20439300,0,0,0,51
16576,20439299,20439299,20439366,0,0,0,67
16577,20439367,20439367,20439425,0,0,0,58
16578,20439424,20439424,20439486,0,0,0,62
16579,20439456,20439456,20439536,0,0,0,80
16580,20439463,20439463,20439543,0,0,0,80
16581,20439689,20439689,20439744,0,0,0,55
16301,20178410,20180594,20439748,0,0,2184,261338
16582,20439698,20439698,20439767,0,0,0,69
16571,20438023,20438023,20439872,0,0,0,1849
16583,20439782,20439782,20439901,0,0,0,119
16546,20420338,20420338,20440015,0,0,0,19677
16585,20439904,20439904,20440016,0,0,0,112
16592,20439907,20439907,20440025,0,0,0,118
16593,20439907,20439907,20440025,0,0,0,118
16594,20439907,20439907,20440025,0,0,0,118
16596,20439908,20439908,20440026,0,0,0,118
16597,20439908,20439908,20440026,0,0,0,118
16587,20439906,20439906,20440030,0,0,0,124
16588,20439906,20439906,20440030,0,0,0,124
16589,20439906,20439906,20440030,0,0,0,124
16591,20439907,20439907,20440031,0,0,0,124
16595,20439907,20439907,20440036,0,0,0,129
16604,20439910,20439910,20440038,0,0,0,128
16598,20439908,20439908,20440045,0,0,0,137
16599,20439908,20439908,20440045,0,0,0,137
16600,20439909,20439909,20440046,0,0,0,137
16601,20439909,20439909,20440046,0,0,0,137
16602,20439909,20439909,20440048,0,0,0,139
16603,20439909,20439909,20440048,0,0,0,139
16586,20439905,20439905,20440060,0,0,0,155
16590,20439906,20439906,20440061,0,0,0,155
16608,20441290,20441290,20441406,0,0,0,116
16609,20441538,20441538,20441611,0,0,0,73
16610,20441696,20441696,20441836,0,0,0,140
16584,20439868,20439868,20442119,0,0,0,2251
16612,20442374,20442374,20442513,0,0,0,139
16618,20442637,20442637,20442730,0,0,0,93
16617,20442636,20442636,20442751,0,0,0,115
16615,20442634,20442634,20442757,0,0,0,123
16616,20442635,20442635,20442761,0,0,0,126
16619,20442638,20442638,20442768,0,0,0,130
16605,20439975,20439975,20443150,0,0,0,3175
16561,20430865,20430865,20443353,0,0,0,12488
16621,20443329,20443329,20444006,0,0,0,677
16620,20442829,20442829,20444060,0,0,0,1231
16570,20437279,20437279,20447934,0,0,0,10655
16613,20442406,20442406,20450450,0,0,0,8044
16614,20442501,20442501,20450546,0,0,0,8045
16611,20442347,20442347,20451314,0,0,0,8967
16661,20451374,20451374,20452243,0,0,0,869
16667,20452267,20452267,20452349,0,0,0,82
16664,20451505,20451505,20452444,0,0,0,939
16665,20451509,20451509,20452490,0,0,0,981
16666,20451513,20451513,20452556,0,0,0,1043
16662,20451387,20451387,20452565,0,0,0,1178
16663,20451399,20451399,20452630,0,0,0,1231
16558,20430116,20430116,20453220,0,0,0,23104
16560,20430770,20430770,20453220,0,0,0,22450
16530,20414457,20414457,20456877,0,0,0,42420
16531,20415895,20415895,20459278,0,0,0,43383
16623,20444155,20444155,20460991,0,0,0,16836
16606,20440204,20440204,20461177,0,0,0,20973
16559,20430367,20430367,20461748,0,0,0,31381
16566,20434373,20434373,20461786,0,0,0,27413
16564,20433252,20433252,20461791,0,0,0,28539
16668,20452331,20452331,20476153,0,0,0,23822
16625,20449213,20449213,20501285,0,0,0,52072
16626,20449213,20449213,20502208,0,0,0,52995
16627,20449213,20449213,20502332,0,0,0,53119
16628,20449213,20449213,20502456,0,0,0,53243
16629,20449214,20449214,20502457,0,0,0,53243
16645,20451104,20451104,20502835,0,0,0,51731
16643,20451102,20451102,20502895,0,0,0,51793
16630,20449214,20449214,20503232,0,0,0,54018
16631,20449214,20449214,20503232,0,0,0,54018
16646,20451104,20451104,20503269,0,0,0,52165
16649,20451105,20451105,20503449,0,0,0,52344
16650,20451105,20451105,20503480,0,0,0,52375
16632,20449214,20449214,20503491,0,0,0,54277
16651,20451105,20451105,20503511,0,0,0,52406
16644,20451103,20451103,20503788,0,0,0,52685
16647,20451104,20451104,20504440,0,0,0,53336
16633,20449214,20449214,20504638,0,0,0,55424
16634,20451077,20451077,20506959,0,0,0,55882
16635,20451078,20451078,20506960,0,0,0,55882
16642,20451080,20451080,20507086,0,0,0,56006
16636,20451078,20451078,20507766,0,0,0,56688
16672,20507882,20507882,20507995,0,0,0,113
16638,20451079,20451079,20508232,0,0,0,57153
16622,20443677,20443677,20508369,0,0,0,64692
16669,20453144,20453144,20508444,0,0,0,55300
16637,20451078,20451078,20508510,0,0,0,57432
16567,20434881,20434881,20508683,0,0,0,73802
16607,20440302,20440302,20508683,0,0,0,68381
16538,20418342,20418342,20508697,0,0,0,90355
16568,20436198,20436198,20508697,0,0,0,72499
16624,20444959,20444959,20508698,0,0,0,63739
16639,20451079,20451079,20508728,0,0,0,57649
16640,20451079,20451079,20508770,0,0,0,57691
16652,20451148,20451148,20509304,0,0,0,58156
16658,20451150,20451150,20509399,0,0,0,58249
16654,20451149,20451149,20509646,0,0,0,58497
16659,20451150,20451150,20509709,0,0,0,58559
16655,20451149,20451149,20510576,0,0,0,59427
16660,20451150,20451150,20510942,0,0,0,59792
16656,20451149,20451149,20511654,0,0,0,60505
16641,20451079,20451079,20513314,0,0,0,62235
16657,20451149,20451149,20513817,0,0,0,62668
16653,20451148,20451148,20513847,0,0,0,62699
16670,20453162,20453162,20516244,0,0,0,63082
16671,20453385,20453385,20516564,0,0,0,63179
16687,20532926,20532926,20534509,0,0,0,1583
16688,20532961,20532961,20534589,0,0,0,1628
16683,20532613,20532613,20534659,0,0,0,2046
16684,20532677,20532677,20534759,0,0,0,2082
16685,20532723,20532723,20534794,0,0,0,2071
16686,20532762,20532762,20534802,0,0,0,2040
16700,20535826,20535826,20535920,0,0,0,94
16701,20535846,20535846,20535924,0,0,0,78
16689,20532969,20534509,20536224,0,0,1540,3255
16702,20536100,20536100,20536426,0,0,0,326
16704,20536538,20536538,20536590,0,0,0,52
16705,20536545,20536545,20536597,0,0,0,52
16648,20451104,20451104,20537504,0,0,0,86400
16723,20554674,20554674,20554721,0,0,0,47
16690,20533554,20533554,20554832,0,0,0,21278
16703,20536230,20554832,20554936,0,0,18602,18706
16724,20554765,20554765,20555111,0,0,0,346
16699,20535196,20535196,20555607,0,0,0,20411
16725,20563148,20563148,20563314,0,0,0,166
16726,20563530,20563530,20563654,0,0,0,124
16727,20563655,20563655,20564235,0,0,0,580
16736,20595796,20595796,20595968,0,0,0,172
16691,20534470,20534589,20598071,0,0,119,63601
16692,20534601,20534659,20598085,0,0,58,63484
16694,20534668,20534794,20598146,0,0,126,63478
16718,20544140,20598146,20598250,0,0,54006,54110
16740,20598215,20598215,20598293,0,0,0,78
16719,20544212,20598250,20598405,0,0,54038,54193
16720,20544432,20598405,20598529,0,0,53973,54097
16698,20534804,20598071,20598692,0,0,63267,63888
16721,20544629,20598529,20598808,0,0,53900,54179
16722,20544999,20598692,20599127,0,0,53693,54128
16730,20593418,20599127,20599247,0,0,5709,5829
16758,20599501,20599501,20599579,0,0,0,78
16759,20599613,20599613,20599680,0,0,0,67
16697,20534795,20536224,20600072,0,0,1429,65277
16761,20600096,20600096,20600179,0,0,0,83
16760,20600085,20600085,20600184,0,0,0,99
16763,20600182,20600182,20600229,0,0,0,47
16764,20600226,20600226,20600521,0,0,0,295
16762,20600107,20600107,20600919,0,0,0,812
16780,20602915,20602915,20603174,0,0,0,259
16693,20534633,20534759,20603364,0,0,126,68731
16783,20603890,20603890,20603957,0,0,0,67
16782,20603874,20603874,20603988,0,0,0,114
16787,20605092,20605092,20605283,0,0,0,191
16788,20605510,20605510,20605608,0,0,0,98
16789,20605901,20605901,20605968,0,0,0,67
16790,20606061,20606061,20606263,0,0,0,202
16792,20607017,20607017,20607250,0,0,0,233
16793,20607250,20607250,20607349,0,0,0,99
16794,20607354,20607354,20607547,0,0,0,193
16791,20606313,20606313,20607820,0,0,0,1507
16799,20607874,20607874,20607976,0,0,0,102
16781,20602981,20602981,20608197,0,0,0,5216
16784,20604696,20608197,20608625,0,0,3501,3929
16786,20605007,20608625,20608932,0,0,3618,3925
16796,20607555,20608932,20609274,0,0,1377,1719
16797,20607645,20609274,20609449,0,0,1629,1804
16800,20607945,20607976,20609502,0,0,31,1557
16802,20608900,20608900,20610436,0,0,0,1536
16807,20611314,20611314,20611413,0,0,0,99
16808,20611416,20611416,20611488,0,0,0,72
16809,20611472,20611472,20611559,0,0,0,87
16811,20611605,20611605,20611672,0,0,0,67
16805,20609939,20609939,20611751,0,0,0,1812
16814,20612184,20612184,20612282,0,0,0,98
16813,20612171,20612171,20612286,0,0,0,115
16815,20612850,20612850,20612922,0,0,0,72
16801,20608627,20609449,20613027,0,0,822,4400
16695,20534766,20534802,20614326,0,0,36,79560
16743,20599230,20614326,20614433,0,0,15096,15203
16744,20599231,20614433,20614537,0,0,15202,15306
16745,20599231,20614537,20614677,0,0,15306,15446
16785,20604921,20614326,20614747,0,0,9405,9826
16746,20599232,20614677,20614817,0,0,15445,15585
16747,20599233,20614817,20614910,0,0,15584,15677
16748,20599325,20614910,20615003,0,0,15585,15678
16749,20599326,20615003,20615112,0,0,15677,15786
16810,20611496,20614747,20615188,0,0,3251,3692
16750,20599327,20615112,20615221,0,0,15785,15894
16751,20599328,20615221,20615330,0,0,15893,16002
16752,20599329,20615330,20615439,0,0,16001,16110
16753,20599366,20615439,20615548,0,0,16073,16182
16812,20611719,20615188,20615592,0,0,3469,3873
16754,20599367,20615548,20615657,0,0,16181,16290
16755,20599368,20615657,20615766,0,0,16289,16398
16756,20599369,20615766,20615875,0,0,16397,16506
16757,20599369,20615875,20615999,0,0,16506,16630
16822,20616001,20616001,20616328,0,0,0,327
16765,20600310,20615999,20616371,0,0,15689,16061
16823,20616034,20616034,20616371,0,0,0,337
16766,20600311,20616371,20616743,0,0,16060,16432
16767,20600312,20616743,20617115,0,0,16431,16803
16816,20613501,20615592,20617129,0,0,2091,3628
16732,20594204,20599247,20617247,0,0,5043,23043
16768,20600312,20617115,20617487,0,0,16803,17175
16769,20600313,20617487,20617849,0,0,17174,17536
16770,20600338,20617849,20618221,0,0,17511,17883
16771,20600339,20618221,20618585,0,0,17882,18246
16826,20618604,20618604,20618697,0,0,0,93
16827,20618765,20618765,20618812,0,0,0,47
16829,20618765,20618765,20618843,0,0,0,78
16832,20618766,20618766,20618859,0,0,0,93
16833,20618766,20618843,20618936,0,0,77,170
16772,20600340,20618585,20618963,0,0,18245,18623
16773,20600340,20618963,20619366,0,0,18623,19026
16774,20600341,20619366,20619738,0,0,19025,19397
16775,20600356,20619738,20620141,0,0,19382,19785
16729,20593164,20598808,20620540,0,0,5644,27376
16776,20600358,20620141,20620544,0,0,19783,20186
16777,20600359,20620540,20620943,0,0,20181,20584
16779,20600361,20620544,20620947,0,0,20183,20586
16778,20600360,20620540,20620974,0,0,20180,20614
16828,20618765,20620947,20621025,0,0,2182,2260
16798,20607695,20620943,20621543,0,0,13248,13848
16821,20614389,20617129,20623355,0,0,2740,8966
16825,20617057,20617057,20623695,0,0,0,6638
16731,20594131,20603364,20625782,0,0,9233,31651
16834,20618766,20625782,20625875,0,0,7016,7109
16733,20594822,20600072,20625885,0,0,5250,31063
16843,20626698,20626698,20626766,0,0,0,68
16844,20627171,20627171,20627260,0,0,0,89
16845,20627179,20627179,20627268,0,0,0,89
16846,20627190,20627190,20627289,0,0,0,99
16848,20627211,20627211,20627289,0,0,0,78
16847,20627199,20627199,20627298,0,0,0,99
16851,20627342,20627342,20627415,0,0,0,73
16850,20627329,20627329,20627418,0,0,0,89
16853,20627366,20627366,20627418,0,0,0,52
16852,20627349,20627349,20627422,0,0,0,73
16849,20627320,20627320,20627425,0,0,0,105
16854,20627379,20627379,20627446,0,0,0,67
16855,20627658,20627658,20627716,0,0,0,58
16856,20627685,20627685,20627750,0,0,0,65
16857,20627705,20627705,20627931,0,0,0,226
16858,20627714,20627931,20628146,0,0,217,432
16859,20627722,20628146,20628443,0,0,424,721
16860,20627729,20628443,20628636,0,0,714,907
16861,20627748,20628636,20629035,0,0,888,1287
16870,20629672,20629672,20629776,0,0,0,104
16872,20629693,20629693,20629776,0,0,0,83
16871,20629678,20629678,20629782,0,0,0,104
16873,20629700,20629700,20629783,0,0,0,83
16869,20629659,20629659,20629810,0,0,0,151
16874,20629855,20629855,20630093,0,0,0,238
16875,20629869,20629869,20630195,0,0,0,326
16862,20627765,20629035,20630584,0,0,1270,2819
16881,20630614,20630614,20630666,0,0,0,52
16880,20630601,20630601,20630669,0,0,0,68
16879,20630587,20630587,20630672,0,0,0,85
16882,20630625,20630625,20630692,0,0,0,67
16890,20631204,20631204,20631251,0,0,0,47
16892,20631506,20631506,20631573,0,0,0,67
16863,20627824,20630584,20632668,0,0,2760,4844
16864,20627864,20632668,20634772,0,0,4804,6908
16734,20594909,20614326,20636679,0,0,19417,41770
16867,20628964,20636679,20636759,0,0,7715,7795
16735,20594932,20614326,20636817,0,0,19394,41885
16868,20628973,20636759,20636839,0,0,7786,7866
16865,20627901,20634772,20636876,0,0,6871,8975
16883,20630829,20636817,20637244,0,0,5988,6415
16885,20630850,20636817,20637253,0,0,5967,6403
16884,20630839,20636817,20637264,0,0,5978,6425
16886,20630858,20636839,20637264,0,0,5981,6406
16893,20631715,20636876,20637372,0,0,5161,5657
16682,20532394,20532394,20640605,0,0,0,108211
16824,20616873,20623355,20644611,0,0,6482,27738
16900,20642770,20644611,20644715,0,0,1841,1945
16899,20642464,20644611,20644736,0,0,2147,2272
16901,20642887,20644715,20644839,0,0,1828,1952
16902,20643010,20644736,20644851,0,0,1726,1841
16904,20644589,20644851,20644975,0,0,262,386
16903,20643066,20644839,20644994,0,0,1773,1928
16907,20646687,20646687,20646822,0,0,0,135
16909,20647281,20647281,20647405,0,0,0,124
16910,20647506,20647506,20647639,0,0,0,133
16681,20532339,20532339,20649409,0,0,0,117070
16738,20598077,20649409,20650072,0,0,51332,51995
16739,20598086,20650072,20653718,0,0,51986,55632
16795,20607460,20649409,20654287,0,0,41949,46827
16737,20598066,20640605,20656250,0,0,42539,58184
16819,20614318,20654287,20657064,0,0,39969,42746
16877,20630346,20657064,20657138,0,0,26718,26792
16741,20598673,20653718,20659493,0,0,55045,60820
16896,20633683,20657138,20660687,0,0,23455,27004
16803,20609366,20659493,20661330,0,0,50127,51964
16742,20598684,20656250,20661994,0,0,57566,63310
16804,20609420,20661330,20664371,0,0,51910,54951
16897,20637462,20660687,20664462,0,0,23225,27000
16898,20641360,20664462,20667785,0,0,23102,26425
16905,20645246,20667785,20668188,0,0,22539,22942
16906,20645697,20668188,20670074,0,0,22491,24377
16911,20647543,20670074,20673260,0,0,22531,25717
16837,20620563,20620974,20674235,0,0,411,53672
16835,20618766,20674235,20674328,0,0,55469,55562
16914,20677594,20677594,20677889,0,0,0,295
16806,20611300,20661994,20678622,0,0,50694,67322
16916,20678845,20678845,20678912,0,0,0,67
16915,20677897,20677897,20679065,0,0,0,1168
16817,20614292,20664371,20679201,0,0,50079,64909
16923,20680796,20680796,20681070,0,0,0,274
16924,20680810,20680810,20681148,0,0,0,338
16925,20680845,20681070,20681439,0,0,225,594
16927,20681070,20681070,20681771,0,0,0,701
16937,20682297,20682297,20682369,0,0,0,72
16935,20682297,20682297,20682379,0,0,0,82
16936,20682297,20682297,20682379,0,0,0,82
16934,20682291,20682291,20682386,0,0,0,95
16940,20682322,20682322,20682394,0,0,0,72
16941,20682323,20682323,20682405,0,0,0,82
16942,20682323,20682323,20682405,0,0,0,82
16943,20682323,20682323,20682421,0,0,0,98
16938,20682322,20682322,20682425,0,0,0,103
16939,20682322,20682322,20682425,0,0,0,103
16945,20682907,20682907,20683442,0,0,0,535
16818,20614305,20678622,20684082,0,0,64317,69777
16950,20684709,20684709,20684861,0,0,0,152
16952,20685332,20685332,20685430,0,0,0,98
16954,20686105,20686105,20686172,0,0,0,67
16955,20686335,20686335,20686402,0,0,0,67
16956,20686493,20686493,20686577,0,0,0,84
16957,20686535,20686535,20686631,0,0,0,96
16959,20686576,20686576,20686685,0,0,0,109
16960,20686617,20686617,20686686,0,0,0,69
16961,20686649,20686649,20686717,0,0,0,68
16964,20687616,20687616,20688317,0,0,0,701
16895,20633161,20674328,20688810,0,0,41167,55649
16965,20688710,20688810,20688903,0,0,100,193
16931,20681569,20688810,20688945,0,0,7241,7376
16932,20682052,20688945,20689100,0,0,6893,7048
16930,20681507,20688810,20689348,0,0,7303,7841
16908,20647105,20647105,20689463,0,0,0,42358
16944,20682597,20689348,20689472,0,0,6751,6875
16967,20689425,20689425,20689518,0,0,0,93
16946,20683140,20689472,20689577,0,0,6332,6437
16947,20683306,20689577,20689712,0,0,6271,6406
16948,20683871,20689712,20689765,0,0,5841,5894
16949,20683883,20689765,20689900,0,0,5882,6017
16974,20690216,20690216,20690328,0,0,0,112
16976,20690760,20690760,20690817,0,0,0,57
16951,20685180,20689900,20690892,0,0,4720,5712
16958,20686551,20690892,20691053,0,0,4341,4502
16977,20690781,20690781,20691100,0,0,0,319
16962,20686910,20691053,20691226,0,0,4143,4316
16963,20687123,20691226,20691967,0,0,4103,4844
16966,20688957,20691967,20692567,0,0,3010,3610
16978,20690861,20692567,20692661,0,0,1706,1800
16820,20614329,20679201,20693021,0,0,64872,78692
16987,20692942,20692942,20693041,0,0,0,99
16891,20631291,20636839,20693134,0,0,5548,61843
16836,20619632,20684082,20693155,0,0,64450,73523
16988,20693269,20693269,20693367,0,0,0,98
16991,20693871,20693871,20693954,0,0,0,83
16992,20694053,20694053,20694100,0,0,0,47
16917,20679092,20688810,20694531,0,0,9718,15439
16842,20623496,20693021,20695161,0,0,69525,71665
16866,20628948,20693155,20695184,0,0,64207,66236
16840,20621100,20621100,20695206,0,0,0,74106
16876,20630170,20695161,20695215,0,0,64991,65045
17004,20696605,20696605,20696745,0,0,0,140
16878,20630383,20695184,20696799,0,0,64801,66416
17002,20695145,20695206,20697084,0,0,61,1939
17005,20697213,20697213,20697306,0,0,0,93
17006,20697328,20697328,20697421,0,0,0,93
17007,20697420,20697420,20697546,0,0,0,126
17008,20697502,20697502,20697637,0,0,0,135
17009,20697635,20697637,20697772,0,0,2,137
16918,20679542,20688810,20698189,0,0,9268,18647
17010,20698063,20698063,20698218,0,0,0,155
17012,20699610,20699610,20699724,0,0,0,114
17013,20699680,20699680,20699727,0,0,0,47
17016,20699886,20699886,20699933,0,0,0,47
16680,20532335,20532335,20700326,0,0,0,167991
16933,20682055,20689100,20701448,0,0,7045,19393
17028,20704204,20704204,20704260,0,0,0,56
17029,20704358,20704358,20704441,0,0,0,83
17030,20705167,20705167,20705637,0,0,0,470
17033,20708633,20708633,20708804,0,0,0,171
17034,20708804,20708804,20708955,0,0,0,151
17035,20708961,20708961,20709029,0,0,0,68
16894,20633048,20695215,20709839,0,0,62167,76791
16953,20685481,20700326,20714360,0,0,14845,28879
16676,20532303,20532303,20715171,0,0,0,182868
16995,20694491,20715171,20715264,0,0,20680,20773
16994,20694480,20715171,20715280,0,0,20691,20800
16997,20694694,20715171,20715288,0,0,20477,20594
17001,20694920,20715171,20715295,0,0,20251,20375
16996,20694632,20715171,20715297,0,0,20539,20665
17036,20709031,20709031,20715358,0,0,0,6327
17003,20696326,20715280,20715373,0,0,18954,19047
17014,20699751,20715295,20715402,0,0,15544,15651
17018,20699997,20715297,20715433,0,0,15300,15436
17040,20715440,20715440,20715507,0,0,0,67
17015,20699826,20715288,20715521,0,0,15462,15695
17000,20694768,20715171,20715538,0,0,20403,20770
17041,20715713,20715713,20715780,0,0,0,67
17046,20716125,20716125,20716376,0,0,0,251
17047,20716355,20716376,20717219,0,0,21,864
17042,20715794,20715794,20717244,0,0,0,1450
17052,20717018,20717244,20717306,0,0,226,288
17050,20716946,20717219,20717315,0,0,273,369
17053,20717019,20717306,20717368,0,0,287,349
17054,20717020,20717315,20717377,0,0,295,357
17055,20717037,20717368,20717435,0,0,331,398
17057,20717275,20717435,20717488,0,0,160,213
17058,20717302,20717488,20717556,0,0,186,254
17059,20717416,20717556,20717809,0,0,140,393
17060,20717428,20717809,20718082,0,0,381,654
16970,20689876,20692567,20719132,0,0,2691,29256
16982,20692044,20698218,20719138,0,0,6174,27094
16973,20689904,20693134,20719165,0,0,3230,29261
16971,20689885,20692567,20719256,0,0,2682,29371
16980,20692020,20695206,20719264,0,0,3186,27244
16972,20689894,20693134,20719400,0,0,3240,29506
16969,20689867,20689867,20719820,0,0,0,29953
16968,20689857,20689857,20720422,0,0,0,30565
17021,20700656,20715402,20721491,0,0,14746,20835
16975,20690335,20714360,20721560,0,0,24025,31225
17022,20702868,20721560,20721653,0,0,18692,18785
16984,20692079,20701448,20721953,0,0,9369,29874
16981,20692031,20698189,20722232,0,0,6158,30201
16919,20679608,20709839,20724999,0,0,30231,45391
17066,20724936,20724936,20725446,0,0,0,510
17067,20725349,20725349,20725695,0,0,0,346
17062,20717646,20718082,20728159,0,0,436,10513
16979,20690975,20694531,20731001,0,0,3556,40026
17024,20703103,20722232,20732212,0,0,19129,29109
16913,20647611,20700326,20732336,0,0,52715,84725
16985,20692199,20714360,20735322,0,0,22161,43123
17037,20713500,20715521,20736060,0,0,2021,22560
17032,20707316,20715402,20736437,0,0,8086,29121
17038,20713898,20715538,20736474,0,0,1640,22576
17023,20702979,20721653,20736624,0,0,18674,33645
16921,20680247,20724999,20739565,0,0,44752,59318
16989,20693785,20739565,20739669,0,0,45780,45884
16990,20693786,20739669,20739762,0,0,45883,45976
17039,20713955,20719132,20740078,0,0,5177,26123
16922,20680317,20732336,20741484,0,0,52019,61167
16912,20647590,20696799,20742197,0,0,49209,94607
17044,20716014,20719165,20743426,0,0,3151,27412
17051,20717010,20719820,20743896,0,0,2810,26886
16983,20692071,20701448,20744648,0,0,9377,52577
17043,20715881,20719138,20745422,0,0,3257,29541
17048,20716382,20719264,20745649,0,0,2882,29267
17045,20716109,20719256,20745686,0,0,3147,29577
17049,20716509,20719400,20745799,0,0,2891,29290
17020,20700639,20732212,20746472,0,0,31573,45833
17056,20717227,20717377,20747528,0,0,150,30301
16998,20694707,20739762,20748891,0,0,45055,54184
17063,20717670,20720422,20751208,0,0,2752,33538
17065,20720360,20721560,20751701,0,0,1200,31341
17068,20733980,20735322,20755952,0,0,1342,21972
17069,20734771,20736060,20757122,0,0,1289,22351
17070,20734840,20736474,20757389,0,0,1634,22549
16993,20694354,20715171,20758371,0,0,20817,64017
17081,20760257,20760257,20760368,0,0,0,111
17082,20760302,20760368,20760484,0,0,66,182
17085,20760368,20760368,20760581,0,0,0,213
17083,20760349,20760349,20760682,0,0,0,333
17087,20762621,20762621,20762688,0,0,0,67
17088,20762718,20762718,20762834,0,0,0,116
17091,20762797,20762797,20762875,0,0,0,78
17071,20740206,20740206,20764383,0,0,0,24177
17064,20719774,20721491,20764691,0,0,1717,44917
17072,20741023,20741023,20765210,0,0,0,24187
16675,20532295,20532295,20767186,0,0,0,234891
16920,20679949,20679949,20768444,0,0,0,88495
17073,20742102,20742102,20768674,0,0,0,26572
17074,20742496,20742496,20769469,0,0,0,26973
17075,20742723,20743426,20770398,0,0,703,27675
17076,20742854,20743896,20771308,0,0,1042,28454
17084,20760350,20760484,20771527,0,0,134,11177
16674,20532290,20532290,20771940,0,0,0,239650
17093,20762936,20767186,20773039,0,0,4250,10103
17017,20699946,20715373,20773285,0,0,15427,73339
17011,20698942,20715264,20775646,0,0,16322,76704
17078,20754570,20754570,20775669,0,0,0,21099
17115,20776051,20776051,20777255,0,0,0,1204
17079,20755715,20755952,20777523,0,0,237,21808
17120,20777539,20777539,20777601,0,0,0,62
17086,20760376,20767186,20778466,0,0,6810,18090
17080,20755770,20757122,20778609,0,0,1352,22839
17077,20750438,20751208,20781640,0,0,770,31202
17126,20782068,20782068,20782173,0,0,0,105
17125,20781971,20781971,20782235,0,0,0,264
17128,20782742,20782742,20782991,0,0,0,249
17089,20762747,20764383,20784243,0,0,1636,21496
17101,20769496,20769496,20784939,0,0,0,15443
17092,20762837,20767186,20787144,0,0,4349,24307
17094,20764323,20764691,20789226,0,0,368,24903
17095,20765145,20765210,20789786,0,0,65,24641
16673,20531893,20531893,20791093,0,0,0,259200
16677,20532306,20532306,20791506,0,0,0,259200
16678,20532326,20532326,20791526,0,0,0,259200
16679,20532332,20532332,20791532,0,0,0,259200
17139,20788131,20791532,20791605,0,0,3401,3474
17135,20787646,20791532,20791658,0,0,3886,4012
17134,20787573,20791526,20791692,0,0,3953,4119
17136,20787670,20791692,20791835,0,0,4022,4165
17152,20792163,20792163,20792270,0,0,0,107
16696,20534772,20534772,20792522,0,0,0,257750
16839,20620932,20621025,20792609,0,0,93,171677
17019,20700086,20715297,20792650,0,0,15211,92564
17155,20792554,20792609,20792702,0,0,55,148
17129,20784789,20787144,20793672,0,0,2355,8883
17157,20792763,20793672,20793770,0,0,909,1007
16887,20631118,20637253,20793851,0,0,6135,162733
17158,20792950,20793770,20793858,0,0,820,908
17147,20791617,20793851,20793926,0,0,2234,2309
17160,20793434,20793851,20793944,0,0,417,510
17025,20703986,20742197,20793949,0,0,38211,89963
16888,20631123,20637372,20793970,0,0,6249,162847
17162,20793951,20793951,20794024,0,0,0,73
17161,20793755,20793755,20794030,0,0,0,275
17163,20793959,20793959,20794052,0,0,0,93
17159,20793012,20794024,20794117,0,0,1012,1105
17026,20704023,20748891,20794136,0,0,44868,90113
17107,20775142,20793949,20794199,0,0,18807,19057
17164,20794110,20794110,20794203,0,0,0,93
17166,20794220,20794220,20794313,0,0,0,93
17112,20775752,20794199,20794314,0,0,18447,18562
17165,20794210,20794210,20794314,0,0,0,104
17167,20794345,20794345,20794418,0,0,0,73
17169,20794463,20794463,20794536,0,0,0,73
17170,20794604,20794604,20794708,0,0,0,104
17099,20768611,20768611,20794745,0,0,0,26134
17172,20794869,20794869,20794962,0,0,0,93
17140,20788234,20791605,20795205,0,0,3371,6971
17173,20795205,20795205,20795298,0,0,0,93
17174,20795423,20795423,20795516,0,0,0,93
17100,20769413,20769413,20795578,0,0,0,26165
17176,20795551,20795551,20795644,0,0,0,93
17109,20775367,20775367,20795855,0,0,0,20488
17178,20795823,20795823,20795916,0,0,0,93
17179,20795956,20795956,20796018,0,0,0,62
17180,20796069,20796069,20796166,0,0,0,97
17111,20775616,20775616,20796215,0,0,0,20599
17182,20796166,20796166,20796246,0,0,0,80
17102,20769636,20769636,20796247,0,0,0,26611
17184,20796292,20796292,20796385,0,0,0,93
17185,20796625,20796625,20796718,0,0,0,93
17186,20796721,20796721,20796794,0,0,0,73
17187,20796813,20796813,20796906,0,0,0,93
17188,20796907,20796907,20796980,0,0,0,73
17190,20797007,20797007,20797088,0,0,0,81
17191,20797057,20797057,20797134,0,0,0,77
17106,20770224,20770398,20797153,0,0,174,26929
17192,20797107,20797107,20797166,0,0,0,59
16889,20631133,20640605,20797203,0,0,9472,166070
17193,20797134,20797134,20797238,0,0,0,104
17194,20797231,20797231,20797336,0,0,0,105
17118,20777202,20777202,20798163,0,0,0,20961
17197,20797375,20798163,20798227,0,0,788,852
17200,20797460,20798163,20798256,0,0,703,796
17119,20777224,20777224,20798264,0,0,0,21040
17201,20797571,20798227,20798320,0,0,656,749
17202,20797678,20798256,20798349,0,0,578,671
17203,20797806,20798264,20798357,0,0,458,551
17205,20798162,20798349,20798450,0,0,187,288
17207,20798341,20798357,20798451,0,0,16,110
16841,20623125,20625875,20798675,0,0,2750,175550
17105,20770009,20770009,20799525,0,0,0,29516
17096,20765692,20791532,20801342,0,0,25840,35650
17103,20769745,20769745,20802020,0,0,0,32275
17104,20769799,20769799,20803136,0,0,0,33337
16999,20694715,20741484,20803204,0,0,46769,108489
17150,20792085,20792085,20803979,0,0,0,11894
17110,20775499,20794136,20804156,0,0,18637,28657
17209,20798711,20804156,20804249,0,0,5445,5538
17208,20798543,20804156,20804250,0,0,5613,5707
17210,20798826,20804156,20804250,0,0,5330,5424
17211,20798937,20804249,20804342,0,0,5312,5405
17228,20804602,20804602,20804649,0,0,0,47
17229,20804731,20804731,20804799,0,0,0,68
17108,20775311,20775311,20805317,0,0,0,30006
17117,20776663,20776663,20805463,0,0,0,28800
17138,20787857,20787857,20805958,0,0,0,18101
17027,20704028,20791526,20806946,0,0,87498,102918
16706,20537045,20554936,20807536,0,0,17891,270491
17154,20792262,20792262,20807637,0,0,0,15375
17145,20791255,20792522,20810522,0,0,1267,19267
17124,20780802,20780802,20811058,0,0,0,30256
17090,20762780,20767186,20811620,0,0,4406,48840
17141,20788818,20788818,20812870,0,0,0,24052
17144,20789658,20791658,20815744,0,0,2000,26086
17177,20795813,20795813,20816350,0,0,0,20537
17181,20796145,20796145,20816734,0,0,0,20589
17204,20798098,20798320,20819664,0,0,222,21566
17171,20794682,20794682,20820698,0,0,0,26016
17175,20795540,20795540,20821992,0,0,0,26452
17183,20796184,20796184,20822605,0,0,0,26421
16728,20564231,20564231,20823431,0,0,0,259200
17198,20797381,20798451,20823437,0,0,1070,26056
17189,20796924,20796924,20823451,0,0,0,26527
17206,20798179,20803979,20824985,0,0,5800,26806
17137,20787729,20791835,20825830,0,0,4106,38101
17156,20792704,20792704,20828704,0,0,0,36000
17199,20797407,20804156,20829192,0,0,6749,31785
17148,20791639,20793926,20831513,0,0,2287,39874
17151,20792159,20797203,20832085,0,0,5044,39926
17195,20797332,20797332,20833226,0,0,0,35894
17196,20797359,20797359,20833504,0,0,0,36145
17235,20816289,20816350,20837001,0,0,61,20712
17233,20812813,20812870,20837069,0,0,57,24256
17236,20816665,20816734,20837272,0,0,69,20607
17234,20813684,20815744,20839999,0,0,2060,26315
17237,20819549,20819664,20840573,0,0,115,21024
17232,20810998,20811620,20841521,0,0,622,30523
17238,20820487,20820698,20841633,0,0,211,21146
17230,20805254,20811620,20841710,0,0,6366,36456
17153,20792201,20798675,20843776,0,0,6474,51575
17239,20820656,20821992,20848296,0,0,1336,27640
17240,20821930,20822605,20848975,0,0,675,27045
17241,20823348,20823437,20850010,0,0,89,26662
16707,20537138,20598085,20850685,0,0,60947,313547
16708,20537174,20598085,20850685,0,0,60911,313511
16709,20537205,20598085,20850685,0,0,60880,313480
16710,20537333,20598146,20850746,0,0,60813,313413
16711,20537368,20598146,20850746,0,0,60778,313378
16712,20537406,20598692,20851292,0,0,61286,313886
16713,20537431,20598692,20851292,0,0,61261,313861
17242,20824626,20824626,20851466,0,0,0,26840
16714,20538748,20600072,20852672,0,0,61324,313924
16715,20538767,20600072,20852672,0,0,61305,313905
16830,20618765,20852672,20852765,0,0,233907,234000
17097,20766357,20771527,20854327,0,0,5170,87970
16716,20538785,20603364,20855964,0,0,64579,317179
16717,20538804,20603364,20855964,0,0,64560,317160
17031,20706865,20706865,20856832,0,0,0,149967
17244,20836939,20837001,20857636,0,0,62,20697
17246,20837206,20837272,20857957,0,0,66,20751
17098,20766386,20771940,20858340,0,0,5554,91954
17218,20799626,20805463,20859755,0,0,5837,60129
17220,20800000,20807536,20859879,0,0,7536,59879
16831,20618765,20859879,20859973,0,0,241114,241208
17219,20799922,20807536,20860622,0,0,7614,60700
17245,20837008,20837069,20861178,0,0,61,24170
17221,20800040,20807536,20861574,0,0,7496,61534
17248,20840455,20840573,20861590,0,0,118,21135
17222,20800073,20807536,20862549,0,0,7463,62476
17250,20841382,20841633,20862559,0,0,251,21177
17223,20800098,20807536,20863479,0,0,7438,63381
17247,20837947,20839999,20864064,0,0,2052,26117
17225,20800173,20810522,20864109,0,0,10349,63936
17226,20800198,20810522,20864361,0,0,10324,64163
17227,20800295,20811058,20865269,0,0,10763,64974
17243,20835344,20835344,20865568,0,0,0,30224
17263,20866604,20866604,20866698,0,0,0,94
17264,20866936,20866936,20867030,0,0,0,94
17265,20867721,20867721,20867814,0,0,0,93
17266,20867863,20867863,20867957,0,0,0,94
17267,20868234,20868234,20868307,0,0,0,73
17127,20782132,20782132,20868532,0,0,0,86400
17268,20868468,20868468,20868553,0,0,0,85
17269,20868492,20868492,20868598,0,0,0,106
17270,20868589,20868589,20868664,0,0,0,75
17271,20868729,20868729,20868844,0,0,0,115
17272,20868804,20868804,20868877,0,0,0,73
17273,20868891,20868891,20869015,0,0,0,124
17274,20869019,20869019,20869143,0,0,0,124
17275,20869802,20869802,20869884,0,0,0,82
17276,20869864,20869864,20869957,0,0,0,93
17224,20800155,20807637,20871526,0,0,7482,71371
17249,20840893,20841521,20871609,0,0,628,30716
17251,20846959,20846959,20873610,0,0,0,26651
17252,20848293,20848293,20874307,0,0,0,26014
17142,20789051,20789226,20875626,0,0,175,86575
17143,20789507,20789786,20876186,0,0,279,86679
17253,20849921,20849921,20876618,0,0,0,26697
17284,20877049,20877049,20877153,0,0,0,104
17285,20877483,20877483,20877700,0,0,0,217
17286,20877787,20877787,20877894,0,0,0,107
17287,20877832,20877832,20877926,0,0,0,94
17116,20776480,20803204,20877958,0,0,26724,101478
17255,20857512,20857512,20878006,0,0,0,20494
17289,20878069,20878069,20878162,0,0,0,93
17254,20851408,20851408,20878275,0,0,0,26867
17291,20878406,20878406,20878499,0,0,0,93
17256,20857825,20857825,20878549,0,0,0,20724
17293,20878510,20878510,20878614,0,0,0,104
17294,20878744,20878744,20879299,0,0,0,555
16838,20620583,20620583,20879783,0,0,0,259200
17295,20879235,20879235,20879784,0,0,0,549
17297,20880013,20880013,20880086,0,0,0,73
17296,20879738,20879738,20880087,0,0,0,349
17298,20880028,20880028,20880152,0,0,0,124
17299,20880634,20880634,20880711,0,0,0,77
17301,20880711,20880711,20880835,0,0,0,124
17300,20880657,20880657,20880866,0,0,0,209
17282,20875908,20875908,20882196,0,0,0,6288
17259,20861410,20861410,20882525,0,0,0,21115
17261,20862246,20862246,20883281,0,0,0,21035
17306,20883450,20883450,20883543,0,0,0,93
17257,20861076,20861076,20885079,0,0,0,24003
17307,20884617,20884617,20885217,0,0,0,600
17260,20861970,20861970,20885990,0,0,0,24020
17212,20799625,20804250,20890650,0,0,4625,91025
17213,20799625,20804250,20890650,0,0,4625,91025
17214,20799625,20804342,20890742,0,0,4717,91117
17215,20799625,20805317,20891717,0,0,5692,92092
17216,20799625,20805463,20891863,0,0,5838,92238
17217,20799625,20805463,20891863,0,0,5838,92238
17262,20865500,20865500,20895533,0,0,0,30033
17288,20877943,20877943,20898524,0,0,0,20581
17292,20878504,20878504,20899056,0,0,0,20552
17278,20873548,20873548,20899909,0,0,0,26361
17279,20874245,20874245,20900450,0,0,0,26205
17277,20870923,20870923,20901218,0,0,0,30295
17122,20780559,20791506,20902649,0,0,10947,122090
17283,20876556,20876556,20903236,0,0,0,26680
17304,20882480,20882480,20903461,0,0,0,20981
17305,20883217,20883217,20904313,0,0,0,21096
17290,20878231,20878231,20905003,0,0,0,26772
17308,20885019,20885019,20908841,0,0,0,23822
17309,20885928,20885928,20909789,0,0,0,23861
17123,20780579,20804156,20910252,0,0,23577,129673
17146,20791516,20828704,20918578,0,0,37188,127062
17311,20898462,20898462,20919024,0,0,0,20562
17312,20899021,20899021,20919501,0,0,0,20480
17133,20787515,20850746,20920131,0,0,63231,132616
17149,20791650,20793970,20923570,0,0,2320,131920
17317,20903404,20903404,20924215,0,0,0,20811
17318,20904271,20904271,20925299,0,0,0,21028
17310,20895470,20895470,20925428,0,0,0,29958
17313,20899846,20899846,20926109,0,0,0,26263
17314,20900395,20900395,20927456,0,0,0,27061
17328,20927393,20927393,20929245,0,0,0,1852
17316,20903170,20903170,20929930,0,0,0,26760
17315,20901153,20901153,20931331,0,0,0,30178
17319,20904939,20904939,20931587,0,0,0,26648
17320,20908778,20908778,20932846,0,0,0,24068
17321,20909727,20909727,20933743,0,0,0,24016
16986,20692650,20692650,20936151,0,0,0,243501
17322,20918962,20918962,20939608,0,0,0,20646
17113,20775929,20794314,20939725,0,0,18385,163796
17338,20939866,20939866,20939959,0,0,0,93
17323,20919438,20919438,20940035,0,0,0,20597
16926,20681014,20681148,20940348,0,0,134,259334
16928,20681077,20681439,20940639,0,0,362,259562
17340,20940281,20940281,20940808,0,0,0,527
17341,20940755,20940755,20940932,0,0,0,177
17342,20940900,20940900,20941500,0,0,0,600
17343,20943261,20943261,20943354,0,0,0,93
17344,20943376,20943376,20943501,0,0,0,125
17345,20944041,20944041,20944165,0,0,0,124
17346,20944386,20944386,20944521,0,0,0,135
17324,20924170,20924170,20945185,0,0,0,21015
17348,20945268,20945268,20945362,0,0,0,94
17349,20945422,20945422,20945526,0,0,0,104
17325,20925237,20925237,20946067,0,0,0,20830
17351,20946655,20946655,20946759,0,0,0,104
16929,20681144,20688810,20948010,0,0,7666,266866
17352,20948357,20948357,20948450,0,0,0,93
17353,20949033,20949033,20949633,0,0,0,600
17354,20949260,20949260,20950530,0,0,0,1270
17361,20950752,20950752,20950845,0,0,0,93
17362,20950925,20950925,20951029,0,0,0,104
17363,20950992,20950992,20951085,0,0,0,93
17302,20882122,20882122,20951505,0,0,0,69383
17280,20874954,20874954,20952165,0,0,0,77211
17327,20926045,20926045,20952237,0,0,0,26192
17281,20875024,20875024,20952514,0,0,0,77490
17329,20929200,20929200,20955349,0,0,0,26149
17326,20925388,20925388,20955662,0,0,0,30274
17367,20956376,20956376,20956480,0,0,0,104
17330,20929872,20929872,20956621,0,0,0,26749
17333,20932784,20932784,20956674,0,0,0,23890
17370,20956895,20956895,20957495,0,0,0,600
17334,20933700,20933700,20957612,0,0,0,23912
17332,20931529,20931529,20958157,0,0,0,26628
17357,20949522,20949522,20959708,0,0,0,10186
17356,20949480,20949480,20959887,0,0,0,10407
17337,20939541,20939541,20960262,0,0,0,20721
17339,20939973,20939973,20960495,0,0,0,20522
17331,20931268,20931268,20961122,0,0,0,29854
17114,20776048,20801342,20965605,0,0,25294,189557
17347,20945116,20945116,20966085,0,0,0,20969
17168,20794417,20794417,20967166,0,0,0,172749
17131,20787457,20833504,20967358,0,0,46047,179901
17350,20946007,20946007,20967371,0,0,0,21364
17377,20966895,20966895,20967495,0,0,0,600
17303,20882144,20882144,20968544,0,0,0,86400
17364,20952172,20952172,20978490,0,0,0,26318
17130,20785788,20806946,20979264,0,0,21158,193476
17369,20956615,20956615,20980351,0,0,0,23736
17373,20960193,20960193,20980803,0,0,0,20610
17374,20960423,20960423,20980983,0,0,0,20560
17365,20955305,20955305,20981216,0,0,0,25911
17371,20957549,20957549,20981328,0,0,0,23779
17368,20956558,20956558,20983218,0,0,0,26660
17372,20958094,20958094,20984390,0,0,0,26296
17366,20955588,20955588,20985473,0,0,0,29885
17132,20787474,20850685,20985680,0,0,63211,198206
17376,20966032,20966032,20987034,0,0,0,21002
17378,20967308,20967308,20988207,0,0,0,20899
17375,20961069,20961069,20991239,0,0,0,30170
17258,20861386,20861386,20995592,0,0,0,134206
17383,20980815,20980815,21001297,0,0,0,20482
17384,20980992,20980992,21001685,0,0,0,20693
17382,20980292,20980292,21003208,0,0,0,22916
17386,20981274,20981274,21003846,0,0,0,22572
17381,20978450,20978450,21004882,0,0,0,26432
17061,20717567,20746472,21005672,0,0,28905,288105
17385,20981155,20981155,21007342,0,0,0,26187
17360,20949880,20949880,21007508,0,0,0,57628
17390,20986972,20986972,21008131,0,0,0,21159
17391,20988228,20988228,21009204,0,0,0,20976
17387,20983153,20983153,21009853,0,0,0,26700
17388,20984346,20984346,21011253,0,0,0,26907
17389,20985399,20985399,21015093,0,0,0,29694
17359,20949857,20949857,21015885,0,0,0,66028
17396,21007701,21007701,21018294,0,0,0,10593
17392,20991239,20991239,21020743,0,0,0,29504
17358,20949834,20949834,21022104,0,0,0,72270
17402,21023714,21023714,21023774,0,0,0,60
17403,21024222,21024222,21024476,0,0,0,254
17409,21024945,21024945,21024992,0,0,0,47
17406,21024742,21024742,21024995,0,0,0,253
17408,21024932,21024932,21024995,0,0,0,63
17410,21024996,21024996,21025268,0,0,0,272
17393,21004805,21004805,21025451,0,0,0,20646
17405,21024731,21024731,21025652,0,0,0,921
17404,21024724,21024724,21026099,0,0,0,1375
17411,21025536,21025536,21026136,0,0,0,600
17395,21006100,21006100,21026733,0,0,0,20633
17418,21026312,21026312,21027284,0,0,0,972
17416,21026049,21026049,21027375,0,0,0,1326
17422,21027497,21027497,21027564,0,0,0,67
17415,21025988,21025988,21027723,0,0,0,1735
17417,21026294,21026294,21027748,0,0,0,1454
17423,21027669,21027669,21027790,0,0,0,121
17424,21027827,21027827,21027900,0,0,0,73
17414,21025856,21025856,21027969,0,0,0,2113
17430,21027971,21027971,21028050,0,0,0,79
17425,21027925,21027925,21028061,0,0,0,136
17426,21027931,21027931,21028067,0,0,0,136
17428,21027945,21027945,21028112,0,0,0,167
17431,21028019,21028019,21028129,0,0,0,110
17433,21028226,21028226,21028311,0,0,0,85
17412,21025834,21025834,21028405,0,0,0,2571
17413,21025847,21025847,21028418,0,0,0,2571
17434,21028374,21028374,21028447,0,0,0,73
17394,21006092,21006092,21028586,0,0,0,22494
17435,21028503,21028503,21028596,0,0,0,93
17436,21028667,21028667,21028743,0,0,0,76
17438,21028710,21028710,21028816,0,0,0,106
17444,21028922,21028922,21028995,0,0,0,73
17443,21028886,21028886,21029021,0,0,0,135
17446,21029198,21029198,21029513,0,0,0,315
17442,21028778,21028778,21030419,0,0,0,1641
17441,21028773,21028773,21030706,0,0,0,1933
17440,21028763,21028763,21030707,0,0,0,1944
17455,21030921,21030921,21030988,0,0,0,67
17400,21020838,21020838,21031298,0,0,0,10460
17432,21028067,21028067,21031563,0,0,0,3496
17401,21021475,21021475,21032115,0,0,0,10640
17454,21030767,21030767,21032298,0,0,0,1531
17397,21010770,21010770,21033222,0,0,0,22452
17458,21033986,21033986,21034070,0,0,0,84
17460,21034261,21034261,21034348,0,0,0,87
17461,21034317,21034317,21034410,0,0,0,93
17462,21034468,21034468,21034572,0,0,0,104
17463,21034595,21034595,21034733,0,0,0,138
17464,21034703,21034703,21035159,0,0,0,456
17466,21035127,21035127,21035313,0,0,0,186
17467,21035450,21035450,21035606,0,0,0,156
17459,21033987,21033987,21035756,0,0,0,1769
17469,21035797,21035797,21036119,0,0,0,322
17470,21036077,21036077,21036502,0,0,0,425
17472,21036464,21036464,21036753,0,0,0,289
17477,21036761,21036761,21036958,0,0,0,197
17478,21036936,21036936,21037102,0,0,0,166
17476,21036717,21036717,21037133,0,0,0,416
17480,21037153,21037153,21037496,0,0,0,343
17483,21037443,21037443,21037508,0,0,0,65
17468,21035783,21035783,21037716,0,0,0,1933
17485,21037482,21037482,21038082,0,0,0,600
17473,21036503,21036503,21038341,0,0,0,1838
17421,21027293,21027293,21038873,0,0,0,11580
17398,21013174,21013174,21039492,0,0,0,26318
17487,21037669,21037716,21039664,0,0,47,1995
17493,21040340,21040340,21040475,0,0,0,135
17488,21038743,21038743,21040627,0,0,0,1884
17448,21030421,21030421,21041091,0,0,0,10670
17447,21030320,21030320,21041139,0,0,0,10819
17450,21030492,21030492,21041173,0,0,0,10681
17449,21030477,21030477,21041189,0,0,0,10712
17498,21041148,21041173,21041302,0,0,25,154
17501,21041242,21041242,21041320,0,0,0,78
17452,21030670,21030670,21041380,0,0,0,10710
17451,21030637,21030637,21041390,0,0,0,10753
17505,21041344,21041380,21041442,0,0,36,98
17491,21039559,21039559,21041515,0,0,0,1956
17508,21041470,21041470,21041566,0,0,0,96
17509,21041569,21041569,21041688,0,0,0,119
17502,21041325,21041325,21041809,0,0,0,484
17506,21041416,21041416,21041843,0,0,0,427
17453,21030737,21030737,21041869,0,0,0,11132
17510,21041687,21041687,21041968,0,0,0,281
17511,21041943,21041943,21042006,0,0,0,63
17499,21041172,21041809,21042014,0,0,637,842
17512,21041950,21042006,21042069,0,0,56,119
17513,21041955,21042069,21042132,0,0,114,177
17514,21042760,21042760,21043191,0,0,0,431
17518,21043007,21043007,21043280,0,0,0,273
17507,21041441,21041441,21043356,0,0,0,1915
17121,20780555,20784243,21043443,0,0,3688,262888
17520,21043496,21043496,21043563,0,0,0,67
17521,21043613,21043613,21044027,0,0,0,414
17399,21017932,21017932,21044859,0,0,0,26927
17527,21044865,21044865,21044974,0,0,0,109
17525,21044779,21044859,21045582,0,0,80,803
17503,21041329,21041329,21046615,0,0,0,5286
17445,21029031,21029031,21046659,0,0,0,17628
17529,21045857,21046615,21046708,0,0,758,851
17528,21045760,21046615,21046750,0,0,855,990
17231,20806013,20806013,21047594,0,0,0,241581
17471,21036079,21036079,21047740,0,0,0,11661
17500,21041182,21042014,21047790,0,0,832,6608
17534,21046551,21047790,21047874,0,0,1239,1323
17538,21047124,21047790,21047967,0,0,666,843
17542,21047790,21047790,21047995,0,0,0,205
17543,21047966,21047966,21048121,0,0,0,155
17380,20974066,20974066,21048122,0,0,0,74056
17496,21041103,21041103,21048197,0,0,0,7094
17497,21041145,21041145,21048218,0,0,0,7073
17523,21044169,21047790,21048224,0,0,3621,4055
17420,21027241,21027241,21048308,0,0,0,21067
17481,21037200,21037200,21048308,0,0,0,11108
17479,21037071,21037071,21048370,0,0,0,11299
17549,21048391,21048391,21048510,0,0,0,119
17530,21046348,21046615,21048764,0,0,267,2416
17551,21048692,21048692,21048790,0,0,0,98
17379,20974035,20974035,21049162,0,0,0,75127
17553,21049152,21049152,21049307,0,0,0,155
17552,21048899,21048899,21049314,0,0,0,415
17554,21049323,21049323,21049525,0,0,0,202
17555,21049451,21049451,21049768,0,0,0,317
17556,21049649,21049649,21049835,0,0,0,186
17557,21049918,21049918,21049985,0,0,0,67
17437,21028702,21028702,21050268,0,0,0,21566
17559,21050040,21050040,21050485,0,0,0,445
17489,21039120,21041189,21051224,0,0,2069,12104
17407,21024792,21024792,21051295,0,0,0,26503
17531,21046549,21046659,21052146,0,0,110,5597
17562,21052649,21052649,21052804,0,0,0,155
17495,21040590,21040590,21052877,0,0,0,12287
17536,21046551,21047790,21053074,0,0,1239,6523
17537,21046551,21047790,21053136,0,0,1239,6585
17532,21046550,21047594,21053143,0,0,1044,6593
17565,21053162,21053162,21053251,0,0,0,89
17563,21052820,21052820,21053283,0,0,0,463
17533,21046550,21047740,21053320,0,0,1190,6770
17535,21046551,21047790,21053401,0,0,1239,6850
17567,21053218,21053218,21053459,0,0,0,241
17558,21049991,21049991,21053486,0,0,0,3495
17569,21053557,21053557,21053617,0,0,0,60
17570,21053589,21053589,21053656,0,0,0,67
17568,21053492,21053492,21053906,0,0,0,414
17572,21053855,21053855,21054110,0,0,0,255
17564,21053055,21053055,21054183,0,0,0,1128
17457,21033805,21033805,21054335,0,0,0,20530
17579,21054662,21054662,21054755,0,0,0,93
17575,21054118,21054118,21054922,0,0,0,804
17578,21054547,21054547,21055081,0,0,0,534
17583,21055143,21055143,21055221,0,0,0,78
17580,21054925,21054925,21055276,0,0,0,351
17465,21034857,21034857,21055318,0,0,0,20461
17548,21048386,21048386,21055437,0,0,0,7051
17581,21055043,21055043,21055906,0,0,0,863
17593,21056633,21056633,21057084,0,0,0,451
17598,21057983,21057983,21058056,0,0,0,73
17596,21057859,21057859,21058087,0,0,0,228
17586,21055330,21055330,21058228,0,0,0,2898
17456,21031717,21031717,21058243,0,0,0,26526
17524,21044630,21044630,21058301,0,0,0,13671
17594,21056641,21056641,21058327,0,0,0,1686
17576,21054249,21054249,21058328,0,0,0,4079
17589,21055662,21055662,21058331,0,0,0,2669
17597,21057880,21058228,21058364,0,0,348,484
17566,21053204,21053204,21058392,0,0,0,5188
17571,21053797,21053797,21058429,0,0,0,4632
17574,21054018,21054018,21058429,0,0,0,4411
17522,21043837,21044027,21058490,0,0,190,14653
17595,21057495,21058327,21058772,0,0,832,1277
17603,21058804,21058804,21058902,0,0,0,98
17605,21059043,21059043,21059214,0,0,0,171
17604,21058950,21058950,21059393,0,0,0,443
17591,21055999,21055999,21059504,0,0,0,3505
17474,21036667,21036667,21059709,0,0,0,23042
17475,21036687,21036687,21059710,0,0,0,23023
17606,21059563,21059563,21060051,0,0,0,488
17610,21060107,21060107,21060174,0,0,0,67
17609,21060069,21060069,21060230,0,0,0,161
17612,21060278,21060278,21060345,0,0,0,67
17611,21060238,21060238,21060398,0,0,0,160
17492,21040277,21040277,21061629,0,0,0,21352
17588,21055452,21055452,21064354,0,0,0,8902
17613,21060572,21060572,21064800,0,0,0,4228
17615,21065402,21065402,21065589,0,0,0,187
17617,21065694,21065694,21065787,0,0,0,93
17616,21065625,21065625,21065816,0,0,0,191
17618,21066257,21066257,21066519,0,0,0,262
17619,21066594,21066594,21066865,0,0,0,271
17494,21040515,21040515,21066938,0,0,0,26423
17592,21056477,21056477,21067309,0,0,0,10832
17573,21053905,21053905,21067700,0,0,0,13795
17621,21066903,21066903,21067731,0,0,0,828
17622,21067664,21067664,21067834,0,0,0,170
17620,21066841,21066841,21068641,0,0,0,1800
17544,21048240,21048308,21069090,0,0,68,20850
17626,21070950,21070950,21071023,0,0,0,73
17625,21068989,21068989,21071051,0,0,0,2062
17599,21058015,21058243,21071150,0,0,228,13135
17628,21071152,21071152,21071245,0,0,0,93
17629,21071317,21071317,21071472,0,0,0,155
17560,21050226,21050226,21071567,0,0,0,21341
17631,21071518,21071518,21071662,0,0,0,144
17335,20937881,20937881,21071976,0,0,0,134095
17336,20938012,20938012,21072238,0,0,0,134226
17526,21044810,21045582,21072287,0,0,772,27477
17519,21043315,21043315,21073146,0,0,0,29831
17627,21071141,21071141,21073188,0,0,0,2047
17633,21071852,21071852,21073529,0,0,0,1677
17577,21054272,21054272,21074774,0,0,0,20502
17584,21055245,21055276,21075887,0,0,31,20642
17561,21051235,21051235,21077553,0,0,0,26318
17429,21027952,21027952,21077860,0,0,0,49908
17637,21075006,21075006,21078192,0,0,0,3186
17640,21078160,21078160,21081760,0,0,0,3600
17614,21061570,21061570,21082922,0,0,0,21352
17607,21059654,21059654,21083182,0,0,0,23528
17608,21059662,21059662,21083264,0,0,0,23602
17427,21027938,21027938,21083482,0,0,0,55544
17601,21058194,21058331,21084986,0,0,137,26792
17634,21072003,21072003,21086110,0,0,0,14107
17624,21068953,21068953,21089867,0,0,0,20914
17632,21071546,21071546,21092313,0,0,0,20767
17623,21067777,21067777,21094102,0,0,0,26325
17636,21074706,21074706,21095372,0,0,0,20666
17638,21075794,21075794,21096226,0,0,0,20432
17504,21041334,21043443,21098324,0,0,2109,56990
17630,21071472,21071472,21098614,0,0,0,27142
17539,21047192,21048197,21099569,0,0,1005,52377
17541,21047501,21048224,21102005,0,0,723,54504
17635,21073094,21073094,21103034,0,0,0,29940
17641,21082862,21082862,21104141,0,0,0,21279
17639,21077486,21077486,21104164,0,0,0,26678
17642,21083138,21083138,21105703,0,0,0,22565
17643,21083207,21083207,21105886,0,0,0,22679
17657,21109148,21109148,21109245,0,0,0,97
17658,21110032,21110032,21110126,0,0,0,94
17659,21110150,21110150,21110254,0,0,0,104
17660,21110210,21110210,21110325,0,0,0,115
17661,21110283,21110283,21110387,0,0,0,104
17645,21089823,21089823,21110659,0,0,0,20836
17666,21111341,21111341,21111461,0,0,0,120
17665,21111140,21111140,21111462,0,0,0,322
17667,21111471,21111471,21111587,0,0,0,116
17669,21111540,21111540,21111625,0,0,0,85
17644,21084804,21084804,21111911,0,0,0,27107
17670,21111562,21111562,21111983,0,0,0,421
17672,21111924,21111924,21112002,0,0,0,78
17673,21111960,21111960,21112168,0,0,0,208
17675,21112237,21112237,21112319,0,0,0,82
17646,21092250,21092250,21113218,0,0,0,20968
17668,21111508,21111508,21113959,0,0,0,2451
17677,21113917,21113917,21113979,0,0,0,62
17540,21047281,21048218,21114211,0,0,937,66930
17585,21055281,21072238,21114246,0,0,16957,58965
17678,21114191,21114191,21114302,0,0,0,111
17674,21112011,21112011,21114412,0,0,0,2401
17682,21114740,21114740,21114811,0,0,0,71
17515,21042976,21042976,21114851,0,0,0,71875
17683,21114806,21114806,21114884,0,0,0,78
17516,21042991,21042991,21114935,0,0,0,71944
17517,21043006,21043006,21114970,0,0,0,71964
17685,21114880,21114880,21114985,0,0,0,105
17684,21114813,21114813,21115131,0,0,0,318
17686,21114888,21114888,21115199,0,0,0,311
17687,21114913,21114913,21115217,0,0,0,304
17690,21115174,21115174,21115326,0,0,0,152
17689,21115140,21115140,21115346,0,0,0,206
17688,21115095,21115095,21115385,0,0,0,290
17695,21115468,21115468,21115572,0,0,0,104
17692,21115284,21115284,21115584,0,0,0,300
17648,21095316,21095316,21116000,0,0,0,20684
17649,21096178,21096178,21116637,0,0,0,20459
17694,21115325,21115325,21116686,0,0,0,1361
17693,21115308,21115308,21116700,0,0,0,1392
17691,21115215,21115215,21117334,0,0,0,2119
17707,21117444,21117444,21117704,0,0,0,260
17647,21094031,21094031,21120377,0,0,0,26346
17355,20949272,20949272,21122072,0,0,0,172800
17651,21102966,21102966,21123824,0,0,0,20858
17545,21048254,21051224,21125130,0,0,2970,76876
17713,21123371,21123371,21125328,0,0,0,1957
17650,21098553,21098553,21125432,0,0,0,26879
17679,21114271,21114271,21125776,0,0,0,11505
17701,21115843,21115843,21125778,0,0,0,9935
17702,21115911,21115911,21125785,0,0,0,9874
17704,21115960,21115960,21125785,0,0,0,9825
17699,21115769,21115769,21125819,0,0,0,10050
17700,21115809,21115809,21125859,0,0,0,10050
17546,21048258,21071976,21125877,0,0,23718,77619
17490,21039542,21039542,21125942,0,0,0,86400
17723,21126045,21126045,21126387,0,0,0,342
17725,21126317,21126317,21126402,0,0,0,85
17712,21123223,21123223,21126411,0,0,0,3188
17726,21126375,21126375,21126454,0,0,0,79
17697,21115567,21115567,21126467,0,0,0,10900
17727,21126406,21126406,21126467,0,0,0,61
17696,21115540,21115540,21126502,0,0,0,10962
17719,21125788,21125788,21126549,0,0,0,761
17728,21126438,21126438,21126556,0,0,0,118
17730,21126473,21126473,21126557,0,0,0,84
17731,21126504,21126504,21126613,0,0,0,109
17722,21125885,21125885,21126718,0,0,0,833
17733,21127003,21127003,21127070,0,0,0,67
17732,21126750,21126750,21127239,0,0,0,489
17734,21127206,21127206,21127276,0,0,0,70
17735,21127302,21127302,21127437,0,0,0,135
17729,21126438,21126438,21127818,0,0,0,1380
17654,21105646,21105646,21128963,0,0,0,23317
17655,21105825,21105825,21129163,0,0,0,23338
17737,21128078,21128078,21129377,0,0,0,1299
17740,21129485,21129485,21130055,0,0,0,570
17587,21055406,21098324,21130538,0,0,42918,75132
17653,21104110,21104110,21131012,0,0,0,26902
17736,21127495,21127495,21131095,0,0,0,3600
17747,21130814,21131012,21131515,0,0,198,701
17662,21110597,21110597,21131517,0,0,0,20920
17748,21130951,21131515,21132018,0,0,564,1067
17652,21104068,21104068,21133584,0,0,0,29516
17709,21117973,21125130,21133977,0,0,7157,16004
17676,21113156,21113156,21134014,0,0,0,20858
17751,21131741,21133584,21134452,0,0,1843,2711
17759,21134659,21134659,21134758,0,0,0,99
17754,21133617,21134452,21134880,0,0,835,1263
17744,21129901,21130055,21134966,0,0,154,5065
17743,21129893,21129893,21135017,0,0,0,5124
17741,21129873,21129873,21135021,0,0,0,5148
17742,21129887,21129887,21135022,0,0,0,5135
17755,21133761,21134880,21135035,0,0,1119,1274
17752,21133043,21133977,21135544,0,0,934,2501
17760,21135802,21135802,21135873,0,0,0,71
17762,21135878,21135878,21136126,0,0,0,248
17703,21115920,21115920,21136369,0,0,0,20449
17758,21134039,21135017,21136428,0,0,978,2389
17756,21133940,21134966,21136544,0,0,1026,2604
17773,21136708,21136708,21136807,0,0,0,99
17774,21136776,21136776,21136881,0,0,0,105
17775,21136807,21136807,21136885,0,0,0,78
17766,21136033,21136033,21136979,0,0,0,946
17777,21137090,21137090,21137174,0,0,0,84
17778,21137131,21137131,21137198,0,0,0,67
17768,21136344,21136369,21137340,0,0,25,996
17779,21137284,21137284,21137453,0,0,0,169
17706,21116597,21116597,21137615,0,0,0,21018
17746,21129914,21133977,21137628,0,0,4063,7714
17671,21111849,21111849,21138919,0,0,0,27070
17745,21129908,21133977,21138944,0,0,4069,9036
17796,21140931,21140931,21141029,0,0,0,98
17714,21123768,21123768,21144692,0,0,0,20924
17710,21120323,21120323,21146677,0,0,0,26354
17763,21135884,21135884,21148050,0,0,0,12166
17761,21135859,21135859,21148056,0,0,0,12197
17800,21145089,21148050,21148143,0,0,2961,3054
17764,21135906,21135906,21148149,0,0,0,12243
17765,21135923,21135923,21148212,0,0,0,12289
17772,21136633,21136633,21148860,0,0,0,12227
17770,21136595,21136595,21148906,0,0,0,12311
17769,21136581,21136581,21148939,0,0,0,12358
17771,21136619,21137628,21149948,0,0,1009,13329
17780,21137390,21137390,21151733,0,0,0,14343
17801,21146630,21151733,21151903,0,0,5103,5273
17717,21125369,21125369,21152055,0,0,0,26686
17738,21128900,21128900,21152400,0,0,0,23500
17749,21131446,21131517,21152497,0,0,71,21051
17739,21129100,21129100,21152535,0,0,0,23435
17788,21139079,21144692,21152674,0,0,5613,13595
17757,21133945,21134966,21155816,0,0,1021,21871
17797,21142498,21148906,21156106,0,0,6408,13608
17767,21136297,21136297,21156886,0,0,0,20589
17781,21137575,21137575,21158350,0,0,0,20775
17750,21131485,21132018,21158391,0,0,533,26906
17790,21139338,21144692,21159035,0,0,5354,19697
17789,21139145,21144692,21159043,0,0,5547,19898
17809,21157791,21158350,21159586,0,0,559,1795
17724,21126098,21130538,21160547,0,0,4440,34449
17791,21139404,21146677,21161020,0,0,7273,21616
17792,21139470,21146677,21161020,0,0,7207,21550
17793,21139555,21146677,21161020,0,0,7122,21465
17794,21139627,21148149,21162492,0,0,8522,22865
17753,21133523,21134014,21162564,0,0,491,29041
17815,21164558,21164558,21165426,0,0,0,868
17787,21138877,21138919,21165578,0,0,42,26701
17812,21163586,21163586,21165815,0,0,0,2229
17818,21165106,21165426,21166294,0,0,320,1188
17819,21165279,21165578,21166477,0,0,299,1198
17798,21143569,21160547,21166952,0,0,16978,23383
17821,21165552,21166294,21167218,0,0,742,1666
17799,21144646,21149948,21171032,0,0,5302,26386
17419,21027145,21027145,21171145,0,0,0,144000
17804,21152368,21152400,21173497,0,0,32,21129
17785,21137720,21149948,21175251,0,0,12228,37531
17708,21117688,21122072,21175409,0,0,4384,57721
17803,21152307,21152307,21176181,0,0,0,23874
17805,21152487,21152497,21176369,0,0,10,23882
17807,21154734,21155816,21176669,0,0,1082,21935
17813,21163740,21163740,21176982,0,0,0,13242
17814,21164247,21164247,21177110,0,0,0,12863
17808,21156817,21156886,21177416,0,0,69,20599
17816,21164705,21164705,21177817,0,0,0,13112
17802,21151994,21151994,21178900,0,0,0,26906
17820,21165367,21165578,21178907,0,0,211,13540
17806,21152642,21152642,21179169,0,0,0,26527
17817,21164941,21164941,21179286,0,0,0,14345
17822,21165607,21166477,21180230,0,0,870,14623
17810,21159635,21159635,21180301,0,0,0,20666
17718,21125781,21125781,21180837,0,0,0,55056
17782,21137695,21138944,21181467,0,0,1249,43772
17823,21165723,21166952,21181573,0,0,1229,15850
17795,21140558,21159035,21184235,0,0,18477,43677
17784,21137711,21148212,21185653,0,0,10501,47942
17681,21114491,21114491,21185907,0,0,0,71416
17783,21137703,21148212,21187074,0,0,10509,49371
17824,21165861,21165861,21187404,0,0,0,21543
17664,21111071,21111071,21189766,0,0,0,78695
17663,21111046,21111046,21190045,0,0,0,78999
17811,21162030,21162030,21190344,0,0,0,28314
17825,21173449,21173449,21194477,0,0,0,21028
17656,21109124,21109124,21195524,0,0,0,86400
17776,21136847,21136847,21196763,0,0,0,59916
17843,21197953,21197953,21198340,0,0,0,387
17845,21197963,21197963,21198350,0,0,0,387
17841,21197934,21197934,21198404,0,0,0,470
17832,21191256,21191256,21198583,0,0,0,7327
17842,21197941,21197941,21198690,0,0,0,749
17826,21178892,21178892,21200014,0,0,0,21122
17847,21199644,21199644,21200032,0,0,0,388
17846,21198314,21198314,21200114,0,0,0,1800
17849,21200110,21200110,21201047,0,0,0,937
17850,21200649,21200649,21201560,0,0,0,911
17852,21201583,21201583,21201651,0,0,0,68
17838,21197041,21197041,21202389,0,0,0,5348
17856,21202425,21202425,21202688,0,0,0,263
17830,21180696,21180696,21203217,0,0,0,22521
17859,21202761,21202761,21203419,0,0,0,658
17860,21203310,21203310,21203419,0,0,0,109
17863,21203822,21203822,21203952,0,0,0,130
17869,21204813,21204813,21205176,0,0,0,363
17870,21205135,21205135,21205233,0,0,0,98
17871,21205542,21205542,21205589,0,0,0,47
17827,21179015,21179015,21205703,0,0,0,26688
17872,21205889,21205889,21205925,0,0,0,36
17828,21179548,21179548,21206070,0,0,0,26522
17873,21206194,21206194,21206241,0,0,0,47
17829,21180143,21180143,21206634,0,0,0,26491
17874,21206810,21206810,21206865,0,0,0,55
17875,21207217,21207217,21207284,0,0,0,67
17876,21207392,21207392,21207568,0,0,0,176
17711,21122375,21122375,21208287,0,0,0,85912
17831,21185878,21185878,21208433,0,0,0,22555
17882,21208811,21208811,21208909,0,0,0,98
17883,21209045,21209045,21209422,0,0,0,377
17698,21115569,21115569,21209744,0,0,0,94175
17858,21202600,21202600,21210577,0,0,0,7977
17887,21211905,21211905,21212193,0,0,0,288
17888,21212132,21212132,21212210,0,0,0,78
17880,21208194,21208194,21212460,0,0,0,4266
17857,21202521,21202521,21212753,0,0,0,10232
17889,21212721,21212721,21212914,0,0,0,193
17890,21213037,21213037,21213104,0,0,0,67
17885,21209644,21209644,21213290,0,0,0,3646
17705,21116408,21116700,21213642,0,0,292,97234
17892,21213716,21213716,21213763,0,0,0,47
17786,21138687,21160547,21213784,0,0,21860,75097
17884,21209432,21209432,21213940,0,0,0,4508
17893,21213874,21213874,21214169,0,0,0,295
17896,21214170,21214170,21214600,0,0,0,430
17897,21214387,21214387,21214688,0,0,0,301
17898,21214640,21214640,21214886,0,0,0,246
17901,21214886,21214886,21214933,0,0,0,47
17902,21214924,21214924,21214982,0,0,0,58
17900,21214884,21214884,21214997,0,0,0,113
17899,21214854,21214854,21215027,0,0,0,173
17903,21214951,21214951,21215280,0,0,0,329
17906,21215462,21215462,21215786,0,0,0,324
17907,21215499,21215499,21215885,0,0,0,386
17908,21215519,21215519,21215936,0,0,0,417
17905,21215435,21215435,21216015,0,0,0,580
17867,21204169,21204169,21216028,0,0,0,11859
17868,21204180,21204180,21216068,0,0,0,11888
17909,21216222,21216222,21216290,0,0,0,68
17866,21204149,21204149,21216693,0,0,0,12544
17910,21216544,21216544,21216882,0,0,0,338
17836,21196410,21196410,21216920,0,0,0,20510
17911,21216561,21216561,21216925,0,0,0,364
17912,21216802,21216802,21216957,0,0,0,155
17891,21213346,21213346,21216959,0,0,0,3613
17916,21217036,21217036,21217207,0,0,0,171
17715,21124536,21124536,21217449,0,0,0,92913
17895,21214075,21214075,21217465,0,0,0,3390
17919,21217470,21217470,21217590,0,0,0,120
17920,21217497,21217497,21217591,0,0,0,94
17918,21217342,21217342,21217868,0,0,0,526
17837,21196741,21196741,21217916,0,0,0,21175
17921,21217761,21217761,21217987,0,0,0,226
17716,21124546,21125130,21218043,0,0,584,93497
17924,21218003,21218003,21218245,0,0,0,242
17926,21218140,21218140,21218408,0,0,0,268
17894,21214053,21214053,21218478,0,0,0,4425
17917,21217037,21217037,21218749,0,0,0,1712
17939,21218685,21218685,21218751,0,0,0,66
17913,21216836,21216836,21218826,0,0,0,1990
17942,21219008,21219008,21219051,0,0,0,43
17941,21218809,21218809,21219117,0,0,0,308
17943,21219074,21219074,21219168,0,0,0,94
17927,21218172,21218172,21219292,0,0,0,1120
17944,21219393,21219393,21219464,0,0,0,71
17929,21218346,21218346,21219528,0,0,0,1182
17945,21219525,21219525,21219603,0,0,0,78
17946,21219618,21219618,21219960,0,0,0,342
17848,21199681,21199681,21220333,0,0,0,20652
17886,21210542,21210542,21220462,0,0,0,9920
17915,21216898,21216898,21220510,0,0,0,3612
17949,21220080,21220080,21220691,0,0,0,611
17954,21221892,21221892,21221947,0,0,0,55
17933,21218407,21218407,21222872,0,0,0,4465
17853,21201819,21201819,21222904,0,0,0,21085
17955,21221916,21222904,21222998,0,0,988,1082
17960,21223160,21223160,21223233,0,0,0,73
17961,21223635,21223635,21223708,0,0,0,73
17952,21220509,21220509,21224165,0,0,0,3656
17968,21225338,21225338,21225461,0,0,0,123
17970,21225515,21225515,21225800,0,0,0,285
17971,21225851,21225851,21226722,0,0,0,871
17962,21223744,21223744,21226748,0,0,0,3004
17861,21203387,21203387,21227161,0,0,0,23774
17958,21222788,21222788,21227241,0,0,0,4453
17934,21218445,21218445,21227445,0,0,0,9000
17964,21224391,21227445,21227538,0,0,3054,3147
17965,21224685,21227538,21227631,0,0,2853,2946
17963,21224093,21224093,21227696,0,0,0,3603
17956,21222283,21222998,21227700,0,0,715,5417
17966,21225014,21227631,21227724,0,0,2617,2710
17967,21225209,21227700,21227793,0,0,2491,2584
17969,21225407,21227724,21227818,0,0,2317,2411
17582,21055051,21055081,21227824,0,0,30,172773
17855,21202390,21202390,21228720,0,0,0,26330
17977,21227458,21228720,21228828,0,0,1262,1370
17979,21228017,21228828,21228921,0,0,811,904
17851,21201150,21201150,21230780,0,0,0,29630
17978,21227643,21227696,21231356,0,0,53,3713
17976,21227194,21227194,21231629,0,0,0,4435
17953,21221454,21221454,21232166,0,0,0,10712
17881,21208374,21208374,21232192,0,0,0,23818
17680,21114446,21114446,21233881,0,0,0,119435
17877,21207405,21207405,21233944,0,0,0,26539
17981,21228998,21233944,21234038,0,0,4946,5040
17878,21207586,21207586,21234405,0,0,0,26819
17984,21231241,21231356,21235090,0,0,115,3849
17844,21197953,21197953,21235276,0,0,0,37323
17985,21231571,21231629,21236109,0,0,58,4538
17879,21207862,21207862,21236765,0,0,0,28903
17914,21216851,21216851,21237379,0,0,0,20528
17982,21230554,21230554,21237754,0,0,0,7200
17721,21125884,21125884,21238637,0,0,0,112753
17987,21234912,21234912,21238663,0,0,0,3751
17950,21220279,21238637,21238762,0,0,18358,18483
17922,21217854,21217854,21239040,0,0,0,21186
17992,21239009,21239040,21239147,0,0,31,138
17991,21238718,21238718,21239273,0,0,0,555
17835,21196013,21196013,21240023,0,0,0,44010
17988,21235980,21236109,21240673,0,0,129,4693
17951,21220289,21220289,21241030,0,0,0,20741
17973,21226721,21226721,21241033,0,0,0,14312
17974,21226752,21226752,21241070,0,0,0,14318
17990,21238595,21238595,21242373,0,0,0,3778
17925,21218025,21218025,21244419,0,0,0,26394
17983,21230725,21230780,21244599,0,0,55,13874
17999,21240484,21240673,21245226,0,0,189,4742
17972,21226667,21238762,21245470,0,0,12095,18803
18006,21244941,21245470,21245568,0,0,529,627
18009,21245239,21245568,21245724,0,0,329,485
17995,21239227,21245470,21246070,0,0,6243,6843
17998,21240127,21245470,21246070,0,0,5343,5943
18010,21245429,21245724,21246324,0,0,295,895
17840,21197921,21197921,21246433,0,0,0,48512
17935,21218615,21233881,21247412,0,0,15266,28797
17720,21125825,21125825,21247586,0,0,0,121761
17947,21219699,21247586,21248186,0,0,27887,28487
17959,21222842,21227161,21248201,0,0,4319,25359
18002,21242317,21244599,21248393,0,0,2282,6076
17948,21219712,21248186,21248403,0,0,28474,28691
18013,21248337,21248337,21248492,0,0,0,155
18007,21244981,21244981,21249574,0,0,0,4593
18012,21246044,21246044,21249835,0,0,0,3791
17904,21215402,21215402,21250473,0,0,0,35071
17839,21197889,21197889,21250646,0,0,0,52757
17975,21227105,21227793,21251939,0,0,688,24834
17957,21222368,21227824,21253024,0,0,5456,30656
18018,21250917,21250917,21253275,0,0,0,2358
18016,21249777,21249777,21253552,0,0,0,3775
17854,21202351,21202351,21254046,0,0,0,51695
18015,21249506,21249506,21254119,0,0,0,4613
17980,21228664,21228921,21255412,0,0,257,26748
18020,21253488,21253488,21257265,0,0,0,3777
18017,21250900,21250900,21257457,0,0,0,6557
17989,21237549,21237549,21258270,0,0,0,20721
18021,21254062,21254062,21258653,0,0,0,4591
18023,21257176,21257176,21260964,0,0,0,3788
17994,21239210,21240023,21261172,0,0,813,21962
18025,21258610,21258610,21263235,0,0,0,4625
18027,21260905,21260905,21264703,0,0,0,3798
18000,21240950,21244419,21264801,0,0,3469,23851
17997,21240093,21241030,21265401,0,0,937,25308
17993,21239085,21239147,21265741,0,0,62,26656
18004,21243881,21245470,21266202,0,0,1589,22321
17996,21239540,21240023,21266773,0,0,483,27233
18029,21263188,21263188,21267742,0,0,0,4554
18032,21264636,21264636,21268450,0,0,0,3814
18037,21271707,21271707,21271879,0,0,0,172
18008,21245214,21245470,21271948,0,0,256,26734
18038,21271827,21271827,21271995,0,0,0,168
18036,21268396,21268396,21272227,0,0,0,3831
18035,21267686,21267686,21272300,0,0,0,4614
18014,21248694,21248694,21272393,0,0,0,23699
17833,21194712,21194712,21273912,0,0,0,79200
17834,21194726,21194726,21273926,0,0,0,79200
18005,21244475,21245470,21274469,0,0,995,29994
18044,21273480,21273480,21274824,0,0,0,1344
18003,21243698,21245470,21274914,0,0,1772,31216
18019,21251189,21251189,21275373,0,0,0,24184
18040,21272164,21272164,21275957,0,0,0,3793
18045,21274753,21274753,21276085,0,0,0,1332
18041,21272257,21272257,21276911,0,0,0,4654
17865,21204073,21204073,21276930,0,0,0,72857
17862,21203435,21203435,21277272,0,0,0,73837
18001,21242262,21242373,21278373,0,0,111,36111
18024,21258199,21258199,21278909,0,0,0,20710
18047,21275890,21275890,21279681,0,0,0,3791
17439,21028754,21028754,21280885,0,0,0,252131
18022,21255091,21255091,21281354,0,0,0,26263
18054,21281293,21281293,21281443,0,0,0,150
18049,21276844,21276844,21281573,0,0,0,4729
18026,21260684,21260684,21281739,0,0,0,21055
18028,21261344,21261344,21281935,0,0,0,20591
18051,21279624,21279624,21283408,0,0,0,3784
18031,21264629,21264629,21285593,0,0,0,20964
18062,21285789,21285789,21285980,0,0,0,191
18056,21281535,21281535,21286217,0,0,0,4682
18063,21286057,21286057,21286684,0,0,0,627
18059,21283361,21283361,21287152,0,0,0,3791
18066,21286971,21286971,21287216,0,0,0,245
18068,21287224,21287224,21287601,0,0,0,377
18069,21287733,21287733,21288019,0,0,0,286
18073,21288280,21288280,21288431,0,0,0,151
18071,21288227,21288227,21288437,0,0,0,210
18076,21288442,21288442,21288588,0,0,0,146
18030,21264479,21264479,21288663,0,0,0,24184
18077,21288562,21288562,21288704,0,0,0,142
17482,21037400,21037400,21289506,0,0,0,252106
17486,21037494,21037508,21289622,0,0,14,252128
18080,21288678,21288678,21290762,0,0,0,2084
18065,21286156,21286156,21290793,0,0,0,4637
18067,21287094,21287094,21290877,0,0,0,3783
18082,21290792,21290792,21290907,0,0,0,115
18085,21290933,21290933,21291079,0,0,0,146
18086,21291038,21291038,21291173,0,0,0,135
18087,21291045,21291045,21291377,0,0,0,332
18084,21290930,21290930,21291409,0,0,0,479
18033,21265673,21265673,21292486,0,0,0,26813
18092,21292639,21292639,21292732,0,0,0,93
18088,21291178,21291178,21292905,0,0,0,1727
18093,21293021,21293021,21293131,0,0,0,110
18094,21293101,21293101,21293206,0,0,0,105
18034,21266706,21266706,21293230,0,0,0,26524
18096,21293255,21293255,21293348,0,0,0,93
18075,21288423,21288423,21293648,0,0,0,5225
18097,21293603,21293603,21293696,0,0,0,93
18098,21294039,21294039,21294174,0,0,0,135
18099,21294195,21294195,21294319,0,0,0,124
17986,21231801,21234038,21294439,0,0,2237,62638
18090,21292071,21292071,21294461,0,0,0,2390
18089,21292034,21292034,21294497,0,0,0,2463
18083,21290813,21290813,21294644,0,0,0,3831
18081,21290725,21290725,21295422,0,0,0,4697
18064,21286131,21286131,21295544,0,0,0,9413
17484,21037449,21037449,21296649,0,0,0,259200
18132,21297549,21297549,21297674,0,0,0,125
18133,21297837,21297837,21297884,0,0,0,47
18134,21298255,21298255,21298404,0,0,0,149
18119,21294577,21294577,21298419,0,0,0,3842
18136,21298386,21298386,21298480,0,0,0,94
18039,21271933,21271933,21298529,0,0,0,26596
18138,21298463,21298463,21298639,0,0,0,176
18046,21275307,21275307,21298704,0,0,0,23397
18050,21278875,21278875,21299577,0,0,0,20702
18151,21299876,21299876,21299960,0,0,0,84
18152,21299894,21299894,21300037,0,0,0,143
18128,21295366,21295366,21300076,0,0,0,4710
18154,21300038,21300038,21300097,0,0,0,59
18156,21300481,21300481,21300610,0,0,0,129
18043,21273147,21273147,21301466,0,0,0,28319
18159,21301385,21301385,21301525,0,0,0,140
18158,21300788,21300788,21301597,0,0,0,809
18135,21298382,21298382,21302266,0,0,0,3884
18057,21281676,21281676,21302444,0,0,0,20768
18058,21281883,21281883,21302561,0,0,0,20678
18072,21288234,21288234,21303193,0,0,0,14959
18074,21288351,21288351,21303246,0,0,0,14895
18070,21288218,21288218,21303463,0,0,0,15245
18048,21276032,21276032,21304642,0,0,0,28610
18155,21300076,21300076,21304723,0,0,0,4647
18178,21304533,21304533,21304816,0,0,0,283
18182,21304969,21304969,21305062,0,0,0,93
18176,21303918,21303918,21305157,0,0,0,1239
18177,21304394,21304394,21305189,0,0,0,795
18183,21305231,21305231,21305525,0,0,0,294
18185,21305432,21305432,21305525,0,0,0,93
18186,21305488,21305488,21305582,0,0,0,94
18189,21305625,21305625,21305692,0,0,0,67
18187,21305526,21305526,21305807,0,0,0,281
18190,21305949,21305949,21306017,0,0,0,68
18192,21306122,21306122,21306169,0,0,0,47
18167,21302240,21302240,21306172,0,0,0,3932
18184,21305380,21305380,21306178,0,0,0,798
18061,21285535,21285535,21306625,0,0,0,21090
18201,21306490,21306625,21306683,0,0,135,193
18206,21306660,21306683,21306750,0,0,23,90
18209,21306775,21306775,21306831,0,0,0,56
18194,21306422,21306422,21307217,0,0,0,795
18223,21307393,21307393,21307465,0,0,0,72
18224,21307439,21307439,21307506,0,0,0,67
17547,21048268,21048308,21307508,0,0,40,259240
18055,21281398,21281398,21307916,0,0,0,26518
18238,21308231,21308231,21308325,0,0,0,94
18226,21307640,21307640,21308380,0,0,0,740
18239,21308312,21308312,21308390,0,0,0,78
18240,21308541,21308541,21308604,0,0,0,63
18250,21308797,21308797,21309270,0,0,0,473
18180,21304660,21304660,21309336,0,0,0,4676
18175,21303452,21303452,21309774,0,0,0,6322
18207,21306732,21309774,21309867,0,0,3042,3135
18227,21307858,21309867,21309965,0,0,2009,2107
18191,21306119,21306119,21309987,0,0,0,3868
18181,21304929,21304929,21310146,0,0,0,5217
18219,21307035,21310146,21310239,0,0,3111,3204
18220,21307045,21310239,21310333,0,0,3194,3288
17550,21048391,21051224,21310424,0,0,2833,262033
18173,21303440,21303440,21310678,0,0,0,7238
18174,21303446,21303446,21310727,0,0,0,7281
18262,21310050,21310050,21311022,0,0,0,972
18079,21288597,21288597,21312000,0,0,0,23403
18137,21298455,21298455,21312031,0,0,0,13576
18261,21309926,21309987,21313892,0,0,61,3966
18251,21309265,21309265,21314023,0,0,0,4758
18225,21307566,21307566,21315328,0,0,0,7762
18331,21314741,21315328,21315528,0,0,587,787
17602,21058211,21058243,21317443,0,0,32,259232
18042,21272823,21272823,21317584,0,0,0,44761
18328,21313832,21313832,21317629,0,0,0,3797
18330,21314503,21314503,21319196,0,0,0,4693
18091,21292447,21292447,21319430,0,0,0,26983
18141,21299511,21299511,21320304,0,0,0,20793
18095,21293190,21293190,21320444,0,0,0,27254
18333,21317622,21317622,21321381,0,0,0,3759
18139,21298638,21298638,21321511,0,0,0,22873
18169,21302498,21302498,21323366,0,0,0,20868
18168,21302389,21302389,21323485,0,0,0,21096
18334,21319197,21319430,21324142,0,0,233,4945
18339,21321321,21321321,21325136,0,0,0,3815
18140,21299380,21299380,21326253,0,0,0,26873
18346,21327136,21327136,21327203,0,0,0,67
18347,21327199,21327199,21327246,0,0,0,47
18349,21327645,21327645,21327712,0,0,0,67
18351,21328044,21328044,21328128,0,0,0,84
18205,21306582,21307508,21328408,0,0,926,21826
18352,21328571,21328571,21328655,0,0,0,84
18344,21325073,21325136,21328917,0,0,63,3844
18341,21323846,21324142,21328952,0,0,296,5106
18357,21329625,21329625,21329692,0,0,0,67
18359,21330113,21330113,21330196,0,0,0,83
18360,21330155,21330155,21330222,0,0,0,67
18363,21330426,21330426,21330556,0,0,0,130
18369,21331041,21331041,21331108,0,0,0,67
18368,21331030,21331030,21331113,0,0,0,83
18160,21301394,21301394,21331128,0,0,0,29734
18371,21331201,21331201,21331264,0,0,0,63
18348,21327458,21331128,21331315,0,0,3670,3857
18372,21331213,21331213,21331318,0,0,0,105
18373,21331268,21331268,21331326,0,0,0,58
18350,21327802,21331315,21331439,0,0,3513,3637
18374,21331425,21331425,21331492,0,0,0,67
18354,21328626,21331439,21331532,0,0,2813,2906
18355,21328787,21328917,21332688,0,0,130,3901
18353,21328571,21328571,21333228,0,0,0,4657
18179,21304576,21304576,21333626,0,0,0,29050
18358,21329811,21331532,21334087,0,0,1721,4276
18381,21332519,21332688,21336426,0,0,169,3907
18228,21307872,21309867,21336736,0,0,1995,28864
18382,21333184,21333228,21337826,0,0,44,4642
18388,21336236,21336236,21339952,0,0,0,3716
18390,21337763,21337763,21342318,0,0,0,4555
18394,21341502,21342318,21346047,0,0,816,4545
18112,21294521,21294521,21346869,0,0,0,52348
18111,21294516,21294516,21346957,0,0,0,52441
18106,21294390,21294390,21347078,0,0,0,52688
18115,21294532,21294532,21347128,0,0,0,52596
18100,21294356,21294356,21347212,0,0,0,52856
18117,21294540,21294540,21347457,0,0,0,52917
18127,21294605,21294605,21347600,0,0,0,52995
18108,21294399,21294399,21347675,0,0,0,53276
18118,21294571,21294571,21347705,0,0,0,53134
18116,21294536,21294536,21347719,0,0,0,53183
18110,21294513,21294513,21347758,0,0,0,53245
18103,21294380,21294380,21347763,0,0,0,53383
18126,21294602,21294602,21347949,0,0,0,53347
18124,21294595,21294595,21347962,0,0,0,53367
18121,21294584,21294584,21348170,0,0,0,53586
18122,21294587,21294587,21348452,0,0,0,53865
18125,21294598,21294598,21348649,0,0,0,54051
18104,21294383,21294383,21348820,0,0,0,54437
18120,21294579,21294579,21348940,0,0,0,54361
18109,21294504,21294504,21349330,0,0,0,54826
18107,21294394,21294394,21349345,0,0,0,54951
18105,21294387,21294387,21349486,0,0,0,55099
18113,21294526,21294526,21349778,0,0,0,55252
18329,21314453,21314453,21350453,0,0,0,36000
18396,21344355,21346047,21350583,0,0,1692,6228
18102,21294375,21294375,21350716,0,0,0,56341
18161,21301698,21301698,21351402,0,0,0,49704
18143,21299656,21299656,21351655,0,0,0,51999
18163,21301909,21301909,21351861,0,0,0,49952
18162,21301812,21301812,21351936,0,0,0,50124
18171,21303100,21303100,21351990,0,0,0,48890
18123,21294592,21294592,21352150,0,0,0,57558
18327,21313648,21351655,21352167,0,0,38007,38519
18146,21299669,21299669,21352226,0,0,0,52557
18164,21301995,21301995,21352393,0,0,0,50398
18142,21299647,21299647,21352415,0,0,0,52768
18165,21302076,21302076,21352536,0,0,0,50460
18144,21299660,21299660,21352590,0,0,0,52930
18149,21299681,21299681,21352764,0,0,0,53083
18150,21299685,21299685,21352985,0,0,0,53300
18172,21303121,21303121,21353042,0,0,0,49921
18145,21299666,21299666,21353372,0,0,0,53706
18148,21299677,21299677,21353569,0,0,0,53892
18398,21345179,21350453,21354179,0,0,5274,9000
18147,21299673,21299673,21354185,0,0,0,54512
18403,21348846,21350583,21354230,0,0,1737,5384
18383,21333196,21354185,21354358,0,0,20989,21162
18170,21303076,21303076,21354667,0,0,0,51591
18166,21302178,21302178,21354731,0,0,0,52553
18385,21333562,21354667,21354839,0,0,21105,21277
18391,21339783,21354839,21355009,0,0,15056,15226
18406,21352508,21352508,21356223,0,0,0,3715
18404,21348867,21351936,21356558,0,0,3069,7691
18052,21280351,21280351,21356670,0,0,0,76319
18053,21280376,21280376,21357326,0,0,0,76950
18364,21330639,21357326,21357420,0,0,26687,26781
18365,21330734,21357420,21357523,0,0,26686,26789
18366,21330741,21357523,21357607,0,0,26782,26866
18367,21330773,21357607,21357700,0,0,26834,26927
18409,21353495,21353495,21358088,0,0,0,4593
18370,21331162,21357700,21358151,0,0,26538,26989
18412,21356202,21356223,21359990,0,0,21,3788
18101,21294368,21294368,21362319,0,0,0,67951
18195,21306448,21306448,21362411,0,0,0,55963
18395,21341651,21362319,21362490,0,0,20668,20839
18413,21358088,21358088,21362693,0,0,0,4605
18196,21306461,21306461,21362991,0,0,0,56530
18210,21306868,21307508,21363056,0,0,640,56188
18414,21359906,21359906,21363660,0,0,0,3754
18216,21306895,21307916,21363774,0,0,1021,56879
18197,21306467,21306467,21363873,0,0,0,57406
18212,21306881,21307508,21364143,0,0,627,57262
18204,21306506,21307508,21364174,0,0,1002,57668
18202,21306490,21307508,21364188,0,0,1018,57698
18199,21306474,21307217,21364437,0,0,743,57963
18200,21306479,21307217,21364549,0,0,738,58070
18203,21306500,21307508,21364763,0,0,1008,58263
18211,21306876,21307508,21364825,0,0,632,57949
18237,21308189,21310424,21365077,0,0,2235,56888
18229,21308147,21309867,21365273,0,0,1720,57126
18218,21306903,21309867,21365428,0,0,2964,58525
18214,21306888,21307508,21365620,0,0,620,58732
18213,21306885,21307508,21365682,0,0,623,58797
18157,21300722,21300722,21365753,0,0,0,65031
18249,21308617,21310678,21365768,0,0,2061,57151
18230,21308160,21309867,21365791,0,0,1707,57631
18408,21353013,21365753,21365924,0,0,12740,12911
18410,21355412,21365753,21365924,0,0,10341,10512
18416,21362768,21365768,21365939,0,0,3000,3171
18215,21306892,21307508,21366015,0,0,616,59123
18217,21306899,21309867,21366181,0,0,2968,59282
18421,21366621,21366621,21366714,0,0,0,93
18232,21308168,21309867,21366816,0,0,1699,58648
18233,21308172,21309867,21366837,0,0,1695,58665
18234,21308176,21309867,21366988,0,0,1691,58812
18241,21308571,21310424,21367069,0,0,1853,58498
18246,21308595,21310424,21367165,0,0,1829,58570
18236,21308183,21310424,21367204,0,0,2241,59021
18415,21362626,21362693,21367218,0,0,67,4592
18231,21308164,21309867,21367390,0,0,1703,59226
18235,21308179,21309965,21367396,0,0,1786,59217
18418,21363618,21363618,21367434,0,0,0,3816
18193,21306126,21306126,21367679,0,0,0,61553
18260,21309639,21310678,21367807,0,0,1039,58168
18271,21310116,21310727,21367955,0,0,611,57839
18252,21309588,21310678,21368043,0,0,1090,58455
18244,21308588,21310424,21368266,0,0,1836,59678
18272,21310422,21310727,21368328,0,0,305,57906
18264,21310083,21310727,21368332,0,0,644,58249
18245,21308592,21310424,21368390,0,0,1832,59798
18242,21308578,21310424,21368489,0,0,1846,59911
18248,21308610,21310424,21368566,0,0,1814,59956
18425,21367401,21367401,21368596,0,0,0,1195
18426,21368785,21368785,21368893,0,0,0,108
18263,21310073,21310727,21368901,0,0,654,58828
18427,21368796,21368893,21368970,0,0,97,174
18428,21368809,21368970,21369047,0,0,161,238
18243,21308582,21310424,21369305,0,0,1842,60723
18257,21309627,21310678,21369338,0,0,1051,59711
18269,21310108,21310727,21369618,0,0,619,59510
18265,21310086,21310727,21369786,0,0,641,59700
18266,21310096,21310727,21369822,0,0,631,59726
18268,21310104,21310727,21370024,0,0,623,59920
18255,21309619,21310678,21370125,0,0,1059,60506
18273,21310436,21312000,21370213,0,0,1564,59777
18277,21310463,21312031,21370349,0,0,1568,59886
18270,21310111,21310727,21370393,0,0,616,60282
18256,21309623,21310678,21370434,0,0,1055,60811
18278,21310473,21312031,21370439,0,0,1558,59966
18258,21309630,21310678,21370451,0,0,1048,60821
18279,21310481,21312031,21370563,0,0,1550,60082
18429,21368825,21369047,21371059,0,0,222,2234
18254,21309615,21310678,21371179,0,0,1063,61564
18247,21308602,21310424,21371183,0,0,1822,62581
18424,21367362,21367362,21371186,0,0,0,3824
18267,21310100,21310727,21371192,0,0,627,61092
18433,21370060,21371192,21371266,0,0,1132,1206
18282,21311001,21312031,21371343,0,0,1030,60342
18434,21370072,21371266,21371359,0,0,1194,1287
18060,21285039,21285039,21371439,0,0,0,86400
18274,21310441,21312031,21371605,0,0,1590,61164
18422,21367093,21367093,21371629,0,0,0,4536
18275,21310451,21312031,21371721,0,0,1580,61270
18290,21311680,21320444,21371764,0,0,8764,60084
18281,21310990,21312031,21371777,0,0,1041,60787
18435,21370449,21371359,21371920,0,0,910,1471
18280,21310491,21312031,21371954,0,0,1540,61463
18283,21311005,21312031,21372315,0,0,1026,61310
18276,21310457,21312031,21372326,0,0,1574,61869
18198,21306470,21306625,21372335,0,0,155,65865
18336,21320308,21352167,21372554,0,0,31859,52246
18432,21369018,21370024,21372821,0,0,1006,3803
18291,21311690,21321511,21373132,0,0,9821,61442
18431,21368836,21371059,21373144,0,0,2223,4308
18446,21372992,21372992,21373220,0,0,0,228
18342,21324332,21352764,21373345,0,0,28432,49013
18259,21309634,21310678,21373926,0,0,1044,64292
18343,21324577,21353042,21374128,0,0,28465,49551
18356,21329472,21353569,21374450,0,0,24097,44978
18308,21311937,21351990,21374764,0,0,40053,62827
18442,21371103,21371103,21374943,0,0,0,3840
18292,21311693,21323366,21375018,0,0,11673,63325
18294,21311698,21323485,21375579,0,0,11787,63881
18293,21311695,21323485,21375672,0,0,11790,63977
18453,21375803,21375803,21375871,0,0,0,68
18454,21375943,21375943,21376119,0,0,0,176
18444,21371584,21371584,21376171,0,0,0,4587
18455,21375984,21375984,21376171,0,0,0,187
18456,21376029,21376029,21376200,0,0,0,171
18457,21376089,21376089,21376264,0,0,0,175
18459,21376091,21376091,21376266,0,0,0,175
18253,21309610,21310678,21376284,0,0,1068,66674
18460,21376092,21376092,21376309,0,0,0,217
18458,21376090,21376090,21376369,0,0,0,279
18461,21376117,21376117,21376392,0,0,0,275
18463,21376118,21376118,21376393,0,0,0,275
18464,21376119,21376119,21376394,0,0,0,275
18340,21322077,21352590,21376573,0,0,30513,54496
18285,21311011,21317584,21376679,0,0,6573,65668
18286,21311016,21317584,21377022,0,0,6568,66006
18284,21311009,21317584,21377144,0,0,6575,66135
18393,21340634,21357326,21377886,0,0,16692,37252
18295,21311701,21326253,21378409,0,0,14552,66708
18452,21374881,21374881,21378770,0,0,0,3889
18392,21340454,21355009,21379014,0,0,14555,38560
18335,21319370,21352150,21379192,0,0,32780,59822
18288,21311023,21319430,21379238,0,0,8407,68215
18337,21320386,21352536,21379421,0,0,32150,59035
18470,21379845,21379845,21379959,0,0,0,114
18469,21379839,21379839,21380001,0,0,0,162
18473,21379871,21379959,21380016,0,0,88,145
18345,21326253,21353372,21380024,0,0,27119,53771
18471,21379850,21379850,21380026,0,0,0,176
18472,21379855,21379855,21380031,0,0,0,176
18296,21311704,21328408,21380099,0,0,16704,68395
18474,21379874,21380001,21380275,0,0,127,401
18289,21311033,21320304,21380277,0,0,9271,69244
18475,21379877,21380016,21380290,0,0,139,413
18478,21380445,21380445,21380616,0,0,0,171
18479,21380449,21380449,21380620,0,0,0,171
18476,21380429,21380429,21380621,0,0,0,192
18462,21376117,21376117,21380698,0,0,0,4581
18480,21380453,21380453,21380706,0,0,0,253
18477,21380433,21380433,21380707,0,0,0,274
18481,21380471,21380471,21380729,0,0,0,258
18482,21380477,21380477,21380771,0,0,0,294
18114,21294529,21294529,21380929,0,0,0,86400
18486,21380768,21380768,21380944,0,0,0,176
18487,21380771,21380771,21380947,0,0,0,176
18484,21380759,21380759,21380952,0,0,0,193
18488,21380791,21380791,21381034,0,0,0,243
18485,21380765,21380765,21381065,0,0,0,300
18489,21380795,21380795,21381069,0,0,0,274
18490,21380801,21380801,21381075,0,0,0,274
18287,21311019,21319196,21382001,0,0,8177,70982
18492,21381988,21381988,21382154,0,0,0,166
18493,21382092,21382092,21382258,0,0,0,166
18494,21382193,21382193,21382361,0,0,0,168
18498,21382487,21382487,21382569,0,0,0,82
18445,21371810,21371810,21382610,0,0,0,10800
18468,21378708,21378708,21382615,0,0,0,3907
18297,21311708,21331128,21382633,0,0,19420,70925
18500,21382572,21382572,21382800,0,0,0,228
18501,21382980,21382980,21383033,0,0,0,53
18397,21344852,21362411,21383055,0,0,17559,38203
18503,21383111,21383111,21383168,0,0,0,57
18504,21383132,21383132,21383169,0,0,0,37
18399,21345620,21362490,21383248,0,0,16870,37628
18502,21382990,21382990,21383264,0,0,0,274
18505,21383223,21383223,21383423,0,0,0,200
18506,21383418,21383418,21383683,0,0,0,265
18507,21383528,21383528,21383728,0,0,0,200
18384,21333371,21354358,21383755,0,0,20987,50384
18508,21384008,21384008,21384208,0,0,0,200
18510,21384239,21384239,21384321,0,0,0,82
18511,21384306,21384306,21384438,0,0,0,132
18386,21333740,21354731,21384622,0,0,20991,50882
18512,21384581,21384581,21384705,0,0,0,124
18078,21288583,21288583,21384709,0,0,0,96126
18513,21384790,21384790,21384889,0,0,0,99
18509,21384078,21384078,21384944,0,0,0,866
18483,21380645,21380645,21385134,0,0,0,4489
18514,21385036,21385036,21385168,0,0,0,132
18298,21311711,21333626,21386017,0,0,21915,74306
18466,21376803,21376803,21386031,0,0,0,9228
18400,21345997,21362991,21386249,0,0,16994,40252
18499,21382537,21382537,21386364,0,0,0,3827
18153,21299967,21299967,21386367,0,0,0,86400
18405,21350305,21365620,21386657,0,0,15315,36352
18441,21371060,21384709,21387188,0,0,13649,16128
18131,21296096,21296096,21388088,0,0,0,91992
18129,21296082,21296082,21388137,0,0,0,92055
18130,21296092,21296092,21388147,0,0,0,92055
18517,21386103,21386367,21388167,0,0,264,2064
18299,21311821,21336736,21388431,0,0,24915,76610
18443,21371156,21384944,21388905,0,0,13788,17749
18375,21331581,21358151,21389065,0,0,26570,57484
18420,21365656,21365924,21389210,0,0,268,23554
18515,21385061,21385134,21389681,0,0,73,4620
18518,21386300,21386300,21390182,0,0,0,3882
18377,21331627,21364143,21390842,0,0,32516,59215
18379,21331663,21364549,21391007,0,0,32886,59344
18300,21311830,21339952,21391036,0,0,28122,79206
18380,21331684,21364825,21391081,0,0,33141,59397
18437,21370847,21370847,21391562,0,0,0,20715
18523,21391483,21391483,21392022,0,0,0,539
18411,21355521,21365753,21392282,0,0,10232,36761
18407,21352842,21365682,21392286,0,0,12840,39444
18376,21331610,21363774,21392402,0,0,32164,60792
18401,21346365,21365273,21392409,0,0,18908,46044
18525,21391862,21391862,21392427,0,0,0,565
18402,21347226,21365428,21392458,0,0,18202,45232
18527,21392561,21392561,21392744,0,0,0,183
18529,21392685,21392685,21392866,0,0,0,181
18378,21331643,21364188,21393558,0,0,32545,61915
18528,21392662,21392662,21393736,0,0,0,1074
18532,21393922,21393922,21393990,0,0,0,68
18533,21393949,21393949,21394036,0,0,0,87
18534,21393961,21393961,21394047,0,0,0,86
18521,21390141,21390141,21394068,0,0,0,3927
18535,21393984,21393984,21394069,0,0,0,85
18536,21393998,21393998,21394093,0,0,0,95
18539,21394031,21394031,21394102,0,0,0,71
18538,21394010,21394010,21394133,0,0,0,123
18520,21389552,21389552,21394150,0,0,0,4598
18540,21394068,21394068,21394161,0,0,0,93
18550,21394234,21394234,21394270,0,0,0,36
18551,21394276,21394276,21394349,0,0,0,73
18552,21394298,21394298,21394378,0,0,0,80
18553,21394310,21394310,21394391,0,0,0,81
18419,21363623,21365924,21394398,0,0,2301,30775
18554,21394360,21394360,21394444,0,0,0,84
18450,21373657,21373926,21394474,0,0,269,20817
18555,21394383,21394383,21394475,0,0,0,92
18562,21394574,21394574,21394642,0,0,0,68
18516,21385387,21386031,21394719,0,0,644,9332
18522,21391377,21391562,21394863,0,0,185,3486
18338,21320960,21351861,21395061,0,0,30901,74101
18564,21395010,21395061,21395155,0,0,51,145
18451,21374557,21374557,21395412,0,0,0,20855
18417,21362876,21365791,21395522,0,0,2915,32646
18567,21396551,21396551,21396680,0,0,0,129
18465,21376270,21376270,21397234,0,0,0,20964
18301,21311833,21346869,21397619,0,0,35036,85786
18537,21394007,21394007,21397954,0,0,0,3947
18304,21311843,21347128,21398475,0,0,35285,86632
18311,21312066,21347719,21398668,0,0,35653,86602
18541,21394085,21394085,21398671,0,0,0,4586
18307,21311854,21347600,21398817,0,0,35746,86963
18309,21312057,21347675,21398830,0,0,35618,86773
18305,21311846,21347212,21398843,0,0,35366,86997
18526,21392043,21392286,21399002,0,0,243,6959
18570,21397340,21397340,21399153,0,0,0,1813
18310,21312063,21347705,21399181,0,0,35642,87118
18303,21311840,21347078,21399219,0,0,35238,87379
18312,21312069,21347758,21399276,0,0,35689,87207
18314,21312076,21347949,21399430,0,0,35873,87354
18306,21311850,21347457,21399440,0,0,35607,87590
18316,21312081,21348170,21399471,0,0,36089,87390
18315,21312078,21347962,21399551,0,0,35884,87473
18317,21312085,21348452,21399609,0,0,36367,87524
18319,21312259,21348820,21400279,0,0,36561,88020
18302,21311836,21346957,21400317,0,0,35121,88481
18320,21312262,21348940,21400461,0,0,36678,88199
18436,21370699,21371920,21400463,0,0,1221,29764
18569,21397201,21397201,21400888,0,0,0,3687
18313,21312072,21347763,21400946,0,0,35691,88874
18440,21370954,21379421,21401068,0,0,8467,30114
18324,21312276,21349778,21401208,0,0,37502,88932
17590,21055836,21055836,21401436,0,0,0,345600
18322,21312269,21349345,21401452,0,0,37076,89183
18438,21370852,21372821,21401457,0,0,1969,30605
18323,21312273,21349486,21401495,0,0,37213,89222
18439,21370876,21373144,21401662,0,0,2268,30786
18571,21397901,21397954,21401877,0,0,53,3976
18467,21378493,21378493,21401984,0,0,0,23491
18325,21312280,21350716,21402031,0,0,38436,89751
18321,21312266,21349330,21402837,0,0,37064,90571
18572,21398635,21398635,21403212,0,0,0,4577
18326,21312284,21351402,21403368,0,0,39118,91084
17600,21058173,21058173,21403773,0,0,0,345600
18556,21394391,21398671,21404205,0,0,4280,9814
18531,21393372,21400463,21404331,0,0,7091,10959
18574,21398753,21401068,21404936,0,0,2315,6183
18549,21394228,21397619,21405093,0,0,3391,10865
18575,21398770,21401457,21405325,0,0,2687,6555
18449,21373364,21373364,21405421,0,0,0,32057
18577,21401763,21401763,21405684,0,0,0,3921
18563,21394675,21400279,21406019,0,0,5604,11344
18579,21403152,21403152,21407766,0,0,0,4614
18448,21373362,21373362,21408032,0,0,0,34670
18447,21373358,21373358,21408111,0,0,0,34753
18491,21381844,21381844,21408569,0,0,0,26725
18597,21408523,21408523,21408695,0,0,0,172
18496,21382302,21382302,21408824,0,0,0,26522
18497,21382377,21382377,21408897,0,0,0,26520
18599,21408761,21408761,21408952,0,0,0,191
18601,21408952,21408952,21409103,0,0,0,151
18495,21382281,21382281,21409197,0,0,0,26916
18602,21409123,21409123,21409293,0,0,0,170
18548,21394173,21394863,21409543,0,0,690,15370
18592,21405639,21405639,21409597,0,0,0,3958
18318,21312249,21348649,21411351,0,0,36400,99102
18519,21388880,21388905,21412376,0,0,25,23496
18593,21407703,21407703,21412382,0,0,0,4679
18524,21391499,21392282,21412677,0,0,783,21178
18530,21392803,21392803,21413013,0,0,0,20210
18605,21409537,21409537,21413457,0,0,0,3920
18557,21394408,21398843,21413532,0,0,4435,19124
18559,21394422,21399276,21413768,0,0,4854,19346
18558,21394415,21399181,21413793,0,0,4766,19378
18561,21394436,21399551,21413997,0,0,5115,19561
18560,21394429,21399440,21414021,0,0,5011,19592
18543,21394115,21394115,21414376,0,0,0,20261
18544,21394125,21394150,21416170,0,0,25,22045
18546,21394150,21394719,21416241,0,0,569,22091
18565,21395369,21395369,21416360,0,0,0,20991
18608,21412317,21412317,21416988,0,0,0,4671
18547,21394161,21394719,21417027,0,0,558,22866
18610,21413414,21413414,21417341,0,0,0,3927
18542,21394100,21394100,21417584,0,0,0,23484
18568,21397160,21397160,21417721,0,0,0,20561
17864,21204029,21204029,21418314,0,0,0,214285
18362,21330256,21356670,21418547,0,0,26414,88291
18011,21245531,21246324,21419124,0,0,793,173593
18361,21330248,21356670,21419138,0,0,26422,88890
18614,21417301,21417301,21421253,0,0,0,3952
18613,21416920,21416920,21421669,0,0,0,4749
18587,21403369,21419124,21422110,0,0,15755,18741
18616,21421199,21421199,21425108,0,0,0,3909
18578,21401921,21401921,21425365,0,0,0,23444
18617,21421607,21421607,21426274,0,0,0,4667
18621,21428083,21428083,21428267,0,0,0,184
18573,21398694,21398817,21428275,0,0,123,29581
18618,21425063,21425063,21428930,0,0,0,3867
18566,21395372,21395412,21430191,0,0,40,34819
18620,21426218,21426218,21431129,0,0,0,4911
18606,21411832,21411832,21432350,0,0,0,20518
18623,21428891,21428891,21432801,0,0,0,3910
18611,21414315,21414315,21434575,0,0,0,20260
18598,21408681,21408681,21434871,0,0,0,26190
18604,21409273,21409273,21435482,0,0,0,26209
18607,21412277,21412277,21435706,0,0,0,23429
18600,21408853,21408853,21435820,0,0,0,26967
18624,21431063,21431063,21435826,0,0,0,4763
18603,21409131,21409131,21435946,0,0,0,26815
18626,21432741,21432741,21436611,0,0,0,3870
18612,21416313,21416313,21437221,0,0,0,20908
18615,21417655,21417655,21438293,0,0,0,20638
18634,21436567,21436567,21440408,0,0,0,3841
18545,21394132,21394474,21440627,0,0,342,46495
18631,21435775,21435775,21440634,0,0,0,4859
18609,21412969,21412969,21441392,0,0,0,28423
18423,21367346,21367346,21442251,0,0,0,74905
18639,21441394,21442251,21442422,0,0,857,1028
18589,21403380,21441392,21442749,0,0,38012,39369
18637,21440347,21440347,21444208,0,0,0,3861
18638,21440570,21440570,21445403,0,0,0,4833
18430,21368830,21369338,21445652,0,0,508,76822
18641,21444147,21444147,21448014,0,0,0,3867
18619,21425310,21425310,21449535,0,0,0,24225
18642,21445362,21445362,21450154,0,0,0,4792
18643,21447971,21447971,21451801,0,0,0,3830
18625,21432351,21432351,21453033,0,0,0,20682
18627,21434575,21434575,21454882,0,0,0,20307
18645,21450097,21450097,21454884,0,0,0,4787
18646,21451730,21451730,21455555,0,0,0,3825
18635,21437163,21437163,21457739,0,0,0,20576
18622,21428200,21428200,21457818,0,0,0,29618
18652,21457755,21457755,21457926,0,0,0,171
18636,21438237,21438237,21458981,0,0,0,20744
18650,21455502,21455502,21459338,0,0,0,3836
18648,21454804,21454804,21459590,0,0,0,4786
18630,21435718,21435718,21459901,0,0,0,24183
18628,21434870,21434870,21461122,0,0,0,26252
18658,21461059,21461059,21461229,0,0,0,170
18629,21435437,21435437,21461993,0,0,0,26556
18660,21461933,21461933,21462101,0,0,0,168
18632,21435798,21435798,21462702,0,0,0,26904
18633,21435918,21435918,21462706,0,0,0,26788
18655,21459275,21459275,21463030,0,0,0,3755
18656,21459531,21459531,21464429,0,0,0,4898
18664,21462967,21462967,21466765,0,0,0,3798
18665,21464362,21464362,21469225,0,0,0,4863
18666,21466693,21466693,21470423,0,0,0,3730
17923,21217965,21217965,21470565,0,0,0,252600
18667,21467596,21470565,21470669,0,0,2969,3073
18674,21470848,21470848,21470916,0,0,0,68
17928,21218332,21218332,21470932,0,0,0,252600
17930,21218353,21218353,21470953,0,0,0,252600
17931,21218372,21218372,21470972,0,0,0,252600
18675,21470956,21470956,21471023,0,0,0,67
18677,21471311,21471311,21471436,0,0,0,125
18669,21467995,21470953,21471552,0,0,2958,3557
18640,21441513,21442251,21472173,0,0,738,30660
18668,21467969,21470669,21472268,0,0,2700,4299
18678,21471374,21471374,21472385,0,0,0,1011
18676,21471036,21471036,21472576,0,0,0,1540
18644,21449465,21449465,21473215,0,0,0,23750
17932,21218394,21220691,21473291,0,0,2297,254897
18647,21452970,21452970,21473498,0,0,0,20528
18682,21471667,21471667,21473559,0,0,0,1892
18670,21469171,21469171,21473974,0,0,0,4803
18680,21471399,21471399,21474103,0,0,0,2704
18673,21470368,21470368,21474107,0,0,0,3739
18672,21470105,21472268,21474464,0,0,2163,4359
18681,21471621,21471621,21475066,0,0,0,3445
18649,21454839,21454839,21475144,0,0,0,20305
18584,21403226,21405325,21475890,0,0,2099,72664
18671,21470101,21471552,21476445,0,0,1451,6344
18685,21472857,21472857,21477378,0,0,0,4521
18689,21474039,21474039,21477761,0,0,0,3722
18651,21457676,21457676,21478276,0,0,0,20600
18583,21403217,21404936,21478647,0,0,1719,75430
18688,21473933,21473933,21478660,0,0,0,4727
18691,21477159,21477159,21478764,0,0,0,1605
18692,21477184,21477184,21479008,0,0,0,1824
18693,21477200,21477200,21479024,0,0,0,1824
18654,21458921,21458921,21479648,0,0,0,20727
18699,21479005,21479008,21479964,0,0,3,959
18700,21479040,21479040,21479965,0,0,0,925
18694,21477725,21477725,21481653,0,0,0,3928
18585,21403355,21413532,21482116,0,0,10177,78761
18696,21478594,21478594,21483421,0,0,0,4827
18657,21459838,21459838,21483594,0,0,0,23756
18705,21481593,21481593,21485289,0,0,0,3696
17936,21218650,21233881,21486481,0,0,15231,267831
18653,21457863,21457863,21487810,0,0,0,29947
17937,21218665,21235276,21487876,0,0,16611,269211
17938,21218682,21235276,21487876,0,0,16594,269194
18709,21487768,21487768,21487928,0,0,0,160
18659,21461166,21461166,21487959,0,0,0,26793
18710,21487875,21487875,21488046,0,0,0,171
18711,21487897,21487897,21488055,0,0,0,158
18706,21483357,21483357,21488080,0,0,0,4723
18661,21462039,21462039,21488933,0,0,0,26894
18708,21485247,21485247,21489012,0,0,0,3765
18663,21462663,21462663,21489271,0,0,0,26608
18662,21462648,21462648,21489692,0,0,0,27044
17940,21218699,21238637,21491237,0,0,19938,272538
18714,21488014,21488014,21492643,0,0,0,4629
18716,21488950,21488950,21492653,0,0,0,3703
18687,21473436,21473436,21493619,0,0,0,20183
18690,21475084,21475084,21495497,0,0,0,20413
18686,21473154,21473215,21496093,0,0,61,22939
18719,21492600,21492600,21496318,0,0,0,3718
18720,21492606,21492606,21497293,0,0,0,4687
18695,21478234,21478234,21498942,0,0,0,20708
18724,21496262,21496262,21499972,0,0,0,3710
18702,21479585,21479585,21500327,0,0,0,20742
18679,21471384,21471384,21501644,0,0,0,30260
18725,21497235,21497235,21501921,0,0,0,4686
18727,21499930,21499930,21503689,0,0,0,3759
18707,21483531,21483531,21506445,0,0,0,22914
18730,21501859,21501859,21506475,0,0,0,4616
18731,21503631,21503631,21507355,0,0,0,3724
18733,21506413,21506413,21511023,0,0,0,4610
18734,21507308,21507308,21511140,0,0,0,3832
18721,21493556,21493556,21513776,0,0,0,20220
18713,21488005,21488005,21514276,0,0,0,26271
18736,21511082,21511082,21514909,0,0,0,3827
18715,21488889,21488889,21515382,0,0,0,26493
18735,21510955,21510955,21515606,0,0,0,4651
18722,21495426,21495426,21515777,0,0,0,20351
18717,21489229,21489229,21515983,0,0,0,26754
18718,21489650,21489650,21516331,0,0,0,26681
18712,21487991,21487991,21516398,0,0,0,28407
18739,21514846,21514846,21518689,0,0,0,3843
18723,21495976,21495976,21518770,0,0,0,22794
18726,21498898,21498898,21519584,0,0,0,20686
18741,21515550,21515550,21520108,0,0,0,4558
18750,21520838,21520838,21520973,0,0,0,135
18728,21500262,21500262,21521310,0,0,0,21048
18746,21518646,21518646,21522496,0,0,0,3850
18591,21404230,21442749,21523224,0,0,38519,118994
18749,21520037,21520037,21524665,0,0,0,4628
18704,21479964,21482116,21525870,0,0,2152,45906
18752,21522454,21522454,21526375,0,0,0,3921
18753,21524612,21524612,21529118,0,0,0,4506
18732,21506371,21506371,21529226,0,0,0,22855
18754,21526307,21526307,21530205,0,0,0,3898
18703,21479938,21479965,21531866,0,0,27,51928
18729,21501589,21501589,21531909,0,0,0,30320
18755,21529056,21529056,21533616,0,0,0,4560
18737,21513729,21513729,21534038,0,0,0,20309
18757,21530150,21530150,21534117,0,0,0,3967
18742,21515724,21515724,21536266,0,0,0,20542
18761,21534048,21534048,21537976,0,0,0,3928
18759,21533553,21533553,21538109,0,0,0,4556
18748,21519540,21519540,21540318,0,0,0,20778
18738,21514216,21514216,21540583,0,0,0,26367
18588,21403374,21422110,21540629,0,0,18736,137255
18740,21515337,21515337,21541499,0,0,0,26162
18763,21537938,21537938,21541865,0,0,0,3927
18747,21518707,21518707,21542034,0,0,0,23327
18751,21521244,21521244,21542169,0,0,0,20925
18743,21515921,21515921,21542697,0,0,0,26776
18764,21538040,21538040,21542796,0,0,0,4756
18744,21516266,21516266,21543085,0,0,0,26819
18684,21472296,21472296,21545608,0,0,0,73312
18768,21541805,21541805,21545742,0,0,0,3937
18745,21516344,21516344,21546296,0,0,0,29952
18772,21542740,21542740,21547264,0,0,0,4524
18777,21546267,21546267,21549250,0,0,0,2983
18778,21546582,21546582,21549451,0,0,0,2869
18775,21545977,21545977,21549458,0,0,0,3481
18774,21545681,21545681,21549633,0,0,0,3952
18576,21398775,21401662,21550010,0,0,2887,151235
18781,21549396,21549396,21550024,0,0,0,628
18683,21472281,21472281,21550175,0,0,0,77894
18780,21549179,21549179,21550464,0,0,0,1285
18779,21547193,21547193,21551765,0,0,0,4572
18581,21403175,21403773,21552121,0,0,598,148946
18701,21479243,21479964,21552133,0,0,721,72890
18697,21478774,21478774,21552149,0,0,0,73375
18698,21478991,21478991,21552149,0,0,0,73158
18595,21408062,21408062,21552416,0,0,0,144354
18756,21529164,21529164,21552467,0,0,0,23303
18582,21403197,21404331,21552648,0,0,1134,149451
18782,21549570,21549570,21553470,0,0,0,3900
18760,21533981,21533981,21554315,0,0,0,20334
18596,21408112,21408112,21554807,0,0,0,146695
18785,21551711,21551711,21556201,0,0,0,4490
18783,21550023,21550023,21556357,0,0,0,6334
18762,21536188,21536188,21556647,0,0,0,20459
18784,21550472,21550472,21557235,0,0,0,6763
18793,21553404,21553404,21557274,0,0,0,3870
18786,21551779,21551779,21558062,0,0,0,6283
18790,21552100,21552100,21558091,0,0,0,5991
18787,21551788,21551788,21558206,0,0,0,6418
18788,21551801,21551801,21558250,0,0,0,6449
18791,21552115,21552115,21558283,0,0,0,6168
18789,21552082,21552082,21558464,0,0,0,6382
18795,21556160,21556160,21560704,0,0,0,4544
18594,21408043,21408043,21560832,0,0,0,152789
18765,21540260,21540260,21561005,0,0,0,20745
18758,21531850,21531850,21561078,0,0,0,29228
18797,21557232,21557232,21561172,0,0,0,3940
18809,21561033,21561033,21561204,0,0,0,171
18811,21561144,21561144,21561312,0,0,0,168
18812,21561250,21561250,21561419,0,0,0,169
18813,21561357,21561357,21561540,0,0,0,183
18770,21542115,21542115,21562948,0,0,0,20833
18798,21557803,21557803,21563267,0,0,0,5464
18799,21557908,21557908,21563793,0,0,0,5885
18817,21563708,21563708,21564260,0,0,0,552
18804,21558254,21558254,21564293,0,0,0,6039
18821,21564221,21564221,21564450,0,0,0,229
18818,21563731,21563731,21564533,0,0,0,802
18816,21563192,21563192,21564560,0,0,0,1368
18188,21305533,21305533,21564733,0,0,0,259200
18810,21561079,21561079,21565008,0,0,0,3929
18769,21541969,21541969,21565064,0,0,0,23095
18822,21564252,21564252,21565086,0,0,0,834
18807,21560652,21560652,21565203,0,0,0,4551
18801,21558036,21558036,21565380,0,0,0,7344
18766,21540526,21540526,21567075,0,0,0,26549
18767,21541442,21541442,21567895,0,0,0,26453
18826,21564945,21564945,21568864,0,0,0,3919
18771,21542635,21542635,21569318,0,0,0,26683
18222,21307222,21310333,21569533,0,0,3111,262311
18828,21565141,21565141,21569702,0,0,0,4561
18773,21543045,21543045,21569831,0,0,0,26786
18823,21564510,21564510,21572295,0,0,0,7785
18837,21568799,21568799,21572714,0,0,0,3915
18824,21564521,21564521,21573170,0,0,0,8649
18800,21558011,21558011,21574182,0,0,0,16171
18839,21569638,21569638,21574224,0,0,0,4586
18802,21558167,21558167,21574410,0,0,0,16243
18803,21558208,21558208,21574440,0,0,0,16232
18805,21558394,21558394,21574445,0,0,0,16051
18794,21554252,21554252,21574580,0,0,0,20328
18846,21574353,21574440,21574657,0,0,87,304
18847,21574356,21574657,21574750,0,0,301,394
18830,21565335,21565335,21575002,0,0,0,9667
18829,21565239,21565239,21575072,0,0,0,9833
18792,21552413,21552413,21575472,0,0,0,23059
18776,21546247,21546247,21576448,0,0,0,30201
18841,21572654,21572654,21576520,0,0,0,3866
18796,21556600,21556600,21577215,0,0,0,20615
18845,21574184,21574184,21578819,0,0,0,4635
18855,21576474,21576474,21580372,0,0,0,3898
18844,21574121,21574410,21581829,0,0,289,7708
18808,21560960,21560960,21581895,0,0,0,20935
18857,21578767,21578767,21583395,0,0,0,4628
18815,21562886,21562886,21583897,0,0,0,21011
18858,21580306,21580306,21584176,0,0,0,3870
18864,21584122,21584122,21587949,0,0,0,3827
18860,21583334,21583334,21588022,0,0,0,4688
18827,21564984,21564984,21588506,0,0,0,23522
18871,21588155,21588155,21589995,0,0,0,1840
18814,21561471,21561471,21590032,0,0,0,28561
18869,21587904,21587904,21591758,0,0,0,3854
18870,21587977,21587977,21592727,0,0,0,4750
18832,21567031,21567031,21593397,0,0,0,26366
18877,21593337,21593397,21593570,0,0,60,233
18836,21567833,21567833,21594219,0,0,0,26386
18879,21594153,21594219,21594391,0,0,66,238
18849,21574533,21574533,21594892,0,0,0,20359
18875,21591698,21591758,21595538,0,0,60,3840
18838,21569256,21569256,21595667,0,0,0,26411
18852,21575015,21575015,21596203,0,0,0,21188
18840,21569773,21569773,21596519,0,0,0,26746
18876,21592667,21592727,21597465,0,0,60,4798
18856,21577157,21577157,21597574,0,0,0,20417
18853,21575402,21575402,21598941,0,0,0,23539
18883,21595408,21595667,21599472,0,0,259,4064
18886,21597342,21597342,21602079,0,0,0,4737
18859,21581854,21581854,21602721,0,0,0,20867
18889,21599159,21599159,21602916,0,0,0,3757
18831,21566878,21566878,21603468,0,0,0,36590
18862,21583834,21583834,21604667,0,0,0,20833
18854,21576385,21576385,21606467,0,0,0,30082
18894,21606411,21606411,21606582,0,0,0,171
18892,21602853,21602853,21606627,0,0,0,3774
18890,21602016,21602016,21607076,0,0,0,5060
18896,21606579,21606579,21610381,0,0,0,3802
18332,21315484,21352393,21611536,0,0,36909,296052
18897,21607014,21607014,21611867,0,0,0,4853
18872,21588437,21588506,21612402,0,0,69,23965
18898,21610320,21610320,21614107,0,0,0,3787
18881,21594834,21594892,21615419,0,0,58,20585
18899,21611820,21611820,21616631,0,0,0,4811
18901,21614044,21614044,21617768,0,0,0,3724
18887,21597513,21597513,21618129,0,0,0,20616
18906,21619358,21619358,21619528,0,0,0,170
18878,21593448,21593570,21619543,0,0,122,26095
18907,21619468,21619468,21619638,0,0,0,170
18908,21619575,21619575,21619743,0,0,0,168
18873,21589991,21590032,21619989,0,0,41,29998
18910,21619891,21619891,21620060,0,0,0,169
18880,21594266,21594391,21620918,0,0,125,26652
18904,21617711,21617711,21621435,0,0,0,3724
18903,21616572,21616572,21621467,0,0,0,4895
18848,21574383,21574445,21621920,0,0,62,47537
18888,21598904,21598904,21622449,0,0,0,23545
18884,21595593,21596203,21622462,0,0,610,26869
18885,21596458,21596458,21622927,0,0,0,26469
18891,21602661,21602661,21623683,0,0,0,21022
18913,21621389,21621389,21625072,0,0,0,3683
18586,21403362,21416170,21625497,0,0,12808,222135
18893,21604614,21604614,21625614,0,0,0,21000
18914,21621398,21621398,21626260,0,0,0,4862
18928,21626996,21626996,21627047,0,0,0,51
18389,21336576,21367955,21627155,0,0,31379,290579
18922,21626923,21626923,21627302,0,0,0,379
18929,21627009,21627009,21627391,0,0,0,382
18931,21627053,21627053,21627400,0,0,0,347
18930,21627025,21627025,21627422,0,0,0,397
18933,21627092,21627092,21627454,0,0,0,362
18924,21626940,21626940,21627458,0,0,0,518
18932,21627084,21627084,21627462,0,0,0,378
18923,21626934,21626934,21627483,0,0,0,549
18925,21626955,21626955,21627483,0,0,0,528
18934,21627106,21627106,21627483,0,0,0,377
18927,21626976,21626976,21627514,0,0,0,538
18926,21626962,21626962,21627521,0,0,0,559
18919,21625014,21625014,21628728,0,0,0,3714
18843,21573499,21574182,21630135,0,0,683,56636
18938,21630142,21630142,21630460,0,0,0,318
18921,21626178,21626178,21630967,0,0,0,4789
18939,21630402,21630402,21631417,0,0,0,1015
18935,21628665,21628665,21632413,0,0,0,3748
18942,21632339,21632339,21633096,0,0,0,757
18945,21633685,21633685,21634101,0,0,0,416
18946,21634069,21634069,21634194,0,0,0,125
18947,21634076,21634076,21634216,0,0,0,140
18949,21634097,21634097,21634216,0,0,0,119
18948,21634082,21634082,21634222,0,0,0,140
18951,21634118,21634118,21634247,0,0,0,129
18950,21634104,21634104,21634254,0,0,0,150
18953,21634305,21634305,21634383,0,0,0,78
18955,21634326,21634326,21634383,0,0,0,57
18954,21634312,21634312,21634390,0,0,0,78
18952,21634297,21634297,21634391,0,0,0,94
18842,21573078,21573170,21634392,0,0,92,61314
18956,21634335,21634335,21634392,0,0,0,57
18957,21634347,21634347,21634414,0,0,0,67
18959,21634428,21634428,21634968,0,0,0,540
18958,21634421,21634421,21635003,0,0,0,582
18961,21634440,21634440,21635021,0,0,0,581
18963,21634455,21634455,21635036,0,0,0,581
18960,21634434,21634434,21635046,0,0,0,612
18962,21634449,21634449,21635061,0,0,0,612
18964,21634897,21634897,21635216,0,0,0,319
18940,21630906,21630906,21635627,0,0,0,4721
18902,21615317,21615317,21635768,0,0,0,20451
18895,21606522,21606522,21635875,0,0,0,29353
18970,21635876,21635876,21636005,0,0,0,129
18943,21632350,21632350,21636090,0,0,0,3740
18900,21612271,21612271,21636253,0,0,0,23982
18905,21618066,21618066,21638448,0,0,0,20382
18820,21564169,21564169,21639211,0,0,0,75042
18977,21639199,21639199,21639329,0,0,0,130
18975,21637454,21639211,21639711,0,0,1757,2257
18971,21636028,21636028,21639773,0,0,0,3745
18967,21635569,21635569,21640343,0,0,0,4774
18819,21564153,21564153,21641432,0,0,0,77279
18978,21639710,21639710,21643610,0,0,0,3900
18918,21623616,21623616,21644529,0,0,0,20913
18979,21640275,21640275,21645097,0,0,0,4822
18983,21645377,21645377,21645455,0,0,0,78
18909,21619681,21619681,21645599,0,0,0,25918
18985,21645501,21645501,21646229,0,0,0,728
18920,21625548,21625548,21646321,0,0,0,20773
18984,21645488,21645488,21646323,0,0,0,835
18987,21645604,21645604,21646337,0,0,0,733
18916,21622390,21622390,21646422,0,0,0,24032
18912,21620730,21620730,21646495,0,0,0,25765
18990,21646381,21646381,21646521,0,0,0,140
18980,21643550,21643550,21647344,0,0,0,3794
18208,21306754,21388167,21647367,0,0,81413,340613
18993,21647621,21647621,21647699,0,0,0,78
18994,21647713,21647713,21647892,0,0,0,179
18997,21647806,21647806,21647927,0,0,0,121
18998,21647824,21647824,21647929,0,0,0,105
18999,21647849,21647849,21648046,0,0,0,197
19000,21647862,21647862,21648089,0,0,0,227
18915,21621789,21621789,21648090,0,0,0,26301
19001,21648015,21648015,21648090,0,0,0,75
19003,21648042,21648042,21648121,0,0,0,79
19004,21648054,21648054,21648122,0,0,0,68
18995,21647741,21647741,21648125,0,0,0,384
19005,21648125,21648125,21648194,0,0,0,69
19006,21648129,21648129,21648237,0,0,0,108
19009,21648222,21648222,21648275,0,0,0,53
19007,21648166,21648166,21648277,0,0,0,111
19008,21648202,21648202,21648300,0,0,0,98
19010,21648240,21648240,21648307,0,0,0,67
19011,21648359,21648359,21648442,0,0,0,83
19012,21648394,21648394,21648476,0,0,0,82
19013,21648457,21648457,21648515,0,0,0,58
19014,21648478,21648478,21648545,0,0,0,67
19015,21648588,21648588,21648819,0,0,0,231
19025,21648775,21648775,21648879,0,0,0,104
18917,21622865,21622865,21649150,0,0,0,26285
19027,21648891,21648891,21649278,0,0,0,387
19016,21648639,21648639,21649356,0,0,0,717
19017,21648654,21648654,21649386,0,0,0,732
19018,21648670,21648670,21649388,0,0,0,718
19019,21648687,21648687,21649405,0,0,0,718
19020,21648703,21648703,21649425,0,0,0,722
18911,21619998,21619998,21649428,0,0,0,29430
19022,21648735,21648735,21649443,0,0,0,708
19021,21648717,21648717,21649452,0,0,0,735
19024,21648766,21648766,21649499,0,0,0,733
19026,21648787,21648787,21649500,0,0,0,713
18982,21645057,21645057,21649884,0,0,0,4827
19030,21649213,21649213,21649949,0,0,0,736
19031,21649219,21649356,21650111,0,0,137,892
19033,21649232,21649388,21650137,0,0,156,905
19023,21648751,21648751,21650173,0,0,0,1422
19038,21650128,21650128,21650252,0,0,0,124
18221,21307158,21391081,21650281,0,0,83923,343123
18944,21633149,21633149,21650376,0,0,0,17227
19029,21649203,21649203,21650652,0,0,0,1449
19039,21650602,21650602,21650731,0,0,0,129
19032,21649226,21649386,21650859,0,0,160,1633
19040,21650817,21650817,21650876,0,0,0,59
19041,21650840,21650840,21650970,0,0,0,130
18992,21647280,21647280,21651072,0,0,0,3792
19043,21651071,21651071,21651211,0,0,0,140
19044,21651678,21651678,21652050,0,0,0,372
19046,21653264,21653264,21653404,0,0,0,140
19045,21653115,21653115,21653437,0,0,0,322
19036,21649632,21649632,21654328,0,0,0,4696
19047,21654037,21654037,21654378,0,0,0,341
19037,21649825,21649825,21654669,0,0,0,4844
19042,21651029,21651029,21654877,0,0,0,3848
19051,21655579,21655579,21655692,0,0,0,113
19052,21655635,21655635,21655697,0,0,0,62
19053,21655660,21655660,21655728,0,0,0,68
19054,21655729,21655729,21655796,0,0,0,67
19034,21649324,21649405,21655855,0,0,81,6531
19055,21655804,21655804,21655882,0,0,0,78
19056,21655991,21655991,21656059,0,0,0,68
19057,21656066,21656066,21656133,0,0,0,67
19058,21656139,21656139,21656200,0,0,0,61
19059,21656173,21656173,21656252,0,0,0,79
19060,21656209,21656209,21656283,0,0,0,74
18968,21635709,21635709,21656327,0,0,0,20618
19062,21656232,21656232,21656365,0,0,0,133
19050,21655437,21655437,21656368,0,0,0,931
19061,21656230,21656230,21656938,0,0,0,708
19063,21656241,21656241,21656977,0,0,0,736
19066,21656306,21656306,21657021,0,0,0,715
19065,21656297,21656297,21657041,0,0,0,744
19069,21656694,21656694,21657053,0,0,0,359
19067,21656319,21656319,21657054,0,0,0,735
19068,21656325,21656325,21657058,0,0,0,733
19070,21657271,21657271,21657404,0,0,0,133
19072,21657377,21657377,21657444,0,0,0,67
19077,21657602,21657602,21658378,0,0,0,776
18965,21635051,21635051,21658407,0,0,0,23356
19049,21654817,21654817,21658668,0,0,0,3851
18976,21638378,21638378,21658918,0,0,0,20540
19071,21657320,21657320,21658981,0,0,0,1661
19048,21654600,21654600,21659345,0,0,0,4745
19080,21659022,21659022,21659374,0,0,0,352
18972,21636201,21636201,21660127,0,0,0,23926
18941,21631348,21631348,21660130,0,0,0,28782
19082,21660022,21660022,21660324,0,0,0,302
19084,21660437,21660437,21660685,0,0,0,248
18937,21630013,21630013,21660759,0,0,0,30746
18825,21564587,21564587,21660883,0,0,0,96296
19085,21660694,21660694,21661202,0,0,0,508
19087,21661534,21661534,21662092,0,0,0,558
19078,21658627,21658627,21662488,0,0,0,3861
19089,21662807,21662807,21663128,0,0,0,321
19081,21659285,21659285,21663960,0,0,0,4675
19090,21663791,21663791,21664253,0,0,0,462
18969,21635832,21635832,21664448,0,0,0,28616
19092,21664603,21664603,21664904,0,0,0,301
18981,21644471,21644471,21665479,0,0,0,21008
19095,21665709,21665709,21665969,0,0,0,260
19088,21662435,21662435,21666271,0,0,0,3836
19096,21665981,21665981,21666395,0,0,0,414
18988,21646254,21646254,21667205,0,0,0,20951
19093,21664830,21664830,21669520,0,0,0,4690
19098,21666448,21666448,21670048,0,0,0,3600
19097,21666229,21666229,21670168,0,0,0,3939
18989,21646375,21646375,21670507,0,0,0,24132
18986,21645536,21645536,21671556,0,0,0,26020
18861,21583655,21583655,21671836,0,0,0,88181
18865,21584326,21584326,21671836,0,0,0,87510
18867,21584868,21584868,21671836,0,0,0,86968
18866,21584636,21584636,21671856,0,0,0,87220
18850,21574931,21574931,21671865,0,0,0,96934
18868,21585100,21585100,21671866,0,0,0,86766
18863,21583974,21583974,21671897,0,0,0,87923
18874,21590406,21590406,21672115,0,0,0,81709
18882,21595171,21595538,21672166,0,0,367,76995
18991,21646429,21646429,21672555,0,0,0,26126
19105,21672558,21672558,21672729,0,0,0,171
19106,21672668,21672668,21672835,0,0,0,167
19114,21672767,21672767,21672937,0,0,0,170
19102,21670100,21670100,21673980,0,0,0,3880
19101,21669460,21669460,21674126,0,0,0,4666
19002,21648031,21648031,21674418,0,0,0,26387
19116,21673293,21673293,21674896,0,0,0,1603
19119,21673536,21673536,21675021,0,0,0,1485
19118,21673418,21673418,21675083,0,0,0,1665
19028,21649085,21649085,21675264,0,0,0,26179
19064,21656253,21656253,21676657,0,0,0,20404
19117,21673329,21673329,21677817,0,0,0,4488
19120,21673922,21673922,21677824,0,0,0,3902
19121,21674063,21674063,21678664,0,0,0,4601
19035,21649383,21649405,21679209,0,0,22,29826
19079,21658882,21658882,21679435,0,0,0,20553
18387,21335504,21335504,21681104,0,0,0,345600
19126,21677779,21677779,21681731,0,0,0,3952
19127,21678620,21678620,21683207,0,0,0,4587
19083,21660082,21660082,21684164,0,0,0,24082
19133,21683564,21683564,21684758,0,0,0,1194
19123,21675163,21675163,21684849,0,0,0,9686
19137,21685501,21685501,21685616,0,0,0,115
19130,21681665,21681665,21685619,0,0,0,3954
19094,21665418,21665418,21686188,0,0,0,20770
19135,21684765,21684765,21686342,0,0,0,1577
19139,21685596,21685596,21686746,0,0,0,1150
19073,21657512,21657512,21687328,0,0,0,29816
19076,21657570,21657570,21687344,0,0,0,29774
19131,21683146,21683146,21687757,0,0,0,4611
19100,21667209,21667209,21688165,0,0,0,20956
19075,21657527,21657527,21688800,0,0,0,31273
19138,21685577,21685577,21689532,0,0,0,3955
19074,21657520,21657520,21690066,0,0,0,32546
19142,21687690,21687690,21692285,0,0,0,4595
19144,21689477,21689477,21693383,0,0,0,3906
19091,21664383,21664383,21694319,0,0,0,29936
19103,21670492,21670492,21694530,0,0,0,24038
19145,21692221,21692221,21696790,0,0,0,4569
19125,21676619,21676619,21697229,0,0,0,20610
19146,21693320,21693320,21697260,0,0,0,3940
19104,21671556,21671556,21697364,0,0,0,25808
19115,21672880,21672880,21698720,0,0,0,25840
19129,21679375,21679375,21699722,0,0,0,20347
19122,21674432,21674432,21700840,0,0,0,26408
19151,21697198,21697198,21701167,0,0,0,3969
19149,21696750,21696750,21701341,0,0,0,4591
19124,21675284,21675284,21701373,0,0,0,26089
18834,21567557,21572295,21703316,0,0,4738,135759
19156,21701104,21701104,21705050,0,0,0,3946
18590,21404167,21404205,21705243,0,0,38,301076
19157,21701303,21701303,21705883,0,0,0,4580
18851,21574932,21574932,21706754,0,0,0,131822
19140,21686125,21686125,21707072,0,0,0,20947
19134,21684219,21684219,21708148,0,0,0,23929
19128,21679161,21679161,21708646,0,0,0,29485
19143,21688102,21688102,21708822,0,0,0,20720
19159,21704978,21704978,21708894,0,0,0,3916
19168,21709896,21709896,21709963,0,0,0,67
19160,21705820,21705820,21710378,0,0,0,4558
19170,21710726,21710726,21711142,0,0,0,416
19165,21708842,21708842,21712717,0,0,0,3875
19173,21713134,21713134,21713352,0,0,0,218
19169,21710333,21710333,21714902,0,0,0,4569
19176,21714710,21714710,21715460,0,0,0,750
19182,21715314,21715314,21715460,0,0,0,146
19177,21714725,21714725,21715464,0,0,0,739
19178,21714745,21714745,21715493,0,0,0,748
19183,21715366,21715366,21715495,0,0,0,129
19179,21714756,21714756,21715562,0,0,0,806
19180,21714768,21714768,21715574,0,0,0,806
19185,21715531,21715531,21715621,0,0,0,90
19184,21715498,21715498,21715644,0,0,0,146
19186,21715585,21715585,21715653,0,0,0,68
19187,21715684,21715684,21715751,0,0,0,67
19192,21715847,21715847,21715940,0,0,0,93
19172,21712653,21712653,21716540,0,0,0,3887
19199,21716665,21716665,21717259,0,0,0,594
19198,21716659,21716659,21717456,0,0,0,797
19193,21715854,21715854,21717490,0,0,0,1636
19150,21697142,21697142,21717522,0,0,0,20380
19148,21694467,21694467,21718398,0,0,0,23931
19181,21714861,21714861,21719360,0,0,0,4499
19194,21715995,21715995,21719560,0,0,0,3565
19166,21709036,21709036,21719836,0,0,0,10800
19205,21719876,21719876,21719978,0,0,0,102
19190,21715833,21715833,21719980,0,0,0,4147
19191,21715841,21715841,21719988,0,0,0,4147
19207,21719945,21719945,21720013,0,0,0,68
19208,21720035,21720035,21720101,0,0,0,66
19210,21720060,21720060,21720143,0,0,0,83
19211,21720109,21720109,21720187,0,0,0,78
19154,21699651,21699651,21720211,0,0,0,20560
19197,21716480,21716480,21720356,0,0,0,3876
19214,21720816,21720816,21720894,0,0,0,78
19189,21715827,21715827,21721325,0,0,0,5498
19216,21721473,21721473,21721554,0,0,0,81
19215,21721138,21721138,21721667,0,0,0,529
19217,21721492,21721492,21721859,0,0,0,367
19230,21722746,21722746,21722783,0,0,0,37
18973,21636515,21636515,21722915,0,0,0,86400
19232,21723012,21723012,21723059,0,0,0,47
18974,21636741,21636741,21723141,0,0,0,86400
19233,21723408,21723408,21723492,0,0,0,84
19152,21697295,21697295,21723515,0,0,0,26220
19235,21723554,21723554,21723680,0,0,0,126
19234,21723460,21723460,21723684,0,0,0,224
19147,21694257,21694257,21723686,0,0,0,29429
19236,21723637,21723637,21723809,0,0,0,172
19204,21719320,21719320,21723879,0,0,0,4559
19188,21715800,21715800,21724072,0,0,0,8272
19213,21720290,21720290,21724145,0,0,0,3855
19153,21698656,21698656,21724764,0,0,0,26108
19221,21722343,21722343,21725607,0,0,0,3264
19202,21718409,21718409,21725663,0,0,0,7254
19238,21723710,21723710,21726468,0,0,0,2758
19209,21720053,21720053,21726799,0,0,0,6746
19155,21700781,21700781,21727067,0,0,0,26286
19243,21726321,21726321,21727137,0,0,0,816
19228,21722711,21722711,21727556,0,0,0,4845
19229,21722720,21722720,21727565,0,0,0,4845
19158,21701308,21701308,21727571,0,0,0,26263
19227,21722704,21722704,21727580,0,0,0,4876
19240,21724078,21724078,21727828,0,0,0,3750
19161,21707026,21707026,21727970,0,0,0,20944
19239,21723827,21723827,21728418,0,0,0,4591
19244,21726588,21726588,21728756,0,0,0,2168
19164,21708766,21708766,21729682,0,0,0,20916
19220,21721991,21721991,21730761,0,0,0,8770
19167,21709271,21709271,21730871,0,0,0,21600
18806,21558430,21558430,21731230,0,0,0,172800
19252,21731182,21731182,21731306,0,0,0,124
19203,21719092,21719092,21731424,0,0,0,12332
19247,21727792,21727792,21731624,0,0,0,3832
19226,21722630,21722630,21731656,0,0,0,9026
19219,21721972,21721972,21731885,0,0,0,9913
19162,21708106,21708106,21731964,0,0,0,23858
19218,21721941,21721941,21732247,0,0,0,10306
19223,21722365,21722365,21732359,0,0,0,9994
19224,21722378,21722378,21732394,0,0,0,10016
19249,21728356,21728356,21732891,0,0,0,4535
19258,21733380,21733380,21734514,0,0,0,1134
19222,21722347,21722347,21734527,0,0,0,12180
19253,21731625,21731625,21735399,0,0,0,3774
19260,21735795,21735795,21736395,0,0,0,600
19261,21735795,21735795,21736395,0,0,0,600
19262,21735796,21735796,21736396,0,0,0,600
19263,21735796,21735796,21736396,0,0,0,600
19264,21735796,21735796,21736396,0,0,0,600
19265,21735797,21735797,21736397,0,0,0,600
19266,21735799,21735799,21736399,0,0,0,600
19267,21735799,21735799,21736399,0,0,0,600
19268,21735799,21735799,21736399,0,0,0,600
19269,21735800,21735800,21736400,0,0,0,600
19270,21735800,21735800,21736400,0,0,0,600
19271,21735800,21735800,21736400,0,0,0,600
19272,21735800,21735800,21736400,0,0,0,600
19273,21735800,21735800,21736400,0,0,0,600
19274,21735801,21735801,21736401,0,0,0,600
19275,21735801,21735801,21736401,0,0,0,600
19276,21735801,21735801,21736401,0,0,0,600
19277,21735801,21735801,21736401,0,0,0,600
19278,21735801,21735801,21736401,0,0,0,600
19279,21735802,21735802,21736402,0,0,0,600
19280,21735802,21735802,21736402,0,0,0,600
19281,21735802,21735802,21736402,0,0,0,600
19282,21735802,21735802,21736402,0,0,0,600
19283,21735803,21735803,21736403,0,0,0,600
19196,21716154,21716154,21736709,0,0,0,20555
19286,21736974,21736974,21737093,0,0,0,119
19195,21716044,21716044,21737143,0,0,0,21099
19257,21732891,21732891,21737427,0,0,0,4536
18996,21647802,21647802,21737961,0,0,0,90159
19200,21717462,21717462,21738030,0,0,0,20568
19206,21719890,21719890,21738658,0,0,0,18768
19163,21708593,21708593,21738686,0,0,0,30093
19259,21735338,21735338,21739119,0,0,0,3781
19284,21735988,21735988,21740677,0,0,0,4689
19212,21720156,21720156,21740732,0,0,0,20576
19291,21740271,21740271,21741432,0,0,0,1161
19256,21732154,21732154,21742126,0,0,0,9972
19287,21737427,21737427,21742202,0,0,0,4775
19201,21718351,21718351,21742266,0,0,0,23915
19086,21660742,21660742,21742724,0,0,0,81982
19290,21739108,21739108,21742840,0,0,0,3732
19297,21742763,21742763,21743363,0,0,0,600
19298,21742769,21742769,21743369,0,0,0,600
19299,21742769,21742769,21743369,0,0,0,600
19300,21742769,21742769,21743369,0,0,0,600
19301,21742770,21742770,21743370,0,0,0,600
19302,21742770,21742770,21743370,0,0,0,600
19303,21742770,21742770,21743370,0,0,0,600
19304,21742770,21742770,21743370,0,0,0,600
19305,21742771,21742771,21743371,0,0,0,600
19306,21742771,21742771,21743371,0,0,0,600
19307,21742771,21742771,21743371,0,0,0,600
19308,21742771,21742771,21743371,0,0,0,600
19309,21742772,21742772,21743372,0,0,0,600
19310,21742772,21742772,21743372,0,0,0,600
19311,21742772,21742772,21743372,0,0,0,600
19312,21742772,21742772,21743372,0,0,0,600
19313,21742773,21742773,21743373,0,0,0,600
19314,21742773,21742773,21743373,0,0,0,600
19315,21742773,21742773,21743373,0,0,0,600
19316,21742774,21742774,21743374,0,0,0,600
19317,21742774,21742774,21743374,0,0,0,600
19318,21742774,21742774,21743374,0,0,0,600
19319,21742774,21742774,21743374,0,0,0,600
19320,21742774,21742774,21743374,0,0,0,600
19321,21742775,21742775,21743375,0,0,0,600
19322,21742775,21742775,21743375,0,0,0,600
19323,21742775,21742775,21743375,0,0,0,600
19324,21742775,21742775,21743375,0,0,0,600
19325,21742775,21742775,21743375,0,0,0,600
19326,21742776,21742776,21743376,0,0,0,600
19327,21742776,21742776,21743376,0,0,0,600
19328,21742776,21742776,21743376,0,0,0,600
19330,21743643,21743643,21743768,0,0,0,125
19331,21743794,21743794,21743919,0,0,0,125
19332,21743803,21743803,21744217,0,0,0,414
19333,21743962,21743962,21744228,0,0,0,266
19295,21742567,21742567,21744643,0,0,0,2076
19334,21745517,21745517,21745584,0,0,0,67
19336,21745611,21745611,21745714,0,0,0,103
19338,21745677,21745677,21745776,0,0,0,99
19337,21745659,21745659,21745777,0,0,0,118
19339,21745720,21745720,21745803,0,0,0,83
19340,21745741,21745741,21745808,0,0,0,67
19341,21745819,21745819,21745918,0,0,0,99
19342,21745851,21745851,21745936,0,0,0,85
19343,21745897,21745897,21745976,0,0,0,79
19344,21745918,21745918,21745976,0,0,0,58
19345,21745940,21745940,21746007,0,0,0,67
19356,21746175,21746175,21746330,0,0,0,155
19329,21742871,21742871,21746553,0,0,0,3682
19285,21736031,21736031,21746864,0,0,0,10833
19296,21742751,21742751,21747367,0,0,0,4616
19364,21747551,21747551,21747644,0,0,0,93
19365,21747764,21747764,21747857,0,0,0,93
19352,21746147,21746147,21748474,0,0,0,2327
19248,21727911,21727911,21748602,0,0,0,20691
18580,21403157,21403157,21748757,0,0,0,345600
19237,21723659,21723659,21749413,0,0,0,25754
19370,21750012,21750012,21750207,0,0,0,195
19360,21746488,21746488,21750210,0,0,0,3722
19372,21750182,21750182,21750379,0,0,0,197
19374,21750375,21750375,21750543,0,0,0,168
19242,21724697,21724697,21750549,0,0,0,25852
19293,21741797,21741797,21750557,0,0,0,8760
19251,21729636,21729636,21750576,0,0,0,20940
19375,21750572,21750572,21750751,0,0,0,179
19377,21750776,21750776,21750900,0,0,0,124
19376,21750740,21750740,21750908,0,0,0,168
19367,21749057,21749057,21751812,0,0,0,2755
19383,21753069,21753069,21753277,0,0,0,208
19380,21752014,21752014,21753311,0,0,0,1297
19384,21753219,21753219,21753386,0,0,0,167
19385,21753324,21753324,21753500,0,0,0,176
19245,21726980,21726980,21753511,0,0,0,26531
19371,21750126,21750126,21753878,0,0,0,3752
19171,21710735,21710735,21753935,0,0,0,43200
19241,21724257,21724257,21753994,0,0,0,29737
19246,21727515,21727515,21754013,0,0,0,26498
19361,21747305,21747305,21754505,0,0,0,7200
19368,21749710,21749710,21755659,0,0,0,5949
19255,21731907,21731907,21755693,0,0,0,23786
19335,21745585,21745585,21755991,0,0,0,10406
19388,21753815,21753815,21757553,0,0,0,3738
19392,21755076,21755659,21757735,0,0,583,2659
19288,21738034,21738034,21758587,0,0,0,20553
18936,21629873,21629873,21759875,0,0,0,130002
19394,21755171,21759875,21760198,0,0,4704,5027
19395,21755176,21760198,21760417,0,0,5022,5241
19292,21740734,21740734,21761204,0,0,0,20470
19398,21757512,21757512,21761225,0,0,0,3713
19351,21746139,21746139,21761365,0,0,0,15226
19346,21746099,21746099,21761730,0,0,0,15631
19348,21746117,21746117,21761809,0,0,0,15692
19357,21746183,21746183,21761827,0,0,0,15644
19349,21746125,21746125,21761888,0,0,0,15763
19347,21746110,21746110,21762030,0,0,0,15920
19350,21746132,21746132,21762050,0,0,0,15918
19355,21746169,21746169,21762124,0,0,0,15955
19353,21746155,21746155,21762172,0,0,0,16017
19359,21746375,21746375,21762237,0,0,0,15862
19358,21746345,21746345,21762238,0,0,0,15893
19354,21746162,21746162,21762427,0,0,0,16265
19400,21759421,21761809,21763029,0,0,2388,3608
19412,21763087,21763087,21763191,0,0,0,104
19410,21762845,21762845,21764165,0,0,0,1320
19407,21761171,21761171,21764918,0,0,0,3747
19415,21763328,21763328,21765282,0,0,0,1954
19294,21742248,21742248,21766074,0,0,0,23826
19289,21738639,21738639,21768433,0,0,0,29794
19418,21764857,21764857,21768589,0,0,0,3732
19419,21765654,21765654,21769332,0,0,0,3678
19423,21770440,21770440,21770612,0,0,0,172
19424,21770549,21770549,21770717,0,0,0,168
19373,21750330,21750330,21771273,0,0,0,20943
19421,21768526,21768526,21772300,0,0,0,3774
19382,21752380,21752380,21773277,0,0,0,20897
19427,21772257,21772257,21776182,0,0,0,3925
19378,21750919,21750919,21777309,0,0,0,26390
19430,21777302,21777302,21777459,0,0,0,157
19431,21777412,21777412,21777569,0,0,0,157
19432,21777523,21777523,21777700,0,0,0,177
19399,21759191,21759191,21779520,0,0,0,20329
19429,21776119,21776119,21779907,0,0,0,3788
19386,21753432,21753432,21780022,0,0,0,26590
19436,21779959,21779959,21780132,0,0,0,173
19437,21780069,21780069,21780238,0,0,0,169
19438,21780176,21780176,21780343,0,0,0,167
19439,21780282,21780282,21780457,0,0,0,175
19440,21780394,21780394,21780563,0,0,0,169
19389,21754043,21754043,21780702,0,0,0,26659
19390,21754388,21754388,21781335,0,0,0,26947
19408,21761219,21761219,21781647,0,0,0,20428
19435,21779863,21779863,21783630,0,0,0,3767
19391,21754437,21754437,21783920,0,0,0,29483
19446,21783942,21783942,21784119,0,0,0,177
19445,21783571,21783571,21787355,0,0,0,3784
18966,21635517,21635517,21789431,0,0,0,153914
19401,21759483,21762237,21790146,0,0,2754,30663
19420,21766077,21766077,21790273,0,0,0,24196
19448,21787313,21787313,21791126,0,0,0,3813
19426,21771244,21771244,21792191,0,0,0,20947
19402,21759494,21763029,21792791,0,0,3535,33297
19404,21759811,21790146,21793505,0,0,30335,33694
19428,21773215,21773215,21794052,0,0,0,20837
19175,21713227,21713227,21794159,0,0,0,80932
19174,21713196,21713196,21794196,0,0,0,81000
19450,21791072,21791072,21794851,0,0,0,3779
19405,21759832,21792791,21796167,0,0,32959,36335
19409,21761783,21796167,21798288,0,0,34384,36505
19453,21794788,21794788,21798681,0,0,0,3893
19396,21755894,21755894,21799094,0,0,0,43200
19425,21770654,21770654,21799407,0,0,0,28753
19393,21755118,21757735,21799503,0,0,2617,44385
19455,21799345,21799345,21799532,0,0,0,187
19457,21799490,21799490,21799836,0,0,0,346
19434,21779458,21779458,21800006,0,0,0,20548
19458,21799953,21799953,21800011,0,0,0,58
19231,21722936,21722936,21800581,0,0,0,77645
19464,21800853,21800853,21800921,0,0,0,68
19465,21801182,21801182,21801260,0,0,0,78
19469,21801359,21801359,21801441,0,0,0,82
19470,21801410,21801410,21801503,0,0,0,93
19471,21801553,21801553,21801642,0,0,0,89
19472,21801590,21801590,21801674,0,0,0,84
19444,21781576,21781576,21802195,0,0,0,20619
19454,21798640,21798640,21802563,0,0,0,3923
19476,21802500,21802500,21802604,0,0,0,104
19479,21802627,21802627,21802700,0,0,0,73
19480,21802785,21802785,21802879,0,0,0,94
19481,21802977,21802977,21803064,0,0,0,87
19433,21777635,21777635,21803745,0,0,0,26110
19483,21803090,21803090,21804115,0,0,0,1025
19486,21804116,21804116,21804215,0,0,0,99
19487,21804236,21804236,21804296,0,0,0,60
19488,21804264,21804264,21804358,0,0,0,94
19489,21804360,21804360,21804520,0,0,0,160
19490,21804367,21804367,21804802,0,0,0,435
19492,21804708,21804708,21804803,0,0,0,95
19494,21804770,21804803,21804896,0,0,33,126
19495,21804895,21804896,21805011,0,0,1,116
19496,21804977,21805011,21805135,0,0,34,158
19397,21757142,21760417,21805372,0,0,3275,48230
19477,21802528,21802528,21806440,0,0,0,3912
19441,21780500,21780500,21806610,0,0,0,26110
19501,21807067,21807067,21807145,0,0,0,78
19442,21780705,21780705,21807292,0,0,0,26587
19504,21807325,21807325,21807392,0,0,0,67
19443,21781349,21781349,21808059,0,0,0,26710
19493,21804708,21805372,21808744,0,0,664,4036
19508,21808730,21808744,21808804,0,0,14,74
19369,21749734,21749734,21809042,0,0,0,59308
19509,21809236,21809236,21809296,0,0,0,60
19510,21809465,21809465,21809525,0,0,0,60
19511,21809611,21809611,21809671,0,0,0,60
19499,21806381,21806381,21810330,0,0,0,3949
19514,21810362,21810362,21810422,0,0,0,60
19482,21803002,21803002,21812038,0,0,0,9036
19451,21792139,21792139,21812979,0,0,0,20840
19478,21802605,21802605,21813380,0,0,0,10775
19497,21805193,21805193,21813803,0,0,0,8610
19513,21810265,21810265,21814193,0,0,0,3928
19447,21784052,21784052,21814221,0,0,0,30169
19449,21790201,21790201,21814601,0,0,0,24400
19507,21808477,21813803,21814849,0,0,5326,6372
19452,21794005,21794005,21814946,0,0,0,20941
19516,21813848,21814849,21815190,0,0,1001,1342
19524,21815156,21815156,21815223,0,0,0,67
19460,21799980,21799980,21815733,0,0,0,15753
19525,21815294,21815294,21815795,0,0,0,501
19463,21800084,21800084,21815827,0,0,0,15743
19461,21800009,21800009,21815959,0,0,0,15950
19462,21800041,21800041,21816101,0,0,0,16060
19526,21815832,21815832,21816362,0,0,0,530
19468,21801325,21801325,21816919,0,0,0,15594
19528,21816898,21816898,21816972,0,0,0,74
19467,21801317,21801317,21817090,0,0,0,15773
19498,21805471,21808744,21817246,0,0,3273,11775
19473,21801611,21801611,21817249,0,0,0,15638
19475,21802170,21802170,21817893,0,0,0,15723
19517,21814128,21814128,21818059,0,0,0,3931
19535,21818519,21818519,21818579,0,0,0,60
19530,21816990,21816990,21818907,0,0,0,1917
19536,21818829,21818829,21818995,0,0,0,166
19537,21819042,21819042,21819166,0,0,0,124
19539,21819170,21819170,21819274,0,0,0,104
19538,21819167,21819167,21819313,0,0,0,146
19541,21819281,21819281,21819416,0,0,0,135
19542,21819337,21819337,21819417,0,0,0,80
19543,21819380,21819380,21819458,0,0,0,78
19544,21819444,21819444,21819599,0,0,0,155
19545,21819602,21819602,21819662,0,0,0,60
19546,21819608,21819608,21819955,0,0,0,347
19547,21819929,21819929,21820054,0,0,0,125
19548,21820153,21820153,21820268,0,0,0,115
19549,21820165,21820165,21820290,0,0,0,125
19550,21820240,21820240,21820300,0,0,0,60
19459,21799959,21799959,21820487,0,0,0,20528
19553,21820460,21820460,21820553,0,0,0,93
19554,21820737,21820737,21820830,0,0,0,93
19555,21820913,21820913,21821069,0,0,0,156
19529,21816924,21816924,21821717,0,0,0,4793
19557,21821349,21821349,21821721,0,0,0,372
19532,21817990,21817990,21821929,0,0,0,3939
19533,21818069,21821717,21822262,0,0,3648,4193
19531,21817769,21817769,21822520,0,0,0,4751
19474,21802120,21802120,21822586,0,0,0,20466
19561,21822169,21822520,21822646,0,0,351,477
19560,21822062,21822520,21822691,0,0,458,629
19534,21818079,21822262,21822761,0,0,4183,4682
19564,21822802,21822802,21822849,0,0,0,47
19559,21821952,21821952,21822999,0,0,0,1047
19502,21807111,21807111,21823107,0,0,0,15996
19568,21823017,21823017,21823328,0,0,0,311
19569,21823371,21823371,21823467,0,0,0,96
19573,21823482,21823482,21823584,0,0,0,102
19574,21823546,21823546,21823619,0,0,0,73
19576,21823652,21823652,21823767,0,0,0,115
19577,21823759,21823759,21823894,0,0,0,135
19556,21821092,21822520,21824395,0,0,1428,3303
19583,21825591,21825591,21825776,0,0,0,185
19558,21821882,21821882,21825837,0,0,0,3955
19570,21823406,21823406,21826059,0,0,0,2653
19584,21825759,21825776,21826108,0,0,17,349
19586,21826103,21826108,21826248,0,0,5,145
19587,21826271,21826271,21826338,0,0,0,67
19588,21826365,21826365,21826459,0,0,0,94
19589,21826480,21826480,21826604,0,0,0,124
19581,21824408,21824408,21826666,0,0,0,2258
18833,21567551,21567551,21826751,0,0,0,259200
19590,21826714,21826714,21826807,0,0,0,93
19591,21826821,21826821,21826925,0,0,0,104
19592,21826892,21826892,21827001,0,0,0,109
19593,21826973,21826973,21827385,0,0,0,412
19596,21827331,21827331,21827424,0,0,0,93
19595,21827120,21827120,21827480,0,0,0,360
19540,21819246,21819274,21827656,0,0,28,8410
19580,21824190,21824190,21827790,0,0,0,3600
19456,21799453,21799453,21828131,0,0,0,28678
19600,21828552,21828552,21828807,0,0,0,255
19578,21824027,21824027,21829434,0,0,0,5407
19604,21829108,21829108,21829570,0,0,0,462
19582,21825236,21826059,21829659,0,0,823,4423
19585,21825776,21825837,21829787,0,0,61,4011
19485,21803691,21803691,21830066,0,0,0,26375
19606,21829887,21829887,21830501,0,0,0,614
19579,21824111,21824111,21830506,0,0,0,6395
19518,21814135,21815190,21830947,0,0,1055,16812
19611,21831763,21831763,21832400,0,0,0,637
19491,21804553,21804553,21832551,0,0,0,27998
19610,21831269,21831269,21832865,0,0,0,1596
19500,21806537,21806537,21832989,0,0,0,26452
19614,21833479,21833479,21833568,0,0,0,89
19605,21829660,21829660,21833573,0,0,0,3913
19515,21812934,21812934,21833796,0,0,0,20862
19503,21807229,21807292,21833910,0,0,63,26681
19618,21833801,21833801,21833930,0,0,0,129
19619,21833944,21833944,21834011,0,0,0,67
19594,21827048,21827048,21834338,0,0,0,7290
19505,21807983,21808059,21834784,0,0,76,26801
19622,21834990,21834990,21835130,0,0,0,140
19551,21820293,21820293,21835575,0,0,0,15282
19521,21814870,21814870,21835726,0,0,0,20856
19598,21828091,21828091,21836527,0,0,0,8436
19599,21828247,21828247,21836802,0,0,0,8555
19466,21801309,21801309,21836868,0,0,0,35559
19563,21822536,21822536,21836869,0,0,0,14333
19506,21808435,21809042,21836990,0,0,607,28555
19623,21835385,21835385,21836992,0,0,0,1607
19615,21833529,21833529,21837471,0,0,0,3942
19520,21814567,21814567,21838527,0,0,0,23960
19552,21820455,21820455,21840945,0,0,0,20490
18835,21567563,21581829,21841029,0,0,14266,273466
19625,21837411,21837411,21841328,0,0,0,3917
19562,21822534,21822534,21842677,0,0,0,20143
19519,21814165,21814165,21843886,0,0,0,29721
19630,21843823,21843823,21843997,0,0,0,174
19631,21843935,21843935,21844113,0,0,0,178
19632,21844042,21844042,21844211,0,0,0,169
19633,21844157,21844157,21844336,0,0,0,179
19575,21823609,21841029,21844705,0,0,17420,21096
19628,21841257,21841257,21845175,0,0,0,3918
19636,21845470,21845470,21847103,0,0,0,1633
19403,21759596,21789431,21848221,0,0,29835,88625
19572,21823427,21836990,21848856,0,0,13563,25429
19635,21845141,21845141,21849050,0,0,0,3909
19512,21810072,21810072,21851741,0,0,0,41669
19608,21831170,21831170,21852770,0,0,0,21600
19637,21848979,21848979,21852827,0,0,0,3848
19639,21854097,21854097,21854697,0,0,0,600
19616,21833710,21833796,21854720,0,0,86,21010
19641,21854148,21854148,21854748,0,0,0,600
19643,21854212,21854212,21854812,0,0,0,600
19644,21854560,21854560,21855316,0,0,0,756
19624,21835746,21835746,21856362,0,0,0,20616
19645,21854575,21855316,21856403,0,0,741,1828
19607,21830004,21830066,21856515,0,0,62,26511
19648,21856389,21856389,21856594,0,0,0,205
19638,21852794,21852794,21856686,0,0,0,3892
19597,21828068,21828068,21857042,0,0,0,28974
19609,21831217,21836802,21858402,0,0,5585,27185
19613,21832958,21832989,21859346,0,0,31,26388
19655,21858709,21858709,21860292,0,0,0,1583
19651,21856643,21856643,21860462,0,0,0,3819
19617,21833764,21833910,21860927,0,0,146,27163
19484,21803436,21803436,21861032,0,0,0,57596
19621,21834638,21834638,21861064,0,0,0,26426
19627,21840882,21840882,21861333,0,0,0,20451
19571,21823411,21832551,21862032,0,0,9140,38621
19626,21838508,21838508,21862306,0,0,0,23798
19629,21842638,21842638,21862966,0,0,0,20328
19657,21860401,21860401,21864218,0,0,0,3817
19660,21861650,21861650,21866593,0,0,0,4943
19664,21864172,21864172,21868009,0,0,0,3837
19665,21867973,21867973,21871790,0,0,0,3817
19634,21844273,21844273,21872939,0,0,0,28666
19667,21872896,21872896,21873073,0,0,0,177
19666,21871757,21871757,21875494,0,0,0,3737
19646,21854629,21854629,21875526,0,0,0,20897
19406,21759844,21793505,21876737,0,0,33661,116893
19642,21854154,21854154,21877803,0,0,0,23649
19654,21857223,21857223,21878021,0,0,0,20798
19653,21857049,21876737,21878627,0,0,19688,21578
19669,21875450,21875450,21879273,0,0,0,3823
19659,21861270,21861270,21881826,0,0,0,20556
19650,21856540,21856540,21882841,0,0,0,26301
19674,21882799,21882799,21882950,0,0,0,151
19672,21879214,21879214,21882992,0,0,0,3778
19663,21862906,21862906,21883542,0,0,0,20636
19652,21856990,21856990,21885549,0,0,0,28559
19656,21859292,21859292,21885656,0,0,0,26364
19679,21885597,21885597,21885767,0,0,0,170
19680,21885705,21885705,21885873,0,0,0,168
19662,21862237,21862237,21886186,0,0,0,23949
19676,21882924,21882924,21886636,0,0,0,3712
19612,21832358,21832400,21887019,0,0,42,54661
19620,21834050,21834338,21887106,0,0,288,53056
19658,21860717,21860717,21887207,0,0,0,26490
19565,21822849,21822849,21887451,0,0,0,64602
19685,21887593,21887593,21887661,0,0,0,68
19686,21887773,21887773,21887903,0,0,0,130
19687,21888560,21888560,21888689,0,0,0,129
19661,21862165,21862165,21889018,0,0,0,26853
19689,21888946,21888946,21889066,0,0,0,120
19691,21889084,21889084,21889214,0,0,0,130
19688,21888858,21888858,21889458,0,0,0,600
19692,21890032,21890032,21890343,0,0,0,311
19683,21886579,21886579,21890376,0,0,0,3797
19695,21890458,21890458,21890525,0,0,0,67
19601,21828724,21828724,21891110,0,0,0,62386
19566,21822883,21822883,21891223,0,0,0,68340
19698,21892320,21892320,21892398,0,0,0,78
19700,21892733,21892733,21892848,0,0,0,115
19647,21856370,21856403,21893057,0,0,33,36687
19697,21892222,21892222,21893097,0,0,0,875
19704,21892995,21892995,21893104,0,0,0,109
19699,21892667,21892667,21893267,0,0,0,600
19705,21893072,21893072,21893368,0,0,0,296
19702,21892935,21892935,21893535,0,0,0,600
19708,21893689,21893689,21893749,0,0,0,60
19706,21893263,21893263,21893863,0,0,0,600
19709,21893721,21893721,21893867,0,0,0,146
19707,21893447,21893447,21894047,0,0,0,600
19693,21890314,21890314,21894059,0,0,0,3745
19712,21894097,21894097,21894188,0,0,0,91
19713,21894275,21894275,21894342,0,0,0,67
19715,21894834,21894834,21895140,0,0,0,306
19717,21895098,21895098,21895238,0,0,0,140
19718,21895102,21895102,21895282,0,0,0,180
19719,21895257,21895257,21895373,0,0,0,116
19720,21895342,21895342,21895436,0,0,0,94
19721,21895435,21895435,21895557,0,0,0,122
19722,21895526,21895526,21895620,0,0,0,94
19710,21893867,21893867,21895667,0,0,0,1800
19723,21895669,21895669,21895949,0,0,0,280
19670,21875455,21875455,21895998,0,0,0,20543
19726,21895966,21895966,21896033,0,0,0,67
19714,21894393,21894393,21896193,0,0,0,1800
19727,21896172,21896172,21896266,0,0,0,94
19728,21896272,21896272,21896339,0,0,0,67
19724,21895737,21895737,21896471,0,0,0,734
19729,21896401,21896401,21896536,0,0,0,135
19716,21895075,21895075,21896875,0,0,0,1800
19730,21896786,21896786,21896891,0,0,0,105
19711,21893998,21893998,21897709,0,0,0,3711
19733,21898477,21898477,21898607,0,0,0,130
19671,21877955,21877955,21898902,0,0,0,20947
19737,21899162,21899162,21899447,0,0,0,285
19736,21898910,21898910,21899851,0,0,0,941
19649,21856422,21862032,21899958,0,0,5610,43536
19734,21898622,21898622,21900422,0,0,0,1800
19738,21900784,21900784,21900852,0,0,0,68
19739,21901012,21901012,21901110,0,0,0,98
19740,21901196,21901196,21901294,0,0,0,98
19731,21897638,21897638,21901363,0,0,0,3725
19668,21873006,21873006,21901396,0,0,0,28390
19741,21901340,21901340,21901512,0,0,0,172
19742,21901450,21901450,21901622,0,0,0,172
19743,21901560,21901560,21901729,0,0,0,169
19746,21901822,21901822,21901900,0,0,0,78
19673,21881764,21881764,21902304,0,0,0,20540
19747,21902229,21902229,21902398,0,0,0,169
19749,21902247,21902247,21902425,0,0,0,178
19750,21902261,21902261,21902427,0,0,0,166
19752,21902477,21902477,21902545,0,0,0,68
19753,21902657,21902657,21902725,0,0,0,68
19754,21903092,21903092,21903170,0,0,0,78
19694,21890374,21890374,21903327,0,0,0,12953
19703,21892942,21892942,21903742,0,0,0,10800
19757,21903789,21903789,21903871,0,0,0,82
19677,21883480,21883480,21904176,0,0,0,20696
19756,21903562,21903562,21904338,0,0,0,776
19759,21904401,21904401,21904468,0,0,0,67
19760,21904652,21904652,21904730,0,0,0,78
19761,21904662,21904662,21904767,0,0,0,105
19762,21904746,21904746,21904820,0,0,0,74
19763,21904779,21904779,21904858,0,0,0,79
19764,21904836,21904836,21904948,0,0,0,112
19765,21904916,21904916,21905010,0,0,0,94
19567,21822892,21826751,21905060,0,0,3859,82168
19766,21905100,21905100,21905189,0,0,0,89
19767,21905151,21905151,21905244,0,0,0,93
19768,21905200,21905200,21905282,0,0,0,82
19769,21905209,21905209,21905306,0,0,0,97
19770,21905253,21905253,21905315,0,0,0,62
19751,21902261,21902261,21905613,0,0,0,3352
19772,21905618,21905618,21905685,0,0,0,67
19773,21905838,21905838,21905906,0,0,0,68
19776,21906863,21906863,21906930,0,0,0,67
19701,21892749,21892749,21907149,0,0,0,14400
19603,21828752,21829659,21907416,0,0,907,78664
19778,21907359,21907359,21907426,0,0,0,67
19779,21907504,21907504,21907571,0,0,0,67
19774,21906063,21906063,21907656,0,0,0,1593
19777,21906998,21906998,21907969,0,0,0,971
19781,21908218,21908218,21908285,0,0,0,67
19780,21908197,21908197,21908350,0,0,0,153
19782,21908344,21908344,21908396,0,0,0,52
19783,21908354,21908354,21908421,0,0,0,67
19784,21908645,21908645,21908769,0,0,0,124
19799,21908779,21908779,21908873,0,0,0,94
19675,21882918,21882918,21909036,0,0,0,26118
19812,21908974,21908974,21909154,0,0,0,180
19846,21909358,21909358,21909490,0,0,0,132
19847,21909371,21909371,21909518,0,0,0,147
19848,21909435,21909435,21909569,0,0,0,134
19850,21909535,21909535,21909607,0,0,0,72
19696,21891973,21891973,21909611,0,0,0,17638
19851,21909544,21909544,21909616,0,0,0,72
19849,21909533,21909533,21909677,0,0,0,144
19813,21909285,21909285,21910029,0,0,0,744
19682,21886125,21886125,21910200,0,0,0,24075
19602,21828740,21829434,21910434,0,0,694,81694
19930,21910088,21910434,21910580,0,0,346,492
19932,21910439,21910439,21910594,0,0,0,155
19941,21910914,21910914,21911018,0,0,0,104
19362,21747367,21747367,21911198,0,0,0,163831
19942,21911253,21911253,21911357,0,0,0,104
19681,21885811,21885811,21911841,0,0,0,26030
19684,21887150,21887150,21914058,0,0,0,26908
19678,21885477,21885477,21914841,0,0,0,29364
19972,21912053,21914841,21915441,0,0,2788,3388
19690,21888978,21888978,21915470,0,0,0,26492
19975,21913908,21915441,21916117,0,0,1533,2209
19982,21916318,21916318,21916396,0,0,0,78
19725,21895950,21895950,21916745,0,0,0,20795
19985,21916716,21916716,21916858,0,0,0,142
19984,21916702,21916702,21916860,0,0,0,158
19986,21916808,21916808,21916861,0,0,0,53
19987,21916817,21916817,21916884,0,0,0,67
19755,21903555,21903555,21917242,0,0,0,13687
19893,21909765,21917242,21917533,0,0,7477,7768
19977,21914395,21916117,21917698,0,0,1722,3303
19979,21914941,21917698,21917791,0,0,2757,2850
19980,21915295,21917698,21918180,0,0,2403,2885
19991,21918433,21918433,21918527,0,0,0,94
19993,21918485,21918485,21918614,0,0,0,129
19892,21909754,21917242,21918859,0,0,7488,9105
19996,21919163,21919163,21919230,0,0,0,67
19775,21906733,21906733,21919697,0,0,0,12964
19997,21919308,21919308,21919697,0,0,0,389
19732,21898179,21898179,21919779,0,0,0,21600
19998,21919739,21919739,21919922,0,0,0,183
19735,21898868,21898868,21919925,0,0,0,21057
19992,21918443,21918443,21920024,0,0,0,1581
20000,21919970,21920024,21920211,0,0,54,241
20001,21920441,21920441,21921599,0,0,0,1158
19748,21902229,21902229,21922423,0,0,0,20194
20004,21922961,21922961,21923090,0,0,0,129
20005,21922981,21922981,21923129,0,0,0,148
20007,21923123,21923123,21923190,0,0,0,67
20006,21923112,21923112,21923195,0,0,0,83
20002,21922419,21922419,21923898,0,0,0,1479
19758,21904113,21904113,21924532,0,0,0,20419
19099,21667066,21667066,21926266,0,0,0,259200
20011,21923915,21924532,21926332,0,0,617,2417
19387,21753763,21753763,21926563,0,0,0,172800
19771,21905585,21905585,21927185,0,0,0,21600
19745,21901666,21901666,21930695,0,0,0,29029
20016,21925069,21930695,21931441,0,0,5626,6372
19107,21672688,21672688,21931888,0,0,0,259200
19108,21672688,21672688,21931888,0,0,0,259200
19109,21672689,21672689,21931889,0,0,0,259200
19110,21672689,21672689,21931889,0,0,0,259200
19111,21672689,21672689,21931889,0,0,0,259200
19112,21672690,21672690,21931890,0,0,0,259200
19113,21672690,21672690,21931890,0,0,0,259200
19744,21901621,21901621,21932097,0,0,0,30476
20017,21926004,21931441,21932165,0,0,5437,6161
19949,21911440,21932097,21932190,0,0,20657,20750
19363,21747395,21747395,21932280,0,0,0,184885
20014,21924589,21931888,21933482,0,0,7299,8893
19136,21684849,21684849,21944049,0,0,0,259200
20026,21938390,21944049,21944903,0,0,5659,6513
20027,21938391,21944903,21945777,0,0,6512,7386
19141,21686979,21686979,21946179,0,0,0,259200
20028,21938392,21945777,21946273,0,0,7385,7881
20029,21938392,21946179,21946675,0,0,7787,8283
20030,21938392,21946273,21946769,0,0,7881,8377
20031,21938392,21946675,21947171,0,0,8283,8779
20032,21938393,21946769,21947296,0,0,8376,8903
19931,21910136,21926563,21950270,0,0,16427,40134
19800,21908779,21908779,21956780,0,0,0,48001
19794,21908778,21908778,21957314,0,0,0,48536
19796,21908778,21908778,21957349,0,0,0,48571
19795,21908778,21908778,21957376,0,0,0,48598
19804,21908780,21908780,21957385,0,0,0,48605
19807,21908781,21908781,21957551,0,0,0,48770
19806,21908781,21908781,21957687,0,0,0,48906
19792,21908777,21908777,21957724,0,0,0,48947
19785,21908776,21908776,21957742,0,0,0,48966
19797,21908778,21908778,21957752,0,0,0,48974
19805,21908781,21908781,21957779,0,0,0,48998
19798,21908778,21908778,21957783,0,0,0,49005
20018,21930631,21957724,21957871,0,0,27093,27240
20019,21932147,21957752,21957899,0,0,25605,25752
19801,21908779,21908779,21957938,0,0,0,49159
20020,21932368,21957783,21957971,0,0,25415,25603
19810,21908782,21908782,21958011,0,0,0,49229
19788,21908777,21908777,21958013,0,0,0,49236
20021,21932369,21957871,21958048,0,0,25502,25679
19811,21908782,21908782,21958073,0,0,0,49291
19808,21908781,21908781,21958189,0,0,0,49408
19809,21908782,21908782,21958276,0,0,0,49494
19802,21908779,21908779,21958280,0,0,0,49501
19789,21908777,21908777,21958429,0,0,0,49652
19829,21909342,21909342,21958500,0,0,0,49158
19838,21909343,21909343,21958504,0,0,0,49161
19790,21908777,21908777,21958527,0,0,0,49750
19971,21911778,21932280,21958671,0,0,20502,46893
19818,21909340,21909340,21958712,0,0,0,49372
19853,21909570,21909570,21958791,0,0,0,49221
19989,21917090,21958504,21958793,0,0,41414,41703
19814,21909339,21909339,21958804,0,0,0,49465
19835,21909343,21909343,21958831,0,0,0,49488
20008,21923250,21958671,21958972,0,0,35421,35722
19988,21917041,21958429,21959059,0,0,41388,42018
20009,21923260,21958793,21959069,0,0,35533,35809
19793,21908777,21908777,21959075,0,0,0,50298
19815,21909339,21909339,21959094,0,0,0,49755
19862,21909731,21909731,21959361,0,0,0,49630
20023,21932520,21957938,21959407,0,0,25418,26887
19863,21909731,21909731,21959640,0,0,0,49909
19852,21909569,21909569,21959670,0,0,0,50101
19819,21909340,21909340,21959972,0,0,0,50632
19823,21909341,21909341,21959973,0,0,0,50632
19834,21909342,21909342,21960062,0,0,0,50720
19856,21909728,21909728,21960067,0,0,0,50339
19840,21909344,21909344,21960198,0,0,0,50854
19816,21909339,21909339,21960219,0,0,0,50880
19803,21908779,21908779,21960220,0,0,0,51441
19855,21909571,21909571,21960313,0,0,0,50742
19820,21909340,21909340,21960344,0,0,0,51004
19976,21914013,21933482,21960354,0,0,19469,46341
19830,21909342,21909342,21960532,0,0,0,51190
19842,21909345,21909345,21960787,0,0,0,51442
19832,21909342,21909342,21960859,0,0,0,51517
19833,21909342,21909342,21961011,0,0,0,51669
19973,21912321,21960344,21961244,0,0,48023,48923
19843,21909345,21909345,21961451,0,0,0,52106
19824,21909341,21909341,21961487,0,0,0,52146
20052,21961325,21961325,21961497,0,0,0,172
19825,21909341,21909341,21961957,0,0,0,52616
19839,21909343,21909343,21961962,0,0,0,52619
19791,21908777,21908777,21961965,0,0,0,53188
19836,21909343,21909343,21962079,0,0,0,52736
19821,21909340,21909340,21962416,0,0,0,53076
20056,21962629,21962629,21962800,0,0,0,171
19874,21909734,21911198,21962873,0,0,1464,53139
20040,21943611,21958013,21962877,0,0,14402,19266
19870,21909733,21911198,21962961,0,0,1465,53228
20057,21962737,21962800,21962978,0,0,63,241
20058,21962848,21962873,21963043,0,0,25,195
19866,21909732,21910434,21963070,0,0,702,53338
19854,21909570,21909570,21963119,0,0,0,53549
19822,21909340,21909340,21963247,0,0,0,53907
19826,21909341,21909341,21963279,0,0,0,53938
19841,21909344,21909344,21963621,0,0,0,54277
19831,21909342,21909342,21964262,0,0,0,54920
19894,21909791,21917242,21964599,0,0,7451,54808
19896,21909792,21917533,21965048,0,0,7741,55256
19844,21909345,21909345,21965632,0,0,0,56287
19875,21909734,21911198,21965873,0,0,1464,56139
19878,21909735,21911841,21965952,0,0,2106,56217
19858,21909730,21909730,21966173,0,0,0,56443
19895,21909791,21917533,21966285,0,0,7742,56494
19827,21909341,21909341,21966561,0,0,0,57220
19974,21912335,21965873,21966773,0,0,53538,54438
19871,21909733,21911198,21966896,0,0,1465,57163
19897,21909792,21918859,21967007,0,0,9067,57215
20024,21932868,21966773,21967606,0,0,33905,34738
19898,21909792,21918859,21967635,0,0,9067,57843
19904,21909794,21919779,21967642,0,0,9985,57848
19903,21909794,21919779,21967766,0,0,9985,57972
19859,21909730,21909730,21967907,0,0,0,58177
19905,21909794,21919922,21967940,0,0,10128,58146
19864,21909731,21910200,21967942,0,0,469,58211
19872,21909733,21911198,21968150,0,0,1465,58417
19901,21909793,21919779,21968275,0,0,9986,58482
19867,21909732,21910434,21968285,0,0,702,58553
20012,21924458,21959972,21968345,0,0,35514,43887
19860,21909730,21909730,21968458,0,0,0,58728
19900,21909793,21919779,21968481,0,0,9986,58688
20015,21924599,21960067,21968528,0,0,35468,43929
19786,21908776,21908776,21968686,0,0,0,59910
19899,21909792,21919697,21968917,0,0,9905,59125
19902,21909793,21919779,21968965,0,0,9986,59172
19906,21909794,21919925,21969342,0,0,10131,59548
19861,21909730,21909730,21969451,0,0,0,59721
19879,21909735,21911841,21969757,0,0,2106,60022
20054,21962156,21962156,21970650,0,0,0,8494
19873,21909733,21911198,21970731,0,0,1465,60998
19907,21909795,21922423,21970972,0,0,12628,61177
19884,21909736,21917242,21971381,0,0,7506,61645
20055,21962314,21963043,21971422,0,0,729,9108
19876,21909734,21911198,21971707,0,0,1464,61973
19877,21909734,21911198,21971738,0,0,1464,62004
19908,21909795,21923898,21972339,0,0,14103,62544
19868,21909732,21911198,21972837,0,0,1466,63105
19880,21909735,21914058,21972929,0,0,4323,63194
19909,21909795,21924532,21973521,0,0,14737,63726
19934,21910491,21926563,21974194,0,0,16072,63703
19913,21909796,21926266,21974228,0,0,16470,64432
19922,21909798,21926266,21974252,0,0,16468,64454
19912,21909796,21926266,21974285,0,0,16470,64489
19921,21909798,21926266,21974314,0,0,16468,64516
19915,21909796,21926266,21974401,0,0,16470,64605
19886,21909736,21917242,21974443,0,0,7506,64707
19914,21909796,21926266,21974460,0,0,16470,64664
19926,21909799,21926266,21974566,0,0,16467,64767
19933,21910490,21926563,21974701,0,0,16073,64211
19919,21909797,21926266,21974717,0,0,16469,64920
19918,21909797,21926266,21974835,0,0,16469,65038
19927,21909799,21926266,21975000,0,0,16467,65201
19935,21910492,21926563,21975058,0,0,16071,64566
19917,21909797,21926266,21975105,0,0,16469,65308
19881,21909735,21914841,21975189,0,0,5106,65454
19911,21909796,21926266,21975299,0,0,16470,65503
19885,21909736,21917242,21975321,0,0,7506,65585
19943,21911304,21927185,21975342,0,0,15881,64038
19923,21909798,21926266,21975440,0,0,16468,65642
19924,21909798,21926266,21975533,0,0,16468,65735
20067,21975515,21975515,21975645,0,0,0,130
19920,21909797,21926266,21975703,0,0,16469,65906
19887,21909736,21917242,21975737,0,0,7506,66001
19937,21910492,21927185,21975752,0,0,16693,65260
19928,21909799,21926266,21975755,0,0,16467,65956
19916,21909797,21926266,21975880,0,0,16469,66083
20068,21975771,21975771,21975922,0,0,0,151
20071,21975952,21975952,21976031,0,0,0,79
19929,21909799,21926266,21976091,0,0,16467,66292
19890,21909737,21917242,21976195,0,0,7505,66458
19910,21909795,21926266,21976432,0,0,16471,66637
20065,21974921,21974921,21976721,0,0,0,1800
19940,21910493,21927185,21976724,0,0,16692,66231
19225,21722411,21722411,21976765,0,0,0,254354
19939,21910493,21927185,21976930,0,0,16692,66437
19938,21910492,21927185,21977015,0,0,16693,66523
19882,21909735,21915470,21977110,0,0,5735,67375
19936,21910492,21926563,21977180,0,0,16071,66688
19837,21909343,21909343,21977451,0,0,0,68108
20072,21975984,21975984,21977465,0,0,0,1481
20078,21977617,21977617,21977699,0,0,0,82
20003,21922437,21957385,21977740,0,0,34948,55303
20080,21977709,21977709,21977762,0,0,0,53
20073,21976195,21976195,21977800,0,0,0,1605
20082,21977815,21977815,21977909,0,0,0,94
19889,21909737,21917242,21977954,0,0,7505,68217
20083,21977992,21977992,21978060,0,0,0,68
20074,21976301,21976301,21978101,0,0,0,1800
19999,21919875,21957376,21978156,0,0,37501,58281
19888,21909736,21917242,21978259,0,0,7506,68523
20081,21977734,21977734,21978262,0,0,0,528
19983,21916682,21957314,21978303,0,0,40632,61621
20013,21924489,21957687,21978332,0,0,33198,53843
20077,21976498,21977800,21978370,0,0,1302,1872
20079,21977675,21977675,21978372,0,0,0,697
20084,21978155,21978155,21978504,0,0,0,349
20085,21978427,21978427,21978505,0,0,0,78
20086,21978466,21978466,21978568,0,0,0,102
19955,21911537,21932097,21978649,0,0,20560,67112
19944,21911439,21930695,21978677,0,0,19256,67238
20043,21952559,21958073,21978716,0,0,5514,26157
20087,21978808,21978808,21978912,0,0,0,104
20044,21952846,21958189,21978929,0,0,5343,26083
20088,21978874,21978874,21979066,0,0,0,192
20089,21979132,21979132,21979256,0,0,0,124
20045,21953002,21958276,21979355,0,0,5274,26353
19978,21914780,21950270,21979391,0,0,35490,64611
20092,21979491,21979491,21979564,0,0,0,73
20090,21979445,21979445,21979627,0,0,0,182
20046,21953193,21958712,21979800,0,0,5519,26607
20093,21979524,21979524,21980124,0,0,0,600
19945,21911439,21931889,21980248,0,0,20450,68809
19946,21911439,21931889,21980397,0,0,20450,68958
19950,21911440,21932097,21980420,0,0,20657,68980
20099,21980381,21980381,21980521,0,0,0,140
20069,21975822,21975822,21980598,0,0,0,4776
20102,21980620,21980620,21980687,0,0,0,67
20103,21980742,21980742,21981094,0,0,0,352
19951,21911440,21932097,21981195,0,0,20657,69755
19963,21911644,21932280,21981273,0,0,20636,69629
19962,21911644,21932190,21981380,0,0,20546,69736
19948,21911439,21932097,21981745,0,0,20658,70306
19947,21911439,21931890,21981759,0,0,20451,70320
20104,21981598,21981598,21981815,0,0,0,217
19964,21911645,21932280,21981877,0,0,20635,70232
20105,21981876,21981876,21982000,0,0,0,124
20106,21981891,21981891,21982046,0,0,0,155
20112,21982095,21982095,21982188,0,0,0,93
19952,21911440,21932097,21982291,0,0,20657,70851
19990,21918033,21961011,21982611,0,0,42978,64578
19965,21911645,21932280,21982675,0,0,20635,71030
19966,21911645,21932280,21982940,0,0,20635,71295
20070,21975892,21975892,21982949,0,0,0,7057
20047,21955854,21958804,21982995,0,0,2950,27141
19981,21915412,21956780,21983517,0,0,41368,68105
20115,21982672,21982672,21983572,0,0,0,900
19969,21911646,21932280,21984052,0,0,20634,72406
19967,21911645,21932280,21984096,0,0,20635,72451
20022,21932479,21957899,21984143,0,0,25420,51664
19970,21911646,21932280,21984652,0,0,20634,73006
20116,21984734,21984734,21984893,0,0,0,159
20118,21984862,21984862,21985041,0,0,0,179
20048,21958595,21958831,21985059,0,0,236,26464
20049,21958688,21958972,21985208,0,0,284,26520
20051,21959096,21959096,21985339,0,0,0,26243
20050,21958941,21958972,21985607,0,0,31,26666
20142,21985804,21985804,21985834,0,0,0,30
20143,21985986,21985986,21986148,0,0,0,162
20108,21981938,21981938,21986549,0,0,0,4611
20025,21933967,21957971,21986696,0,0,24004,52729
19959,21911538,21932097,21986760,0,0,20559,75222
19956,21911537,21932097,21986776,0,0,20560,75239
20146,21986732,21986732,21986888,0,0,0,156
19957,21911537,21932097,21986901,0,0,20560,75364
20010,21923796,21961957,21986973,0,0,38161,63177
19960,21911538,21932097,21987508,0,0,20559,75970
19954,21911536,21932097,21987640,0,0,20561,76104
20111,21982081,21982081,21987950,0,0,0,5869
19250,21728915,21728915,21988115,0,0,0,259200
20148,21988807,21988807,21989096,0,0,0,289
20147,21987577,21987577,21989099,0,0,0,1522
20150,21989064,21989064,21989274,0,0,0,210
20151,21989248,21989248,21989454,0,0,0,206
20152,21989454,21989454,21990055,0,0,0,601
20053,21961435,21961435,21991149,0,0,0,29714
20145,21986510,21986510,21991176,0,0,0,4666
19961,21911538,21932165,21991503,0,0,20627,79965
20059,21962960,21962961,21992311,0,0,1,29351
20156,21992239,21992239,21992411,0,0,0,172
20157,21992357,21992357,21992530,0,0,0,173
20158,21992468,21992468,21992922,0,0,0,454
20161,21993236,21993236,21993329,0,0,0,93
20162,21993434,21993434,21993538,0,0,0,104
20060,21973128,21973128,21993835,0,0,0,20707
20164,21993996,21993996,21994083,0,0,0,87
20062,21973526,21973526,21994120,0,0,0,20594
20064,21974217,21974217,21995120,0,0,0,20903
19787,21908776,21908776,21995176,0,0,0,86400
20063,21974021,21974021,21995235,0,0,0,21214
19817,21909339,21909339,21995739,0,0,0,86400
19828,21909341,21909341,21995741,0,0,0,86400
19845,21909345,21909345,21995745,0,0,0,86400
20154,21991118,21991118,21995859,0,0,0,4741
19857,21909729,21909729,21996129,0,0,0,86400
20114,21982424,21982424,21996413,0,0,0,13989
20170,21996459,21996459,21996548,0,0,0,89
19865,21909731,21910434,21996834,0,0,703,87103
19869,21909732,21911198,21997598,0,0,1466,87866
20149,21988835,21988835,21997660,0,0,0,8825
20171,21996522,21996522,21998244,0,0,0,1722
20172,21996914,21996914,21998714,0,0,0,1800
20061,21973166,21973166,21999485,0,0,0,26319
20176,21998106,21998106,21999627,0,0,0,1521
20180,21999705,21999705,21999891,0,0,0,186
20169,21995788,21995788,22000490,0,0,0,4702
20183,22000722,22000722,22000939,0,0,0,217
20182,22000497,22000497,22001534,0,0,0,1037
20185,22001538,22001538,22001703,0,0,0,165
20186,22001790,22001790,22001953,0,0,0,163
20184,22000726,22000939,22002739,0,0,213,2013
19883,21909735,21916745,22003145,0,0,7010,93410
20190,22002527,22002527,22003399,0,0,0,872
19891,21909737,21917242,22003642,0,0,7505,93905
20098,21979974,21979974,22003658,0,0,0,23684
20191,22003088,22003088,22003896,0,0,0,808
20193,22003865,22003865,22004709,0,0,0,844
20181,22000437,22000437,22005110,0,0,0,4673
20194,22003892,22003892,22005185,0,0,0,1293
20197,22005191,22005191,22005295,0,0,0,104
20179,21999636,21999636,22005409,0,0,0,5773
20199,22005340,22005340,22005546,0,0,0,206
20198,22005199,22005199,22005551,0,0,0,352
20202,22005814,22005814,22006031,0,0,0,217
20175,21997824,21997824,22006159,0,0,0,8335
20203,22005861,22006031,22006211,0,0,170,350
20113,21982271,21982271,22006463,0,0,0,24192
20200,22005539,22005539,22006523,0,0,0,984
20196,22005158,22005158,22006722,0,0,0,1564
20205,22006625,22006625,22006765,0,0,0,140
20207,22006917,22006917,22007114,0,0,0,197
20075,21976311,21976311,22007442,0,0,0,31131
19366,21748357,21748357,22007557,0,0,0,259200
20208,22007755,22007755,22007973,0,0,0,218
20209,22007948,22007948,22008196,0,0,0,248
20206,22006868,22006868,22008440,0,0,0,1572
20210,22008666,22008666,22008775,0,0,0,109
20211,22009238,22009238,22009316,0,0,0,78
20212,22009318,22009318,22009407,0,0,0,89
20213,22009367,22009367,22009440,0,0,0,73
20214,22009367,22009367,22009563,0,0,0,196
20195,22005048,22005048,22009926,0,0,0,4878
20217,22010295,22010295,22010388,0,0,0,93
20218,22010559,22010559,22010653,0,0,0,94
20219,22010764,22010764,22010861,0,0,0,97
20117,21984844,21984844,22010891,0,0,0,26047
20221,22010829,22010829,22011001,0,0,0,172
20222,22010939,22010939,22011090,0,0,0,151
20119,21984971,21984971,22011121,0,0,0,26150
19381,21752200,21752200,22011400,0,0,0,259200
20141,21985513,21985513,22011938,0,0,0,26425
20140,21985295,21985295,22012008,0,0,0,26713
20097,21979711,21979711,22012168,0,0,0,32457
20220,22010787,22010787,22012587,0,0,0,1800
19925,21909798,21926266,22012666,0,0,16468,102868
20225,22011506,22011506,22013080,0,0,0,1574
20187,22001794,22012587,22013187,0,0,10793,11393
20188,22001818,22013187,22013787,0,0,11369,11969
20163,21993788,21993788,22014271,0,0,0,20483
20189,22001825,22013787,22014387,0,0,11962,12562
20201,22005544,22005544,22014544,0,0,0,9000
20215,22009856,22009856,22014579,0,0,0,4723
20165,21994057,21994057,22014775,0,0,0,20718
20167,21995059,21995059,22016143,0,0,0,21084
20168,21995167,21995167,22016173,0,0,0,21006
20076,21976317,21976721,22017680,0,0,404,41363
20233,22016979,22016979,22017879,0,0,0,900
20155,21991979,22017680,22017898,0,0,25701,25919
19254,21731684,21731684,22018246,0,0,0,286562
20234,22017511,22017511,22018411,0,0,0,900
19953,21911535,21932097,22018497,0,0,20562,106962
19958,21911537,21932097,22018497,0,0,20560,106960
19968,21911645,21932280,22018680,0,0,20635,107035
20235,22017816,22017816,22018716,0,0,0,900
20229,22014513,22014513,22019290,0,0,0,4777
20177,21999005,21999005,22020176,0,0,0,21171
20153,21991102,21991102,22020974,0,0,0,29872
20241,22020903,22020903,22021083,0,0,0,180
20242,22021030,22021030,22021202,0,0,0,172
20236,22019172,22019172,22021872,0,0,0,2700
20244,22021851,22021851,22021955,0,0,0,104
20094,21979627,21979627,22022112,0,0,0,42485
19411,21762939,21762939,22022139,0,0,0,259200
20245,22022085,22022085,22022176,0,0,0,91
20159,21992859,21992859,22022278,0,0,0,29419
19413,21763156,21763156,22022356,0,0,0,259200
19414,21763251,21763251,22022451,0,0,0,259200
19416,21763413,21763413,22022613,0,0,0,259200
19417,21763506,21763506,22022706,0,0,0,259200
20160,21993059,21993059,22022892,0,0,0,29833
20237,22019233,22019233,22023993,0,0,0,4760
20249,22025756,22025756,22026239,0,0,0,483
20192,22003619,22003619,22027328,0,0,0,23709
20095,21979701,21979701,22027462,0,0,0,47761
20252,22027419,22027419,22027685,0,0,0,266
20253,22027654,22027654,22027840,0,0,0,186
20248,22023931,22023931,22028738,0,0,0,4807
19422,21769641,21769641,22028841,0,0,0,259200
19132,21683327,21683327,22028927,0,0,0,345600
20204,22006401,22006401,22030548,0,0,0,24147
20255,22028694,22028694,22033487,0,0,0,4793
19994,21918993,21959069,22034970,0,0,40076,115977
20228,22014208,22014208,22035290,0,0,0,21082
20230,22014712,22014712,22035455,0,0,0,20743
19995,21919010,21959407,22035711,0,0,40397,116701
20133,21985277,21985277,22036274,0,0,0,50997
20134,21985277,21985277,22036449,0,0,0,51172
20122,21985169,21985169,22036541,0,0,0,51372
20091,21979485,22036541,22036759,0,0,57056,57274
20130,21985276,21985276,22036855,0,0,0,51579
20120,21985168,21985168,22036943,0,0,0,51775
20132,21985277,21985277,22037215,0,0,0,51938
20232,22016110,22016110,22037233,0,0,0,21123
20231,22016089,22016089,22037265,0,0,0,21176
20223,22011047,22011047,22037344,0,0,0,26297
20224,22011059,22011059,22037385,0,0,0,26326
20121,21985168,21985168,22037501,0,0,0,52333
20271,22037338,22037338,22037516,0,0,0,178
20131,21985276,21985276,22037557,0,0,0,52281
20272,22037451,22037451,22037620,0,0,0,169
20123,21985169,21985169,22037865,0,0,0,52696
20265,22033445,22033445,22038198,0,0,0,4753
20124,21985169,21985169,22038361,0,0,0,53192
20226,22011875,22011875,22038601,0,0,0,26726
20227,22011947,22011947,22038767,0,0,0,26820
20126,21985216,21985216,22039954,0,0,0,54738
20128,21985216,21985216,22040488,0,0,0,55272
20127,21985216,21985216,22040601,0,0,0,55385
20125,21985216,21985216,22040830,0,0,0,55614
20129,21985216,21985216,22041511,0,0,0,56295
20136,21985293,21985293,22042262,0,0,0,56969
20137,21985293,21985293,22042744,0,0,0,57451
20274,22038138,22038138,22042895,0,0,0,4757
20247,22023111,22023111,22042911,0,0,0,19800
20135,21985293,21985293,22043330,0,0,0,58037
20138,21985293,21985293,22045149,0,0,0,59856
20277,22042832,22042832,22047641,0,0,0,4809
20254,22028262,22028262,22048062,0,0,0,19800
20139,21985293,21985293,22050144,0,0,0,64851
20239,22020104,22020104,22050982,0,0,0,30878
20243,22021139,22021139,22051140,0,0,0,30001
20279,22051073,22051073,22051244,0,0,0,171
20251,22027271,22027271,22051365,0,0,0,24094
20280,22051186,22051186,22051365,0,0,0,179
20281,22051291,22051291,22051485,0,0,0,194
20066,21975387,22050982,22051945,0,0,75595,76558
20107,21981920,22051945,22052148,0,0,70025,70228
20246,22022235,22022235,22052154,0,0,0,29919
20278,22047572,22047572,22052313,0,0,0,4741
20263,22030485,22030485,22054463,0,0,0,23978
20266,22035227,22035227,22055960,0,0,0,20733
20267,22035409,22035409,22056060,0,0,0,20651
20285,22052258,22052258,22056987,0,0,0,4729
20269,22037202,22037202,22058266,0,0,0,21064
20268,22037175,22037175,22058363,0,0,0,21188
20238,22019645,22019645,22060253,0,0,0,40608
20110,21981968,22060253,22061029,0,0,78285,79061
20289,22056925,22056925,22061617,0,0,0,4692
20270,22037281,22037281,22063719,0,0,0,26438
20273,22037566,22037566,22063798,0,0,0,26232
20293,22063657,22063657,22063828,0,0,0,171
20295,22063751,22063751,22063902,0,0,0,151
20294,22063727,22063727,22064156,0,0,0,429
20298,22064064,22064064,22064156,0,0,0,92
20299,22064128,22064128,22064300,0,0,0,172
20300,22064256,22064256,22064335,0,0,0,79
20275,22038533,22038533,22065248,0,0,0,26715
20276,22038706,22038706,22065327,0,0,0,26621
20292,22061554,22061554,22066221,0,0,0,4667
20301,22064311,22064311,22067027,0,0,0,2716
20305,22067321,22067321,22067451,0,0,0,130
19522,21814915,21814915,22067515,0,0,0,252600
19523,21815104,21815104,22067704,0,0,0,252600
20240,22020110,22020110,22068236,0,0,0,48126
20306,22068305,22068305,22068373,0,0,0,68
20307,22068395,22068395,22068462,0,0,0,67
20308,22068480,22068480,22068548,0,0,0,68
19527,21815962,21815962,22068562,0,0,0,252600
20309,22068653,22068653,22068735,0,0,0,82
20310,22068749,22068749,22068816,0,0,0,67
20311,22068857,22068857,22068924,0,0,0,67
20312,22069166,22069166,22069255,0,0,0,89
20109,21981944,22068236,22070036,0,0,86292,88092
20304,22066177,22066177,22070832,0,0,0,4655
20318,22071058,22071058,22071151,0,0,0,93
20319,22071501,22071501,22071599,0,0,0,98
20320,22071706,22071706,22071774,0,0,0,68
20321,22071793,22071793,22071890,0,0,0,97
20322,22071811,22071811,22071946,0,0,0,135
20324,22071909,22071909,22071977,0,0,0,68
20323,22071846,22071846,22072230,0,0,0,384
20326,22073012,22073012,22073291,0,0,0,279
20317,22070769,22070769,22075447,0,0,0,4678
20282,22051317,22051317,22075521,0,0,0,24204
20287,22055898,22055898,22076526,0,0,0,20628
20288,22056000,22056000,22076627,0,0,0,20627
20332,22077007,22077007,22077269,0,0,0,262
20333,22077253,22077253,22077369,0,0,0,116
20335,22077409,22077409,22077545,0,0,0,136
20337,22077493,22077493,22077602,0,0,0,109
20339,22078006,22078006,22078132,0,0,0,126
20286,22054401,22054401,22078501,0,0,0,24100
19640,21854130,21854130,22078593,0,0,0,224463
20291,22058308,22058308,22079369,0,0,0,21061
20290,22058213,22058213,22079401,0,0,0,21188
20328,22075388,22075388,22079939,0,0,0,4551
20283,22051398,22051398,22081313,0,0,0,29915
20284,22052092,22052092,22081743,0,0,0,29651
20349,22081680,22081680,22081846,0,0,0,166
20343,22078200,22078200,22083037,0,0,0,4837
20347,22079867,22079867,22084468,0,0,0,4601
20100,21980539,21980539,22088539,0,0,0,108000
20101,21980571,21980598,22088598,0,0,27,108027
20351,22084416,22084416,22088971,0,0,0,4555
20297,22063855,22063855,22090074,0,0,0,26219
20296,22063766,22063766,22090110,0,0,0,26344
20353,22090002,22090002,22090190,0,0,0,188
20354,22090038,22090038,22090215,0,0,0,177
20356,22090157,22090157,22090323,0,0,0,166
20357,22090264,22090264,22090434,0,0,0,170
20358,22090374,22090374,22090544,0,0,0,170
20359,22090481,22090481,22090666,0,0,0,185
20302,22065193,22065193,22091732,0,0,0,26539
20303,22065282,22065282,22092082,0,0,0,26800
20352,22088929,22088929,22093492,0,0,0,4563
20330,22076457,22076457,22097196,0,0,0,20739
19379,21751644,21751644,22097244,0,0,0,345600
20331,22076562,22076562,22097369,0,0,0,20807
20365,22093437,22093437,22098042,0,0,0,4605
20329,22075464,22075464,22099742,0,0,0,24278
20345,22079328,22079328,22100362,0,0,0,21034
20346,22079333,22079333,22100563,0,0,0,21230
20341,22078043,22078043,22100775,0,0,0,22732
20369,22097983,22097983,22102421,0,0,0,4438
20344,22078438,22078438,22102512,0,0,0,24074
20372,22102359,22102359,22106816,0,0,0,4457
20348,22081271,22081271,22111298,0,0,0,30027
20375,22106753,22106753,22111321,0,0,0,4568
20377,22111707,22111707,22111879,0,0,0,172
20350,22082745,22082745,22112717,0,0,0,29972
20325,22072242,22072242,22115442,0,0,0,43200
20376,22111258,22111258,22115771,0,0,0,4513
20174,21997782,22011400,22116193,0,0,13618,118411
20355,22090114,22090114,22116375,0,0,0,26261
20360,22090589,22090589,22116927,0,0,0,26338
20367,22097282,22097282,22117819,0,0,0,20537
20366,22097131,22097131,22117848,0,0,0,20717
20361,22091661,22091661,22118303,0,0,0,26642
20364,22092043,22092043,22118701,0,0,0,26658
20380,22115725,22115725,22120221,0,0,0,4496
20371,22100393,22100393,22121515,0,0,0,21122
20397,22121642,22121642,22121768,0,0,0,126
20370,22099676,22099676,22123105,0,0,0,23429
20373,22102467,22102467,22123522,0,0,0,21055
20388,22120162,22120162,22124711,0,0,0,4549
20374,22102512,22102512,22126552,0,0,0,24040
20400,22124648,22124648,22129167,0,0,0,4519
20402,22129122,22129122,22133725,0,0,0,4603
20384,22117752,22117752,22138366,0,0,0,20614
20403,22133662,22133662,22138406,0,0,0,4744
20385,22117790,22117790,22138438,0,0,0,20648
20378,22111816,22111816,22141582,0,0,0,29766
20407,22141540,22141540,22141717,0,0,0,177
20389,22121463,22121463,22142410,0,0,0,20947
20379,22112641,22112641,22142513,0,0,0,29872
20381,22116336,22116336,22142863,0,0,0,26527
20405,22138334,22138334,22142952,0,0,0,4618
20411,22142812,22142812,22142985,0,0,0,173
20399,22123478,22123478,22144493,0,0,0,21015
20386,22118247,22118247,22144988,0,0,0,26741
20387,22118640,22118640,22145185,0,0,0,26545
20398,22123042,22123042,22146791,0,0,0,23749
20412,22142876,22142876,22147469,0,0,0,4593
20401,22126486,22126486,22150198,0,0,0,23712
20418,22147408,22147408,22152032,0,0,0,4624
20313,22069228,22069228,22155628,0,0,0,86400
20420,22151963,22151963,22156582,0,0,0,4619
20406,22138380,22138380,22159012,0,0,0,20632
20404,22138293,22138293,22159109,0,0,0,20816
20327,22073083,22073083,22159483,0,0,0,86400
20383,22116864,22116864,22160064,0,0,0,43200
20421,22156527,22156527,22161128,0,0,0,4601
20409,22142339,22142339,22163381,0,0,0,21042
20414,22144433,22144433,22165531,0,0,0,21098
20424,22161082,22161082,22165880,0,0,0,4798
20396,22121636,22121636,22166001,0,0,0,44365
20362,22091894,22091894,22167162,0,0,0,75268
20166,21994385,21994385,22168770,0,0,0,174385
20413,22142922,22142922,22169158,0,0,0,26236
20429,22169096,22169096,22169267,0,0,0,171
20427,22165817,22165817,22170593,0,0,0,4776
20417,22146733,22146733,22171012,0,0,0,24279
20416,22145114,22145114,22171330,0,0,0,26216
20415,22144942,22144942,22171625,0,0,0,26683
20408,22141649,22141649,22171720,0,0,0,30071
20435,22171664,22171664,22171836,0,0,0,172
20436,22171773,22171773,22171944,0,0,0,171
20410,22142444,22142444,22172318,0,0,0,29874
20363,22091919,22091919,22172919,0,0,0,81000
20382,22116560,22116560,22173057,0,0,0,56497
20419,22150134,22150134,22174310,0,0,0,24176
20431,22170535,22170535,22175267,0,0,0,4732
20443,22179033,22179033,22179204,0,0,0,171
20444,22179141,22179141,22179311,0,0,0,170
20445,22179249,22179249,22179431,0,0,0,182
20423,22159042,22159042,22179458,0,0,0,20416
20446,22179358,22179358,22179535,0,0,0,177
20422,22158949,22158949,22179619,0,0,0,20670
20448,22179466,22179466,22179643,0,0,0,177
20442,22175202,22175202,22180103,0,0,0,4901
20216,22010013,22010013,22182813,0,0,0,172800
20425,22163326,22163326,22184531,0,0,0,21205
20451,22180044,22180044,22184741,0,0,0,4697
20426,22165469,22165469,22186418,0,0,0,20949
20454,22184700,22184700,22189448,0,0,0,4748
20456,22189396,22189396,22194145,0,0,0,4749
20432,22170970,22170970,22194983,0,0,0,24013
20430,22169204,22169204,22195263,0,0,0,26059
20459,22195221,22195221,22195367,0,0,0,146
20460,22195323,22195323,22195500,0,0,0,177
20434,22171562,22171562,22197859,0,0,0,26297
20433,22171276,22171276,22197895,0,0,0,26619
20439,22174268,22174268,22198061,0,0,0,23793
20457,22194104,22194104,22198897,0,0,0,4793
20447,22179398,22179398,22199821,0,0,0,20423
20449,22179575,22179575,22200153,0,0,0,20578
20338,22077505,22077505,22201766,0,0,0,124261
20438,22172257,22172257,22202039,0,0,0,29782
20437,22171882,22171882,22202047,0,0,0,30165
20096,21979705,21979705,22202942,0,0,0,223237
20465,22198845,22198845,22203620,0,0,0,4775
20336,22077472,22077472,22203707,0,0,0,126235
20334,22077275,22077275,22204388,0,0,0,127113
20471,22204342,22204342,22204539,0,0,0,197
20452,22184471,22184471,22205326,0,0,0,20855
20450,22179582,22179582,22206019,0,0,0,26437
20033,21940210,21947171,22206371,0,0,6961,266161
20034,21940211,21947296,22206496,0,0,7085,266285
20455,22186350,22186350,22207304,0,0,0,20954
20469,22203557,22203557,22208338,0,0,0,4781
20483,22208276,22208276,22213067,0,0,0,4791
20035,21940211,21957349,22216549,0,0,17138,276338
20036,21940211,21957551,22216751,0,0,17340,276540
20037,21940212,21957742,22216942,0,0,17530,276730
20038,21940212,21957779,22216979,0,0,17567,276767
20039,21940212,21958011,22217211,0,0,17799,276999
20041,21944269,21958013,22217213,0,0,13744,272944
20042,21946422,21958048,22217248,0,0,11626,270826
20484,22213010,22213010,22217730,0,0,0,4720
20458,22194922,22194922,22219119,0,0,0,24197
20466,22200093,22200093,22220680,0,0,0,20587
20461,22195432,22195432,22221520,0,0,0,26088
20464,22197993,22197993,22221627,0,0,0,23634
20485,22217690,22217690,22222449,0,0,0,4759
20462,22197806,22197806,22224261,0,0,0,26455
20463,22197832,22197832,22224379,0,0,0,26547
20479,22205263,22205263,22226131,0,0,0,20868
20490,22222397,22222397,22227047,0,0,0,4650
20482,22207248,22207248,22228473,0,0,0,21225
20497,22228880,22228880,22229195,0,0,0,315
20495,22228500,22228500,22229340,0,0,0,840
20178,21999272,21999272,22229367,0,0,0,230095
20496,22228655,22228655,22229468,0,0,0,813
20493,22226984,22226984,22231636,0,0,0,4652
20468,22202000,22202000,22232013,0,0,0,30013
20467,22201966,22201966,22232041,0,0,0,30075
20481,22205963,22205963,22232079,0,0,0,26116
20501,22231984,22231984,22232165,0,0,0,181
20502,22232017,22232017,22232168,0,0,0,151
20504,22232126,22232126,22232303,0,0,0,177
20503,22232096,22232096,22232408,0,0,0,312
20508,22236037,22236037,22236130,0,0,0,93
20499,22231572,22231572,22236295,0,0,0,4723
20510,22236315,22236315,22236408,0,0,0,93
20511,22237145,22237145,22237218,0,0,0,73
20512,22237443,22237443,22237536,0,0,0,93
20513,22237714,22237714,22237807,0,0,0,93
20515,22239262,22239262,22239391,0,0,0,129
20516,22239813,22239813,22239908,0,0,0,95
20509,22236228,22236228,22240848,0,0,0,4620
20518,22240429,22240429,22241003,0,0,0,574
20521,22241310,22241310,22241427,0,0,0,117
20487,22220635,22220635,22241429,0,0,0,20794
20520,22241015,22241015,22241737,0,0,0,722
20507,22235426,22235426,22242017,0,0,0,6591
20514,22238543,22238543,22242602,0,0,0,4059
20486,22219087,22219087,22243393,0,0,0,24306
20527,22243593,22243593,22244341,0,0,0,748
20528,22244572,22244572,22244918,0,0,0,346
20144,21986002,21986002,22245142,0,0,0,259140
20519,22240812,22240812,22245466,0,0,0,4654
20489,22221586,22221586,22245763,0,0,0,24177
20529,22245114,22245114,22247453,0,0,0,2339
20532,22247456,22247456,22247799,0,0,0,343
20488,22221465,22221465,22247878,0,0,0,26413
20534,22247812,22247812,22248164,0,0,0,352
20535,22248107,22248107,22248460,0,0,0,353
20536,22248399,22248399,22248731,0,0,0,332
20533,22247491,22247491,22248866,0,0,0,1375
20538,22248688,22248688,22249051,0,0,0,363
20494,22228411,22228411,22249251,0,0,0,20840
20540,22248979,22248979,22249332,0,0,0,353
20537,22248682,22248682,22249582,0,0,0,900
20543,22249269,22249269,22249623,0,0,0,354
20544,22249552,22249552,22249908,0,0,0,356
20530,22245385,22245385,22250059,0,0,0,4674
20547,22250401,22250401,22250494,0,0,0,93
20548,22250497,22250497,22250600,0,0,0,103
20549,22250540,22250540,22250648,0,0,0,108
20550,22250575,22250575,22250668,0,0,0,93
20551,22250603,22250603,22250761,0,0,0,158
20491,22224200,22224200,22250792,0,0,0,26592
20492,22224317,22224317,22251130,0,0,0,26813
20553,22251048,22251048,22251203,0,0,0,155
20440,22174284,22174284,22251285,0,0,0,77001
20555,22252193,22252193,22252318,0,0,0,125
20524,22242469,22242469,22253280,0,0,0,10811
20560,22253186,22253186,22253341,0,0,0,155
20561,22254032,22254032,22254136,0,0,0,104
20525,22242472,22242472,22254180,0,0,0,11708
20562,22254092,22254092,22254218,0,0,0,126
20563,22254188,22254188,22254334,0,0,0,146
20556,22252345,22252345,22254697,0,0,0,2352
20546,22249996,22249996,22254732,0,0,0,4736
20557,22252785,22252785,22255239,0,0,0,2454
20559,22252802,22252802,22255287,0,0,0,2485
20558,22252793,22252793,22255309,0,0,0,2516
20565,22254733,22254733,22255333,0,0,0,600
20441,22174374,22174374,22255374,0,0,0,81000
20566,22255120,22255120,22256117,0,0,0,997
20572,22256234,22256234,22256318,0,0,0,84
20574,22256604,22256604,22256799,0,0,0,195
20571,22256224,22256224,22256824,0,0,0,600
20573,22256282,22256282,22256928,0,0,0,646
20539,22248726,22248726,22256992,0,0,0,8266
20575,22256869,22256869,22257037,0,0,0,168
20541,22249033,22249033,22257543,0,0,0,8510
20576,22256993,22256993,22257593,0,0,0,600
20578,22257736,22257736,22257814,0,0,0,78
20567,22255437,22255437,22258065,0,0,0,2628
20505,22232235,22232235,22258100,0,0,0,25865
20580,22258034,22258034,22258200,0,0,0,166
20568,22255547,22255547,22258241,0,0,0,2694
20569,22256042,22256042,22258601,0,0,0,2559
20570,22256138,22256138,22258743,0,0,0,2605
20564,22254660,22254660,22259213,0,0,0,4553
20584,22259107,22259107,22259357,0,0,0,250
20587,22259679,22259679,22259746,0,0,0,67
20586,22259357,22259357,22260161,0,0,0,804
20589,22260283,22260283,22260846,0,0,0,563
20579,22257750,22257750,22261276,0,0,0,3526
20577,22257408,22257408,22261495,0,0,0,4087
20588,22260166,22260166,22261702,0,0,0,1536
20522,22241379,22241379,22261757,0,0,0,20378
20500,22231949,22231949,22261790,0,0,0,29841
20593,22261836,22261836,22261846,0,0,0,10
20595,22261891,22261891,22261901,0,0,0,10
20592,22261730,22261730,22261910,0,0,0,180
20594,22261845,22261845,22262000,0,0,0,155
20596,22261964,22261964,22262115,0,0,0,151
20597,22262072,22262072,22262145,0,0,0,73
20506,22232361,22232361,22262315,0,0,0,29954
20590,22261670,22261670,22262422,0,0,0,752
20599,22262257,22262257,22262429,0,0,0,172
20601,22262468,22262468,22262933,0,0,0,465
20585,22259160,22259160,22263785,0,0,0,4625
20173,21997707,22007442,22266642,0,0,9735,268935
20526,22243341,22243341,22267605,0,0,0,24264
20602,22263722,22263722,22268327,0,0,0,4605
20606,22268621,22268621,22268731,0,0,0,110
20607,22268659,22268659,22268758,0,0,0,99
20608,22268687,22268687,22268767,0,0,0,80
20609,22268704,22268704,22268797,0,0,0,93
20610,22269321,22269321,22269755,0,0,0,434
20531,22245706,22245706,22269953,0,0,0,24247
20612,22269628,22269628,22270015,0,0,0,387
20542,22249188,22249188,22270046,0,0,0,20858
20613,22269670,22269670,22272122,0,0,0,2452
20614,22269692,22269692,22272153,0,0,0,2461
20605,22268273,22268273,22272766,0,0,0,4493
20582,22258323,22258323,22275630,0,0,0,17307
20545,22249852,22249852,22276400,0,0,0,26548
20616,22272703,22272703,22277279,0,0,0,4576
20552,22250729,22250729,22277393,0,0,0,26664
20554,22251066,22251066,22277744,0,0,0,26678
20603,22263862,22263862,22281528,0,0,0,17666
20618,22277214,22277214,22281753,0,0,0,4539
20591,22261724,22261724,22282252,0,0,0,20528
20581,22258163,22258163,22284429,0,0,0,26266
20621,22281713,22281713,22286223,0,0,0,4510
20611,22269324,22269324,22287138,0,0,0,17814
20624,22287864,22287864,22287957,0,0,0,93
20257,22029585,22029585,22288785,0,0,0,259200
20258,22029586,22029586,22288786,0,0,0,259200
20259,22029586,22029586,22288786,0,0,0,259200
20260,22029587,22029587,22288787,0,0,0,259200
20261,22029619,22029619,22288819,0,0,0,259200
20262,22029620,22029620,22288820,0,0,0,259200
20264,22030987,22030987,22290187,0,0,0,259200
20250,22026728,22026728,22290363,0,0,0,263635
20623,22286154,22286154,22290645,0,0,0,4491
20604,22267562,22267562,22291723,0,0,0,24161
20598,22262072,22262072,22291934,0,0,0,29862
20600,22262367,22262367,22292194,0,0,0,29827
20638,22292122,22292122,22292299,0,0,0,177
20639,22292242,22292242,22292414,0,0,0,172
20640,22292356,22292356,22292529,0,0,0,173
20641,22292467,22292467,22292636,0,0,0,169
20615,22269890,22269890,22294084,0,0,0,24194
20617,22276338,22276338,22302651,0,0,0,26313
20619,22277362,22277362,22303852,0,0,0,26490
20620,22277702,22277702,22304460,0,0,0,26758
20390,22121530,22121530,22306775,0,0,0,185245
20626,22289197,22289197,22308940,0,0,0,19743
20622,22284372,22284372,22310619,0,0,0,26247
20636,22291678,22291678,22315829,0,0,0,24151
20498,22229313,22229313,22317041,0,0,0,87728
20643,22294038,22294038,22317462,0,0,0,23424
20637,22291872,22291872,22322069,0,0,0,30197
20642,22292574,22292574,22322298,0,0,0,29724
20654,22323382,22323382,22323661,0,0,0,279
20655,22323667,22323667,22324092,0,0,0,425
20658,22323739,22323739,22324405,0,0,0,666
20656,22323701,22323701,22326075,0,0,0,2374
20659,22323756,22323756,22326294,0,0,0,2538
20661,22327363,22327363,22327591,0,0,0,228
20662,22327554,22327554,22328027,0,0,0,473
20634,22290832,22290832,22328265,0,0,0,37433
20650,22319195,22319195,22328328,0,0,0,9133
20314,22069715,22069715,22328915,0,0,0,259200
20660,22327150,22327150,22328950,0,0,0,1800
20315,22069771,22069771,22328971,0,0,0,259200
20644,22302584,22302584,22328976,0,0,0,26392
20316,22069909,22069909,22329109,0,0,0,259200
20665,22329000,22329000,22329144,0,0,0,144
20669,22329297,22329297,22329390,0,0,0,93
20668,22329255,22329255,22329555,0,0,0,300
20651,22319711,22319711,22329611,0,0,0,9900
20666,22329071,22329071,22329741,0,0,0,670
20670,22329710,22329710,22329803,0,0,0,93
20671,22329998,22329998,22330076,0,0,0,78
20625,22288032,22288032,22330548,0,0,0,42516
20340,22078027,22078027,22330627,0,0,0,252600
20342,22078068,22078068,22330668,0,0,0,252600
20667,22329126,22329126,22330724,0,0,0,1598
20646,22304399,22304399,22331228,0,0,0,26829
20645,22303806,22303806,22331254,0,0,0,27448
20676,22332003,22332003,22332077,0,0,0,74
20672,22330271,22330271,22332787,0,0,0,2516
20678,22333149,22333149,22333366,0,0,0,217
20684,22335334,22335334,22335412,0,0,0,78
20683,22335326,22335326,22335467,0,0,0,141
20583,22258989,22258989,22336340,0,0,0,77351
20686,22336350,22336350,22336536,0,0,0,186
20687,22336372,22336372,22336569,0,0,0,197
20688,22336394,22336394,22336592,0,0,0,198
20690,22336695,22336695,22336850,0,0,0,155
20689,22336414,22336592,22336903,0,0,178,489
20647,22310552,22310552,22337062,0,0,0,26510
20682,22334928,22334928,22337442,0,0,0,2514
20648,22315789,22315789,22339821,0,0,0,24032
20673,22330632,22330632,22340828,0,0,0,10196
20649,22317389,22317389,22341120,0,0,0,23731
20657,22323730,22323730,22343076,0,0,0,19346
20692,22337350,22337350,22343394,0,0,0,6044
20696,22341787,22341787,22343693,0,0,0,1906
20698,22343664,22343664,22343762,0,0,0,98
20685,22335724,22335724,22343792,0,0,0,8068
20699,22343976,22343976,22344117,0,0,0,141
20701,22344195,22344195,22344582,0,0,0,387
20677,22332040,22332040,22345012,0,0,0,12972
20700,22344116,22344116,22345916,0,0,0,1800
20695,22341738,22341738,22346294,0,0,0,4556
20705,22346262,22346262,22347662,0,0,0,1400
20709,22348889,22348889,22348961,0,0,0,72
20710,22348962,22348962,22349038,0,0,0,76
20711,22349078,22349078,22349156,0,0,0,78
20712,22349289,22349289,22349356,0,0,0,67
20713,22349382,22349382,22349449,0,0,0,67
20715,22349660,22349660,22349742,0,0,0,82
20716,22349894,22349894,22350003,0,0,0,109
20704,22346236,22346236,22350706,0,0,0,4470
20718,22351214,22351214,22351328,0,0,0,114
20719,22351318,22351318,22351416,0,0,0,98
20720,22351420,22351420,22351519,0,0,0,99
20721,22351520,22351520,22351603,0,0,0,83
20722,22351567,22351567,22351657,0,0,0,90
20652,22322022,22322022,22351946,0,0,0,29924
20724,22351911,22351911,22351994,0,0,0,83
20723,22351873,22351873,22352040,0,0,0,167
20725,22351947,22351947,22352067,0,0,0,120
20729,22352107,22352107,22352148,0,0,0,41
20726,22351994,22351994,22352150,0,0,0,156
20728,22352106,22352106,22352209,0,0,0,103
20653,22322236,22322236,22352430,0,0,0,30194
20732,22352473,22352473,22352571,0,0,0,98
20730,22352247,22352247,22352847,0,0,0,600
20733,22352833,22352833,22352937,0,0,0,104
20734,22353301,22353301,22353355,0,0,0,54
20735,22353359,22353359,22353415,0,0,0,56
20736,22353379,22353379,22353498,0,0,0,119
20737,22353608,22353608,22353676,0,0,0,68
20738,22354266,22354266,22354302,0,0,0,36
20739,22354547,22354547,22354646,0,0,0,99
20740,22354891,22354891,22355000,0,0,0,109
20717,22350670,22350670,22355102,0,0,0,4432
20742,22355106,22355106,22355173,0,0,0,67
20743,22355137,22355137,22355236,0,0,0,99
20664,22328908,22328908,22355261,0,0,0,26353
20745,22355318,22355318,22355417,0,0,0,99
20746,22355463,22355463,22355593,0,0,0,130
20747,22355814,22355814,22355892,0,0,0,78
20748,22355894,22355894,22355961,0,0,0,67
20749,22356115,22356115,22356162,0,0,0,47
20750,22356301,22356301,22356430,0,0,0,129
20751,22356745,22356745,22356843,0,0,0,98
20752,22357032,22357032,22357079,0,0,0,47
20753,22357206,22357206,22357284,0,0,0,78
20453,22184652,22184652,22357452,0,0,0,172800
20754,22357363,22357363,22357459,0,0,0,96
20755,22357689,22357689,22357769,0,0,0,80
20756,22357768,22357768,22357835,0,0,0,67
20675,22331196,22331196,22358126,0,0,0,26930
20674,22331154,22331154,22358213,0,0,0,27059
20741,22355035,22355035,22359527,0,0,0,4492
20691,22337004,22337004,22363594,0,0,0,26590
20759,22359490,22359490,22363952,0,0,0,4462
20693,22339760,22339760,22363988,0,0,0,24228
20694,22341062,22341062,22365393,0,0,0,24331
20761,22363908,22363908,22368415,0,0,0,4507
20764,22368359,22368359,22372940,0,0,0,4581
20256,22029496,22029496,22375096,0,0,0,345600
20765,22372877,22372877,22377475,0,0,0,4598
20391,22121543,22121543,22380743,0,0,0,259200
20392,22121552,22121552,22380752,0,0,0,259200
20393,22121571,22121571,22380771,0,0,0,259200
20394,22121576,22121576,22380776,0,0,0,259200
20395,22121581,22121581,22380781,0,0,0,259200
20744,22355202,22355202,22381636,0,0,0,26434
20766,22377413,22377413,22381993,0,0,0,4580
20727,22352105,22352105,22382300,0,0,0,30195
20731,22352364,22352364,22382388,0,0,0,30024
20702,22344835,22344835,22384097,0,0,0,39262
20757,22358060,22358060,22384786,0,0,0,26726
20758,22358150,22358150,22384964,0,0,0,26814
20769,22381931,22381931,22386536,0,0,0,4605
20762,22363921,22363921,22388417,0,0,0,24496
20703,22344905,22344905,22388790,0,0,0,43885
20763,22365322,22365322,22389229,0,0,0,23907
20760,22363524,22363524,22390041,0,0,0,26517
20774,22386467,22386467,22391107,0,0,0,4640
20714,22349448,22349448,22392648,0,0,0,43200
20778,22391044,22391044,22395714,0,0,0,4670
20779,22395659,22395659,22400222,0,0,0,4563
20780,22400176,22400176,22404813,0,0,0,4637
20782,22405821,22405821,22405993,0,0,0,172
20784,22405900,22405900,22406087,0,0,0,187
20783,22405844,22405844,22406118,0,0,0,274
20786,22407505,22407505,22407634,0,0,0,129
20517,22240165,22240165,22407668,0,0,0,167503
20768,22381576,22381576,22408198,0,0,0,26622
20787,22408133,22408133,22408295,0,0,0,162
20788,22408161,22408161,22408297,0,0,0,136
20790,22408265,22408265,22408375,0,0,0,110
20789,22408241,22408241,22408425,0,0,0,184
20796,22408702,22408702,22408800,0,0,0,98
20798,22408993,22408993,22409113,0,0,0,120
20799,22409019,22409019,22409262,0,0,0,243
20781,22404755,22404755,22409380,0,0,0,4625
20797,22408803,22408803,22409703,0,0,0,900
20801,22409470,22409470,22409742,0,0,0,272
20804,22410298,22410298,22410391,0,0,0,93
20803,22410278,22410278,22410961,0,0,0,683
20805,22411068,22411068,22411172,0,0,0,104
20806,22411139,22411139,22411243,0,0,0,104
20772,22384718,22384718,22411495,0,0,0,26777
20808,22411548,22411548,22411658,0,0,0,110
20809,22411626,22411626,22411702,0,0,0,76
20771,22382329,22382329,22411733,0,0,0,29404
20810,22411670,22411670,22411842,0,0,0,172
20773,22384901,22384901,22411902,0,0,0,27001
20770,22382240,22382240,22411926,0,0,0,29686
20775,22388377,22388377,22412363,0,0,0,23986
20815,22412646,22412646,22412744,0,0,0,98
20816,22412854,22412854,22412952,0,0,0,98
20817,22412952,22412952,22412999,0,0,0,47
20818,22413003,22413003,22413087,0,0,0,84
20819,22413157,22413157,22413215,0,0,0,58
20820,22413290,22413290,22413358,0,0,0,68
20776,22389192,22389192,22413392,0,0,0,24200
20821,22413320,22413320,22413397,0,0,0,77
20823,22413360,22413360,22413397,0,0,0,37
20825,22413511,22413511,22413603,0,0,0,92
20829,22413705,22413705,22413765,0,0,0,60
20831,22413730,22413730,22413793,0,0,0,63
20834,22413797,22413797,22413895,0,0,0,98
20800,22409317,22409317,22414083,0,0,0,4766
20830,22413711,22413711,22414190,0,0,0,479
20832,22413738,22413738,22414240,0,0,0,502
20828,22413681,22413681,22414295,0,0,0,614
20837,22414259,22414259,22414326,0,0,0,67
20827,22413661,22413661,22414760,0,0,0,1099
20663,22328642,22328642,22415042,0,0,0,86400
20838,22415235,22415235,22415302,0,0,0,67
20839,22415502,22415502,22415626,0,0,0,124
20826,22413578,22413578,22415694,0,0,0,2116
20840,22415637,22415637,22415694,0,0,0,57
20841,22415658,22415658,22415756,0,0,0,98
20842,22415802,22415802,22415869,0,0,0,67
20824,22413413,22413413,22415870,0,0,0,2457
20843,22415875,22415875,22415957,0,0,0,82
20844,22415957,22415957,22416042,0,0,0,85
20845,22415982,22415982,22416071,0,0,0,89
20846,22416086,22416086,22416153,0,0,0,67
20847,22416189,22416189,22416277,0,0,0,88
20777,22389986,22389986,22416494,0,0,0,26508
20848,22416402,22416402,22416574,0,0,0,172
20849,22416511,22416511,22416682,0,0,0,171
20850,22416619,22416619,22416788,0,0,0,169
20836,22414020,22414020,22418743,0,0,0,4723
20785,22406631,22406631,22419207,0,0,0,12576
20428,22167672,22167672,22420272,0,0,0,252600
20853,22422433,22422433,22422551,0,0,0,118
20854,22422498,22422498,22422592,0,0,0,94
20855,22422529,22422529,22422654,0,0,0,125
20856,22422648,22422648,22422784,0,0,0,136
20857,22422731,22422731,22422814,0,0,0,83
20858,22422748,22422748,22422889,0,0,0,141
20859,22422837,22422837,22422973,0,0,0,136
20861,22423004,22423004,22423082,0,0,0,78
20860,22422937,22422937,22423088,0,0,0,151
20863,22423182,22423182,22423273,0,0,0,91
20852,22418676,22418676,22423331,0,0,0,4655
20697,22343301,22343301,22424301,0,0,0,81000
20865,22424720,22424720,22424844,0,0,0,124
20866,22424845,22424845,22424969,0,0,0,124
20867,22425064,22425064,22425188,0,0,0,124
20868,22425448,22425448,22425509,0,0,0,61
20707,22348124,22348124,22425535,0,0,0,77411
20870,22425635,22425635,22425702,0,0,0,67
20871,22425978,22425978,22426144,0,0,0,166
20873,22426183,22426183,22426783,0,0,0,600
20872,22426118,22426118,22426924,0,0,0,806
20875,22426950,22426950,22427001,0,0,0,51
20862,22423047,22423047,22427266,0,0,0,4219
20874,22426877,22426877,22427270,0,0,0,393
20877,22427227,22427227,22427363,0,0,0,136
20878,22427300,22427300,22427394,0,0,0,94
20869,22425477,22425477,22427582,0,0,0,2105
20879,22427535,22427535,22427602,0,0,0,67
20880,22427634,22427634,22427719,0,0,0,85
20882,22427726,22427726,22427820,0,0,0,94
20883,22427881,22427881,22427928,0,0,0,47
20864,22423273,22423273,22427991,0,0,0,4718
20885,22427940,22427940,22428142,0,0,0,202
20889,22428284,22428284,22428359,0,0,0,75
20891,22428324,22428324,22428423,0,0,0,99
20887,22428238,22428238,22428492,0,0,0,254
20892,22428440,22428440,22428585,0,0,0,145
20893,22428935,22428935,22429112,0,0,0,177
20895,22429218,22429218,22429313,0,0,0,95
20876,22426969,22426969,22429698,0,0,0,2729
20896,22429577,22429577,22429698,0,0,0,121
20894,22429107,22429107,22429707,0,0,0,600
20899,22429655,22429655,22429733,0,0,0,78
20898,22429650,22429650,22429761,0,0,0,111
20900,22429704,22429704,22429773,0,0,0,69
20897,22429628,22429628,22429801,0,0,0,173
20901,22429758,22429758,22430467,0,0,0,709
20903,22430380,22430380,22430511,0,0,0,131
20906,22430480,22430480,22430573,0,0,0,93
20905,22430474,22430474,22430598,0,0,0,124
20904,22430456,22430456,22430798,0,0,0,342
20908,22430703,22430703,22430875,0,0,0,172
20907,22430652,22430652,22431111,0,0,0,459
20912,22431110,22431110,22431194,0,0,0,84
20911,22431050,22431050,22431237,0,0,0,187
20913,22431155,22431155,22431279,0,0,0,124
20914,22431428,22431428,22431537,0,0,0,109
20909,22430995,22430995,22431595,0,0,0,600
20915,22431428,22431428,22431596,0,0,0,168
20916,22431607,22431607,22431772,0,0,0,165
20910,22431021,22431021,22431782,0,0,0,761
20918,22431788,22431788,22431898,0,0,0,110
20833,22413744,22413744,22432013,0,0,0,18269
20921,22431984,22431984,22432149,0,0,0,165
20922,22432046,22432046,22432200,0,0,0,154
20923,22432105,22432105,22432291,0,0,0,186
20924,22432247,22432247,22432369,0,0,0,122
20884,22427927,22427927,22432661,0,0,0,4734
20919,22431911,22431911,22432721,0,0,0,810
20926,22432430,22432430,22433030,0,0,0,600
20917,22431747,22431747,22433332,0,0,0,1585
20929,22433329,22433329,22433461,0,0,0,132
20925,22432336,22432336,22434136,0,0,0,1800
20932,22434241,22434241,22434365,0,0,0,124
20931,22434189,22434189,22434425,0,0,0,236
20933,22434391,22434391,22434469,0,0,0,78
20934,22434615,22434615,22434683,0,0,0,68
20935,22434784,22434784,22434866,0,0,0,82
20936,22434893,22434893,22434992,0,0,0,99
20791,22408344,22408344,22435033,0,0,0,26689
20938,22435356,22435356,22435527,0,0,0,171
20814,22412303,22412303,22436179,0,0,0,23876
20939,22435646,22435646,22436246,0,0,0,600
20928,22432577,22432577,22437248,0,0,0,4671
20822,22413341,22413341,22437670,0,0,0,24329
20945,22438059,22438059,22438133,0,0,0,74
20948,22438060,22438060,22438133,0,0,0,73
20946,22438060,22438060,22438153,0,0,0,93
20949,22438060,22438060,22438153,0,0,0,93
20950,22438061,22438061,22438154,0,0,0,93
20951,22438061,22438061,22438154,0,0,0,93
20952,22438061,22438061,22438154,0,0,0,93
20953,22438061,22438061,22438154,0,0,0,93
20954,22438062,22438062,22438155,0,0,0,93
20947,22438060,22438060,22438164,0,0,0,104
20955,22438062,22438062,22438169,0,0,0,107
20956,22438062,22438062,22438169,0,0,0,107
20957,22438063,22438063,22438173,0,0,0,110
20964,22438064,22438154,22438209,0,0,90,145
20963,22438064,22438154,22438231,0,0,90,167
20807,22411442,22411442,22438236,0,0,0,26794
20959,22438063,22438133,22438237,0,0,70,174
20962,22438064,22438154,22438242,0,0,90,178
20958,22438063,22438133,22438243,0,0,70,180
20960,22438063,22438153,22438246,0,0,90,183
20961,22438064,22438153,22438252,0,0,89,188
20944,22437923,22437923,22438523,0,0,0,600
20812,22411838,22411838,22438783,0,0,0,26945
20969,22439033,22439033,22439143,0,0,0,110
20968,22438790,22438790,22439390,0,0,0,600
20991,22439804,22439804,22440094,0,0,0,290
20990,22439748,22439748,22440248,0,0,0,500
20966,22438589,22438589,22440338,0,0,0,1749
20992,22440415,22440415,22440940,0,0,0,525
21093,22440999,22440999,22441077,0,0,0,78
21094,22441258,22441258,22441387,0,0,0,129
20813,22411870,22411870,22441522,0,0,0,29652
21096,22441695,22441695,22441765,0,0,0,70
21097,22441731,22441731,22441767,0,0,0,36
20940,22437197,22437197,22441845,0,0,0,4648
20811,22411780,22411780,22441937,0,0,0,30157
21099,22441874,22441874,22442046,0,0,0,172
21102,22442187,22442187,22442223,0,0,0,36
21101,22442157,22442157,22442224,0,0,0,67
21103,22442349,22442349,22442407,0,0,0,58
21104,22442394,22442394,22442560,0,0,0,166
20851,22416726,22416726,22443165,0,0,0,26439
20368,22097698,22097698,22443298,0,0,0,345600
21106,22443211,22443211,22443332,0,0,0,121
21109,22443898,22443898,22444022,0,0,0,124
20941,22437528,22437528,22444128,0,0,0,6600
20943,22437734,22437734,22444334,0,0,0,6600
21107,22443798,22443798,22444384,0,0,0,586
21108,22443896,22444128,22444854,0,0,232,958
20976,22439604,22439604,22445040,0,0,0,5436
20970,22439604,22439604,22445044,0,0,0,5440
20973,22439604,22439604,22445061,0,0,0,5457
20980,22439605,22439605,22445066,0,0,0,5461
20979,22439605,22439605,22445072,0,0,0,5467
20981,22439605,22439605,22445072,0,0,0,5467
20982,22439605,22439605,22445125,0,0,0,5520
20974,22439604,22439604,22445357,0,0,0,5753
20975,22439604,22439604,22445373,0,0,0,5769
20978,22439605,22439605,22445384,0,0,0,5779
20971,22439604,22439604,22445643,0,0,0,6039
20977,22439605,22439605,22445665,0,0,0,6060
20972,22439604,22439604,22445682,0,0,0,6078
21098,22441789,22441789,22446454,0,0,0,4665
21110,22445828,22445828,22446603,0,0,0,775
20983,22439605,22443298,22449067,0,0,3693,9462
20984,22439606,22445040,22450507,0,0,5434,10901
20985,22439606,22445044,22450511,0,0,5438,10905
20986,22439606,22445061,22450528,0,0,5455,10922
20993,22440522,22445125,22450592,0,0,4603,10070
20987,22439606,22445066,22450804,0,0,5460,11198
20988,22439606,22445072,22450841,0,0,5466,11235
20994,22440523,22445357,22450866,0,0,4834,10343
20989,22439606,22445072,22451102,0,0,5466,11496
20995,22440523,22445373,22451111,0,0,4850,10588
20997,22440524,22445643,22451152,0,0,5119,10628
21111,22446398,22446454,22451173,0,0,56,4775
20996,22440523,22445384,22451402,0,0,4861,10879
20998,22440524,22445665,22451434,0,0,5141,10910
20999,22440524,22445682,22451774,0,0,5158,11250
20792,22408394,22408394,22452622,0,0,0,44228
21112,22451059,22451059,22455756,0,0,0,4697
21001,22440525,22450507,22456016,0,0,9982,15491
21002,22440525,22450511,22456063,0,0,9986,15538
21005,22440526,22450804,22456313,0,0,10278,15787
21003,22440525,22450528,22456340,0,0,10003,15815
21009,22440527,22451111,22456577,0,0,10584,16050
21006,22440526,22450841,22456610,0,0,10315,16084
21010,22440527,22451152,22456618,0,0,10625,16091
21007,22440526,22450866,22456635,0,0,10340,16109
21004,22440525,22450592,22456653,0,0,10067,16128
21011,22440527,22451402,22456868,0,0,10875,16341
21008,22440526,22451102,22456945,0,0,10576,16419
21012,22440528,22451434,22457203,0,0,10906,16675
21013,22440608,22451774,22457240,0,0,11166,16632
21015,22440608,22452622,22458080,0,0,12014,17472
21014,22440608,22452622,22458088,0,0,12014,17480
21017,22440609,22452622,22458387,0,0,12013,17778
21018,22440609,22452622,22458680,0,0,12013,18071
21016,22440609,22452622,22458686,0,0,12013,18077
21113,22455693,22455693,22460422,0,0,0,4729
21019,22440609,22456016,22461478,0,0,15407,20869
20937,22434991,22434991,22461535,0,0,0,26544
21022,22440610,22456340,22461824,0,0,15730,21214
21020,22440610,22456063,22461848,0,0,15453,21238
20942,22437607,22437607,22461856,0,0,0,24249
21023,22440610,22456577,22462048,0,0,15967,21438
21021,22440610,22456313,22462094,0,0,15703,21484
21026,22440611,22456635,22462119,0,0,16024,21508
21024,22440611,22456610,22462369,0,0,15999,21758
21030,22440612,22457203,22462671,0,0,16591,22059
21025,22440611,22456618,22462676,0,0,16007,22065
21027,22440611,22456653,22462695,0,0,16042,22084
21028,22440612,22456868,22462934,0,0,16256,22322
21029,22440612,22456945,22462980,0,0,16333,22368
21031,22440612,22457240,22463297,0,0,16628,22685
20470,22204341,22204341,22463541,0,0,0,259200
20472,22204342,22204342,22463542,0,0,0,259200
20473,22204342,22204342,22463542,0,0,0,259200
20474,22204342,22204342,22463542,0,0,0,259200
20475,22204342,22204342,22463542,0,0,0,259200
20476,22204342,22204342,22463542,0,0,0,259200
21032,22440612,22458080,22463848,0,0,17468,23236
20477,22204745,22204745,22463945,0,0,0,259200
21033,22440626,22458088,22464127,0,0,17462,23501
20478,22204973,22204973,22464173,0,0,0,259200
21034,22440626,22458387,22464214,0,0,17761,23588
21036,22440627,22458686,22464441,0,0,18059,23814
21035,22440626,22458680,22464728,0,0,18054,24102
21114,22460381,22460381,22465024,0,0,0,4643
20480,22205845,22205845,22465045,0,0,0,259200
20965,22438192,22438192,22465144,0,0,0,26952
20967,22438717,22438717,22465328,0,0,0,26611
21037,22440627,22461478,22466960,0,0,20851,26333
21038,22440627,22461824,22467286,0,0,21197,26659
21039,22440627,22461848,22467616,0,0,21221,26989
21040,22440627,22462048,22467847,0,0,21421,27220
21042,22440627,22462119,22467890,0,0,21492,27263
21043,22440628,22462369,22468131,0,0,21741,27503
21041,22440627,22462094,22468152,0,0,21467,27525
21044,22440628,22462671,22468434,0,0,22043,27806
21048,22440628,22462980,22468446,0,0,22352,27818
21045,22440628,22462676,22468470,0,0,22048,27842
21047,22440628,22462934,22468677,0,0,22306,28049
21046,22440628,22462695,22468730,0,0,22067,28102
21049,22440629,22463297,22469104,0,0,22668,28475
21050,22440629,22463542,22469307,0,0,22913,28678
21051,22440630,22463848,22469340,0,0,23218,28710
21053,22440658,22464127,22469586,0,0,23469,28928
20930,22433599,22433599,22469599,0,0,0,36000
21128,22464992,22464992,22469614,0,0,0,4622
21054,22440660,22464214,22469680,0,0,23554,29020
21105,22443121,22443121,22469689,0,0,0,26568
21052,22440630,22463945,22469998,0,0,23315,29368
21055,22440660,22464441,22470169,0,0,23781,29509
21056,22440660,22464728,22470241,0,0,24068,29581
21095,22441480,22441480,22471438,0,0,0,29958
21100,22441985,22441985,22471590,0,0,0,29605
21058,22440661,22467286,22472748,0,0,26625,32087
21057,22440660,22466960,22472998,0,0,26300,32338
21000,22440524,22449067,22473065,0,0,8543,32541
21060,22440661,22467847,22473326,0,0,27186,32665
21059,22440661,22467616,22473385,0,0,26955,32724
21062,22440662,22468131,22473592,0,0,27469,32930
21063,22440662,22468152,22473593,0,0,27490,32931
21061,22440661,22467890,22473656,0,0,27229,32995
21066,22440663,22468470,22473974,0,0,27807,33311
21067,22440663,22468677,22474150,0,0,28014,33487
21064,22440662,22468434,22474186,0,0,27772,33524
21065,22440662,22468446,22474500,0,0,27784,33838
21070,22440664,22469307,22474775,0,0,28643,34111
21068,22440663,22468730,22474808,0,0,28067,34145
21071,22440664,22469340,22474839,0,0,28676,34175
21069,22440663,22469104,22474886,0,0,28441,34223
21073,22440683,22469599,22475074,0,0,28916,34391
21135,22471367,22475074,22475256,0,0,3707,3889
21136,22471485,22475256,22475402,0,0,3771,3917
21075,22440684,22469998,22475471,0,0,29314,34787
21072,22440664,22469586,22475660,0,0,28922,34996
21074,22440684,22469680,22475739,0,0,28996,35055
21076,22440684,22470169,22475897,0,0,29485,35213
21077,22440684,22470241,22475995,0,0,29557,35311
21078,22440685,22472748,22478196,0,0,32063,37511
21079,22440685,22472998,22478798,0,0,32313,38113
21081,22440685,22473326,22478804,0,0,32641,38119
21080,22440685,22473065,22478831,0,0,32380,38146
21082,22440686,22473385,22478863,0,0,32699,38177
21083,22440686,22473592,22479066,0,0,32906,38380
21085,22440686,22473656,22479141,0,0,32970,38455
21139,22474048,22474886,22479416,0,0,838,5368
21086,22440687,22473974,22479443,0,0,33287,38756
21133,22469547,22474886,22479457,0,0,5339,9910
21087,22440687,22474150,22479612,0,0,33463,38925
21084,22440686,22473593,22479619,0,0,32907,38933
21088,22440687,22474186,22479663,0,0,33499,38976
21089,22440687,22474500,22480531,0,0,33813,39844
21090,22440687,22474775,22480858,0,0,34088,40171
21091,22440688,22474808,22480891,0,0,34120,40203
21092,22440688,22474839,22480953,0,0,34151,40265
21140,22478543,22478543,22483175,0,0,0,4632
21119,22461791,22461856,22485993,0,0,65,24202
21141,22483113,22483175,22487762,0,0,62,4649
21117,22461493,22461535,22488033,0,0,42,26540
20886,22428223,22428223,22490989,0,0,0,62766
20888,22428250,22428250,22491223,0,0,0,62973
20902,22430297,22430297,22491319,0,0,0,61022
21143,22487637,22487762,22492357,0,0,125,4720
21150,22495838,22495838,22496148,0,0,0,310
21129,22465081,22469689,22496351,0,0,4608,31270
21153,22496510,22496510,22496616,0,0,0,106
21146,22492170,22492170,22496690,0,0,0,4520
21155,22496583,22496583,22496754,0,0,0,171
21158,22496918,22496918,22497427,0,0,0,509
21130,22465300,22471438,22498488,0,0,6138,33188
21160,22497098,22498488,22498561,0,0,1390,1463
21157,22496828,22496828,22498628,0,0,0,1800
21168,22498208,22498208,22498633,0,0,0,425
21161,22497182,22498561,22498654,0,0,1379,1472
21162,22497372,22498628,22498721,0,0,1256,1349
21163,22497399,22498654,22498800,0,0,1255,1401
21166,22497844,22498721,22498814,0,0,877,970
21170,22498960,22498960,22499040,0,0,0,80
21172,22499031,22499031,22499129,0,0,0,98
21159,22496933,22497427,22499227,0,0,494,2294
21173,22499543,22499543,22499678,0,0,0,135
21175,22499780,22499780,22499847,0,0,0,67
21174,22499645,22499678,22499849,0,0,33,204
21176,22499849,22499849,22500020,0,0,0,171
21178,22500168,22500168,22500328,0,0,0,160
20523,22241401,22241401,22500601,0,0,0,259200
21171,22498978,22498978,22500740,0,0,0,1762
21179,22500687,22500687,22500812,0,0,0,125
21180,22500807,22500807,22500958,0,0,0,151
21156,22496644,22496644,22501165,0,0,0,4521
21177,22499892,22499892,22501692,0,0,0,1800
21134,22469622,22474886,22501826,0,0,5264,32204
21183,22501216,22501692,22501856,0,0,476,640
21185,22501580,22501580,22501942,0,0,0,362
21184,22501413,22501826,22502324,0,0,413,911
21188,22502234,22502234,22502927,0,0,0,693
21189,22503550,22503550,22504243,0,0,0,693
21190,22504513,22504513,22504884,0,0,0,371
21137,22471521,22475402,22505153,0,0,3881,33632
21138,22471587,22475471,22505357,0,0,3884,33770
21182,22501124,22501124,22505647,0,0,0,4523
21181,22500829,22500829,22506387,0,0,0,5558
20890,22428303,22428303,22506439,0,0,0,78136
21164,22497541,22506439,22506532,0,0,8898,8991
21167,22498134,22506532,22506641,0,0,8398,8507
21191,22505351,22506641,22506734,0,0,1290,1383
21194,22507029,22507029,22507238,0,0,0,209
21196,22507340,22507340,22507527,0,0,0,187
21193,22505768,22505768,22507568,0,0,0,1800
21197,22507387,22507387,22507611,0,0,0,224
21198,22507579,22507579,22507723,0,0,0,144
21199,22507726,22507726,22507877,0,0,0,151
21201,22507927,22507927,22508045,0,0,0,118
20706,22347472,22347472,22508065,0,0,0,160593
21203,22508301,22508301,22508912,0,0,0,611
21195,22507093,22507093,22508915,0,0,0,1822
21204,22508819,22508819,22509408,0,0,0,589
21200,22507846,22507846,22509646,0,0,0,1800
21142,22485951,22485993,22510101,0,0,42,24150
21192,22505583,22505583,22510133,0,0,0,4550
21208,22510140,22510140,22510207,0,0,0,67
21205,22509990,22509990,22511492,0,0,0,1502
21210,22511079,22511079,22511918,0,0,0,839
21214,22512559,22512559,22512626,0,0,0,67
21215,22512629,22512629,22512696,0,0,0,67
21213,22512394,22512394,22512965,0,0,0,571
21211,22511612,22511612,22513090,0,0,0,1478
21216,22512733,22512733,22513117,0,0,0,384
21217,22512868,22513090,22513214,0,0,222,346
21218,22513606,22513606,22513688,0,0,0,82
21219,22513651,22513651,22513718,0,0,0,67
21220,22513714,22513714,22513761,0,0,0,47
21212,22511842,22511842,22513788,0,0,0,1946
21221,22513807,22513807,22513885,0,0,0,78
21207,22510070,22510070,22513917,0,0,0,3847
21222,22513807,22513807,22514195,0,0,0,388
21223,22514388,22514388,22514484,0,0,0,96
21224,22514452,22514452,22514541,0,0,0,89
21144,22487971,22488033,22514649,0,0,62,26678
21226,22514567,22514567,22514867,0,0,0,300
21225,22514505,22514505,22514872,0,0,0,367
21228,22515297,22515297,22515609,0,0,0,312
21230,22515832,22515832,22515879,0,0,0,47
21231,22515975,22515975,22516230,0,0,0,255
21233,22516199,22516199,22516458,0,0,0,259
21232,22516190,22516190,22516539,0,0,0,349
21234,22516417,22516417,22516829,0,0,0,412
21238,22516978,22516978,22517045,0,0,0,67
21237,22516922,22516922,22517301,0,0,0,379
21235,22516539,22516539,22517408,0,0,0,869
21229,22515620,22515620,22517420,0,0,0,1800
21243,22517855,22517855,22517933,0,0,0,78
21145,22491746,22491746,22518440,0,0,0,26694
21245,22518387,22518387,22518472,0,0,0,85
21147,22492289,22492289,22518792,0,0,0,26503
21239,22517394,22517394,22519172,0,0,0,1778
21227,22514577,22514577,22519587,0,0,0,5010
21248,22519205,22519205,22519615,0,0,0,410
21251,22520142,22520142,22520323,0,0,0,181
21244,22518033,22518033,22520392,0,0,0,2359
21253,22520286,22520286,22520396,0,0,0,110
21256,22520759,22520759,22520839,0,0,0,80
21257,22520894,22520894,22520962,0,0,0,68
21259,22521122,22521122,22521189,0,0,0,67
21249,22519580,22519580,22521380,0,0,0,1800
21262,22521466,22521466,22521601,0,0,0,135
21263,22521564,22521564,22522820,0,0,0,1256
21152,22496509,22496509,22523436,0,0,0,26927
21265,22522916,22522916,22523567,0,0,0,651
21268,22524346,22524346,22524560,0,0,0,214
21250,22519596,22519596,22524580,0,0,0,4984
21270,22524908,22524908,22525327,0,0,0,419
21273,22526058,22526058,22526483,0,0,0,425
21274,22526603,22526603,22526815,0,0,0,212
21202,22507982,22507982,22529582,0,0,0,21600
21240,22517609,22529582,22529675,0,0,11973,12066
21241,22517625,22529675,22529768,0,0,12050,12143
21255,22520696,22529768,22529861,0,0,9072,9165
21258,22521042,22529861,22529985,0,0,8819,8943
21260,22521194,22529985,22530109,0,0,8791,8915
21266,22523600,22530109,22530561,0,0,6509,6961
21269,22524376,22530561,22531023,0,0,6185,6647
21242,22517668,22523567,22531047,0,0,5899,13379
21271,22524957,22531023,22531426,0,0,6066,6469
21276,22527758,22531047,22531590,0,0,3289,3832
21186,22501585,22501856,22532006,0,0,271,30421
21277,22529347,22531426,22532421,0,0,2079,3074
21187,22502072,22502324,22532486,0,0,252,30414
21280,22532091,22532421,22532598,0,0,330,507
21282,22532202,22532486,22532658,0,0,284,456
21279,22530741,22532006,22532740,0,0,1265,1999
21283,22532316,22532598,22532796,0,0,282,480
21206,22510038,22510038,22534071,0,0,0,24033
21247,22518782,22518792,22545428,0,0,10,26646
21246,22518440,22518440,22545546,0,0,0,27106
20627,22289318,22289318,22548518,0,0,0,259200
20628,22289318,22289318,22548518,0,0,0,259200
20629,22289319,22289319,22548519,0,0,0,259200
20630,22289319,22289319,22548519,0,0,0,259200
20631,22289348,22289348,22548548,0,0,0,259200
20632,22289349,22289349,22548549,0,0,0,259200
21289,22542308,22548518,22548591,0,0,6210,6283
20795,22408533,22408533,22549352,0,0,0,140819
21151,22496501,22549352,22549869,0,0,52851,53368
21165,22497716,22549869,22549963,0,0,52153,52247
21288,22537536,22545546,22549988,0,0,8010,12452
20633,22290791,22290791,22549991,0,0,0,259200
21169,22498282,22549963,22550056,0,0,51681,51774
21254,22520327,22550056,22550153,0,0,29729,29826
21290,22542339,22548519,22550186,0,0,6180,7847
21264,22522034,22550153,22550270,0,0,28119,28236
21267,22523680,22524580,22551075,0,0,900,27395
21272,22525850,22531047,22557237,0,0,5197,31387
21281,22532154,22532421,22561990,0,0,267,29836
20635,22290968,22290968,22562105,0,0,0,271137
21284,22532469,22532658,22562531,0,0,189,30062
21285,22534073,22545428,22569628,0,0,11355,35555
21292,22545916,22548591,22575166,0,0,2675,29250
21300,22550120,22550120,22576549,0,0,0,26429
21293,22546226,22549869,22576921,0,0,3643,30695
21302,22551980,22551980,22578218,0,0,0,26238
21312,22576510,22576510,22581548,0,0,0,5038
21303,22558229,22558229,22582639,0,0,0,24410
21318,22581854,22581854,22583654,0,0,0,1800
21321,22584065,22584065,22584159,0,0,0,94
21320,22584027,22584027,22584259,0,0,0,232
21322,22584155,22584155,22584259,0,0,0,104
21324,22584958,22584958,22585211,0,0,0,253
21326,22586433,22586433,22586794,0,0,0,361
20835,22413997,22413997,22586797,0,0,0,172800
21329,22586434,22586434,22586981,0,0,0,547
21338,22586497,22586497,22587003,0,0,0,506
21327,22586433,22586433,22587033,0,0,0,600
21328,22586433,22586433,22587033,0,0,0,600
21330,22586434,22586434,22587034,0,0,0,600
21331,22586434,22586434,22587034,0,0,0,600
21332,22586434,22586434,22587034,0,0,0,600
21333,22586434,22586434,22587034,0,0,0,600
21334,22586435,22586435,22587035,0,0,0,600
21335,22586435,22586435,22587035,0,0,0,600
21336,22586435,22586435,22587035,0,0,0,600
21337,22586435,22586435,22587035,0,0,0,600
21339,22586497,22586497,22587097,0,0,0,600
21340,22586497,22586497,22587097,0,0,0,600
21341,22586498,22586498,22587098,0,0,0,600
21342,22586498,22586498,22587098,0,0,0,600
21343,22586498,22586498,22587098,0,0,0,600
21344,22586498,22586498,22587098,0,0,0,600
21345,22586499,22586499,22587099,0,0,0,600
20794,22408487,22408487,22587279,0,0,0,178792
21349,22587713,22587713,22588313,0,0,0,600
21350,22587713,22587713,22588313,0,0,0,600
21351,22587714,22587714,22588314,0,0,0,600
21352,22587714,22587714,22588314,0,0,0,600
21353,22587714,22587714,22588314,0,0,0,600
21354,22587714,22587714,22588314,0,0,0,600
21355,22587715,22587715,22588315,0,0,0,600
21356,22587715,22587715,22588315,0,0,0,600
21357,22587715,22587715,22588315,0,0,0,600
21358,22587715,22587715,22588315,0,0,0,600
21359,22587716,22587716,22588316,0,0,0,600
21360,22587716,22587716,22588316,0,0,0,600
21361,22587716,22587716,22588316,0,0,0,600
21362,22587717,22587717,22588317,0,0,0,600
21363,22587717,22587717,22588317,0,0,0,600
21364,22587717,22587717,22588317,0,0,0,600
21365,22587717,22587717,22588317,0,0,0,600
21366,22587718,22587718,22588318,0,0,0,600
21367,22587718,22587718,22588318,0,0,0,600
21368,22587718,22587718,22588318,0,0,0,600
21370,22588900,22588900,22589140,0,0,0,240
21381,22589168,22589168,22589266,0,0,0,98
21376,22588902,22588902,22589291,0,0,0,389
21377,22588902,22588902,22589333,0,0,0,431
21371,22588900,22588900,22589500,0,0,0,600
21372,22588900,22588900,22589500,0,0,0,600
21373,22588901,22588901,22589501,0,0,0,600
21374,22588901,22588901,22589501,0,0,0,600
21375,22588901,22588901,22589501,0,0,0,600
21378,22588902,22588902,22589502,0,0,0,600
21379,22588902,22588902,22589502,0,0,0,600
21387,22590119,22590119,22590367,0,0,0,248
21395,22590121,22590121,22590369,0,0,0,248
21388,22590119,22590119,22590719,0,0,0,600
21389,22590119,22590119,22590719,0,0,0,600
21390,22590120,22590120,22590720,0,0,0,600
21391,22590120,22590120,22590720,0,0,0,600
21392,22590120,22590120,22590720,0,0,0,600
21393,22590120,22590120,22590720,0,0,0,600
21394,22590120,22590120,22590720,0,0,0,600
21396,22590121,22590121,22590721,0,0,0,600
21397,22591252,22591252,22591424,0,0,0,172
21398,22591360,22591424,22591596,0,0,64,236
21304,22561672,22561990,22591638,0,0,318,29966
21399,22591473,22591596,22591794,0,0,123,321
21400,22591623,22591638,22591815,0,0,15,192
21401,22591737,22591794,22591964,0,0,57,227
21402,22591851,22591851,22592022,0,0,0,171
21305,22562278,22562278,22592647,0,0,0,30369
21385,22589296,22589296,22592896,0,0,0,3600
21404,22592522,22592522,22593122,0,0,0,600
21405,22592522,22592522,22593122,0,0,0,600
21406,22592522,22592522,22593122,0,0,0,600
21407,22592523,22592523,22593123,0,0,0,600
21408,22592523,22592523,22593123,0,0,0,600
21409,22592523,22592523,22593123,0,0,0,600
21410,22592523,22592523,22593123,0,0,0,600
21411,22592523,22592523,22593123,0,0,0,600
21412,22592524,22592524,22593124,0,0,0,600
21413,22592524,22592524,22593124,0,0,0,600
20679,22334197,22334197,22593397,0,0,0,259200
21261,22521326,22530109,22593428,0,0,8783,72102
21236,22516777,22517420,22593504,0,0,643,76727
20680,22334349,22334349,22593549,0,0,0,259200
21306,22571450,22593504,22593608,0,0,22054,22158
21307,22572224,22593608,22593701,0,0,21384,21477
20681,22334502,22334502,22593702,0,0,0,259200
21309,22572745,22593701,22593794,0,0,20956,21049
21310,22573168,22593794,22593902,0,0,20626,20734
21291,22544848,22593397,22593972,0,0,48549,49124
21311,22573343,22593902,22594006,0,0,20559,20663
21415,22593683,22593702,22594114,0,0,19,431
21417,22594488,22594488,22594581,0,0,0,93
21418,22594704,22594704,22594782,0,0,0,78
21419,22594755,22594782,22594924,0,0,27,169
21416,22593854,22593972,22594954,0,0,118,1100
21424,22594926,22594926,22595315,0,0,0,389
21420,22594925,22594925,22595525,0,0,0,600
21421,22594925,22594925,22595525,0,0,0,600
21422,22594925,22594925,22595525,0,0,0,600
21423,22594925,22594925,22595525,0,0,0,600
21425,22594926,22594926,22595526,0,0,0,600
21426,22594926,22594926,22595526,0,0,0,600
21427,22594926,22594926,22595526,0,0,0,600
21428,22594926,22594926,22595526,0,0,0,600
21429,22594927,22594927,22595527,0,0,0,600
21437,22595724,22595724,22595971,0,0,0,247
21441,22596775,22596775,22596891,0,0,0,116
21442,22596855,22596855,22597000,0,0,0,145
21286,22535103,22587279,22597355,0,0,52176,62252
21316,22578560,22597355,22597448,0,0,18795,18888
21447,22597334,22597334,22597576,0,0,0,242
21445,22597148,22597148,22597587,0,0,0,439
21451,22597335,22597335,22597658,0,0,0,323
21457,22597520,22597520,22597756,0,0,0,236
21456,22597519,22597519,22597910,0,0,0,391
21446,22597328,22597328,22597928,0,0,0,600
21448,22597334,22597334,22597934,0,0,0,600
21449,22597334,22597334,22597934,0,0,0,600
21450,22597334,22597334,22597934,0,0,0,600
21452,22597335,22597335,22597935,0,0,0,600
21453,22597335,22597335,22597935,0,0,0,600
21454,22597335,22597335,22597935,0,0,0,600
21455,22597336,22597336,22597936,0,0,0,600
21461,22597521,22597521,22598046,0,0,0,525
21458,22597520,22597520,22598120,0,0,0,600
21459,22597520,22597520,22598120,0,0,0,600
21460,22597520,22597520,22598120,0,0,0,600
21462,22597521,22597521,22598121,0,0,0,600
21463,22597521,22597521,22598121,0,0,0,600
21464,22597521,22597521,22598121,0,0,0,600
21465,22597521,22597576,22598176,0,0,55,655
21467,22598161,22598161,22598199,0,0,0,38
21475,22598724,22598724,22598940,0,0,0,216
21468,22598342,22598342,22599031,0,0,0,689
21472,22598723,22598723,22599125,0,0,0,402
21476,22598724,22598724,22599199,0,0,0,475
21470,22598722,22598722,22599322,0,0,0,600
21471,22598722,22598722,22599322,0,0,0,600
21473,22598723,22598723,22599323,0,0,0,600
21474,22598723,22598723,22599323,0,0,0,600
21477,22598724,22598724,22599324,0,0,0,600
21478,22598724,22598724,22599324,0,0,0,600
21308,22572432,22572432,22599388,0,0,0,26956
21482,22599423,22599423,22599488,0,0,0,65
21495,22599811,22599811,22600021,0,0,0,210
21483,22599471,22599471,22600150,0,0,0,679
21485,22599736,22599736,22600336,0,0,0,600
21486,22599736,22599736,22600336,0,0,0,600
21487,22599737,22599737,22600337,0,0,0,600
21488,22599737,22599737,22600337,0,0,0,600
21489,22599737,22599737,22600337,0,0,0,600
21490,22599737,22599737,22600337,0,0,0,600
21491,22599738,22599738,22600338,0,0,0,600
21492,22599738,22599738,22600338,0,0,0,600
21493,22599738,22599738,22600338,0,0,0,600
21494,22599738,22599738,22600338,0,0,0,600
21496,22600446,22600446,22600786,0,0,0,340
21498,22600749,22600749,22600820,0,0,0,71
21430,22594979,22599388,22601120,0,0,4409,6141
21505,22601127,22601127,22601343,0,0,0,216
21501,22601126,22601126,22601373,0,0,0,247
21502,22601126,22601126,22601466,0,0,0,340
21500,22601125,22601125,22601682,0,0,0,557
21503,22601126,22601126,22601726,0,0,0,600
21504,22601126,22601126,22601726,0,0,0,600
21506,22601127,22601127,22601727,0,0,0,600
21507,22601127,22601127,22601727,0,0,0,600
21508,22601127,22601127,22601727,0,0,0,600
21287,22536892,22587279,22601853,0,0,50387,64961
21438,22595971,22601853,22601985,0,0,5882,6014
21432,22595321,22601853,22602019,0,0,6532,6698
21440,22596659,22601985,22602137,0,0,5326,5478
21443,22596906,22602019,22602174,0,0,5113,5268
21469,22598519,22602137,22602274,0,0,3618,3755
21479,22598782,22602174,22602329,0,0,3392,3547
21509,22602139,22602139,22602348,0,0,0,209
21480,22599136,22602274,22602429,0,0,3138,3293
21519,22602297,22602297,22602559,0,0,0,262
21510,22602139,22602139,22602739,0,0,0,600
21511,22602139,22602139,22602739,0,0,0,600
21512,22602139,22602139,22602739,0,0,0,600
21513,22602160,22602160,22602760,0,0,0,600
21514,22602161,22602161,22602761,0,0,0,600
21515,22602161,22602161,22602761,0,0,0,600
21516,22602161,22602161,22602761,0,0,0,600
21517,22602161,22602161,22602761,0,0,0,600
21518,22602162,22602162,22602762,0,0,0,600
21522,22603529,22603529,22603787,0,0,0,258
21526,22603530,22603530,22603788,0,0,0,258
21275,22526788,22550270,22603942,0,0,23482,77154
21527,22603530,22603530,22604047,0,0,0,517
21528,22603530,22603530,22604078,0,0,0,548
21520,22603528,22603528,22604107,0,0,0,579
21521,22603528,22603528,22604107,0,0,0,579
21523,22603529,22603529,22604129,0,0,0,600
21524,22603529,22603529,22604129,0,0,0,600
21525,22603529,22603529,22604129,0,0,0,600
21529,22603530,22603530,22604130,0,0,0,600
21530,22604252,22604252,22604351,0,0,0,99
21314,22578156,22578156,22604708,0,0,0,26552
21497,22600497,22604708,22604884,0,0,4211,4387
21499,22600779,22604884,22605016,0,0,4105,4237
21533,22604563,22604563,22605142,0,0,0,579
21531,22604562,22604562,22605162,0,0,0,600
21532,22604562,22604562,22605162,0,0,0,600
21534,22604563,22604563,22605163,0,0,0,600
21535,22604563,22604563,22605163,0,0,0,600
21536,22604563,22604563,22605163,0,0,0,600
21537,22604564,22604564,22605164,0,0,0,600
21538,22604564,22604564,22605164,0,0,0,600
21539,22604564,22604564,22605164,0,0,0,600
21540,22604564,22604564,22605164,0,0,0,600
21542,22605360,22605360,22605459,0,0,0,99
21543,22605638,22605638,22605823,0,0,0,185
21323,22584448,22603942,22606073,0,0,19494,21625
21544,22605931,22605931,22606086,0,0,0,155
21431,22595162,22606073,22606135,0,0,10911,10973
21439,22595997,22606135,22606238,0,0,10138,10241
21545,22605931,22605931,22606531,0,0,0,600
21546,22605931,22605931,22606531,0,0,0,600
21547,22605932,22605932,22606532,0,0,0,600
21548,22605932,22605932,22606532,0,0,0,600
21549,22605932,22605932,22606532,0,0,0,600
21550,22605932,22605932,22606532,0,0,0,600
21551,22605932,22605932,22606532,0,0,0,600
21552,22605933,22605933,22606533,0,0,0,600
21553,22605933,22605933,22606533,0,0,0,600
21319,22582578,22582578,22606596,0,0,0,24018
21466,22597605,22606073,22606761,0,0,8468,9156
21555,22606965,22606965,22607189,0,0,0,224
21558,22606966,22606966,22607266,0,0,0,300
21565,22607353,22607353,22607390,0,0,0,37
21563,22607008,22607008,22607422,0,0,0,414
21556,22606965,22606965,22607565,0,0,0,600
21557,22606965,22606965,22607565,0,0,0,600
21559,22606966,22606966,22607566,0,0,0,600
21560,22606966,22606966,22607566,0,0,0,600
21561,22606966,22606966,22607566,0,0,0,600
21562,22606966,22606966,22607566,0,0,0,600
21564,22607008,22607008,22607608,0,0,0,600
20708,22348559,22348559,22607759,0,0,0,259200
21317,22581487,22581487,22607809,0,0,0,26322
21576,22608336,22608336,22608502,0,0,0,166
21572,22608335,22608335,22608687,0,0,0,352
21579,22608461,22608461,22608762,0,0,0,301
21573,22608335,22608335,22608895,0,0,0,560
21574,22608335,22608335,22608926,0,0,0,591
21577,22608336,22608336,22608927,0,0,0,591
21569,22608334,22608334,22608934,0,0,0,600
21570,22608334,22608334,22608934,0,0,0,600
21571,22608334,22608334,22608934,0,0,0,600
21575,22608335,22608335,22608935,0,0,0,600
21578,22608336,22608336,22608936,0,0,0,600
21586,22609538,22609538,22609677,0,0,0,139
21582,22609537,22609537,22610101,0,0,0,564
21587,22609538,22609538,22610102,0,0,0,564
21583,22609537,22609537,22610137,0,0,0,600
21584,22609537,22609537,22610137,0,0,0,600
21585,22609537,22609537,22610137,0,0,0,600
21588,22609538,22609538,22610138,0,0,0,600
21325,22585536,22597448,22612942,0,0,11912,27406
21568,22608299,22612942,22613109,0,0,4643,4810
21581,22608773,22613109,22613264,0,0,4336,4491
21589,22609995,22613264,22613432,0,0,3269,3437
21591,22610511,22613432,22613556,0,0,2921,3045
21599,22614673,22614673,22614740,0,0,0,67
21315,22578389,22594954,22614762,0,0,16565,36373
21590,22610030,22614762,22615014,0,0,4732,4984
21600,22614984,22614984,22615073,0,0,0,89
21592,22610650,22615014,22615468,0,0,4364,4818
21313,22577876,22594006,22616374,0,0,16130,38498
21601,22615034,22616374,22616540,0,0,1340,1506
21598,22614367,22614367,22619064,0,0,0,4697
21566,22607394,22612942,22620313,0,0,5548,12919
21414,22592579,22592579,22622008,0,0,0,29429
21580,22608730,22608762,22622045,0,0,32,13315
21403,22591960,22591964,22622065,0,0,4,30105
21604,22622017,22622017,22622163,0,0,0,146
21603,22621973,22621973,22622327,0,0,0,354
21602,22620860,22620860,22623240,0,0,0,2380
21594,22610653,22616374,22624191,0,0,5721,13538
21608,22625505,22625505,22625573,0,0,0,68
21609,22625594,22625594,22625679,0,0,0,85
21611,22625742,22625742,22625809,0,0,0,67
21607,22624863,22624863,22625902,0,0,0,1039
21612,22625938,22625938,22626006,0,0,0,68
21613,22625954,22625954,22626006,0,0,0,52
21614,22625964,22625964,22626031,0,0,0,67
21615,22626037,22626037,22626084,0,0,0,47
21616,22626170,22626170,22626222,0,0,0,52
21617,22626181,22626181,22626248,0,0,0,67
21618,22626256,22626256,22626324,0,0,0,68
21619,22626278,22626278,22626330,0,0,0,52
21620,22626290,22626290,22626373,0,0,0,83
21621,22626338,22626338,22626421,0,0,0,83
21622,22626373,22626373,22626451,0,0,0,78
21624,22627004,22627004,22627067,0,0,0,63
21623,22626645,22626645,22627694,0,0,0,1049
21481,22599318,22602329,22628721,0,0,3011,29403
21625,22628059,22628059,22628928,0,0,0,869
21484,22599666,22602429,22629182,0,0,2763,29516
21626,22629088,22629088,22630080,0,0,0,992
21627,22630174,22630174,22630247,0,0,0,73
21554,22606595,22606595,22630460,0,0,0,23865
21541,22604641,22605016,22631114,0,0,375,26473
21596,22611766,22630460,22631360,0,0,18694,19594
21629,22630715,22631360,22632291,0,0,645,1576
21595,22611032,22624191,22632300,0,0,13159,21268
21630,22631716,22631716,22632596,0,0,0,880
21567,22607740,22607740,22633948,0,0,0,26208
21606,22622289,22622289,22651907,0,0,0,29618
21610,22625648,22625648,22652177,0,0,0,26529
21605,22622121,22622121,22652206,0,0,0,30085
21628,22630659,22631114,22657221,0,0,455,26562
21631,22633889,22633948,22660714,0,0,59,26825
20793,22408426,22408426,22667626,0,0,0,259200
20802,22409631,22409631,22668831,0,0,0,259200
21593,22610652,22615468,22671597,0,0,4816,60945
21380,22588905,22632596,22678794,0,0,43691,89889
21644,22678281,22678281,22678869,0,0,0,588
21640,22678280,22678280,22678880,0,0,0,600
21641,22678280,22678280,22678880,0,0,0,600
21642,22678280,22678280,22678880,0,0,0,600
21643,22678280,22678280,22678880,0,0,0,600
21645,22678281,22678281,22678881,0,0,0,600
21646,22678281,22678281,22678881,0,0,0,600
21647,22678281,22678281,22678881,0,0,0,600
21648,22678282,22678282,22678882,0,0,0,600
21649,22678282,22678282,22678882,0,0,0,600
21650,22678282,22678282,22678882,0,0,0,600
21651,22678282,22678282,22678882,0,0,0,600
21652,22678282,22678282,22678882,0,0,0,600
21653,22678283,22678283,22678883,0,0,0,600
21654,22678283,22678283,22678883,0,0,0,600
21655,22678283,22678283,22678883,0,0,0,600
21656,22678283,22678283,22678883,0,0,0,600
21657,22678370,22678370,22678970,0,0,0,600
21658,22678370,22678370,22678970,0,0,0,600
21659,22678371,22678371,22678971,0,0,0,600
21673,22678909,22678909,22679440,0,0,0,531
21661,22678895,22678895,22679495,0,0,0,600
21662,22678895,22678895,22679495,0,0,0,600
21663,22678906,22678906,22679506,0,0,0,600
21664,22678906,22678906,22679506,0,0,0,600
21665,22678907,22678907,22679507,0,0,0,600
21666,22678907,22678907,22679507,0,0,0,600
21667,22678907,22678907,22679507,0,0,0,600
21668,22678907,22678907,22679507,0,0,0,600
21669,22678908,22678908,22679508,0,0,0,600
21670,22678908,22678908,22679508,0,0,0,600
21671,22678908,22678908,22679508,0,0,0,600
21672,22678908,22678908,22679508,0,0,0,600
21674,22678909,22678909,22679509,0,0,0,600
21675,22678909,22678909,22679509,0,0,0,600
21676,22678910,22678910,22679510,0,0,0,600
21677,22678910,22678910,22679510,0,0,0,600
21678,22678910,22678910,22679510,0,0,0,600
21679,22678910,22678910,22679510,0,0,0,600
21680,22678911,22678911,22679511,0,0,0,600
21660,22678673,22678673,22679557,0,0,0,884
20881,22427687,22427687,22680287,0,0,0,252600
21681,22679729,22679729,22680619,0,0,0,890
21632,22651855,22651907,22682068,0,0,52,30213
21633,22652143,22652177,22682343,0,0,34,30200
21684,22682250,22682250,22682422,0,0,0,172
21685,22682359,22682359,22682531,0,0,0,172
21682,22680931,22680931,22682590,0,0,0,1659
21687,22682595,22682595,22683353,0,0,0,758
21688,22684536,22684536,22685592,0,0,0,1056
21634,22660609,22660609,22686830,0,0,0,26221
21689,22686119,22686119,22686861,0,0,0,742
21692,22686862,22686862,22686909,0,0,0,47
21691,22686782,22686782,22687032,0,0,0,250
21694,22686939,22686939,22687182,0,0,0,243
21693,22686933,22686933,22687192,0,0,0,259
21695,22686942,22686942,22687216,0,0,0,274
21696,22686946,22686946,22687220,0,0,0,274
21697,22686949,22686949,22687223,0,0,0,274
21698,22686970,22686970,22687244,0,0,0,274
21699,22686975,22686975,22687249,0,0,0,274
21700,22686978,22686978,22687252,0,0,0,274
21701,22687961,22687961,22688701,0,0,0,740
21702,22689600,22689600,22690955,0,0,0,1355
20920,22431966,22431966,22691166,0,0,0,259200
20927,22432450,22432450,22691650,0,0,0,259200
21154,22496530,22691166,22691849,0,0,194636,195319
21704,22692159,22692159,22692976,0,0,0,817
21597,22614235,22619064,22698653,0,0,4829,84418
21706,22693966,22698653,22699460,0,0,4687,5494
21707,22701360,22701360,22702105,0,0,0,745
21708,22702395,22702395,22703131,0,0,0,736
21636,22668032,22680287,22703525,0,0,12255,35493
21709,22703908,22703908,22704705,0,0,0,797
21710,22704911,22704911,22705562,0,0,0,651
21711,22706070,22706070,22706163,0,0,0,93
21639,22668618,22691166,22707107,0,0,22548,38489
21712,22706708,22706708,22707235,0,0,0,527
21713,22707354,22707354,22707820,0,0,0,466
21703,22691900,22691900,22710000,0,0,0,18100
21705,22692751,22692976,22710154,0,0,225,17403
21683,22681954,22681954,22711775,0,0,0,29821
21686,22682469,22682469,22712925,0,0,0,30456
21690,22686750,22686750,22713011,0,0,0,26261
21638,22668071,22691166,22719522,0,0,23095,51451
21121,22464122,22464173,22723373,0,0,51,259251
20767,22378346,22378346,22723946,0,0,0,345600
21122,22464123,22465045,22724245,0,0,922,260122
21123,22464123,22465144,22724344,0,0,1021,260221
21124,22464123,22465144,22724344,0,0,1021,260221
21125,22464123,22465328,22724528,0,0,1205,260405
21126,22464123,22465328,22724528,0,0,1205,260405
21637,22668058,22691166,22726443,0,0,23108,58385
21127,22464123,22469614,22728814,0,0,5491,264691
21635,22668020,22671597,22729400,0,0,3577,61380
21131,22466524,22471590,22730790,0,0,5066,264266
21132,22466575,22471590,22730790,0,0,5015,264215
21115,22461406,22479066,22738266,0,0,17660,276860
21116,22461462,22480953,22740153,0,0,19491,278691
21209,22510615,22740153,22740309,0,0,229538,229694
21348,22587425,22668831,22741726,0,0,81406,154301
21714,22711712,22711712,22742162,0,0,0,30450
21715,22712879,22712879,22743149,0,0,0,30270
21346,22587342,22607759,22746352,0,0,20417,159010
21148,22493355,22493355,22752555,0,0,0,259200
21149,22493370,22493370,22752570,0,0,0,259200
21118,22461500,22500601,22759801,0,0,39101,298301
21730,22762330,22762330,22762930,0,0,0,600
21731,22762336,22762336,22762936,0,0,0,600
21732,22762336,22762336,22762936,0,0,0,600
21733,22762337,22762337,22762937,0,0,0,600
21734,22762337,22762337,22762937,0,0,0,600
21735,22762337,22762337,22762937,0,0,0,600
21736,22762337,22762337,22762937,0,0,0,600
21737,22762338,22762338,22762938,0,0,0,600
21738,22762338,22762338,22762938,0,0,0,600
21739,22762338,22762338,22762938,0,0,0,600
21740,22762338,22762338,22762938,0,0,0,600
21741,22762339,22762339,22762939,0,0,0,600
21742,22762339,22762339,22762939,0,0,0,600
21743,22762339,22762339,22762939,0,0,0,600
21744,22762340,22762340,22762940,0,0,0,600
21745,22762340,22762340,22762940,0,0,0,600
21746,22762340,22762340,22762940,0,0,0,600
21747,22762340,22762340,22762940,0,0,0,600
21748,22762341,22762341,22762941,0,0,0,600
21749,22762341,22762341,22762941,0,0,0,600
21750,22762341,22762341,22762941,0,0,0,600
21751,22762341,22762341,22762941,0,0,0,600
21752,22762341,22762341,22762941,0,0,0,600
21753,22762342,22762342,22762942,0,0,0,600
21754,22762342,22762342,22762942,0,0,0,600
21755,22762342,22762342,22762942,0,0,0,600
21756,22762342,22762342,22762942,0,0,0,600
21757,22762342,22762342,22762942,0,0,0,600
21758,22762343,22762343,22762943,0,0,0,600
21759,22762343,22762343,22762943,0,0,0,600
21769,22763161,22763161,22763548,0,0,0,387
21760,22763159,22763159,22763759,0,0,0,600
21761,22763159,22763159,22763759,0,0,0,600
21762,22763159,22763159,22763759,0,0,0,600
21763,22763159,22763159,22763759,0,0,0,600
21764,22763159,22763159,22763759,0,0,0,600
21765,22763160,22763160,22763760,0,0,0,600
21766,22763160,22763160,22763760,0,0,0,600
21767,22763160,22763160,22763760,0,0,0,600
21768,22763160,22763160,22763760,0,0,0,600
21770,22763161,22763161,22763761,0,0,0,600
21771,22763161,22763161,22763761,0,0,0,600
21772,22763161,22763161,22763761,0,0,0,600
21773,22763161,22763161,22763761,0,0,0,600
21774,22763162,22763162,22763762,0,0,0,600
21775,22763162,22763162,22763762,0,0,0,600
21776,22763162,22763162,22763762,0,0,0,600
21777,22763162,22763162,22763762,0,0,0,600
21778,22763162,22763162,22763762,0,0,0,600
21779,22763259,22763259,22763859,0,0,0,600
21780,22764744,22764744,22765344,0,0,0,600
21781,22764744,22764744,22765344,0,0,0,600
21782,22764744,22764744,22765344,0,0,0,600
21783,22764744,22764744,22765344,0,0,0,600
21784,22764745,22764745,22765345,0,0,0,600
21785,22764745,22764745,22765345,0,0,0,600
21786,22764745,22764745,22765345,0,0,0,600
21787,22764745,22764745,22765345,0,0,0,600
21788,22764745,22764745,22765345,0,0,0,600
21789,22764791,22764791,22765391,0,0,0,600
21369,22587825,22691849,22765538,0,0,104024,177713
21793,22765661,22765661,22766061,0,0,0,400
21790,22765660,22765660,22766260,0,0,0,600
21791,22765660,22765660,22766260,0,0,0,600
21792,22765660,22765660,22766260,0,0,0,600
21794,22765661,22765661,22766261,0,0,0,600
21795,22765661,22765661,22766261,0,0,0,600
21796,22765661,22765661,22766261,0,0,0,600
21797,22765661,22765661,22766261,0,0,0,600
21798,22765662,22765662,22766262,0,0,0,600
21799,22765662,22765662,22766262,0,0,0,600
21800,22767192,22767192,22767792,0,0,0,600
21801,22767198,22767198,22767798,0,0,0,600
21802,22767198,22767198,22767798,0,0,0,600
21803,22767199,22767199,22767799,0,0,0,600
21804,22767199,22767199,22767799,0,0,0,600
21805,22767199,22767199,22767799,0,0,0,600
21806,22767199,22767199,22767799,0,0,0,600
21807,22767200,22767200,22767800,0,0,0,600
21808,22767200,22767200,22767800,0,0,0,600
21809,22767200,22767200,22767800,0,0,0,600
21815,22768064,22768064,22768444,0,0,0,380
21816,22768064,22768064,22768475,0,0,0,411
21810,22768063,22768063,22768663,0,0,0,600
21811,22768063,22768063,22768663,0,0,0,600
21812,22768063,22768063,22768663,0,0,0,600
21813,22768063,22768063,22768663,0,0,0,600
21814,22768063,22768063,22768663,0,0,0,600
21817,22768064,22768064,22768664,0,0,0,600
21818,22768064,22768064,22768664,0,0,0,600
21819,22768064,22768064,22768664,0,0,0,600
21820,22769601,22769601,22770201,0,0,0,600
21821,22769607,22769607,22770207,0,0,0,600
21822,22769607,22769607,22770207,0,0,0,600
21823,22769607,22769607,22770207,0,0,0,600
21824,22769608,22769608,22770208,0,0,0,600
21825,22769608,22769608,22770208,0,0,0,600
21826,22769608,22769608,22770208,0,0,0,600
21827,22769608,22769608,22770208,0,0,0,600
21828,22769609,22769609,22770209,0,0,0,600
21829,22769609,22769609,22770209,0,0,0,600
21834,22770482,22770482,22770867,0,0,0,385
21830,22770465,22770465,22771065,0,0,0,600
21831,22770465,22770465,22771065,0,0,0,600
21832,22770465,22770465,22771065,0,0,0,600
21833,22770481,22770481,22771081,0,0,0,600
21835,22770482,22770482,22771082,0,0,0,600
21836,22770482,22770482,22771082,0,0,0,600
21837,22770482,22770482,22771082,0,0,0,600
21838,22770483,22770483,22771083,0,0,0,600
21839,22770483,22770483,22771083,0,0,0,600
21726,22742099,22742099,22772539,0,0,0,30440
21727,22743090,22743090,22773405,0,0,0,30315
21444,22597072,22606761,22779561,0,0,9689,182489
21252,22520263,22534071,22786671,0,0,13808,266408
21728,22753221,22753221,22786831,0,0,0,33610
21841,22772476,22772476,22802894,0,0,0,30418
21842,22773334,22773334,22803533,0,0,0,30199
21120,22462690,22462690,22808290,0,0,0,345600
21294,22549627,22549627,22808827,0,0,0,259200
21295,22549627,22549627,22808827,0,0,0,259200
21845,22803479,22803479,22808959,0,0,0,5480
21296,22549815,22549815,22809015,0,0,0,259200
21297,22549816,22549869,22809069,0,0,53,259253
21298,22549817,22549988,22809188,0,0,171,259371
21299,22549817,22549991,22809191,0,0,174,259374
21301,22550253,22550253,22809453,0,0,0,259200
21843,22776346,22776346,22810514,0,0,0,34168
21729,22753281,22753281,22820913,0,0,0,67632
21844,22802831,22802831,22832875,0,0,0,30044
21856,22836269,22836269,22836368,0,0,0,99
21857,22836442,22836442,22836509,0,0,0,67
21858,22836506,22836506,22836600,0,0,0,94
21859,22836567,22836567,22836664,0,0,0,97
21860,22836629,22836629,22836696,0,0,0,67
21861,22836683,22836683,22836831,0,0,0,148
21863,22836702,22836702,22836857,0,0,0,155
21862,22836696,22836696,22836863,0,0,0,167
21864,22837263,22837263,22837416,0,0,0,153
21865,22837295,22837295,22837456,0,0,0,161
21866,22837439,22837439,22837491,0,0,0,52
21867,22837455,22837455,22837522,0,0,0,67
21846,22808876,22808876,22838798,0,0,0,29922
21278,22530213,22586797,22839397,0,0,56584,309184
21869,22839692,22839692,22840015,0,0,0,323
21871,22839810,22839810,22840410,0,0,0,600
21872,22839810,22839810,22840410,0,0,0,600
21873,22839810,22839810,22840410,0,0,0,600
21874,22839826,22839826,22840426,0,0,0,600
21875,22839826,22839826,22840426,0,0,0,600
21876,22839827,22839827,22840427,0,0,0,600
21877,22839827,22839827,22840427,0,0,0,600
21878,22839827,22839827,22840427,0,0,0,600
21879,22839828,22839828,22840428,0,0,0,600
21880,22839828,22839828,22840428,0,0,0,600
21882,22840338,22840338,22840693,0,0,0,355
21883,22840527,22840527,22840875,0,0,0,348
21895,22840954,22840954,22841042,0,0,0,88
21894,22840949,22840949,22841059,0,0,0,110
21893,22840665,22840665,22841123,0,0,0,458
21884,22840527,22840527,22841127,0,0,0,600
21885,22840527,22840527,22841127,0,0,0,600
21886,22840528,22840528,22841128,0,0,0,600
21887,22840528,22840528,22841128,0,0,0,600
21888,22840528,22840528,22841128,0,0,0,600
21889,22840528,22840528,22841128,0,0,0,600
21890,22840528,22840528,22841128,0,0,0,600
21891,22840529,22840529,22841129,0,0,0,600
21892,22840529,22840529,22841129,0,0,0,600
21870,22839728,22839728,22841253,0,0,0,1525
21881,22839894,22839894,22841570,0,0,0,1676
21899,22841520,22841520,22841663,0,0,0,143
21902,22841719,22841719,22841788,0,0,0,69
21901,22841706,22841706,22841791,0,0,0,85
21906,22841895,22841895,22842030,0,0,0,135
21907,22841908,22841908,22842074,0,0,0,166
21900,22841526,22841526,22842113,0,0,0,587
21909,22842117,22842117,22842195,0,0,0,78
21921,22842291,22842291,22842389,0,0,0,98
21922,22842406,22842406,22842473,0,0,0,67
21911,22842229,22842229,22842829,0,0,0,600
21912,22842229,22842229,22842829,0,0,0,600
21913,22842229,22842229,22842829,0,0,0,600
21914,22842229,22842229,22842829,0,0,0,600
21915,22842250,22842250,22842850,0,0,0,600
21916,22842251,22842251,22842851,0,0,0,600
21917,22842251,22842251,22842851,0,0,0,600
21918,22842251,22842251,22842851,0,0,0,600
21919,22842251,22842251,22842851,0,0,0,600
21920,22842252,22842252,22842852,0,0,0,600
21904,22841804,22841804,22843195,0,0,0,1391
21938,22843137,22843137,22843219,0,0,0,82
21896,22841181,22841181,22843223,0,0,0,2042
21897,22841226,22841226,22843224,0,0,0,1998
21942,22843360,22843360,22843459,0,0,0,99
21928,22842929,22842929,22843529,0,0,0,600
21929,22842935,22842935,22843535,0,0,0,600
21930,22842935,22842935,22843535,0,0,0,600
21931,22842936,22842936,22843536,0,0,0,600
21932,22842936,22842936,22843536,0,0,0,600
21933,22842936,22842936,22843536,0,0,0,600
21934,22842936,22842936,22843536,0,0,0,600
21935,22842937,22842937,22843537,0,0,0,600
21936,22842937,22842937,22843537,0,0,0,600
21937,22842937,22842937,22843537,0,0,0,600
21910,22842163,22842163,22843610,0,0,0,1447
21944,22843967,22843967,22844060,0,0,0,93
21946,22844100,22844100,22844202,0,0,0,102
21947,22844268,22844268,22844341,0,0,0,73
21948,22844391,22844391,22844460,0,0,0,69
21949,22844413,22844413,22844477,0,0,0,64
21951,22844437,22844437,22844505,0,0,0,68
21952,22844455,22844455,22844507,0,0,0,52
21950,22844426,22844426,22844510,0,0,0,84
21953,22844471,22844471,22844538,0,0,0,67
21941,22843225,22843225,22844634,0,0,0,1409
21961,22844660,22844660,22844732,0,0,0,72
21954,22844652,22844652,22844740,0,0,0,88
21966,22844668,22844668,22844740,0,0,0,72
21967,22844730,22844730,22844782,0,0,0,52
21968,22844749,22844749,22844816,0,0,0,67
21943,22843498,22843498,22844862,0,0,0,1364
21969,22844881,22844881,22845041,0,0,0,160
21926,22842656,22842656,22845106,0,0,0,2450
21940,22843180,22843180,22845155,0,0,0,1975
21939,22843172,22843172,22845158,0,0,0,1986
21905,22841832,22841832,22845159,0,0,0,3327
21955,22844658,22844658,22845258,0,0,0,600
21956,22844658,22844658,22845258,0,0,0,600
21957,22844659,22844659,22845259,0,0,0,600
21958,22844659,22844659,22845259,0,0,0,600
21959,22844659,22844659,22845259,0,0,0,600
21960,22844659,22844659,22845259,0,0,0,600
21962,22844660,22844660,22845260,0,0,0,600
21963,22844660,22844660,22845260,0,0,0,600
21964,22844660,22844660,22845260,0,0,0,600
21965,22844660,22844660,22845260,0,0,0,600
21974,22845337,22845337,22845403,0,0,0,66
21927,22842871,22842871,22845563,0,0,0,2692
21945,22844040,22844040,22845840,0,0,0,1800
21975,22845338,22845338,22845938,0,0,0,600
21976,22845338,22845338,22845938,0,0,0,600
21977,22845338,22845338,22845938,0,0,0,600
21978,22845339,22845339,22845939,0,0,0,600
21979,22845339,22845339,22845939,0,0,0,600
21980,22845339,22845339,22845939,0,0,0,600
21981,22845340,22845340,22845940,0,0,0,600
21982,22845340,22845340,22845940,0,0,0,600
21983,22845340,22845340,22845940,0,0,0,600
21984,22845340,22845340,22845940,0,0,0,600
21903,22841798,22841798,22846024,0,0,0,4226
21988,22846217,22846217,22846347,0,0,0,130
21989,22846228,22846228,22846358,0,0,0,130
21990,22846236,22846236,22846366,0,0,0,130
21991,22846336,22846336,22846422,0,0,0,86
21992,22846346,22846346,22846438,0,0,0,92
21993,22846365,22846365,22846452,0,0,0,87
21995,22846396,22846396,22846478,0,0,0,82
21998,22847061,22847061,22847661,0,0,0,600
21999,22847067,22847067,22847667,0,0,0,600
22000,22847067,22847067,22847667,0,0,0,600
22001,22847068,22847068,22847668,0,0,0,600
22002,22847068,22847068,22847668,0,0,0,600
22003,22847068,22847068,22847668,0,0,0,600
22004,22847068,22847068,22847668,0,0,0,600
22005,22847069,22847069,22847669,0,0,0,600
22006,22847069,22847069,22847669,0,0,0,600
22007,22847069,22847069,22847669,0,0,0,600
22009,22847576,22847576,22847677,0,0,0,101
21994,22846385,22846385,22847801,0,0,0,1416
21996,22846416,22846416,22847805,0,0,0,1389
21997,22846475,22846475,22847897,0,0,0,1422
22020,22848158,22848158,22848257,0,0,0,99
22010,22847741,22847741,22848341,0,0,0,600
22011,22847741,22847741,22848341,0,0,0,600
22012,22847742,22847742,22848342,0,0,0,600
22013,22847742,22847742,22848342,0,0,0,600
22014,22847742,22847742,22848342,0,0,0,600
22015,22847742,22847742,22848342,0,0,0,600
22016,22847743,22847743,22848343,0,0,0,600
22017,22847743,22847743,22848343,0,0,0,600
22018,22847743,22847743,22848343,0,0,0,600
22019,22847744,22847744,22848344,0,0,0,600
21987,22845876,22845876,22848727,0,0,0,2851
22021,22849733,22849733,22849843,0,0,0,110
22022,22849784,22849784,22849843,0,0,0,59
22023,22849807,22849807,22849893,0,0,0,86
22024,22849848,22849848,22849963,0,0,0,115
22027,22849915,22849915,22849985,0,0,0,70
22028,22849933,22849933,22850016,0,0,0,83
22030,22850144,22850144,22850744,0,0,0,600
22031,22850145,22850145,22850745,0,0,0,600
22032,22850145,22850145,22850745,0,0,0,600
22033,22850145,22850145,22850745,0,0,0,600
22034,22850145,22850145,22850745,0,0,0,600
22035,22850146,22850146,22850746,0,0,0,600
22036,22850146,22850146,22850746,0,0,0,600
22037,22850146,22850146,22850746,0,0,0,600
22038,22850146,22850146,22850746,0,0,0,600
22039,22850146,22850146,22850746,0,0,0,600
21840,22771666,22771666,22851591,0,0,0,79925
21383,22589206,22667626,22852034,0,0,78420,262828
22008,22847524,22847524,22853311,0,0,0,5787
21986,22845518,22845518,22854565,0,0,0,9047
21898,22841500,22841500,22855482,0,0,0,13982
21971,22845102,22845102,22855604,0,0,0,10502
21970,22845063,22845063,22856428,0,0,0,11365
22050,22855874,22855874,22856552,0,0,0,678
21985,22845509,22845509,22856580,0,0,0,11071
22055,22856672,22856672,22856838,0,0,0,166
21908,22842046,22842046,22857127,0,0,0,15081
22049,22855537,22855537,22857326,0,0,0,1789
22057,22857159,22857159,22857558,0,0,0,399
22058,22857666,22857666,22857759,0,0,0,93
22061,22857993,22857993,22858086,0,0,0,93
22060,22857885,22857885,22858272,0,0,0,387
22053,22856509,22856509,22858584,0,0,0,2075
22054,22856515,22856515,22858871,0,0,0,2356
22062,22858313,22858313,22858937,0,0,0,624
22067,22858999,22858999,22859076,0,0,0,77
22040,22853864,22853864,22859642,0,0,0,5778
22041,22853928,22853928,22859675,0,0,0,5747
22042,22854054,22854054,22859765,0,0,0,5711
22051,22855976,22855976,22859954,0,0,0,3978
22063,22858510,22858510,22859955,0,0,0,1445
22064,22858542,22858542,22859956,0,0,0,1414
22052,22856365,22856365,22859988,0,0,0,3623
22074,22860171,22860171,22860265,0,0,0,94
21434,22595579,22601120,22860320,0,0,5541,264741
22043,22854768,22854768,22860471,0,0,0,5703
22065,22858814,22858814,22860502,0,0,0,1688
22076,22860510,22860510,22860614,0,0,0,104
22077,22860582,22860582,22860675,0,0,0,93
22044,22854917,22854917,22860700,0,0,0,5783
21435,22595621,22601853,22861053,0,0,6232,265432
21436,22595660,22601853,22861053,0,0,6193,265393
21973,22845118,22845118,22861406,0,0,0,16288
21972,22845105,22845105,22861415,0,0,0,16310
21855,22832812,22832812,22862939,0,0,0,30127
22084,22862981,22862981,22863074,0,0,0,93
22082,22861760,22861760,22863578,0,0,0,1818
22086,22863649,22863649,22863742,0,0,0,93
22088,22864064,22864064,22864137,0,0,0,73
22087,22863992,22863992,22864138,0,0,0,146
22090,22864289,22864289,22864514,0,0,0,225
22091,22864366,22864366,22864565,0,0,0,199
22094,22864512,22864514,22864580,0,0,2,68
22089,22864286,22864286,22864584,0,0,0,298
22048,22855534,22855534,22865411,0,0,0,9877
22098,22866052,22866052,22866274,0,0,0,222
22093,22864481,22864481,22866886,0,0,0,2405
22096,22864584,22864584,22866907,0,0,0,2323
22095,22864538,22864565,22866909,0,0,27,2371
21347,22587355,22607759,22866959,0,0,20404,279604
22102,22867007,22867007,22867101,0,0,0,94
22099,22866874,22866874,22867272,0,0,0,398
22103,22867476,22867476,22867580,0,0,0,104
22075,22860440,22860440,22867799,0,0,0,7359
22097,22865529,22865529,22867825,0,0,0,2296
22071,22859913,22859913,22867882,0,0,0,7969
22085,22863536,22863536,22867911,0,0,0,4375
22072,22859919,22859919,22867950,0,0,0,8031
22110,22868129,22868129,22868549,0,0,0,420
22111,22868565,22868565,22868658,0,0,0,93
22092,22864425,22864425,22868721,0,0,0,4296
22112,22868832,22868832,22868931,0,0,0,99
21868,22838743,22838743,22869073,0,0,0,30330
22115,22869149,22869149,22869242,0,0,0,93
22114,22869133,22869133,22869353,0,0,0,220
22116,22869286,22869286,22869385,0,0,0,99
22117,22869414,22869414,22869503,0,0,0,89
22119,22869666,22869666,22869744,0,0,0,78
22120,22869681,22869681,22869810,0,0,0,129
22121,22870460,22870460,22870496,0,0,0,36
22122,22870558,22870558,22870605,0,0,0,47
22124,22870991,22870991,22871086,0,0,0,95
22125,22871056,22871056,22871151,0,0,0,95
22126,22871067,22871067,22871151,0,0,0,84
22127,22871090,22871090,22871183,0,0,0,93
22128,22871356,22871356,22871450,0,0,0,94
22130,22871583,22871583,22871656,0,0,0,73
22118,22869462,22869462,22871772,0,0,0,2310
22133,22871821,22871821,22871898,0,0,0,77
22134,22872038,22872038,22872132,0,0,0,94
22025,22849871,22849871,22872286,0,0,0,22415
22026,22849894,22849894,22872318,0,0,0,22424
22136,22873033,22873033,22873130,0,0,0,97
22137,22873103,22873103,22873202,0,0,0,99
22138,22873201,22873201,22873279,0,0,0,78
22135,22872659,22872659,22873280,0,0,0,621
22139,22873957,22873957,22874180,0,0,0,223
22140,22874175,22874175,22874366,0,0,0,191
22141,22874334,22874334,22874494,0,0,0,160
22142,22874490,22874490,22874661,0,0,0,171
22143,22874671,22874671,22874893,0,0,0,222
22129,22871451,22871451,22875354,0,0,0,3903
22081,22861739,22861739,22881044,0,0,0,19305
22131,22871689,22871689,22881569,0,0,0,9880
22132,22871738,22871738,22881855,0,0,0,10117
22108,22867845,22867845,22886290,0,0,0,18445
21433,22595420,22601120,22889085,0,0,5700,293665
22083,22862892,22862892,22892979,0,0,0,30087
22107,22867833,22867833,22898205,0,0,0,30372
22123,22870980,22870980,22898422,0,0,0,27442
22106,22867787,22867787,22898998,0,0,0,31211
22066,22858970,22898998,22899216,0,0,40028,40246
22113,22869010,22869010,22899444,0,0,0,30434
22109,22867918,22867918,22902592,0,0,0,34674
22070,22859905,22859905,22902901,0,0,0,42996
22104,22867541,22867541,22915833,0,0,0,48292
22069,22859889,22859889,22921247,0,0,0,61358
22147,22921667,22921667,22921761,0,0,0,94
22148,22922876,22922876,22922969,0,0,0,93
22145,22892922,22892922,22923086,0,0,0,30164
22153,22923168,22923168,22923251,0,0,0,83
22154,22923317,22923317,22923410,0,0,0,93
22152,22923159,22923159,22923656,0,0,0,497
22151,22923146,22923146,22923690,0,0,0,544
22150,22923137,22923137,22923697,0,0,0,560
22155,22923718,22923718,22923812,0,0,0,94
22156,22924149,22924149,22924242,0,0,0,93
22079,22861370,22861370,22926195,0,0,0,64825
22078,22861338,22861338,22926227,0,0,0,64889
22101,22866889,22866889,22927281,0,0,0,60392
22100,22866881,22866881,22927304,0,0,0,60423
22167,22927853,22927853,22927920,0,0,0,67
22163,22927222,22927222,22928147,0,0,0,925
22165,22927276,22927276,22928170,0,0,0,894
22164,22927246,22927246,22928203,0,0,0,957
22162,22927143,22927143,22928267,0,0,0,1124
22146,22899374,22899374,22929458,0,0,0,30084
22161,22927016,22927016,22929714,0,0,0,2698
22171,22928164,22928164,22929964,0,0,0,1800
22168,22928098,22928098,22930834,0,0,0,2736
22170,22928144,22928144,22930859,0,0,0,2715
22176,22929276,22929276,22930864,0,0,0,1588
22169,22928118,22928118,22930865,0,0,0,2747
22179,22929409,22929409,22930889,0,0,0,1480
22180,22930179,22930179,22930896,0,0,0,717
22175,22929152,22929152,22930952,0,0,0,1800
22181,22930788,22930788,22931674,0,0,0,886
22182,22930795,22930795,22931711,0,0,0,916
22185,22930829,22930829,22931711,0,0,0,882
22184,22930822,22930822,22931716,0,0,0,894
22183,22930803,22930803,22931730,0,0,0,927
22177,22929392,22929392,22931801,0,0,0,2409
22192,22931831,22931831,22931896,0,0,0,65
22193,22931865,22931865,22931950,0,0,0,85
22195,22931948,22931948,22931995,0,0,0,47
22194,22931914,22931914,22931997,0,0,0,83
22197,22932030,22932030,22932205,0,0,0,175
22202,22932400,22932400,22932431,0,0,0,31
22200,22932384,22932384,22932436,0,0,0,52
22201,22932387,22932387,22932439,0,0,0,52
22199,22932342,22932342,22932442,0,0,0,100
22203,22932478,22932478,22932716,0,0,0,238
22205,22932494,22932494,22932767,0,0,0,273
22206,22932496,22932496,22932769,0,0,0,273
22204,22932482,22932482,22932776,0,0,0,294
22207,22932499,22932499,22932803,0,0,0,304
22208,22932501,22932501,22932805,0,0,0,304
22210,22932530,22932530,22932851,0,0,0,321
22209,22932504,22932504,22932861,0,0,0,357
22214,22932741,22932741,22932862,0,0,0,121
22212,22932546,22932546,22932898,0,0,0,352
22213,22932548,22932548,22932900,0,0,0,352
22216,22932860,22932860,22932938,0,0,0,78
22190,22931678,22931678,22933123,0,0,0,1445
22189,22931669,22931669,22933125,0,0,0,1456
22217,22932966,22932966,22933125,0,0,0,159
22188,22931662,22931662,22933129,0,0,0,1467
22186,22931629,22931629,22933130,0,0,0,1501
22187,22931651,22931651,22933130,0,0,0,1479
22191,22931738,22931738,22933130,0,0,0,1392
22237,22933072,22933072,22933166,0,0,0,94
22215,22932825,22932825,22933239,0,0,0,414
22218,22932966,22932966,22933296,0,0,0,330
22224,22932968,22932968,22933546,0,0,0,578
22219,22932966,22932966,22933566,0,0,0,600
22220,22932967,22932967,22933567,0,0,0,600
22221,22932967,22932967,22933567,0,0,0,600
22222,22932967,22932967,22933567,0,0,0,600
22223,22932967,22932967,22933567,0,0,0,600
22225,22932968,22932968,22933568,0,0,0,600
22226,22932968,22932968,22933568,0,0,0,600
22227,22932968,22932968,22933568,0,0,0,600
22228,22932968,22932968,22933568,0,0,0,600
22229,22932969,22932969,22933569,0,0,0,600
22230,22932969,22932969,22933569,0,0,0,600
22231,22932969,22932969,22933569,0,0,0,600
22232,22932969,22932969,22933569,0,0,0,600
22233,22932970,22932970,22933570,0,0,0,600
22234,22932970,22932970,22933570,0,0,0,600
22235,22932970,22932970,22933570,0,0,0,600
22236,22932970,22932970,22933570,0,0,0,600
22198,22932174,22932174,22933974,0,0,0,1800
22245,22933741,22933741,22934057,0,0,0,316
22246,22933892,22933892,22934492,0,0,0,600
22247,22933892,22933892,22934492,0,0,0,600
22248,22933892,22933892,22934492,0,0,0,600
22249,22933892,22933892,22934492,0,0,0,600
22250,22933893,22933893,22934493,0,0,0,600
22251,22933893,22933893,22934493,0,0,0,600
22252,22933893,22933893,22934493,0,0,0,600
22253,22933893,22933893,22934493,0,0,0,600
22254,22933894,22933894,22934494,0,0,0,600
22255,22933894,22933894,22934494,0,0,0,600
22256,22933894,22933894,22934494,0,0,0,600
22257,22933894,22933894,22934494,0,0,0,600
22258,22933895,22933895,22934495,0,0,0,600
22259,22933895,22933895,22934495,0,0,0,600
22260,22933895,22933895,22934495,0,0,0,600
22261,22933895,22933895,22934495,0,0,0,600
22262,22933896,22933896,22934496,0,0,0,600
22263,22933896,22933896,22934496,0,0,0,600
22264,22933896,22933896,22934496,0,0,0,600
22265,22933896,22933896,22934496,0,0,0,600
22266,22933896,22933896,22934496,0,0,0,600
22267,22933897,22933897,22934497,0,0,0,600
22268,22933897,22933897,22934497,0,0,0,600
22269,22933897,22933897,22934497,0,0,0,600
22270,22933897,22933897,22934497,0,0,0,600
22271,22933897,22933897,22934497,0,0,0,600
22272,22933898,22933898,22934498,0,0,0,600
22273,22933898,22933898,22934498,0,0,0,600
22274,22933898,22933898,22934498,0,0,0,600
22275,22933898,22933898,22934498,0,0,0,600
22281,22935378,22935378,22935516,0,0,0,138
22073,22860117,22860117,22935774,0,0,0,75657
22279,22935377,22935377,22935794,0,0,0,417
22282,22935378,22935378,22935795,0,0,0,417
22280,22935377,22935377,22935825,0,0,0,448
22283,22935378,22935378,22935826,0,0,0,448
22285,22935379,22935379,22935889,0,0,0,510
22286,22935379,22935379,22935920,0,0,0,541
22278,22935371,22935371,22935928,0,0,0,557
22284,22935378,22935378,22935978,0,0,0,600
22287,22935379,22935379,22935979,0,0,0,600
22277,22934876,22934876,22936265,0,0,0,1389
22294,22936582,22936582,22936829,0,0,0,247
22288,22936580,22936580,22936920,0,0,0,340
22291,22936581,22936581,22936921,0,0,0,340
22289,22936580,22936580,22936982,0,0,0,402
22295,22936582,22936582,22937015,0,0,0,433
22296,22936582,22936582,22937132,0,0,0,550
22292,22936581,22936581,22937162,0,0,0,581
22059,22857754,22857754,22937163,0,0,0,79409
22290,22936580,22936580,22937180,0,0,0,600
22293,22936581,22936581,22937181,0,0,0,600
22297,22936582,22936582,22937182,0,0,0,600
22276,22934826,22934826,22937376,0,0,0,2550
22211,22932530,22932530,22937724,0,0,0,5194
22303,22937790,22937790,22937990,0,0,0,200
21386,22589303,22678794,22937994,0,0,89491,348691
22300,22937789,22937789,22938093,0,0,0,304
22307,22937791,22937791,22938095,0,0,0,304
22304,22937790,22937790,22938354,0,0,0,564
22299,22937783,22937783,22938383,0,0,0,600
22301,22937789,22937789,22938389,0,0,0,600
22302,22937789,22937789,22938389,0,0,0,600
22305,22937790,22937790,22938390,0,0,0,600
22306,22937790,22937790,22938390,0,0,0,600
22308,22937791,22937791,22938391,0,0,0,600
22080,22861517,22861517,22938711,0,0,0,77194
22311,22938333,22938333,22938758,0,0,0,425
22310,22938217,22938217,22940017,0,0,0,1800
22320,22940194,22940194,22940461,0,0,0,267
22323,22940404,22940404,22940497,0,0,0,93
22316,22940193,22940193,22940522,0,0,0,329
22321,22940194,22940194,22940616,0,0,0,422
22313,22940192,22940192,22940656,0,0,0,464
22317,22940193,22940193,22940657,0,0,0,464
22312,22939837,22939837,22940763,0,0,0,926
22314,22940192,22940192,22940792,0,0,0,600
22315,22940192,22940192,22940792,0,0,0,600
22318,22940193,22940193,22940793,0,0,0,600
22319,22940193,22940193,22940793,0,0,0,600
22322,22940194,22940194,22940794,0,0,0,600
22328,22940631,22940631,22940838,0,0,0,207
22325,22940622,22940622,22940840,0,0,0,218
22326,22940627,22940627,22940845,0,0,0,218
22327,22940629,22940629,22940847,0,0,0,218
22329,22940653,22940653,22940851,0,0,0,198
22330,22940691,22940691,22940884,0,0,0,193
22331,22940698,22940698,22940918,0,0,0,220
22332,22940702,22940702,22940922,0,0,0,220
22333,22940704,22940704,22940924,0,0,0,220
22105,22867757,22867757,22940982,0,0,0,73225
22324,22940620,22940620,22941014,0,0,0,394
22337,22941560,22941560,22941731,0,0,0,171
22338,22941563,22941563,22941734,0,0,0,171
22336,22941554,22941554,22941742,0,0,0,188
22339,22941567,22941567,22941769,0,0,0,202
22340,22941570,22941570,22941772,0,0,0,202
22341,22941591,22941591,22941793,0,0,0,202
22342,22941639,22941639,22941825,0,0,0,186
22343,22941642,22941642,22941828,0,0,0,186
22345,22941664,22941664,22941855,0,0,0,191
22344,22941645,22941645,22941862,0,0,0,217
22335,22941316,22941316,22942744,0,0,0,1428
22350,22942602,22942602,22942803,0,0,0,201
22172,22928210,22928210,22942841,0,0,0,14631
22173,22928345,22928345,22942872,0,0,0,14527
22349,22942596,22942596,22942876,0,0,0,280
22353,22942603,22942603,22943110,0,0,0,507
22357,22942604,22942604,22943111,0,0,0,507
22351,22942602,22942602,22943170,0,0,0,568
22352,22942602,22942602,22943170,0,0,0,568
22354,22942603,22942603,22943171,0,0,0,568
22355,22942603,22942603,22943203,0,0,0,600
22356,22942603,22942603,22943203,0,0,0,600
22358,22942604,22942604,22943204,0,0,0,600
22361,22943144,22943144,22943211,0,0,0,67
22364,22943470,22943470,22943541,0,0,0,71
22367,22943997,22943997,22944199,0,0,0,202
22369,22944366,22944366,22944440,0,0,0,74
22360,22943049,22943049,22944442,0,0,0,1393
22368,22944263,22944263,22944477,0,0,0,214
22371,22944414,22944414,22944488,0,0,0,74
22348,22942474,22942474,22944549,0,0,0,2075
22359,22943004,22943004,22944608,0,0,0,1604
22372,22944443,22944443,22944612,0,0,0,169
22375,22944619,22944619,22944712,0,0,0,93
22370,22944382,22944382,22944719,0,0,0,337
22373,22944601,22944601,22944720,0,0,0,119
22174,22929048,22929048,22944785,0,0,0,15737
22411,22944747,22944785,22944868,0,0,38,121
22410,22944747,22944785,22944884,0,0,38,137
22416,22944779,22944884,22944977,0,0,105,198
22414,22944748,22944868,22944983,0,0,120,235
22393,22944743,22944743,22945082,0,0,0,339
22419,22944919,22944983,22945098,0,0,64,179
22421,22945005,22945005,22945284,0,0,0,279
22434,22945135,22945135,22945338,0,0,0,203
22435,22945138,22945138,22945341,0,0,0,203
22436,22945141,22945141,22945344,0,0,0,203
22437,22945144,22945144,22945347,0,0,0,203
22379,22944739,22944739,22945352,0,0,0,613
22433,22945126,22945126,22945364,0,0,0,238
22365,22943578,22943578,22945378,0,0,0,1800
22438,22945150,22945150,22945384,0,0,0,234
22377,22944738,22944738,22945387,0,0,0,649
22407,22944746,22944746,22945401,0,0,0,655
22427,22945007,22945082,22945420,0,0,75,413
22380,22944739,22944739,22945424,0,0,0,685
22383,22944740,22944740,22945425,0,0,0,685
22384,22944740,22944740,22945425,0,0,0,685
22386,22944741,22944741,22945442,0,0,0,701
22387,22944741,22944741,22945442,0,0,0,701
22443,22945263,22945352,22945446,0,0,89,183
22431,22945008,22945082,22945451,0,0,74,443
22390,22944742,22944742,22945474,0,0,0,732
22394,22944743,22944743,22945475,0,0,0,732
22405,22944746,22944746,22945494,0,0,0,748
22406,22944746,22944746,22945494,0,0,0,748
22423,22945006,22945082,22945500,0,0,76,494
22417,22944889,22945424,22945518,0,0,535,629
22397,22944744,22944744,22945528,0,0,0,784
22398,22944744,22944744,22945528,0,0,0,784
22401,22944745,22944745,22945529,0,0,0,784
22402,22944745,22944745,22945529,0,0,0,784
22425,22945006,22945082,22945534,0,0,76,528
22439,22945154,22945338,22945567,0,0,184,413
22440,22945159,22945341,22945570,0,0,182,411
22441,22945162,22945344,22945573,0,0,182,411
22426,22945006,22945082,22945627,0,0,76,621
22428,22945007,22945082,22945674,0,0,75,667
22424,22945006,22945082,22945682,0,0,76,676
22429,22945007,22945082,22945682,0,0,75,675
22430,22945007,22945082,22945682,0,0,75,675
22442,22945183,22945518,22945772,0,0,335,589
22159,22926333,22926333,22945818,0,0,0,19485
22160,22926589,22926589,22945841,0,0,0,19252
22347,22942447,22942447,22945879,0,0,0,3432
22196,22932008,22932008,22946105,0,0,0,14097
22385,22944740,22944740,22946130,0,0,0,1390
22446,22946039,22946039,22946317,0,0,0,278
22449,22946308,22946308,22946386,0,0,0,78
22422,22945005,22945082,22946436,0,0,77,1431
22451,22946538,22946538,22946627,0,0,0,89
22455,22946572,22946572,22946758,0,0,0,186
22452,22946552,22946552,22946759,0,0,0,207
22456,22946576,22946576,22946762,0,0,0,186
22454,22946561,22946561,22946768,0,0,0,207
22459,22946601,22946601,22946792,0,0,0,191
22457,22946580,22946580,22946797,0,0,0,217
22458,22946598,22946598,22946820,0,0,0,222
22461,22946624,22946624,22946851,0,0,0,227
22463,22946628,22946628,22946855,0,0,0,227
22460,22946605,22946605,22946909,0,0,0,304
22412,22944747,22944785,22946989,0,0,38,2242
22413,22944747,22944785,22946989,0,0,38,2242
22453,22946555,22946555,22947021,0,0,0,466
22166,22927803,22927803,22947024,0,0,0,19221
22466,22946952,22946989,22947062,0,0,37,110
22467,22947108,22947108,22947201,0,0,0,93
22469,22947260,22947260,22947451,0,0,0,191
22470,22947264,22947264,22947455,0,0,0,191
22376,22944737,22944737,22947462,0,0,0,2725
22468,22947254,22947254,22947462,0,0,0,208
22378,22944738,22944738,22947502,0,0,0,2764
22473,22947291,22947291,22947502,0,0,0,211
22476,22947317,22947317,22947502,0,0,0,185
22381,22944739,22944739,22947503,0,0,0,2764
22474,22947295,22947295,22947506,0,0,0,211
22471,22947266,22947266,22947508,0,0,0,242
22472,22947269,22947269,22947511,0,0,0,242
22382,22944739,22944739,22947534,0,0,0,2795
22475,22947299,22947299,22947541,0,0,0,242
22388,22944741,22944741,22947567,0,0,0,2826
22389,22944741,22944741,22947567,0,0,0,2826
22408,22944746,22944746,22947567,0,0,0,2821
22391,22944742,22944742,22947568,0,0,0,2826
22392,22944742,22944742,22947568,0,0,0,2826
22395,22944743,22944743,22947600,0,0,0,2857
22396,22944743,22944743,22947600,0,0,0,2857
22399,22944744,22944744,22947601,0,0,0,2857
22400,22944744,22944744,22947601,0,0,0,2857
22403,22944745,22944745,22947602,0,0,0,2857
22404,22944745,22944745,22947602,0,0,0,2857
22409,22944746,22944785,22947606,0,0,39,2860
22448,22946210,22946210,22947632,0,0,0,1422
22479,22947415,22947415,22947658,0,0,0,243
22420,22944967,22947632,22947726,0,0,2665,2759
22486,22947417,22947417,22947768,0,0,0,351
22489,22947693,22947693,22947895,0,0,0,202
22490,22947697,22947697,22947899,0,0,0,202
22491,22947700,22947700,22947902,0,0,0,202
22488,22947687,22947687,22947905,0,0,0,218
22483,22947416,22947416,22947913,0,0,0,497
22487,22947417,22947417,22947945,0,0,0,528
22492,22947719,22947726,22947955,0,0,7,236
22493,22947724,22947726,22947955,0,0,2,231
22494,22947727,22947727,22947956,0,0,0,229
22495,22947745,22947745,22947979,0,0,0,234
22496,22947748,22947748,22947982,0,0,0,234
22497,22947752,22947752,22947986,0,0,0,234
22514,22947913,22947913,22948007,0,0,0,94
22478,22947409,22947409,22948009,0,0,0,600
22480,22947415,22947415,22948010,0,0,0,595
22481,22947415,22947415,22948015,0,0,0,600
22482,22947415,22947415,22948015,0,0,0,600
22484,22947416,22947416,22948016,0,0,0,600
22485,22947416,22947416,22948016,0,0,0,600
22518,22948102,22948102,22948389,0,0,0,287
22534,22948619,22948619,22948807,0,0,0,188
22520,22948328,22948328,22948928,0,0,0,600
22521,22948328,22948328,22948928,0,0,0,600
22522,22948328,22948328,22948928,0,0,0,600
22523,22948328,22948328,22948928,0,0,0,600
22524,22948329,22948329,22948929,0,0,0,600
22525,22948329,22948329,22948929,0,0,0,600
22526,22948329,22948329,22948929,0,0,0,600
22527,22948329,22948329,22948929,0,0,0,600
22528,22948330,22948330,22948930,0,0,0,600
22529,22948330,22948330,22948930,0,0,0,600
22538,22948620,22948620,22949073,0,0,0,453
22539,22948620,22948620,22949084,0,0,0,464
22536,22948619,22948619,22949130,0,0,0,511
22535,22948619,22948619,22949173,0,0,0,554
22533,22948618,22948618,22949218,0,0,0,600
22537,22948619,22948619,22949219,0,0,0,600
22540,22948620,22948620,22949220,0,0,0,600
22541,22948620,22948620,22949220,0,0,0,600
22542,22948621,22948621,22949221,0,0,0,600
22530,22948385,22948385,22949397,0,0,0,1012
22544,22949327,22949327,22949649,0,0,0,322
22546,22949336,22949336,22949770,0,0,0,434
22547,22949339,22949339,22949773,0,0,0,434
22545,22949333,22949333,22949780,0,0,0,447
22548,22949341,22949397,22949831,0,0,56,490
22549,22949347,22949649,22950134,0,0,302,787
22551,22949353,22949773,22950207,0,0,420,854
22553,22949657,22949831,22950247,0,0,174,590
22477,22947357,22947357,22950282,0,0,0,2925
22550,22949350,22949770,22950291,0,0,420,941
22554,22950359,22950359,22950458,0,0,0,99
22555,22950528,22950528,22950629,0,0,0,101
22556,22950531,22950531,22950855,0,0,0,324
22557,22950541,22950541,22950911,0,0,0,370
22559,22950547,22950629,22950937,0,0,82,390
22561,22950572,22950629,22950999,0,0,57,427
22563,22950577,22950629,22950999,0,0,52,422
22558,22950545,22950629,22951030,0,0,84,485
22560,22950551,22950629,22951030,0,0,78,479
22552,22949492,22949780,22951048,0,0,288,1556
21382,22589197,22691849,22951049,0,0,102652,361852
22565,22950801,22951049,22951142,0,0,248,341
22564,22950580,22950855,22951285,0,0,275,705
22569,22951288,22951288,22951370,0,0,0,82
22568,22951135,22951135,22951487,0,0,0,352
22532,22948385,22948385,22951731,0,0,0,3346
22567,22951115,22951115,22951772,0,0,0,657
22571,22951652,22951652,22951901,0,0,0,249
22572,22951653,22951653,22951933,0,0,0,280
22574,22951658,22951658,22951983,0,0,0,325
22580,22951911,22951911,22951993,0,0,0,82
22578,22951699,22951699,22951994,0,0,0,295
22573,22951655,22951655,22951997,0,0,0,342
22577,22951678,22951678,22952004,0,0,0,326
22576,22951661,22951661,22952018,0,0,0,357
22575,22951660,22951660,22952022,0,0,0,362
22579,22951704,22951704,22952030,0,0,0,326
22519,22948324,22951049,22952057,0,0,2725,3733
22570,22951646,22951646,22952098,0,0,0,452
22562,22950572,22950999,22952238,0,0,427,1666
22582,22952492,22952492,22952568,0,0,0,76
22584,22952569,22952569,22952631,0,0,0,62
22585,22952597,22952597,22952659,0,0,0,62
22581,22952101,22952101,22952711,0,0,0,610
22583,22952544,22952544,22952787,0,0,0,243
22531,22948385,22951049,22952849,0,0,2664,4464
22586,22952645,22952645,22952981,0,0,0,336
22588,22952922,22952922,22953051,0,0,0,129
22589,22953087,22953087,22953141,0,0,0,54
22149,22923025,22923025,22953300,0,0,0,30275
22693,22953524,22953524,22953648,0,0,0,124
22714,22953589,22953589,22953656,0,0,0,67
22029,22849985,22849985,22953694,0,0,0,103709
22715,22953708,22953708,22953962,0,0,0,254
22717,22954411,22954411,22954536,0,0,0,125
22591,22953160,22953160,22954769,0,0,0,1609
22718,22954499,22954769,22954836,0,0,270,337
22840,22955114,22955114,22955161,0,0,0,47
22543,22948750,22951049,22955689,0,0,2299,6939
22587,22952649,22952649,22955720,0,0,0,3071
22842,22955831,22955831,22955903,0,0,0,72
22843,22956466,22956466,22956544,0,0,0,78
22846,22956979,22956979,22957046,0,0,0,67
22848,22957164,22957164,22957231,0,0,0,67
22841,22955534,22955534,22957356,0,0,0,1822
22362,22943249,22943249,22957585,0,0,0,14336
22849,22957555,22957555,22957622,0,0,0,67
22716,22954043,22957585,22957709,0,0,3542,3666
22844,22956550,22957709,22957833,0,0,1159,1283
22845,22956592,22957833,22957943,0,0,1241,1351
22593,22953452,22953452,22958956,0,0,0,5504
22594,22953452,22953452,22958956,0,0,0,5504
22597,22953452,22953694,22959180,0,0,242,5728
22598,22953453,22953694,22959180,0,0,241,5727
22595,22953452,22953452,22959204,0,0,0,5752
22596,22953452,22953452,22959482,0,0,0,6030
22346,22941879,22941879,22959761,0,0,0,17882
22309,22938066,22938066,22959816,0,0,0,21750
22363,22943342,22943342,22960995,0,0,0,17653
22600,22953453,22955689,22961188,0,0,2236,7735
22599,22953453,22955689,22961190,0,0,2236,7737
22566,22951109,22951109,22961430,0,0,0,10321
22601,22953453,22955689,22961458,0,0,2236,8005
22602,22953453,22955689,22961489,0,0,2236,8036
22604,22953454,22957585,22963084,0,0,4131,9630
22590,22953116,22953116,22963125,0,0,0,10009
22603,22953453,22957585,22963664,0,0,4132,10211
22605,22953454,22958956,22964517,0,0,5502,11063
22606,22953454,22958956,22964723,0,0,5502,11269
22607,22953454,22959180,22964978,0,0,5726,11524
22608,22953454,22959180,22965226,0,0,5726,11772
22609,22953454,22959204,22965281,0,0,5750,11827
22614,22953465,22959816,22965295,0,0,6351,11830
22611,22953455,22959761,22965497,0,0,6306,12042
22612,22953455,22959761,22965528,0,0,6306,12073
22613,22953465,22959761,22965550,0,0,6296,12085
22610,22953454,22959482,22965559,0,0,6028,12105
22615,22953465,22959816,22965559,0,0,6351,12094
22617,22953465,22960995,22966448,0,0,7530,12983
22620,22953466,22961190,22966687,0,0,7724,13221
22616,22953465,22960995,22966738,0,0,7530,13273
22618,22953465,22960995,22966788,0,0,7530,13323
22622,22953467,22961458,22966941,0,0,7991,13474
22623,22953467,22961489,22966973,0,0,8022,13506
22621,22953466,22961430,22967802,0,0,7964,14336
22626,22953468,22963664,22969116,0,0,10196,15648
22624,22953467,22963084,22969177,0,0,9617,15710
22625,22953467,22963125,22969280,0,0,9658,15813
21384,22589285,22710154,22969354,0,0,120869,380069
22860,22969834,22969834,22969994,0,0,0,160
22627,22953468,22964517,22970280,0,0,11049,16812
22861,22970402,22970402,22970469,0,0,0,67
22630,22953469,22965226,22970679,0,0,11757,17210
22628,22953468,22964723,22970765,0,0,11255,17297
22631,22953469,22965281,22970765,0,0,11812,17296
22862,22970772,22970772,22970864,0,0,0,92
22634,22953486,22965528,22970974,0,0,12042,17488
22432,22945112,22945446,22970981,0,0,334,25869
22629,22953468,22964978,22971020,0,0,11510,17552
22636,22953486,22965559,22971020,0,0,12073,17534
22633,22953486,22965497,22971260,0,0,12011,17774
22635,22953486,22965550,22971306,0,0,12064,17820
22637,22953487,22965559,22971330,0,0,12072,17843
22632,22953469,22965295,22971379,0,0,11826,17910
22863,22971330,22971330,22971397,0,0,0,67
22864,22971851,22971851,22971949,0,0,0,98
22639,22953487,22966687,22972180,0,0,13200,18693
22638,22953487,22966448,22972188,0,0,12961,18701
22643,22953488,22966973,22972465,0,0,13485,18977
22640,22953487,22966738,22972485,0,0,13251,18998
22641,22953487,22966788,22972560,0,0,13301,19073
22178,22929400,22929400,22972600,0,0,0,43200
22642,22953487,22966941,22972713,0,0,13454,19226
22866,22972959,22972959,22973026,0,0,0,67
22644,22953488,22967802,22973263,0,0,14314,19775
22445,22946035,22946035,22974508,0,0,0,28473
22645,22953489,22969116,22974608,0,0,15627,21119
22649,22953490,22969354,22974815,0,0,15864,21325
22655,22953504,22969354,22974843,0,0,15850,21339
22650,22953490,22969354,22974846,0,0,15864,21356
22646,22953489,22969177,22974979,0,0,15688,21490
22647,22953489,22969280,22975082,0,0,15791,21593
22651,22953490,22969354,22975094,0,0,15864,21604
22657,22953504,22969354,22975105,0,0,15850,21601
22656,22953504,22969354,22975133,0,0,15850,21629
22652,22953490,22969354,22975136,0,0,15864,21646
22653,22953503,22969354,22975156,0,0,15851,21653
22648,22953489,22969354,22975229,0,0,15865,21740
22654,22953503,22969354,22975401,0,0,15851,21898
22660,22953504,22970765,22976237,0,0,17261,22733
22661,22953505,22970765,22976237,0,0,17260,22732
22658,22953504,22970280,22976310,0,0,16776,22806
22659,22953504,22970679,22976430,0,0,17175,22926
22662,22953505,22970974,22976446,0,0,17469,22941
22664,22953505,22970981,22976453,0,0,17476,22948
22663,22953505,22970981,22976484,0,0,17476,22979
22665,22953505,22971020,22976492,0,0,17515,22987
22667,22953506,22971260,22976732,0,0,17754,23226
22669,22953506,22971330,22976802,0,0,17824,23296
22670,22953506,22971379,22976882,0,0,17873,23376
22668,22953506,22971306,22977057,0,0,17800,23551
22666,22953505,22971020,22977081,0,0,17515,23576
22673,22953517,22972465,22977930,0,0,18948,24413
22671,22953506,22972180,22977955,0,0,18674,24449
22674,22953517,22972485,22977970,0,0,18968,24453
22676,22953517,22972600,22978085,0,0,19083,24568
22675,22953517,22972560,22978138,0,0,19043,24621
22677,22953517,22972713,22978198,0,0,19196,24681
22672,22953506,22972188,22978273,0,0,18682,24767
22678,22953517,22973263,22979058,0,0,19746,25541
22680,22953518,22974508,22979961,0,0,20990,26443
22681,22953518,22974608,22980094,0,0,21090,26576
22682,22953518,22974815,22980270,0,0,21297,26752
22679,22953518,22974508,22980272,0,0,20990,26754
22684,22953518,22974846,22980301,0,0,21328,26783
22683,22953518,22974843,22980329,0,0,21325,26811
22686,22953519,22975082,22980537,0,0,21563,27018
22687,22953519,22975094,22980580,0,0,21575,27061
22694,22953534,22975401,22980894,0,0,21867,27360
22689,22953519,22975133,22980905,0,0,21614,27386
22690,22953519,22975136,22980908,0,0,21617,27389
22685,22953518,22974979,22981023,0,0,21461,27505
22692,22953520,22975229,22981094,0,0,21709,27574
22688,22953519,22975105,22981149,0,0,21586,27630
22691,22953519,22975156,22981176,0,0,21637,27657
22695,22953535,22976237,22981699,0,0,22702,28164
22697,22953535,22976310,22981803,0,0,22775,28268
22698,22953535,22976430,22981923,0,0,22895,28388
22701,22953536,22976484,22981945,0,0,22948,28409
22696,22953535,22976237,22982040,0,0,22702,28505
22703,22953537,22976732,22982193,0,0,23195,28656
22700,22953536,22976453,22982194,0,0,22917,28658
22699,22953536,22976446,22982217,0,0,22910,28681
22704,22953537,22976802,22982263,0,0,23265,28726
22705,22953537,22976882,22982343,0,0,23345,28806
22706,22953537,22977057,22982550,0,0,23520,29013
22707,22953537,22977081,22982853,0,0,23544,29316
22592,22953238,22953238,22983135,0,0,0,29897
22709,22953538,22977955,22983416,0,0,24417,29878
22710,22953538,22977970,22983431,0,0,24432,29893
21717,22724540,22724540,22983740,0,0,0,259200
21718,22724541,22724541,22983741,0,0,0,259200
21719,22724541,22724541,22983741,0,0,0,259200
21720,22724541,22724541,22983741,0,0,0,259200
21721,22724541,22724541,22983741,0,0,0,259200
21722,22724542,22724542,22983742,0,0,0,259200
21723,22724542,22724542,22983742,0,0,0,259200
22711,22953538,22978085,22983857,0,0,24547,30319
22713,22953538,22978198,22983969,0,0,24660,30431
22708,22953537,22977930,22983981,0,0,24393,30444
22719,22954811,22978273,22984013,0,0,23462,29202
22712,22953538,22978138,22984188,0,0,24600,30650
22865,22972632,22983742,22984419,0,0,11110,11787
22720,22954812,22979058,22984550,0,0,24246,29738
22619,22953465,22961188,22984797,0,0,7723,31332
22867,22974331,22984419,22985112,0,0,10088,10781
21724,22725931,22725931,22985131,0,0,0,259200
21725,22725964,22725964,22985164,0,0,0,259200
22868,22976678,22985112,22985185,0,0,8434,8507
22721,22954813,22979961,22985453,0,0,25148,30640
22722,22954813,22980094,22985555,0,0,25281,30742
22723,22954813,22980270,22985762,0,0,25457,30949
22724,22954813,22980272,22985764,0,0,25459,30951
22726,22954814,22980329,22985790,0,0,25515,30976
22725,22954814,22980301,22985793,0,0,25487,30979
22869,22976895,22985185,22985930,0,0,8290,9035
22727,22954814,22980537,22986029,0,0,25723,31215
22728,22954814,22980580,22986072,0,0,25766,31258
22729,22954815,22980894,22986386,0,0,26079,31571
22730,22954815,22980905,22986397,0,0,26090,31582
22733,22954816,22981094,22986586,0,0,26278,31770
22734,22954816,22981149,22986610,0,0,26333,31794
22735,22954816,22981176,22986668,0,0,26360,31852
22870,22979563,22985930,22986710,0,0,6367,7147
22731,22954815,22980908,22986958,0,0,26093,32143
22732,22954815,22981023,22987197,0,0,26208,32382
22738,22954817,22981923,22987384,0,0,27106,32567
22736,22954816,22981699,22987501,0,0,26883,32685
22740,22954826,22982040,22987502,0,0,27214,32676
22737,22954817,22981803,22987554,0,0,26986,32737
22742,22954827,22982194,22987656,0,0,27367,32829
22743,22954827,22982217,22987679,0,0,27390,32852
22741,22954826,22982193,22987686,0,0,27367,32860
22444,22946018,22946018,22987717,0,0,0,41699
22744,22954827,22982263,22987756,0,0,27436,32929
22746,22954828,22982550,22988042,0,0,27722,33214
22739,22954826,22981945,22988051,0,0,27119,33225
22745,22954827,22982343,22988053,0,0,27516,33226
22747,22954828,22982853,22988625,0,0,28025,33797
22748,22954828,22983416,22988877,0,0,28588,34049
22749,22954828,22983431,22988917,0,0,28603,34089
22753,22954829,22983969,22989424,0,0,29140,34595
22754,22954829,22983981,22989467,0,0,29152,34638
22755,22954829,22984013,22989479,0,0,29184,34650
22751,22954828,22983741,22989517,0,0,28913,34689
22750,22954828,22983740,22989536,0,0,28912,34708
22756,22954829,22984188,22989685,0,0,29359,34856
22752,22954828,22983857,22989881,0,0,29029,35053
22757,22954829,22984550,22990357,0,0,29721,35528
22758,22954829,22984797,22990852,0,0,29968,36023
22759,22954840,22985453,22990919,0,0,30613,36079
22760,22954840,22985555,22991021,0,0,30715,36181
22762,22954840,22985764,22991230,0,0,30924,36390
22763,22954840,22985790,22991256,0,0,30950,36416
22764,22954841,22985793,22991290,0,0,30952,36449
22765,22954841,22986029,22991495,0,0,31188,36654
22761,22954840,22985762,22991538,0,0,30922,36698
22766,22954841,22986072,22991569,0,0,31231,36728
22768,22954841,22986397,22991956,0,0,31556,37115
22771,22954842,22986668,22992164,0,0,31826,37322
22767,22954841,22986386,22992472,0,0,31545,37631
22769,22954841,22986586,22992640,0,0,31745,37799
22770,22954841,22986610,22992664,0,0,31769,37823
22773,22954842,22987197,22992667,0,0,32355,37825
22772,22954842,22986958,22992722,0,0,32116,37880
22774,22954842,22987384,22992871,0,0,32542,38029
22777,22954843,22987554,22993047,0,0,32711,38204
22780,22954855,22987679,22993141,0,0,32824,38286
22782,22954855,22987717,22993148,0,0,32862,38293
22781,22954855,22987686,22993179,0,0,32831,38324
22783,22954855,22987717,22993179,0,0,32862,38324
22775,22954842,22987501,22993304,0,0,32659,38462
22778,22954843,22987656,22993397,0,0,32813,38554
22787,22954856,22988053,22993526,0,0,33197,38670
22784,22954855,22987756,22993533,0,0,32901,38678
22776,22954842,22987502,22993553,0,0,32660,38711
22785,22954855,22988042,22993788,0,0,33187,38933
22786,22954855,22988051,22994104,0,0,33196,39249
22789,22954857,22988877,22994336,0,0,34020,39479
22788,22954856,22988625,22994405,0,0,33769,39549
22790,22954857,22988917,22994666,0,0,34060,39809
22508,22947912,22947912,22994906,0,0,0,46994
22793,22954858,22989479,22994969,0,0,34621,40111
22794,22954858,22989517,22994976,0,0,34659,40118
22501,22947910,22947910,22995198,0,0,0,47288
22795,22954858,22989536,22995328,0,0,34678,40470
22797,22954859,22989881,22995332,0,0,35022,40473
22509,22947912,22947912,22995402,0,0,0,47490
22499,22947910,22947910,22995438,0,0,0,47528
22796,22954858,22989685,22995457,0,0,34827,40599
22791,22954857,22989424,22995475,0,0,34567,40618
22510,22947912,22947912,22995495,0,0,0,47583
22792,22954857,22989467,22995549,0,0,34610,40692
22500,22947910,22947910,22995562,0,0,0,47652
22798,22954859,22990357,22995839,0,0,35498,40980
22512,22947912,22947912,22995888,0,0,0,47976
22847,22957124,22995839,22995932,0,0,38715,38808
22511,22947912,22947912,22996078,0,0,0,48166
22799,22954859,22990852,22996345,0,0,35993,41486
22374,22944615,22944615,22996355,0,0,0,51740
22498,22947909,22947909,22996534,0,0,0,48625
22800,22954871,22990919,22996691,0,0,36048,41820
22803,22954872,22991256,22996780,0,0,36384,41908
22801,22954871,22991021,22996793,0,0,36150,41922
22804,22954872,22991290,22996814,0,0,36418,41942
22450,22946410,22946410,22996882,0,0,0,50472
22802,22954871,22991230,22996971,0,0,36359,42100
22505,22947911,22947911,22996976,0,0,0,49065
22805,22954872,22991495,22996988,0,0,36623,42116
22502,22947911,22947911,22996997,0,0,0,49086
22807,22954872,22991569,22997062,0,0,36697,42190
22504,22947911,22947911,22997216,0,0,0,49305
22503,22947911,22947911,22997235,0,0,0,49324
22806,22954872,22991538,22997310,0,0,36666,42438
22809,22954873,22992164,22997626,0,0,37291,42753
22808,22954872,22991956,22997820,0,0,37084,42948
22810,22954873,22992472,22997973,0,0,37599,43100
22811,22954873,22992640,22998148,0,0,37767,43275
22814,22954873,22992722,22998215,0,0,37849,43342
22812,22954873,22992664,22998458,0,0,37791,43585
22334,22940794,22940794,22998485,0,0,0,57691
22816,22954874,22993047,22998527,0,0,38173,43653
22850,22958780,22998485,22998579,0,0,39705,39799
22820,22954885,22993179,22998628,0,0,38294,43743
22815,22954873,22992871,22998642,0,0,37998,43769
22447,22946203,22946203,22998704,0,0,0,52501
22813,22954873,22992667,22998741,0,0,37794,43868
22821,22954885,22993304,22998769,0,0,38419,43884
22822,22954886,22993397,22998862,0,0,38511,43976
22817,22954874,22993141,22998916,0,0,38267,44042
22818,22954874,22993148,22998954,0,0,38274,44080
22819,22954874,22993179,22998985,0,0,38305,44111
22823,22954886,22993526,22998986,0,0,38640,44100
22826,22954886,22993788,22999261,0,0,38902,44375
22824,22954886,22993533,22999282,0,0,38647,44396
22506,22947911,22947911,22999395,0,0,0,51484
22825,22954886,22993553,22999581,0,0,38667,44695
22827,22954886,22994104,22999593,0,0,39218,44707
22829,22954887,22994405,22999863,0,0,39518,44976
22418,22944890,22944977,23000341,0,0,87,55451
22830,22954887,22994666,23000403,0,0,39779,45516
22828,22954886,22994336,23000414,0,0,39450,45528
22832,22954887,22994976,23000473,0,0,40089,45586
22831,22954887,22994969,23000737,0,0,40082,45850
22833,22954887,22995328,23000841,0,0,40441,45954
22835,22954888,22995438,23000920,0,0,40550,46032
22836,22954888,22995457,23000939,0,0,40569,46051
22837,22954888,22995475,23000957,0,0,40587,46069
22834,22954887,22995332,23001073,0,0,40445,46186
22871,22980638,22995932,23001414,0,0,15294,20776
22515,22947913,22947913,23001428,0,0,0,53515
22872,22980639,22996078,23001579,0,0,15439,20940
22838,22954888,22995549,23001608,0,0,40661,46720
22839,22954888,22995562,23001621,0,0,40674,46733
22873,22980639,22996345,23001838,0,0,15706,21199
22876,22980640,22996780,23002335,0,0,16140,21695
22465,22946947,22946947,23002398,0,0,0,55451
22879,22980640,22996971,23002427,0,0,16331,21787
22875,22980639,22996691,23002432,0,0,16052,21793
22880,22980641,22996976,23002485,0,0,16335,21844
22881,22980641,22996988,23002492,0,0,16347,21851
22874,22980639,22996534,23002553,0,0,15895,21914
22878,22980640,22996814,23002628,0,0,16174,21988
22884,22980642,22997310,23002779,0,0,16668,22137
22882,22980641,22997062,23002793,0,0,16421,22152
22877,22980640,22996793,23002848,0,0,16153,22208
22885,22980642,22997626,23003124,0,0,16984,22482
22883,22980641,22997216,23003251,0,0,16575,22610
22507,22947911,22947911,23003258,0,0,0,55347
22702,22953536,22976492,23003260,0,0,22956,49724
22886,22980642,22997820,23003566,0,0,17178,22924
22888,22980643,22998148,23003646,0,0,17505,23003
22889,22980643,22998215,23003666,0,0,17572,23023
22887,22980642,22997973,23004023,0,0,17331,23381
22893,22980665,22998579,23004077,0,0,17914,23412
22897,22980666,22998741,23004208,0,0,18075,23542
22898,22980666,22998769,23004236,0,0,18103,23570
22890,22980643,22998458,23004253,0,0,17815,23610
22892,22980664,22998527,23004269,0,0,17863,23605
22894,22980665,22998579,23004352,0,0,17914,23687
22901,22980667,22998954,23004446,0,0,18287,23779
22462,22946624,22946624,23004466,0,0,0,57842
22903,22980667,22998986,23004469,0,0,18319,23802
22902,22980667,22998985,23004494,0,0,18318,23827
22891,22980663,22998485,23004522,0,0,17822,23859
22899,22980666,22998862,23004652,0,0,18196,23986
22895,22980665,22998628,23004680,0,0,17963,24015
22896,22980665,22998642,23004725,0,0,17977,24060
22905,22980668,22999282,23004836,0,0,18614,24168
22464,22946881,22946881,23004942,0,0,0,58061
22900,22980666,22998916,23005007,0,0,18250,24341
22904,22980667,22999261,23005054,0,0,18594,24387
22909,22980669,22999863,23005343,0,0,19194,24674
22906,22980668,22999395,23005476,0,0,18727,24808
22907,22980668,22999581,23005600,0,0,18913,24932
22908,22980668,22999593,23005648,0,0,18925,24980
22911,22980692,23000414,23005863,0,0,19722,25171
22912,22980693,23000473,23005948,0,0,19780,25255
22910,22980669,23000403,23006460,0,0,19734,25791
22913,22980693,23000737,23006522,0,0,20044,25829
22918,22980694,23001073,23006529,0,0,20379,25835
22914,22980693,23000841,23006588,0,0,20148,25895
22915,22980693,23000920,23006683,0,0,20227,25990
22916,22980693,23000939,23006702,0,0,20246,26009
22516,22947913,22947955,23006714,0,0,42,58801
22920,22980694,23001428,23006856,0,0,20734,26162
22919,22980694,23001414,23006873,0,0,20720,26179
22921,22980694,23001579,23007038,0,0,20885,26344
22922,22980694,23001608,23007074,0,0,20914,26380
22923,22980694,23001621,23007087,0,0,20927,26393
22925,22980695,23002335,23007827,0,0,21640,27132
22924,22980694,23001838,23007846,0,0,21144,27152
22928,22980695,23002485,23007966,0,0,21790,27271
22513,22947912,22947912,23007967,0,0,0,60055
22931,22980706,23002628,23008134,0,0,21922,27428
22926,22980695,23002427,23008187,0,0,21732,27492
22929,22980695,23002492,23008259,0,0,21797,27564
22933,22980707,23002793,23008274,0,0,22086,27567
22927,22980695,23002432,23008440,0,0,21737,27745
22935,22980708,23003124,23008585,0,0,22416,27877
22930,22980695,23002553,23008599,0,0,21858,27904
22934,22980707,23002848,23008623,0,0,22141,27916
22937,22980709,23003258,23008732,0,0,22549,28023
22936,22980708,23003251,23008765,0,0,22543,28057
22517,22947913,22947986,23008872,0,0,73,60959
22938,22980709,23003260,23009054,0,0,22551,28345
22932,22980706,23002779,23009104,0,0,22073,28398
22939,22980709,23003566,23009130,0,0,22857,28421
22941,22980710,23003666,23009137,0,0,22956,28427
22940,22980709,23003646,23009407,0,0,22937,28698
22944,22980711,23004208,23009710,0,0,23497,28999
22946,22980711,23004253,23009755,0,0,23542,29044
22947,22980711,23004269,23009759,0,0,23558,29048
22942,22980710,23004023,23009798,0,0,23313,29088
22948,22980712,23004352,23009840,0,0,23640,29128
22943,22980710,23004077,23009845,0,0,23367,29135
22851,22959016,23009759,23009852,0,0,50743,50836
22949,22980712,23004446,23009930,0,0,23734,29218
22951,22980723,23004494,23009947,0,0,23771,29224
22952,22980723,23004522,23009999,0,0,23799,29276
22955,22980724,23004725,23010184,0,0,24001,29460
22945,22980711,23004236,23010274,0,0,23525,29563
22956,22980724,23004836,23010326,0,0,24112,29602
22957,22980724,23004942,23010386,0,0,24218,29662
22953,22980723,23004652,23010392,0,0,23929,29669
22954,22980723,23004680,23010420,0,0,23957,29697
22950,22980712,23004469,23010485,0,0,23757,29773
22959,22980724,23005054,23010529,0,0,24330,29805
22958,22980724,23005007,23010781,0,0,24283,30057
22960,22980724,23005343,23010849,0,0,24619,30125
22962,22980725,23005600,23011099,0,0,24875,30374
22963,22980725,23005648,23011147,0,0,24923,30422
22961,22980724,23005476,23011261,0,0,24752,30537
22964,22980725,23005863,23011652,0,0,25138,30927
22965,22980725,23005948,23011985,0,0,25223,31260
22968,22980726,23006529,23011985,0,0,25803,31259
22971,22980739,23006702,23012191,0,0,25963,31452
22972,22980740,23006856,23012314,0,0,26116,31574
22969,22980726,23006588,23012338,0,0,25862,31612
22973,22980740,23006873,23012353,0,0,26133,31613
22970,22980728,23006683,23012442,0,0,25955,31714
22966,22980725,23006460,23012497,0,0,25735,31772
22976,22980740,23007087,23012569,0,0,26347,31829
22967,22980725,23006522,23012591,0,0,25797,31866
22975,22980740,23007074,23012629,0,0,26334,31889
22974,22980740,23007038,23012797,0,0,26298,32057
22991,22983131,22983131,23012852,0,0,0,29721
22979,22980741,23007966,23013434,0,0,27225,32693
22982,22980742,23008187,23013683,0,0,27445,32941
22984,22980743,23008274,23013740,0,0,27531,32997
22983,22980742,23008259,23013741,0,0,27517,32999
22980,22980741,23007967,23013760,0,0,27226,33019
22977,22980740,23007827,23013847,0,0,27087,33107
22981,22980742,23008134,23013874,0,0,27392,33132
22978,22980740,23007846,23013896,0,0,27106,33156
22985,22980743,23008440,23014219,0,0,27697,33476
22986,22980743,23008585,23014334,0,0,27842,33591
22987,22980743,23008599,23014379,0,0,27856,33636
22988,22980744,23008623,23014397,0,0,27879,33653
22989,22980744,23008732,23014463,0,0,27988,33719
22990,22980744,23008765,23014527,0,0,28021,33783
22298,22937106,22937106,23016417,0,0,0,79311
23008,23018080,23018080,23018159,0,0,0,79
23011,23018201,23018201,23018363,0,0,0,162
23015,23018327,23018327,23018364,0,0,0,37
23014,23018299,23018299,23018509,0,0,0,210
23018,23018470,23018470,23018537,0,0,0,67
23020,23018769,23018769,23018847,0,0,0,78
23021,23019369,23019369,23019461,0,0,0,92
22366,22943603,22943603,23019984,0,0,0,76381
23023,23019882,23019882,23020200,0,0,0,318
23022,23019839,23019839,23020439,0,0,0,600
23024,23020173,23020173,23020594,0,0,0,421
23025,23020567,23020567,23020603,0,0,0,36
23026,23020626,23020626,23020725,0,0,0,99
23027,23020727,23020727,23020825,0,0,0,98
23029,23021505,23021505,23021572,0,0,0,67
23031,23022084,23022084,23022182,0,0,0,98
23034,23024410,23024410,23024470,0,0,0,60
22917,22980693,23000957,23024908,0,0,20264,44215
23035,23025020,23025020,23025129,0,0,0,109
23036,23025553,23025553,23025651,0,0,0,98
22244,22933145,22933145,23025682,0,0,0,92537
23009,23018128,23025682,23025775,0,0,7554,7647
23012,23018233,23025775,23025868,0,0,7542,7635
23016,23018361,23018361,23026664,0,0,0,8303
23037,23026326,23026326,23026908,0,0,0,582
23017,23018464,23018464,23027171,0,0,0,8707
23039,23027015,23027015,23027532,0,0,0,517
23040,23027333,23027333,23027679,0,0,0,346
23003,23013139,23013139,23028164,0,0,0,15025
23010,23018176,23028164,23028257,0,0,9988,10081
23013,23018262,23028257,23028350,0,0,9995,10088
23043,23028297,23028350,23028422,0,0,53,125
23042,23028097,23028097,23028465,0,0,0,368
23019,23018574,23019984,23028489,0,0,1410,9915
23041,23028079,23028079,23028558,0,0,0,479
23044,23029748,23029748,23029815,0,0,0,67
23001,23010143,23010143,23030098,0,0,0,19955
23045,23030241,23030241,23030339,0,0,0,98
23046,23030551,23030551,23030820,0,0,0,269
23048,23030877,23030877,23031152,0,0,0,275
23051,23031983,23031983,23032067,0,0,0,84
23054,23033167,23033167,23033260,0,0,0,93
23053,23033105,23033105,23033409,0,0,0,304
23055,23033507,23033507,23033580,0,0,0,73
22239,22933073,22933073,23033661,0,0,0,100588
23057,23033628,23033628,23033701,0,0,0,73
23038,23026876,23033661,23033755,0,0,6785,6879
23052,23032120,23032120,23033876,0,0,0,1756
23060,23033823,23033823,23033896,0,0,0,73
23061,23033918,23033918,23034033,0,0,0,115
23059,23033817,23033817,23034090,0,0,0,273
23066,23034172,23034172,23034291,0,0,0,119
23067,23034254,23034254,23034508,0,0,0,254
23068,23034806,23034806,23034899,0,0,0,93
23070,23035081,23035081,23035174,0,0,0,93
23071,23035319,23035319,23035412,0,0,0,93
23072,23035408,23035408,23035481,0,0,0,73
23073,23035485,23035485,23035563,0,0,0,78
23074,23035568,23035568,23035674,0,0,0,106
23075,23035681,23035681,23035774,0,0,0,93
23076,23035769,23035769,23035842,0,0,0,73
23077,23035934,23035934,23036007,0,0,0,73
23078,23036042,23036042,23036115,0,0,0,73
23079,23036141,23036141,23036234,0,0,0,93
23080,23036259,23036259,23036353,0,0,0,94
23081,23036431,23036431,23036524,0,0,0,93
23082,23036527,23036527,23036620,0,0,0,93
23083,23036864,23036864,23036988,0,0,0,124
23084,23037233,23037233,23037337,0,0,0,104
23069,23035068,23035068,23042495,0,0,0,7427
23093,23037741,23042495,23042587,0,0,4754,4846
23087,23037538,23042495,23042592,0,0,4957,5054
23096,23037917,23042587,23042660,0,0,4670,4743
23102,23038253,23042592,23042685,0,0,4339,4432
23004,23013147,23013434,23044202,0,0,287,31055
23085,23037477,23037477,23046457,0,0,0,8980
23005,23016312,23016312,23049628,0,0,0,33316
23007,23016483,23016483,23049850,0,0,0,33367
23090,23037609,23049850,23049944,0,0,12241,12335
23092,23037720,23042495,23050841,0,0,4775,13121
23088,23037575,23042495,23051022,0,0,4920,13447
23089,23037578,23037578,23051099,0,0,0,13521
23104,23042172,23051022,23051146,0,0,8850,8974
23105,23042439,23051146,23051239,0,0,8707,8800
23107,23043689,23051239,23051487,0,0,7550,7798
23108,23044070,23051487,23051580,0,0,7417,7510
23109,23044161,23051580,23051653,0,0,7419,7492
23110,23044340,23051653,23051808,0,0,7313,7468
23111,23044541,23051808,23051902,0,0,7267,7361
23112,23045170,23051902,23051996,0,0,6732,6826
23086,23037507,23037507,23052091,0,0,0,14584
22855,22961527,23010392,23054513,0,0,48865,92986
23095,23037801,23046457,23054540,0,0,8656,16739
23002,23012978,23012978,23054564,0,0,0,41586
23056,23033597,23054513,23054660,0,0,20916,21063
23058,23033701,23054564,23054727,0,0,20863,21026
23047,23030602,23033755,23055047,0,0,3153,24445
23030,23022068,23022068,23055262,0,0,0,33194
23094,23037758,23042495,23056160,0,0,4737,18402
22856,22961540,23010849,23057175,0,0,49309,95635
23062,23033959,23057175,23057330,0,0,23216,23371
23103,23038673,23049628,23058444,0,0,10955,19771
23097,23037918,23049628,23058973,0,0,11710,21055
23033,23024008,23028350,23060223,0,0,4342,36215
23106,23042840,23042840,23062047,0,0,0,19207
23091,23037699,23049944,23063701,0,0,12245,26002
22242,22933088,22933088,23066109,0,0,0,133021
21853,22809640,22809640,23067910,0,0,0,258270
22241,22933082,22933082,23068602,0,0,0,135520
21847,22809497,22809497,23068697,0,0,0,259200
21848,22809498,22809498,23068698,0,0,0,259200
21849,22809498,22809498,23068698,0,0,0,259200
21850,22809498,22809498,23068698,0,0,0,259200
21851,22809520,22809520,23068720,0,0,0,259200
21852,22809520,22809520,23068720,0,0,0,259200
21854,22809736,22809736,23068936,0,0,0,259200
21716,22724137,22724137,23069737,0,0,0,345600
23049,23031081,23044202,23086085,0,0,13121,55004
23113,23051076,23054540,23087833,0,0,3464,36757
22857,22961576,23014379,23087876,0,0,52803,126300
22415,22944773,23087876,23088032,0,0,143103,143259
23114,23051113,23054727,23088969,0,0,3614,37856
23050,23031088,23054513,23088973,0,0,23425,57885
23063,23033990,23088973,23089190,0,0,54983,55200
23098,23038130,23054660,23090609,0,0,16530,52479
23099,23038201,23054727,23091836,0,0,16526,53635
22238,22933072,22933072,23094019,0,0,0,160947
23101,23038252,23057175,23094325,0,0,18923,56073
21923,22842547,22842547,23095147,0,0,0,252600
21924,22842561,22842561,23095161,0,0,0,252600
21925,22842578,22842578,23095178,0,0,0,252600
23006,23016348,23016348,23095183,0,0,0,78835
23100,23038227,23055047,23095725,0,0,16820,57498
23126,23097076,23097076,23097170,0,0,0,94
23127,23097607,23097607,23097700,0,0,0,93
23128,23098226,23098226,23098319,0,0,0,93
23129,23098758,23098758,23098851,0,0,0,93
23130,23099301,23099301,23099405,0,0,0,104
23131,23099757,23099757,23099863,0,0,0,106
23132,23100099,23100099,23100193,0,0,0,94
23133,23100412,23100412,23100514,0,0,0,102
23134,23100484,23100484,23100578,0,0,0,94
23136,23100617,23100617,23100701,0,0,0,84
23135,23100607,23100607,23100702,0,0,0,95
23137,23100662,23100662,23100749,0,0,0,87
23138,23100728,23100728,23100822,0,0,0,94
23139,23100824,23100824,23100917,0,0,0,93
23141,23100968,23100968,23101030,0,0,0,62
23142,23101074,23101074,23101167,0,0,0,93
23140,23100934,23100934,23101235,0,0,0,301
23143,23101260,23101260,23101354,0,0,0,94
23144,23101378,23101378,23101482,0,0,0,104
23145,23101439,23101439,23101512,0,0,0,73
23146,23101539,23101539,23101829,0,0,0,290
23147,23101850,23101850,23102172,0,0,0,322
23149,23102249,23102249,23102360,0,0,0,111
23150,23102335,23102335,23102429,0,0,0,94
23148,23102130,23102130,23102480,0,0,0,350
23151,23102526,23102526,23102855,0,0,0,329
23153,23102863,23102863,23102978,0,0,0,115
23154,23102935,23102935,23103008,0,0,0,73
23155,23102943,23102943,23103201,0,0,0,258
23157,23103172,23103172,23103265,0,0,0,93
23159,23103676,23103676,23103749,0,0,0,73
23158,23103571,23103571,23103852,0,0,0,281
23160,23103819,23103819,23103892,0,0,0,73
23164,23105095,23105095,23105331,0,0,0,236
23165,23105238,23105238,23105332,0,0,0,94
23166,23105386,23105386,23105479,0,0,0,93
23167,23105536,23105536,23105609,0,0,0,73
23168,23105737,23105737,23105810,0,0,0,73
23169,23106034,23106034,23106128,0,0,0,94
23170,23106278,23106278,23106537,0,0,0,259
23028,23021339,23025868,23106868,0,0,4529,85529
23171,23108199,23108199,23108835,0,0,0,636
23163,23104274,23104274,23109196,0,0,0,4922
23152,23102737,23102737,23111624,0,0,0,8887
23156,23103145,23103145,23111740,0,0,0,8595
23176,23111921,23111921,23112020,0,0,0,99
23161,23103855,23103855,23112468,0,0,0,8613
23177,23112181,23112181,23112868,0,0,0,687
23178,23113013,23113013,23113717,0,0,0,704
23162,23104012,23104012,23113779,0,0,0,9767
22045,22854961,22854961,23114161,0,0,0,259200
22046,22855004,22855004,23114204,0,0,0,259200
23180,23114217,23114217,23114288,0,0,0,71
22047,22855176,22855176,23114376,0,0,0,259200
23181,23114326,23114326,23114427,0,0,0,101
23185,23114851,23114851,23114949,0,0,0,98
23173,23109800,23109800,23114981,0,0,0,5181
23187,23115239,23115239,23115319,0,0,0,80
23188,23115256,23115256,23115350,0,0,0,94
23189,23115361,23115361,23115519,0,0,0,158
23193,23115803,23115803,23115896,0,0,0,93
23194,23115898,23115898,23115971,0,0,0,73
22056,22856853,22856853,23116053,0,0,0,259200
23195,23116109,23116109,23116202,0,0,0,93
23196,23116216,23116216,23116309,0,0,0,93
23197,23116305,23116305,23116378,0,0,0,73
23064,23034028,23116053,23116712,0,0,82025,82684
23199,23116527,23116527,23116858,0,0,0,331
23200,23116578,23116578,23116910,0,0,0,332
22243,22933088,22933088,23117044,0,0,0,183956
22240,22933079,22933079,23117051,0,0,0,183972
23198,23116411,23116411,23117115,0,0,0,704
23207,23117250,23117250,23117333,0,0,0,83
23065,23034059,23116712,23117510,0,0,82653,83451
23210,23117699,23117699,23117793,0,0,0,94
23175,23111314,23111314,23118010,0,0,0,6696
23209,23117608,23117608,23118474,0,0,0,866
23211,23118009,23118009,23118566,0,0,0,557
23206,23117152,23117152,23118867,0,0,0,1715
23214,23118788,23118788,23118873,0,0,0,85
23216,23119371,23119371,23119725,0,0,0,354
23218,23119594,23119594,23119956,0,0,0,362
23213,23118499,23118499,23120211,0,0,0,1712
23208,23117328,23117328,23120264,0,0,0,2936
23219,23120222,23120222,23120775,0,0,0,553
23179,23113933,23113933,23120805,0,0,0,6872
23186,23115057,23115057,23120836,0,0,0,5779
23191,23115410,23115410,23121072,0,0,0,5662
23222,23121045,23121045,23121124,0,0,0,79
23220,23120877,23120877,23121225,0,0,0,348
23224,23121154,23121154,23121289,0,0,0,135
23221,23121033,23121033,23121321,0,0,0,288
23225,23121321,23121321,23121388,0,0,0,67
23223,23121080,23121080,23121753,0,0,0,673
23228,23122063,23122063,23122154,0,0,0,91
23230,23122121,23122121,23122188,0,0,0,67
23226,23121648,23121648,23122237,0,0,0,589
23215,23118935,23118935,23122324,0,0,0,3389
23192,23115473,23115473,23122352,0,0,0,6879
23229,23122100,23122100,23122418,0,0,0,318
23233,23122482,23122482,23122761,0,0,0,279
23232,23122286,23122286,23122820,0,0,0,534
23236,23122974,23122974,23123054,0,0,0,80
23217,23119417,23119417,23123120,0,0,0,3703
23235,23122906,23122906,23123225,0,0,0,319
23237,23123028,23123028,23123298,0,0,0,270
23238,23123188,23123188,23123788,0,0,0,600
23239,23123236,23123236,23123871,0,0,0,635
23172,23108979,23108979,23124162,0,0,0,15183
23240,23123829,23123829,23124548,0,0,0,719
23248,23125019,23125019,23125098,0,0,0,79
23251,23125103,23125103,23125172,0,0,0,69
23254,23125203,23125203,23125266,0,0,0,63
23231,23122210,23122210,23125297,0,0,0,3087
23247,23124877,23124877,23125452,0,0,0,575
23227,23122008,23122008,23125482,0,0,0,3474
23255,23125573,23125573,23125664,0,0,0,91
23242,23124162,23124162,23125771,0,0,0,1609
23256,23125678,23125678,23125775,0,0,0,97
23258,23125744,23125744,23125819,0,0,0,75
23260,23125998,23125998,23126091,0,0,0,93
23190,23115369,23115369,23126150,0,0,0,10781
23234,23122786,23122786,23126454,0,0,0,3668
23264,23127072,23127072,23127166,0,0,0,94
23266,23127355,23127355,23127459,0,0,0,104
23267,23127485,23127485,23127595,0,0,0,110
23268,23127545,23127545,23127623,0,0,0,78
23269,23127563,23127563,23127656,0,0,0,93
23241,23124004,23124004,23127820,0,0,0,3816
23243,23124336,23124336,23127846,0,0,0,3510
23270,23127778,23127778,23127851,0,0,0,73
23265,23127349,23127349,23127960,0,0,0,611
23244,23124473,23124473,23128076,0,0,0,3603
23249,23125022,23125022,23128078,0,0,0,3056
23253,23125146,23125146,23128524,0,0,0,3378
23245,23124511,23124511,23128575,0,0,0,4064
23257,23125730,23125730,23128576,0,0,0,2846
23259,23125787,23125787,23128576,0,0,0,2789
23252,23125121,23125121,23128707,0,0,0,3586
23271,23128110,23128110,23128742,0,0,0,632
23246,23124559,23124559,23128773,0,0,0,4214
23250,23125096,23125096,23128864,0,0,0,3768
23275,23129012,23129012,23129666,0,0,0,654
23274,23128995,23128995,23129693,0,0,0,698
23276,23129025,23129025,23129775,0,0,0,750
23273,23128574,23128574,23129909,0,0,0,1335
23272,23128544,23128544,23129941,0,0,0,1397
23261,23126122,23126122,23130635,0,0,0,4513
23262,23126391,23126391,23130857,0,0,0,4466
23263,23126713,23126713,23131136,0,0,0,4423
23281,23131027,23131027,23131570,0,0,0,543
23282,23131902,23131902,23131970,0,0,0,68
23284,23132135,23132135,23132182,0,0,0,47
23283,23132011,23132011,23132519,0,0,0,508
23277,23129865,23129865,23132600,0,0,0,2735
23288,23132603,23132603,23132701,0,0,0,98
23290,23132755,23132755,23132900,0,0,0,145
23289,23132746,23132746,23132907,0,0,0,161
23294,23133003,23133003,23133163,0,0,0,160
23204,23116963,23116963,23133182,0,0,0,16219
22157,22926147,22926147,23133286,0,0,0,207139
22158,22926154,22926154,23133329,0,0,0,207175
23297,23133288,23133288,23133448,0,0,0,160
23298,23133461,23133461,23133621,0,0,0,160
23299,23133994,23133994,23134057,0,0,0,63
23300,23134010,23134010,23134057,0,0,0,47
23280,23130715,23130715,23134059,0,0,0,3344
23301,23134072,23134072,23134169,0,0,0,97
23302,23134137,23134137,23134198,0,0,0,61
23304,23134213,23134213,23134249,0,0,0,36
23287,23132586,23132586,23134253,0,0,0,1667
23303,23134170,23134170,23134254,0,0,0,84
23305,23134258,23134258,23134321,0,0,0,63
23279,23130650,23130650,23134327,0,0,0,3677
23307,23134283,23134283,23134366,0,0,0,83
23309,23134329,23134329,23134396,0,0,0,67
23312,23134896,23134896,23134998,0,0,0,102
23313,23134954,23134954,23135008,0,0,0,54
23314,23134971,23134971,23135040,0,0,0,69
23315,23135002,23135002,23135066,0,0,0,64
23317,23135029,23135029,23135097,0,0,0,68
23318,23135045,23135045,23135097,0,0,0,52
23319,23135061,23135061,23135097,0,0,0,36
23316,23135014,23135014,23135098,0,0,0,84
23320,23135116,23135116,23135240,0,0,0,124
23329,23135361,23135361,23135547,0,0,0,186
23115,23058003,23058003,23135591,0,0,0,77588
23323,23135157,23135591,23135833,0,0,434,676
23330,23135565,23135565,23135844,0,0,0,279
23212,23118210,23118210,23135867,0,0,0,17657
23203,23116961,23116961,23138868,0,0,0,21907
23326,23135198,23138868,23138961,0,0,3670,3763
23331,23135868,23138868,23139624,0,0,3000,3756
23306,23134275,23134275,23140256,0,0,0,5981
23332,23136756,23139624,23140326,0,0,2868,3570
22858,22961597,23066109,23140686,0,0,104512,179089
23336,23137017,23140326,23140946,0,0,3309,3929
23333,23136972,23140256,23141013,0,0,3284,4041
23334,23136979,23140256,23141013,0,0,3277,4034
23337,23137063,23140686,23141324,0,0,3623,4261
23338,23137089,23140686,23141364,0,0,3597,4275
23339,23137120,23140686,23141395,0,0,3566,4275
23340,23137153,23140686,23141395,0,0,3533,4242
23341,23137179,23140686,23141399,0,0,3507,4220
23342,23137201,23140686,23141430,0,0,3485,4229
23343,23137227,23140686,23141430,0,0,3459,4203
23292,23132875,23132875,23141440,0,0,0,8565
23293,23132926,23132926,23143893,0,0,0,10967
22853,22961368,23009999,23149637,0,0,48631,188269
23325,23135186,23135844,23149872,0,0,658,14686
23311,23134880,23135867,23149909,0,0,987,15029
23201,23116739,23116739,23150067,0,0,0,33328
23202,23116941,23116941,23150408,0,0,0,33467
23205,23116992,23116992,23150657,0,0,0,33665
23308,23134323,23134323,23155868,0,0,0,21545
23328,23135233,23138961,23158677,0,0,3728,23444
23327,23135221,23138868,23158987,0,0,3647,23766
23285,23132439,23132439,23160479,0,0,0,28040
23291,23132859,23132859,23161459,0,0,0,28600
23286,23132453,23132453,23162624,0,0,0,30171
23324,23135169,23135833,23163328,0,0,664,28159
23310,23134400,23134400,23168495,0,0,0,34095
22068,22859013,23168495,23168589,0,0,309482,309576
23032,23022641,23090609,23169659,0,0,67968,147018
23125,23095254,23095254,23174153,0,0,0,78899
22144,22884711,22884711,23181990,0,0,0,297279
23348,23183658,23183658,23183794,0,0,0,136
23349,23183685,23183685,23183872,0,0,0,187
23352,23184160,23184160,23184227,0,0,0,67
23353,23184298,23184298,23184365,0,0,0,67
23350,23184097,23184097,23184430,0,0,0,333
23354,23184425,23184425,23184503,0,0,0,78
23351,23184113,23184113,23184822,0,0,0,709
23347,23183604,23183604,23185586,0,0,0,1982
23356,23184600,23184600,23185587,0,0,0,987
23358,23185994,23185994,23186216,0,0,0,222
23359,23186431,23186431,23186686,0,0,0,255
23360,23186649,23186649,23186820,0,0,0,171
23361,23186811,23186811,23187411,0,0,0,600
23362,23187545,23187545,23187644,0,0,0,99
23363,23187596,23187596,23187869,0,0,0,273
23364,23187608,23187608,23188115,0,0,0,507
23174,23110866,23110866,23188259,0,0,0,77393
23369,23188219,23188219,23188317,0,0,0,98
23365,23187755,23187755,23188355,0,0,0,600
23373,23189098,23189098,23189208,0,0,0,110
23374,23189247,23189247,23189411,0,0,0,164
23375,23189310,23189310,23189496,0,0,0,186
23376,23189341,23189341,23189504,0,0,0,163
23377,23189370,23189370,23189533,0,0,0,163
23378,23189400,23189400,23189609,0,0,0,209
23380,23189427,23189427,23189645,0,0,0,218
23384,23189635,23189635,23189728,0,0,0,93
23382,23189453,23189453,23189890,0,0,0,437
23379,23189414,23189414,23189901,0,0,0,487
23390,23189965,23189965,23190132,0,0,0,167
23388,23189869,23189869,23190277,0,0,0,408
23371,23188625,23188625,23190346,0,0,0,1721
23389,23189941,23189941,23190355,0,0,0,414
23392,23190014,23190014,23190454,0,0,0,440
23393,23190101,23190101,23190546,0,0,0,445
23381,23189452,23189645,23190582,0,0,193,1130
23394,23190196,23190196,23190661,0,0,0,465
23395,23190276,23190276,23190741,0,0,0,465
23383,23189477,23189477,23190759,0,0,0,1282
23396,23190385,23190385,23190860,0,0,0,475
23397,23190547,23190547,23191689,0,0,0,1142
23398,23190629,23190629,23191771,0,0,0,1142
23370,23188320,23188320,23191920,0,0,0,3600
23399,23190787,23190787,23191958,0,0,0,1171
23372,23188672,23188672,23192272,0,0,0,3600
23400,23190881,23190881,23192498,0,0,0,1617
23408,23191467,23191467,23192521,0,0,0,1054
23407,23191441,23191441,23192548,0,0,0,1107
23409,23191483,23191483,23192618,0,0,0,1135
22852,22961351,23009852,23192747,0,0,48501,231396
23406,23191319,23191319,23193119,0,0,0,1800
23410,23191746,23191746,23193452,0,0,0,1706
23401,23191006,23191006,23194319,0,0,0,3313
23385,23189737,23189737,23194531,0,0,0,4794
23403,23191127,23191127,23194562,0,0,0,3435
23412,23194541,23194541,23195141,0,0,0,600
23413,23194572,23194572,23195172,0,0,0,600
23411,23192207,23192207,23195388,0,0,0,3181
23414,23195746,23195746,23195813,0,0,0,67
23402,23191115,23191115,23196226,0,0,0,5111
23415,23196451,23196451,23196498,0,0,0,47
23417,23196959,23196959,23197026,0,0,0,67
23420,23198021,23198021,23198120,0,0,0,99
23421,23198165,23198165,23198258,0,0,0,93
23278,23130254,23130254,23198373,0,0,0,68119
23422,23198399,23198399,23198508,0,0,0,109
23418,23197426,23197426,23198549,0,0,0,1123
23423,23198460,23198460,23198549,0,0,0,89
23424,23198506,23198506,23198610,0,0,0,104
23419,23197468,23197468,23198611,0,0,0,1143
23426,23198854,23198854,23198922,0,0,0,68
23425,23198771,23198771,23198977,0,0,0,206
23427,23199074,23199074,23199152,0,0,0,78
23429,23199924,23199924,23199992,0,0,0,68
23431,23200101,23200101,23200168,0,0,0,67
23430,23200005,23200005,23200207,0,0,0,202
23322,23135146,23135240,23200250,0,0,94,65104
23321,23135127,23135127,23200261,0,0,0,65134
23416,23196890,23196890,23200331,0,0,0,3441
23368,23188042,23188042,23201107,0,0,0,13065
23449,23201125,23201125,23201203,0,0,0,78
23450,23201261,23201261,23201447,0,0,0,186
23451,23201570,23201570,23201632,0,0,0,62
23452,23201900,23201900,23201967,0,0,0,67
23453,23202156,23202156,23202223,0,0,0,67
23405,23191195,23191195,23202284,0,0,0,11089
23428,23199228,23199228,23202574,0,0,0,3346
23455,23202527,23202527,23202594,0,0,0,67
23456,23202922,23202922,23202989,0,0,0,67
23346,23180739,23180739,23203065,0,0,0,22326
23457,23203600,23203600,23203678,0,0,0,78
23458,23203647,23203647,23203714,0,0,0,67
23459,23203746,23203746,23203835,0,0,0,89
23460,23203794,23203794,23203872,0,0,0,78
23461,23203835,23203835,23203923,0,0,0,88
23463,23203933,23203933,23204045,0,0,0,112
23462,23203892,23203892,23204131,0,0,0,239
23391,23189985,23189985,23204203,0,0,0,14218
23465,23204131,23204131,23204465,0,0,0,334
23466,23204453,23204453,23204789,0,0,0,336
23472,23204757,23204757,23205151,0,0,0,394
23474,23205176,23205176,23205373,0,0,0,197
23475,23205339,23205339,23205538,0,0,0,199
23481,23205633,23205633,23205757,0,0,0,124
23477,23205547,23205547,23206298,0,0,0,751
23479,23205631,23205631,23206375,0,0,0,744
23478,23205630,23205630,23206540,0,0,0,910
23484,23206355,23206355,23206997,0,0,0,642
23485,23206961,23206961,23207085,0,0,0,124
23489,23207582,23207582,23207675,0,0,0,93
23490,23207693,23207693,23207786,0,0,0,93
23491,23207813,23207813,23207886,0,0,0,73
23492,23207967,23207967,23208047,0,0,0,80
23467,23204456,23204456,23208056,0,0,0,3600
23468,23204461,23204461,23208061,0,0,0,3600
23469,23204466,23204466,23208066,0,0,0,3600
23470,23204469,23204469,23208069,0,0,0,3600
23493,23208015,23208015,23208112,0,0,0,97
23487,23207148,23207148,23208113,0,0,0,965
23494,23208048,23208048,23208114,0,0,0,66
23495,23208059,23208059,23208211,0,0,0,152
23486,23207099,23207099,23208250,0,0,0,1151
23497,23208145,23208145,23208251,0,0,0,106
23488,23207236,23207236,23208303,0,0,0,1067
23500,23208337,23208337,23208395,0,0,0,58
23480,23205632,23205632,23208534,0,0,0,2902
23496,23208132,23208132,23208541,0,0,0,409
23503,23208556,23208556,23208646,0,0,0,90
23504,23208615,23208615,23208708,0,0,0,93
23387,23189837,23189837,23208930,0,0,0,19093
23482,23205633,23205633,23209195,0,0,0,3562
23510,23209246,23209246,23209375,0,0,0,129
23502,23208448,23208448,23209617,0,0,0,1169
23513,23209569,23209569,23209647,0,0,0,78
23505,23208908,23208908,23209650,0,0,0,742
23514,23209809,23209809,23209876,0,0,0,67
23515,23209927,23209927,23210032,0,0,0,105
23367,23187983,23187983,23210110,0,0,0,22127
23518,23210056,23210056,23210150,0,0,0,94
23519,23210182,23210182,23210273,0,0,0,91
23520,23210233,23210233,23210311,0,0,0,78
23499,23208277,23208277,23210417,0,0,0,2140
23521,23210352,23210352,23210445,0,0,0,93
23501,23208426,23208426,23210581,0,0,0,2155
23522,23210510,23210510,23210583,0,0,0,73
23523,23210584,23210584,23210708,0,0,0,124
23524,23210733,23210733,23210830,0,0,0,97
23526,23210813,23210813,23210947,0,0,0,134
23525,23210757,23210757,23211357,0,0,0,600
23531,23211769,23211769,23211868,0,0,0,99
23530,23211646,23211646,23211880,0,0,0,234
23355,23184541,23184541,23211895,0,0,0,27354
23527,23210819,23211357,23211957,0,0,538,1138
23532,23211903,23211903,23211970,0,0,0,67
23533,23212313,23212313,23212381,0,0,0,68
23529,23211462,23211957,23212486,0,0,495,1024
23534,23213138,23213138,23213258,0,0,0,120
23535,23213221,23213221,23213258,0,0,0,37
22994,22984501,22986710,23213475,0,0,2209,228974
23546,23214279,23214279,23214700,0,0,0,421
23550,23214279,23214279,23214709,0,0,0,430
23547,23214279,23214279,23214731,0,0,0,452
23548,23214279,23214279,23214731,0,0,0,452
23549,23214279,23214279,23214731,0,0,0,452
23551,23214279,23214700,23215138,0,0,421,859
23553,23214280,23214731,23215152,0,0,451,872
23554,23214280,23214731,23215152,0,0,451,872
23555,23214280,23214731,23215152,0,0,451,872
23588,23215046,23215046,23215299,0,0,0,253
23589,23215303,23215303,23215432,0,0,0,129
23557,23214280,23215152,23215581,0,0,872,1301
23558,23214280,23215152,23215581,0,0,872,1301
23559,23214281,23215152,23215581,0,0,871,1300
23590,23215546,23215546,23215614,0,0,0,68
23556,23214280,23215138,23215620,0,0,858,1340
23560,23214281,23215581,23216010,0,0,1300,1729
23561,23214281,23215581,23216010,0,0,1300,1729
23562,23214281,23215581,23216010,0,0,1300,1729
23563,23214281,23215620,23216049,0,0,1339,1768
23592,23215926,23215926,23216085,0,0,0,159
23593,23216059,23216059,23216158,0,0,0,99
23386,23189835,23189835,23216419,0,0,0,26584
23564,23214281,23216010,23216439,0,0,1729,2158
23565,23214281,23216010,23216439,0,0,1729,2158
23566,23214282,23216010,23216439,0,0,1728,2157
23594,23216349,23216349,23216447,0,0,0,98
23567,23214282,23216049,23216478,0,0,1767,2196
23464,23203979,23203979,23216515,0,0,0,12536
23568,23214282,23216419,23216848,0,0,2137,2566
23573,23214284,23216439,23216859,0,0,2155,2575
23574,23214284,23216439,23216859,0,0,2155,2575
23575,23214284,23216439,23216859,0,0,2155,2575
23569,23214282,23216419,23216869,0,0,2137,2587
23570,23214282,23216419,23216869,0,0,2137,2587
23571,23214282,23216419,23216869,0,0,2137,2587
23572,23214283,23216419,23216870,0,0,2136,2587
23576,23214284,23216478,23216929,0,0,2194,2645
23596,23216843,23216843,23216983,0,0,0,140
23577,23214285,23216848,23217268,0,0,2563,2983
23578,23214285,23216859,23217279,0,0,2574,2994
23579,23214285,23216859,23217279,0,0,2574,2994
23581,23214286,23216869,23217289,0,0,2583,3003
23582,23214286,23216869,23217289,0,0,2583,3003
23583,23214286,23216869,23217289,0,0,2583,3003
23584,23214287,23216870,23217290,0,0,2583,3003
23580,23214285,23216859,23217311,0,0,2574,3026
23585,23214287,23216929,23217368,0,0,2642,3081
23597,23217349,23217349,23217385,0,0,0,36
23598,23217419,23217419,23217504,0,0,0,85
23599,23217439,23217439,23217508,0,0,0,69
23600,23217482,23217482,23217548,0,0,0,66
23601,23217512,23217512,23217606,0,0,0,94
23602,23217570,23217570,23217637,0,0,0,67
23586,23214287,23217268,23217707,0,0,2981,3420
23603,23217643,23217643,23217710,0,0,0,67
23604,23217751,23217751,23217787,0,0,0,36
23605,23217807,23217807,23217860,0,0,0,53
23606,23217823,23217823,23217891,0,0,0,68
23607,23217859,23217859,23217929,0,0,0,70
23608,23217873,23217873,23217943,0,0,0,70
23610,23217910,23217910,23217962,0,0,0,52
23609,23217892,23217892,23217971,0,0,0,79
23611,23217920,23217920,23217989,0,0,0,69
23612,23217929,23217929,23217999,0,0,0,70
23498,23208267,23208267,23218222,0,0,0,9955
23619,23218100,23218222,23218377,0,0,122,277
23614,23217992,23217992,23218385,0,0,0,393
23622,23218495,23218495,23218573,0,0,0,78
23613,23217978,23217978,23218606,0,0,0,628
23623,23218656,23218656,23218724,0,0,0,68
23624,23218773,23218773,23218861,0,0,0,88
23625,23218824,23218824,23218861,0,0,0,37
23366,23187957,23187957,23218887,0,0,0,30930
23621,23218122,23218887,23218980,0,0,765,858
23626,23218913,23218913,23218981,0,0,0,68
22995,22984501,22986710,23219089,0,0,2209,234588
23627,23218979,23218979,23219132,0,0,0,153
23628,23219031,23219031,23219157,0,0,0,126
23631,23219103,23219103,23219160,0,0,0,57
23528,23210915,23210915,23219618,0,0,0,8703
23404,23191169,23191169,23220561,0,0,0,29392
23506,23208933,23208933,23221159,0,0,0,12226
23508,23208942,23208942,23221529,0,0,0,12587
23344,23145036,23145036,23222985,0,0,0,77949
23536,23213351,23213351,23223910,0,0,0,10559
23509,23208947,23208947,23226341,0,0,0,17394
23507,23208938,23208938,23226460,0,0,0,17522
23633,23222667,23222667,23227055,0,0,0,4388
23629,23219037,23227055,23228140,0,0,8018,9103
23512,23209557,23209557,23228257,0,0,0,18700
23630,23219092,23228140,23228791,0,0,9048,9699
23632,23219133,23228791,23229320,0,0,9658,10187
23634,23228890,23228890,23231146,0,0,0,2256
23511,23209556,23209556,23234220,0,0,0,24664
23637,23234788,23234788,23235036,0,0,0,248
23616,23218071,23218071,23237706,0,0,0,19635
23615,23218062,23218062,23237914,0,0,0,19852
23516,23209930,23209930,23244238,0,0,0,34308
22992,22984500,22985131,23244331,0,0,631,259831
22993,22984500,22985164,23244364,0,0,664,259864
23640,23242808,23242808,23244955,0,0,0,2147
23517,23210043,23210043,23244987,0,0,0,34944
23617,23218080,23218080,23245669,0,0,0,27589
22996,22984501,22986710,23245910,0,0,2209,261409
23618,23218090,23218222,23246473,0,0,132,28383
23471,23204630,23204630,23246708,0,0,0,42078
23642,23242836,23244331,23246799,0,0,1495,3963
23641,23242823,23244238,23246904,0,0,1415,4081
22997,22984501,22987717,23246917,0,0,3216,262416
23438,23200747,23200747,23248052,0,0,0,47305
23432,23200745,23200745,23248407,0,0,0,47662
23433,23200745,23200745,23250309,0,0,0,49564
23439,23200747,23200747,23250432,0,0,0,49685
23595,23216628,23220561,23251278,0,0,3933,34650
23434,23200745,23200745,23251518,0,0,0,50773
23345,23174117,23174117,23253091,0,0,0,78974
23435,23200745,23200745,23253478,0,0,0,52733
22998,22984501,22994906,23254106,0,0,10405,269605
22999,22985275,22994906,23254106,0,0,9631,268831
23000,22985341,22995198,23254398,0,0,9857,269057
23445,23200749,23200749,23258070,0,0,0,57321
23441,23200748,23200748,23259092,0,0,0,58344
22779,22954845,23009137,23262124,0,0,54292,307279
23540,23214278,23214278,23263835,0,0,0,49557
23541,23214278,23214278,23264207,0,0,0,49929
23537,23214277,23214277,23264447,0,0,0,50170
23542,23214278,23214278,23264634,0,0,0,50356
23543,23214278,23214278,23264716,0,0,0,50438
23538,23214277,23214277,23265067,0,0,0,50790
23544,23214278,23214278,23265212,0,0,0,50934
23545,23214278,23214278,23265243,0,0,0,50965
23552,23214279,23214709,23265333,0,0,430,51054
23539,23214277,23214277,23265346,0,0,0,51069
23124,23093626,23093626,23266426,0,0,0,172800
23587,23214466,23217289,23270979,0,0,2823,56513
22854,22961468,23012353,23271553,0,0,50885,310085
23660,23279996,23279996,23282084,0,0,0,2088
23661,23282342,23282342,23282869,0,0,0,527
23662,23284314,23284314,23285131,0,0,0,817
23663,23285159,23285159,23285263,0,0,0,104
23665,23285793,23285793,23285928,0,0,0,135
23664,23285623,23285623,23287128,0,0,0,1505
23436,23200746,23200746,23287146,0,0,0,86400
23437,23200746,23200746,23287146,0,0,0,86400
23440,23200747,23200747,23287147,0,0,0,86400
23442,23200748,23200748,23287148,0,0,0,86400
23443,23200748,23200748,23287148,0,0,0,86400
23444,23200748,23200748,23287148,0,0,0,86400
23446,23200749,23200749,23287149,0,0,0,86400
23447,23200749,23200749,23287149,0,0,0,86400
23448,23200749,23200749,23287149,0,0,0,86400
23666,23285970,23285970,23287770,0,0,0,1800
23668,23288944,23288944,23290744,0,0,0,1800
23620,23218113,23218377,23290771,0,0,264,72658
23473,23204820,23204820,23291220,0,0,0,86400
23667,23287093,23287093,23295017,0,0,0,7924
23669,23299711,23299711,23299804,0,0,0,93
23670,23299820,23299820,23301620,0,0,0,1800
23652,23268498,23268498,23302149,0,0,0,33651
23655,23276040,23276040,23302191,0,0,0,26151
23651,23268425,23268425,23302273,0,0,0,33848
23653,23268643,23268643,23306157,0,0,0,37514
23657,23276076,23276076,23308439,0,0,0,32363
23674,23307624,23307624,23309019,0,0,0,1395
23658,23276095,23276095,23309579,0,0,0,33484
23678,23312014,23312014,23312087,0,0,0,73
23679,23312015,23312015,23312088,0,0,0,73
23680,23312015,23312015,23312088,0,0,0,73
23681,23312015,23312015,23312088,0,0,0,73
23682,23312015,23312015,23312088,0,0,0,73
23677,23311910,23311910,23313482,0,0,0,1572
23659,23276100,23276100,23320507,0,0,0,44407
23116,23069191,23069191,23328391,0,0,0,259200
23117,23069192,23069192,23328392,0,0,0,259200
23118,23069193,23069193,23328393,0,0,0,259200
23119,23069193,23069193,23328393,0,0,0,259200
23120,23069224,23069224,23328424,0,0,0,259200
23121,23069225,23069225,23328425,0,0,0,259200
23122,23069336,23069336,23328536,0,0,0,259200
23650,23253092,23253092,23332791,0,0,0,79699
23676,23309517,23309517,23336110,0,0,0,26593
23671,23305960,23305960,23339090,0,0,0,33130
23672,23306017,23306017,23339611,0,0,0,33594
23675,23309442,23309442,23342814,0,0,0,33372
23656,23276058,23276058,23346507,0,0,0,70449
22859,22961647,23088032,23347232,0,0,126385,385585
23476,23205479,23205479,23350992,0,0,0,145513
23697,23359632,23359632,23359767,0,0,0,135
23483,23205866,23205866,23360757,0,0,0,154891
23673,23306193,23306193,23366136,0,0,0,59943
23296,23133254,23133254,23372475,0,0,0,239221
23182,23114336,23114336,23373536,0,0,0,259200
23183,23114403,23114403,23373603,0,0,0,259200
23184,23114534,23114534,23373734,0,0,0,259200
23335,23136996,23140686,23381917,0,0,3690,244921
23700,23366251,23366251,23391786,0,0,0,25535
23295,23133240,23133240,23392440,0,0,0,259200
23698,23365904,23365904,23399256,0,0,0,33352
23699,23365987,23365987,23399762,0,0,0,33775
23713,23409031,23409031,23409315,0,0,0,284
23709,23408945,23408945,23409465,0,0,0,520
23708,23408934,23408934,23409471,0,0,0,537
23711,23408974,23408974,23409772,0,0,0,798
23710,23408962,23408962,23409776,0,0,0,814
23715,23411289,23411289,23411381,0,0,0,92
23714,23411243,23411243,23411382,0,0,0,139
23716,23411346,23411346,23411436,0,0,0,90
23717,23411399,23411399,23411467,0,0,0,68
23718,23411484,23411484,23411627,0,0,0,143
23719,23411513,23411513,23411627,0,0,0,114
23720,23411588,23411588,23411709,0,0,0,121
23722,23411675,23411675,23411738,0,0,0,63
23721,23411627,23411627,23411748,0,0,0,121
23723,23411712,23411712,23411779,0,0,0,67
23696,23332789,23332789,23412123,0,0,0,79334
23123,23069899,23069899,23415499,0,0,0,345600
23636,23234686,23234686,23420575,0,0,0,185889
23357,23185555,23185555,23426724,0,0,0,241169
23654,23275900,23275900,23430301,0,0,0,154401
23635,23234614,23234614,23435254,0,0,0,200640
23726,23440059,23440059,23440169,0,0,0,110
23729,23442052,23442052,23442181,0,0,0,129
23730,23442275,23442275,23442327,0,0,0,52
23731,23442291,23442291,23442358,0,0,0,67
23732,23442944,23442944,23443011,0,0,0,67
23591,23215767,23219618,23443172,0,0,3851,227405
23705,23391842,23391842,23443338,0,0,0,51496
23733,23443276,23443276,23443343,0,0,0,67
23734,23443675,23443675,23443742,0,0,0,67
23735,23443847,23443847,23443915,0,0,0,68
23736,23446800,23446800,23446855,0,0,0,55
23738,23447538,23447538,23447605,0,0,0,67
23741,23448005,23448005,23448052,0,0,0,47
23743,23448163,23448163,23448737,0,0,0,574
23745,23449182,23449182,23449264,0,0,0,82
23746,23449229,23449229,23449795,0,0,0,566
23748,23449956,23449956,23450029,0,0,0,73
23749,23449960,23449960,23450064,0,0,0,104
23751,23450286,23450286,23451778,0,0,0,1492
23750,23450283,23450283,23452282,0,0,0,1999
23752,23452877,23452877,23452955,0,0,0,78
23753,23453102,23453102,23453305,0,0,0,203
23643,23244912,23244912,23453356,0,0,0,208444
23754,23454905,23454905,23455032,0,0,0,127
23756,23454933,23454933,23455084,0,0,0,151
23755,23454919,23454919,23455092,0,0,0,173
23757,23454958,23454958,23455113,0,0,0,155
23758,23454975,23454975,23455576,0,0,0,601
23759,23455045,23455045,23455941,0,0,0,896
23760,23455061,23455113,23456029,0,0,52,968
23761,23457123,23457123,23457216,0,0,0,93
23764,23457300,23457300,23457404,0,0,0,104
23763,23457297,23457297,23458135,0,0,0,838
23762,23457270,23457270,23458251,0,0,0,981
23766,23459283,23459283,23459390,0,0,0,107
23767,23459299,23459299,23459483,0,0,0,184
23727,23440143,23440143,23459517,0,0,0,19374
23638,23235191,23235191,23460576,0,0,0,225385
23772,23461393,23461393,23461460,0,0,0,67
23773,23461748,23461748,23461908,0,0,0,160
23774,23462657,23462657,23462818,0,0,0,161
23639,23235206,23237706,23462956,0,0,2500,227750
23775,23463928,23463928,23463995,0,0,0,67
23776,23464126,23464126,23464204,0,0,0,78
23777,23464271,23464271,23464338,0,0,0,67
23765,23457611,23457611,23464652,0,0,0,7041
23779,23464968,23464968,23465028,0,0,0,60
23781,23465791,23465791,23465869,0,0,0,78
23768,23459362,23459362,23466165,0,0,0,6803
23782,23466016,23466016,23466176,0,0,0,160
23783,23466285,23466285,23466445,0,0,0,160
23785,23466611,23466611,23466678,0,0,0,67
23788,23467301,23467301,23467394,0,0,0,93
23789,23467424,23467424,23467523,0,0,0,99
23790,23467685,23467685,23467752,0,0,0,67
23792,23468081,23468081,23468148,0,0,0,67
23791,23468062,23468062,23470179,0,0,0,2117
23793,23470262,23470262,23470322,0,0,0,60
23794,23470921,23470921,23471071,0,0,0,150
23795,23470998,23470998,23471091,0,0,0,93
23802,23471478,23471478,23471544,0,0,0,66
23800,23471463,23471463,23471663,0,0,0,200
23807,23471812,23471812,23472004,0,0,0,192
23808,23472410,23472410,23472570,0,0,0,160
23809,23472639,23472639,23472717,0,0,0,78
23811,23473350,23473350,23473417,0,0,0,67
23812,23473637,23473637,23473706,0,0,0,69
23814,23474207,23474207,23474350,0,0,0,143
23816,23474384,23474384,23474498,0,0,0,114
23817,23474486,23474486,23474533,0,0,0,47
23818,23474543,23474543,23474637,0,0,0,94
23819,23475335,23475335,23475382,0,0,0,47
23820,23476757,23476757,23476804,0,0,0,47
23821,23476979,23476979,23477046,0,0,0,67
23707,23408910,23408910,23477070,0,0,0,68160
23822,23477234,23477234,23477301,0,0,0,67
23823,23477442,23477442,23477509,0,0,0,67
23824,23477600,23477600,23477668,0,0,0,68
23825,23477853,23477853,23477900,0,0,0,47
23769,23460565,23460565,23478329,0,0,0,17764
23780,23465040,23465040,23479017,0,0,0,13977
23826,23479251,23479251,23479311,0,0,0,60
23827,23479446,23479446,23479506,0,0,0,60
23828,23480108,23480108,23480168,0,0,0,60
23813,23473939,23473939,23481384,0,0,0,7445
23829,23481640,23481640,23481768,0,0,0,128
23810,23472656,23472656,23483341,0,0,0,10685
23712,23409007,23409007,23484115,0,0,0,75108
23683,23312495,23312495,23485295,0,0,0,172800
23685,23312496,23312496,23485296,0,0,0,172800
23830,23481735,23481735,23485335,0,0,0,3600
23833,23485127,23485127,23489585,0,0,0,4458
23724,23412059,23412059,23490399,0,0,0,78340
23454,23202278,23202278,23492583,0,0,0,290305
23644,23244923,23244955,23504155,0,0,32,259232
23645,23244935,23244955,23504155,0,0,20,259220
23646,23244944,23244955,23504155,0,0,11,259211
23647,23245020,23245020,23504220,0,0,0,259200
23648,23245075,23245075,23504275,0,0,0,259200
23649,23245105,23245105,23504305,0,0,0,259200
23739,23447977,23447977,23509163,0,0,0,61186
23747,23449349,23449349,23512675,0,0,0,63326
23798,23471448,23471448,23515148,0,0,0,43700
23799,23471459,23471459,23517233,0,0,0,45774
23737,23446824,23446824,23521116,0,0,0,74292
23838,23528024,23528024,23528184,0,0,0,160
23841,23528569,23528569,23528647,0,0,0,78
23839,23528255,23528255,23528670,0,0,0,415
23843,23528994,23528994,23529123,0,0,0,129
23842,23528808,23528808,23529371,0,0,0,563
23840,23528375,23528375,23529577,0,0,0,1202
23845,23529717,23529717,23529846,0,0,0,129
23846,23529941,23529941,23530070,0,0,0,129
23844,23529541,23529541,23531067,0,0,0,1526
23847,23530155,23530155,23532555,0,0,0,2400
23848,23531282,23531282,23532824,0,0,0,1542
23849,23533328,23533328,23533425,0,0,0,97
23850,23533345,23533345,23533431,0,0,0,86
23778,23464937,23464937,23533866,0,0,0,68929
23854,23534075,23534075,23534328,0,0,0,253
23853,23533442,23533442,23534450,0,0,0,1008
23852,23533433,23533433,23534483,0,0,0,1050
23851,23533421,23533421,23534608,0,0,0,1187
23856,23535120,23535120,23535281,0,0,0,161
23858,23535646,23535646,23535706,0,0,0,60
23859,23535669,23535669,23535736,0,0,0,67
23861,23535956,23535956,23536747,0,0,0,791
23876,23536927,23536927,23537020,0,0,0,93
23877,23536927,23536927,23537020,0,0,0,93
23878,23536928,23536928,23537021,0,0,0,93
23874,23536927,23536927,23537029,0,0,0,102
23875,23536927,23536927,23537029,0,0,0,102
23879,23536928,23537020,23537113,0,0,92,185
23880,23536928,23537020,23537113,0,0,92,185
23881,23536928,23537021,23537114,0,0,93,186
23882,23536929,23537029,23537122,0,0,100,193
23883,23536929,23537029,23537122,0,0,100,193
23884,23536929,23537113,23537206,0,0,184,277
23885,23536929,23537113,23537206,0,0,184,277
23886,23536929,23537114,23537207,0,0,185,278
23887,23536929,23537122,23537235,0,0,193,306
23888,23536930,23537122,23537235,0,0,192,305
23892,23536930,23537235,23537317,0,0,305,387
23893,23536930,23537235,23537317,0,0,305,387
23889,23536930,23537206,23537319,0,0,276,389
23890,23536930,23537206,23537319,0,0,276,389
23891,23536930,23537207,23537320,0,0,277,390
23860,23535821,23535821,23537360,0,0,0,1539
23894,23536931,23537317,23537399,0,0,386,468
23895,23536931,23537317,23537431,0,0,386,500
23896,23536931,23537319,23537433,0,0,388,502
23897,23536931,23537319,23537433,0,0,388,502
23898,23536931,23537320,23537434,0,0,389,503
23899,23536931,23537399,23537513,0,0,468,582
23903,23536932,23537434,23537540,0,0,502,608
23900,23536932,23537431,23537545,0,0,499,613
23901,23536932,23537433,23537547,0,0,501,615
23902,23536932,23537433,23537547,0,0,501,615
23904,23536932,23537513,23537619,0,0,581,687
23905,23536932,23537540,23537646,0,0,608,714
23907,23536933,23537547,23537653,0,0,614,720
23908,23536933,23537547,23537653,0,0,614,720
23906,23536932,23537545,23537683,0,0,613,751
23909,23536933,23537619,23537725,0,0,686,792
23910,23536933,23537646,23537740,0,0,713,807
23911,23536933,23537653,23537747,0,0,720,814
23912,23536933,23537653,23537747,0,0,720,814
23913,23536934,23537683,23537777,0,0,749,843
23914,23537629,23537747,23537849,0,0,118,220
23916,23537768,23537768,23538238,0,0,0,470
23915,23537683,23537683,23538455,0,0,0,772
23784,23466506,23466506,23538649,0,0,0,72143
23917,23538822,23538822,23539052,0,0,0,230
23919,23539015,23539015,23539082,0,0,0,67
23918,23539009,23539009,23539093,0,0,0,84
23920,23539137,23539137,23539327,0,0,0,190
23922,23539484,23539484,23539639,0,0,0,155
23834,23486078,23486078,23539697,0,0,0,53619
23921,23539260,23539260,23539967,0,0,0,707
23923,23539713,23539713,23540515,0,0,0,802
23924,23540166,23540166,23541196,0,0,0,1030
23925,23540177,23540177,23541317,0,0,0,1140
23926,23540186,23540186,23541419,0,0,0,1233
23701,23368919,23368919,23541719,0,0,0,172800
23927,23540438,23540438,23542568,0,0,0,2130
23929,23543433,23543433,23544326,0,0,0,893
23801,23471469,23471469,23545362,0,0,0,73893
23928,23543305,23543305,23545431,0,0,0,2126
23939,23545705,23545705,23545803,0,0,0,98
23857,23535568,23535568,23546181,0,0,0,10613
23938,23545569,23545569,23546469,0,0,0,900
23940,23546420,23546420,23546505,0,0,0,85
23931,23543873,23543873,23546536,0,0,0,2663
23941,23546437,23546437,23547213,0,0,0,776
23863,23536778,23536778,23547452,0,0,0,10674
23862,23536772,23536772,23547458,0,0,0,10686
23942,23547248,23547248,23547830,0,0,0,582
23944,23548234,23548234,23548519,0,0,0,285
23945,23549858,23549858,23549952,0,0,0,94
23855,23534161,23534161,23550068,0,0,0,15907
23947,23550442,23550442,23550535,0,0,0,93
23948,23550916,23550916,23551029,0,0,0,113
23949,23550998,23550998,23551102,0,0,0,104
23950,23551055,23551055,23551128,0,0,0,73
23951,23551136,23551136,23551320,0,0,0,184
23952,23551293,23551293,23551453,0,0,0,160
23953,23551460,23551460,23551567,0,0,0,107
23954,23551539,23551539,23551613,0,0,0,74
23955,23551581,23551581,23551675,0,0,0,94
23957,23551618,23551618,23551696,0,0,0,78
23956,23551608,23551608,23551702,0,0,0,94
23744,23448270,23448270,23551890,0,0,0,103620
23959,23552201,23552201,23552307,0,0,0,106
23958,23552171,23552171,23552315,0,0,0,144
23960,23552261,23552261,23552367,0,0,0,106
23930,23543675,23543675,23552901,0,0,0,9226
23963,23552918,23552918,23553011,0,0,0,93
23964,23553175,23553175,23553268,0,0,0,93
23965,23553185,23553185,23553278,0,0,0,93
23970,23553388,23553388,23553448,0,0,0,60
23969,23553381,23553381,23553581,0,0,0,200
23971,23553548,23553548,23553608,0,0,0,60
23973,23553727,23553727,23553787,0,0,0,60
23972,23553691,23553691,23553826,0,0,0,135
23974,23553894,23553894,23553930,0,0,0,36
23975,23554080,23554080,23554116,0,0,0,36
23976,23554244,23554244,23554311,0,0,0,67
23966,23553303,23553303,23554318,0,0,0,1015
23977,23554361,23554361,23554428,0,0,0,67
23967,23553313,23553313,23554458,0,0,0,1145
23968,23553322,23553322,23554504,0,0,0,1182
23979,23554525,23554525,23554585,0,0,0,60
23978,23554459,23554459,23554616,0,0,0,157
23981,23556090,23556090,23556168,0,0,0,78
23983,23556176,23556176,23556269,0,0,0,93
23984,23556302,23556302,23556375,0,0,0,73
23985,23556421,23556421,23556488,0,0,0,67
23832,23482171,23482171,23556648,0,0,0,74477
23742,23448012,23448012,23557613,0,0,0,109601
23740,23447995,23447995,23557624,0,0,0,109629
23986,23556605,23556605,23558058,0,0,0,1453
23987,23557321,23557321,23558311,0,0,0,990
23988,23557350,23557350,23558402,0,0,0,1052
23989,23557365,23557365,23558424,0,0,0,1059
23998,23561802,23561802,23561993,0,0,0,191
23999,23562436,23562436,23562690,0,0,0,254
24000,23562593,23562593,23562691,0,0,0,98
23831,23482152,23482152,23563152,0,0,0,81000
24001,23563007,23563007,23563293,0,0,0,286
23994,23559633,23563152,23563384,0,0,3519,3751
23982,23556110,23556110,23563530,0,0,0,7420
24004,23563567,23563567,23563727,0,0,0,160
24003,23563239,23563239,23564021,0,0,0,782
23943,23547299,23547299,23564608,0,0,0,17309
23835,23486086,23486086,23568120,0,0,0,82034
23803,23471478,23471478,23568228,0,0,0,96750
23686,23312496,23312496,23568362,0,0,0,255866
23836,23490341,23490341,23569376,0,0,0,79035
24007,23569728,23569728,23569832,0,0,0,104
24006,23569728,23569728,23569843,0,0,0,115
24008,23569729,23569729,23569864,0,0,0,135
23980,23555508,23555508,23569897,0,0,0,14389
24009,23569773,23569773,23569897,0,0,0,124
24010,23569773,23569773,23569897,0,0,0,124
24005,23563763,23563763,23569898,0,0,0,6135
24011,23569774,23569774,23569898,0,0,0,124
24012,23569774,23569774,23569898,0,0,0,124
24015,23570787,23570787,23570911,0,0,0,124
24016,23570787,23570787,23570911,0,0,0,124
24017,23570787,23570787,23570911,0,0,0,124
23687,23312496,23312496,23570972,0,0,0,258476
23996,23560229,23563384,23571160,0,0,3155,10931
24013,23570773,23570773,23574316,0,0,0,3543
24020,23574291,23574291,23574385,0,0,0,94
24021,23574336,23574385,23574478,0,0,49,142
23995,23560205,23563293,23581523,0,0,3088,21318
23871,23536926,23536926,23584556,0,0,0,47630
23865,23536924,23536924,23584782,0,0,0,47858
23867,23536925,23536925,23584814,0,0,0,47889
24023,23583871,23584556,23584835,0,0,685,964
23873,23536926,23536926,23584844,0,0,0,47918
23866,23536924,23536924,23585030,0,0,0,48106
23864,23536923,23536923,23585040,0,0,0,48117
24024,23583901,23584814,23585093,0,0,913,1192
23868,23536925,23536925,23585124,0,0,0,48199
23872,23536926,23536926,23585687,0,0,0,48761
23869,23536925,23536925,23585786,0,0,0,48861
23870,23536925,23536925,23586096,0,0,0,49171
23688,23329827,23329827,23589027,0,0,0,259200
23804,23471485,23515148,23589736,0,0,43663,118251
23689,23332621,23332621,23591821,0,0,0,259200
23690,23332622,23332622,23591822,0,0,0,259200
23691,23332639,23332639,23591839,0,0,0,259200
23692,23332639,23332639,23591839,0,0,0,259200
23693,23332639,23332639,23591839,0,0,0,259200
23694,23332640,23332640,23591840,0,0,0,259200
23695,23332698,23332698,23591898,0,0,0,259200
23786,23467279,23467279,23595611,0,0,0,128332
23787,23467284,23467284,23595616,0,0,0,128332
23991,23557565,23557624,23603132,0,0,59,45567
23684,23312495,23312495,23603400,0,0,0,290905
23992,23557578,23558424,23603996,0,0,846,46418
23990,23557558,23557613,23605114,0,0,55,47556
24002,23563026,23569376,23607366,0,0,6350,44340
23946,23550069,23550069,23609892,0,0,0,59823
23997,23560381,23563530,23613054,0,0,3149,52673
23771,23461003,23461003,23614314,0,0,0,153311
24026,23588337,23588337,23614657,0,0,0,26320
24029,23614878,23614878,23615168,0,0,0,290
24030,23615161,23615161,23615449,0,0,0,288
24031,23616775,23616775,23617567,0,0,0,792
24028,23612993,23612993,23618042,0,0,0,5049
24027,23612918,23612918,23618206,0,0,0,5288
23815,23474288,23478329,23618427,0,0,4041,144139
24032,23618012,23618012,23618929,0,0,0,917
24036,23619085,23619085,23619189,0,0,0,104
24037,23619124,23619124,23619228,0,0,0,104
24038,23619745,23619745,23619781,0,0,0,36
24040,23619898,23619898,23620368,0,0,0,470
24039,23619799,23619799,23620379,0,0,0,580
23962,23552869,23552869,23621168,0,0,0,68299
24042,23620689,23620689,23621316,0,0,0,627
24052,23622608,23622608,23622644,0,0,0,36
24047,23622054,23622054,23622750,0,0,0,696
24053,23622702,23622702,23622791,0,0,0,89
24054,23622759,23622759,23622852,0,0,0,93
24051,23622388,23622388,23623221,0,0,0,833
24056,23623728,23623728,23624581,0,0,0,853
24018,23572365,23572365,23625016,0,0,0,52651
24058,23625740,23625740,23625885,0,0,0,145
24055,23623086,23623086,23626043,0,0,0,2957
24059,23625771,23625771,23626062,0,0,0,291
24060,23625956,23625956,23626220,0,0,0,264
24061,23626310,23626310,23626414,0,0,0,104
24048,23622195,23622195,23626762,0,0,0,4567
24049,23622278,23622278,23626885,0,0,0,4607
24062,23627120,23627120,23627187,0,0,0,67
24064,23628009,23628009,23628076,0,0,0,67
24065,23628140,23628140,23628207,0,0,0,67
24066,23628424,23628424,23628472,0,0,0,48
24068,23628699,23628699,23628766,0,0,0,67
24069,23628792,23628792,23628839,0,0,0,47
24070,23628951,23628951,23629019,0,0,0,68
24071,23629066,23629066,23629133,0,0,0,67
24063,23627611,23627611,23629243,0,0,0,1632
24072,23629176,23629176,23629321,0,0,0,145
24073,23629281,23629281,23629348,0,0,0,67
24076,23629600,23629600,23629693,0,0,0,93
24074,23629528,23629528,23629695,0,0,0,167
24075,23629592,23629592,23629743,0,0,0,151
24080,23629714,23629714,23629781,0,0,0,67
24077,23629629,23629629,23629829,0,0,0,200
24081,23629790,23629790,23629976,0,0,0,186
24082,23630114,23630114,23630150,0,0,0,36
24078,23629664,23629664,23630299,0,0,0,635
24079,23629692,23629829,23630523,0,0,137,831
24083,23630452,23630452,23630677,0,0,0,225
23993,23557907,23558311,23630863,0,0,404,72956
24084,23630578,23630578,23630894,0,0,0,316
24086,23631601,23631601,23631648,0,0,0,47
24087,23631703,23631703,23631770,0,0,0,67
24088,23631935,23631935,23632090,0,0,0,155
24035,23618821,23618821,23632098,0,0,0,13277
24090,23632494,23632494,23632559,0,0,0,65
24091,23632522,23632522,23632590,0,0,0,68
24100,23633562,23633562,23633629,0,0,0,67
24101,23633654,23633654,23633721,0,0,0,67
24102,23633752,23633752,23633819,0,0,0,67
23702,23375260,23375260,23634460,0,0,0,259200
23703,23375289,23375289,23634489,0,0,0,259200
23704,23375315,23375315,23634515,0,0,0,259200
24103,23634595,23634595,23634642,0,0,0,47
24107,23634725,23634725,23634818,0,0,0,93
24109,23635999,23635999,23636067,0,0,0,68
24110,23636126,23636126,23636173,0,0,0,47
24111,23636245,23636245,23636312,0,0,0,67
24112,23636315,23636315,23636362,0,0,0,47
24113,23636570,23636570,23636637,0,0,0,67
24115,23636869,23636869,23636932,0,0,0,63
24114,23636780,23636780,23637583,0,0,0,803
24116,23637657,23637657,23637710,0,0,0,53
24117,23637663,23637663,23637730,0,0,0,67
24119,23637785,23637785,23637832,0,0,0,47
24120,23637959,23637959,23638026,0,0,0,67
24121,23638172,23638172,23638239,0,0,0,67
24122,23638353,23638353,23638420,0,0,0,67
24123,23638508,23638508,23638555,0,0,0,47
24124,23638646,23638646,23638713,0,0,0,67
24125,23638947,23638947,23639014,0,0,0,67
24126,23639018,23639018,23639065,0,0,0,47
24127,23639087,23639087,23639166,0,0,0,79
24129,23639213,23639213,23639281,0,0,0,68
24128,23639128,23639128,23639770,0,0,0,642
24130,23640106,23640106,23640173,0,0,0,67
24131,23640406,23640406,23640466,0,0,0,60
24132,23641131,23641131,23641198,0,0,0,67
23706,23408813,23408813,23642266,0,0,0,233453
24135,23642714,23642714,23642766,0,0,0,52
24136,23642717,23642717,23642801,0,0,0,84
24137,23642785,23642785,23642837,0,0,0,52
24138,23642795,23642795,23642862,0,0,0,67
24139,23642900,23642900,23642967,0,0,0,67
24140,23643094,23643094,23643162,0,0,0,68
24141,23643312,23643312,23643359,0,0,0,47
24142,23643501,23643501,23643569,0,0,0,68
24144,23644089,23644089,23644157,0,0,0,68
24145,23644211,23644211,23644295,0,0,0,84
24147,23644450,23644450,23644517,0,0,0,67
24050,23622292,23622292,23644973,0,0,0,22681
24146,23644248,23644248,23645005,0,0,0,757
24149,23644900,23644900,23645016,0,0,0,116
24067,23628440,23628440,23645108,0,0,0,16668
24045,23621150,23621150,23646366,0,0,0,25216
24151,23645985,23645985,23646698,0,0,0,713
24154,23646754,23646754,23646848,0,0,0,94
24046,23621519,23621519,23649546,0,0,0,28027
24156,23649448,23649448,23651515,0,0,0,2067
24158,23653421,23653421,23653514,0,0,0,93
24159,23653426,23653426,23653519,0,0,0,93
24160,23653431,23653431,23653524,0,0,0,93
24157,23653415,23653415,23653525,0,0,0,110
24161,23653437,23653437,23653530,0,0,0,93
23796,23471265,23471265,23656446,0,0,0,185181
24019,23573146,23573146,23659546,0,0,0,86400
24118,23637742,23637742,23660443,0,0,0,22701
24022,23579172,23581523,23661189,0,0,2351,82017
24133,23642021,23642021,23663347,0,0,0,21326
24152,23646182,23646182,23663525,0,0,0,17343
24155,23648690,23648690,23666157,0,0,0,17467
24163,23665209,23665209,23667364,0,0,0,2155
24034,23618316,23618316,23668989,0,0,0,50673
24043,23620949,23620949,23672308,0,0,0,51359
24044,23620991,23620991,23672649,0,0,0,51658
23728,23440172,23440172,23678264,0,0,0,238092
24153,23646548,23646548,23679667,0,0,0,33119
24150,23644984,23644984,23680984,0,0,0,36000
23935,23543940,23543940,23682385,0,0,0,138445
24041,23620668,23620668,23689106,0,0,0,68438
24033,23618088,23618088,23689817,0,0,0,71729
24164,23665226,23665226,23692849,0,0,0,27623
24014,23570776,23574316,23695602,0,0,3540,124826
24057,23625720,23625720,23697720,0,0,0,72000
24168,23702496,23702496,23702532,0,0,0,36
23770,23461002,23461002,23703863,0,0,0,242861
24085,23631530,23631530,23703973,0,0,0,72443
24173,23704789,23704789,23704893,0,0,0,104
24148,23644523,23644523,23705362,0,0,0,60839
24175,23705229,23705229,23705437,0,0,0,208
24178,23706038,23706038,23706105,0,0,0,67
24025,23585578,23585578,23706310,0,0,0,120732
24179,23706226,23706226,23706319,0,0,0,93
24180,23706532,23706532,23706636,0,0,0,104
24177,23705633,23705633,23706743,0,0,0,1110
24185,23707167,23707167,23707291,0,0,0,124
24186,23707490,23707490,23707738,0,0,0,248
24181,23706702,23706702,23708080,0,0,0,1378
24187,23708183,23708183,23708219,0,0,0,36
24188,23708341,23708341,23708414,0,0,0,73
24192,23709474,23709474,23709567,0,0,0,93
24193,23709597,23709597,23709681,0,0,0,84
24194,23709644,23709644,23709737,0,0,0,93
24195,23709970,23709970,23710063,0,0,0,93
24196,23710125,23710125,23710209,0,0,0,84
24197,23710177,23710177,23710270,0,0,0,93
24198,23710451,23710451,23710519,0,0,0,68
24199,23710689,23710689,23710757,0,0,0,68
24200,23710805,23710805,23710873,0,0,0,68
24201,23710902,23710902,23711197,0,0,0,295
24203,23711462,23711462,23711535,0,0,0,73
24202,23711332,23711332,23711591,0,0,0,259
24183,23706885,23706885,23712330,0,0,0,5445
24204,23712091,23712091,23712339,0,0,0,248
24182,23706884,23706884,23712476,0,0,0,5592
24184,23706886,23706886,23712509,0,0,0,5623
24205,23713351,23713351,23713951,0,0,0,600
24209,23716469,23716469,23716522,0,0,0,53
24208,23716379,23716379,23716525,0,0,0,146
24210,23716494,23716494,23717054,0,0,0,560
24211,23716538,23716538,23717138,0,0,0,600
24215,23717419,23717419,23717512,0,0,0,93
24216,23717536,23717536,23717584,0,0,0,48
24217,23717553,23717553,23717739,0,0,0,186
24218,23717668,23717668,23717814,0,0,0,146
24219,23717683,23717683,23717850,0,0,0,167
24221,23717756,23717756,23717974,0,0,0,218
24223,23717988,23717988,23718066,0,0,0,78
24222,23717782,23717974,23718192,0,0,192,410
24220,23717727,23717727,23718326,0,0,0,599
24224,23718397,23718397,23718464,0,0,0,67
24213,23717054,23717054,23718854,0,0,0,1800
24225,23718956,23718956,23719330,0,0,0,374
24226,23719367,23719367,23719575,0,0,0,208
24227,23719533,23719533,23719720,0,0,0,187
24228,23719722,23719722,23719909,0,0,0,187
24229,23720108,23720108,23720213,0,0,0,105
24230,23720173,23720173,23720403,0,0,0,230
24231,23720331,23720331,23720443,0,0,0,112
24233,23720568,23720568,23720776,0,0,0,208
24235,23720749,23720749,23720848,0,0,0,99
24236,23720791,23720791,23720879,0,0,0,88
24238,23720854,23720854,23721020,0,0,0,166
24239,23720883,23720883,23721050,0,0,0,167
24245,23721780,23721780,23721843,0,0,0,63
24246,23721830,23721830,23721893,0,0,0,63
24247,23721847,23721847,23721910,0,0,0,63
24248,23722288,23722288,23722930,0,0,0,642
24214,23717372,23717372,23723499,0,0,0,6127
24250,23724041,23724041,23724135,0,0,0,94
24251,23724576,23724576,23724680,0,0,0,104
24174,23705014,23705014,23724998,0,0,0,19984
24176,23705336,23705336,23725231,0,0,0,19895
24206,23714887,23714887,23725298,0,0,0,10411
24191,23709296,23709296,23725330,0,0,0,16034
24253,23725225,23725225,23725392,0,0,0,167
24212,23716699,23716699,23726501,0,0,0,9802
24249,23723813,23723813,23726890,0,0,0,3077
24260,23727996,23727996,23728064,0,0,0,68
24266,23728765,23728765,23728982,0,0,0,217
24263,23728721,23728721,23729233,0,0,0,512
24267,23729265,23729265,23729420,0,0,0,155
23797,23471275,23471275,23730475,0,0,0,259200
24165,23668391,23668391,23730731,0,0,0,62340
24268,23731467,23731467,23731602,0,0,0,135
24269,23731654,23731654,23731815,0,0,0,161
24271,23731991,23731991,23732120,0,0,0,129
24264,23728735,23728735,23732129,0,0,0,3394
24252,23724762,23724762,23732146,0,0,0,7384
24272,23732337,23732337,23732497,0,0,0,160
24273,23732588,23732588,23732759,0,0,0,171
24277,23734148,23734148,23734303,0,0,0,155
24278,23734297,23734297,23734375,0,0,0,78
24279,23734681,23734681,23734806,0,0,0,125
24265,23728742,23728742,23738869,0,0,0,10127
24283,23737742,23737742,23739081,0,0,0,1339
24280,23734904,23734904,23741478,0,0,0,6574
24282,23735094,23735094,23741484,0,0,0,6390
24189,23709162,23709162,23745162,0,0,0,36000
24166,23668456,23668456,23745420,0,0,0,76964
24289,23747486,23747486,23747610,0,0,0,124
24285,23738289,23738289,23748145,0,0,0,9856
24270,23731896,23731896,23750514,0,0,0,18618
24169,23703889,23703889,23754295,0,0,0,50406
24288,23747235,23747235,23754667,0,0,0,7432
23725,23416730,23416730,23762330,0,0,0,345600
24274,23733079,23733079,23769079,0,0,0,36000
24276,23733645,23733645,23773848,0,0,0,40203
24190,23709228,23709228,23774558,0,0,0,65330
24171,23703987,23703987,23775303,0,0,0,71316
24172,23704108,23704108,23775900,0,0,0,71792
24287,23740626,23740626,23779281,0,0,0,38655
24232,23720411,23720411,23779617,0,0,0,59206
24284,23737764,23737764,23785098,0,0,0,47334
23961,23552383,23552383,23789424,0,0,0,237041
24286,23739025,23739025,23791310,0,0,0,52285
24296,23794109,23794109,23794213,0,0,0,104
24298,23794416,23794416,23794851,0,0,0,435
24299,23794858,23794858,23795387,0,0,0,529
24305,23796464,23796464,23797240,0,0,0,776
24309,23796584,23797240,23797395,0,0,656,811
24306,23796518,23797240,23797967,0,0,722,1449
24317,23797946,23797967,23798061,0,0,21,115
24308,23796561,23797967,23798153,0,0,1406,1592
24316,23797945,23797967,23798211,0,0,22,266
24320,23798858,23798858,23799029,0,0,0,171
24318,23797951,23797967,23800130,0,0,16,2179
24207,23716259,23716259,23801158,0,0,0,84899
24134,23642492,23642492,23802726,0,0,0,160234
23932,23543916,23543916,23803116,0,0,0,259200
23933,23543917,23543917,23803117,0,0,0,259200
23934,23543917,23543917,23803117,0,0,0,259200
23936,23544062,23544062,23803262,0,0,0,259200
23937,23544062,23544062,23803262,0,0,0,259200
23805,23471629,23545362,23804562,0,0,73733,332933
24294,23792733,23792733,23804820,0,0,0,12087
24363,23804220,23804562,23804956,0,0,342,736
24364,23804590,23804590,23804962,0,0,0,372
24312,23797058,23797967,23805240,0,0,909,8182
24314,23797496,23797967,23805240,0,0,471,7744
24365,23804993,23805240,23805386,0,0,247,393
24366,23805104,23805386,23805769,0,0,282,665
24300,23795000,23795000,23806577,0,0,0,11577
24297,23794271,23794271,23806753,0,0,0,12482
24368,23805535,23806577,23806887,0,0,1042,1352
24304,23795808,23795808,23807361,0,0,0,11553
24370,23807115,23807115,23807454,0,0,0,339
24162,23665100,23665100,23807768,0,0,0,142668
24371,23807418,23807418,23808060,0,0,0,642
24374,23807563,23807563,23808215,0,0,0,652
24375,23807668,23807668,23808273,0,0,0,605
24311,23796686,23797395,23808378,0,0,709,11692
23837,23493904,23493904,23808396,0,0,0,314492
24313,23797431,23797967,23809057,0,0,536,11626
24377,23808582,23808582,23809218,0,0,0,636
24379,23808674,23808674,23809343,0,0,0,669
24383,23810205,23810205,23810330,0,0,0,125
24384,23810386,23810386,23810521,0,0,0,135
24385,23810673,23810673,23810815,0,0,0,142
24302,23795467,23795467,23811067,0,0,0,15600
24389,23811202,23811202,23811379,0,0,0,177
24393,23811441,23811441,23811621,0,0,0,180
24376,23808541,23808541,23811665,0,0,0,3124
24395,23811751,23811751,23811868,0,0,0,117
24367,23805426,23805769,23812415,0,0,343,6989
24398,23811947,23811947,23812547,0,0,0,600
24381,23808991,23812415,23812768,0,0,3424,3777
24400,23813017,23813017,23813090,0,0,0,73
24401,23813197,23813197,23813344,0,0,0,147
24402,23813280,23813280,23813466,0,0,0,186
24403,23813818,23813818,23813891,0,0,0,73
24404,23813856,23813856,23814104,0,0,0,248
24407,23814881,23814881,23814974,0,0,0,93
24319,23797971,23797971,23815864,0,0,0,17893
24386,23810753,23810815,23815904,0,0,62,5151
24405,23814227,23815904,23816091,0,0,1677,1864
24417,23816394,23816394,23816857,0,0,0,463
24428,23817013,23817013,23817437,0,0,0,424
24410,23816325,23816325,23821466,0,0,0,5141
24258,23727805,23727805,23825771,0,0,0,97966
23806,23471640,23568228,23827428,0,0,96588,355788
24315,23797931,23797931,23831238,0,0,0,33307
24303,23795692,23795692,23831692,0,0,0,36000
24301,23795422,23795422,23832513,0,0,0,37091
24399,23812136,23827428,23836448,0,0,15292,24312
24108,23635514,23635514,23837788,0,0,0,202274
24438,23818124,23837788,23838070,0,0,19664,19946
24448,23833215,23838070,23838349,0,0,4855,5134
24432,23817588,23836448,23841524,0,0,18860,23936
24411,23816336,23816336,23846254,0,0,0,29918
24089,23631997,23631997,23846615,0,0,0,214618
24447,23829208,23846615,23846711,0,0,17407,17503
24262,23728179,23728179,23847372,0,0,0,119193
24339,23799018,23799018,23848251,0,0,0,49233
24334,23799017,23799017,23848308,0,0,0,49291
24340,23799018,23799018,23848313,0,0,0,49295
24412,23816349,23821466,23848315,0,0,5117,31966
24336,23799017,23799017,23848510,0,0,0,49493
24452,23838362,23848251,23848530,0,0,9889,10168
24341,23799018,23799018,23848759,0,0,0,49741
24335,23799017,23799017,23848908,0,0,0,49891
24342,23799018,23799018,23848945,0,0,0,49927
24333,23799017,23799017,23849094,0,0,0,50077
24343,23799018,23799018,23849286,0,0,0,50268
24344,23799018,23799018,23849348,0,0,0,50330
24453,23843795,23848313,23849521,0,0,4518,5726
24346,23799019,23800130,23849530,0,0,1111,50511
24455,23843855,23848530,23849677,0,0,4675,5822
24454,23843830,23848510,23849701,0,0,4680,5871
24345,23799018,23800130,23850584,0,0,1112,51566
24348,23799020,23801158,23850651,0,0,2138,51631
24361,23799242,23804962,23851094,0,0,5720,51852
24347,23799019,23801158,23851116,0,0,2139,52097
24349,23799020,23801158,23851488,0,0,2138,52468
24350,23799020,23801158,23851519,0,0,2138,52499
24382,23809188,23812768,23851721,0,0,3580,42533
24359,23799023,23802726,23851863,0,0,3703,52840
24355,23799022,23802726,23851897,0,0,3704,52875
24240,23721090,23721090,23852468,0,0,0,131378
24352,23799021,23802726,23852653,0,0,3705,53632
24356,23799022,23802726,23852746,0,0,3704,53724
24357,23799022,23802726,23852808,0,0,3704,53786
24360,23799023,23802726,23852839,0,0,3703,53816
24358,23799022,23802726,23852963,0,0,3704,53941
24353,23799021,23802726,23853087,0,0,3705,54066
24422,23816459,23832513,23853197,0,0,16054,36738
24423,23816469,23832513,23853228,0,0,16044,36759
24351,23799020,23802726,23853366,0,0,3706,54346
24354,23799021,23802726,23853604,0,0,3705,54583
24420,23816441,23832513,23853622,0,0,16072,37181
24421,23816450,23832513,23853653,0,0,16063,37203
24414,23816369,23827428,23853655,0,0,11059,37286
24416,23816380,23827428,23854173,0,0,11048,37793
24413,23816359,23827428,23854443,0,0,11069,38084
24418,23816425,23831238,23855119,0,0,14813,38694
24419,23816433,23831692,23855531,0,0,15259,39098
24449,23836361,23846711,23859672,0,0,10350,23311
24257,23727597,23727597,23860654,0,0,0,133057
24237,23720827,23720827,23862418,0,0,0,141591
24450,23837146,23849094,23864967,0,0,11948,27821
24430,23817488,23831238,23867005,0,0,13750,49517
24255,23727195,23727195,23873544,0,0,0,146349
24456,23853223,23853223,23874030,0,0,0,20807
24457,23853241,23853241,23874164,0,0,0,20923
24458,23853655,23853655,23874756,0,0,0,21101
24459,23853659,23853659,23874791,0,0,0,21132
24256,23727432,23727432,23877848,0,0,0,150416
24254,23726914,23726914,23879252,0,0,0,152338
24295,23793740,23793740,23879998,0,0,0,86258
24170,23703984,23703984,23881269,0,0,0,177285
24292,23792254,23792254,23881337,0,0,0,89083
24293,23792326,23792326,23881367,0,0,0,89041
24451,23837698,23838349,23881549,0,0,651,43851
24234,23720673,23720673,23881689,0,0,0,161016
24099,23633244,23633244,23883389,0,0,0,250145
24460,23856384,23859672,23883482,0,0,3288,27098
24461,23856395,23859672,23883545,0,0,3277,27150
24321,23799015,23799015,23885415,0,0,0,86400
24322,23799015,23799015,23885415,0,0,0,86400
24323,23799015,23799015,23885415,0,0,0,86400
24324,23799015,23799015,23885415,0,0,0,86400
24325,23799015,23799015,23885415,0,0,0,86400
24326,23799016,23799016,23885416,0,0,0,86400
24327,23799016,23799016,23885416,0,0,0,86400
24328,23799016,23799016,23885416,0,0,0,86400
24329,23799016,23799016,23885416,0,0,0,86400
24330,23799016,23799016,23885416,0,0,0,86400
24331,23799016,23799016,23885416,0,0,0,86400
24332,23799016,23799016,23885416,0,0,0,86400
24337,23799017,23799017,23885417,0,0,0,86400
24338,23799017,23799017,23885417,0,0,0,86400
24275,23733127,23733127,23885658,0,0,0,152531
24310,23796623,23885658,23886341,0,0,89035,89718
24462,23858753,23859672,23886480,0,0,919,27727
24362,23801160,23803116,23886706,0,0,1956,85546
24463,23859271,23862418,23889307,0,0,3147,30036
24281,23735034,23735034,23891799,0,0,0,156765
24464,23859396,23864967,23891831,0,0,5571,32435
24092,23632888,23632888,23892088,0,0,0,259200
24093,23632889,23632889,23892089,0,0,0,259200
24094,23632889,23632889,23892089,0,0,0,259200
24095,23632889,23632889,23892089,0,0,0,259200
24096,23632912,23632912,23892112,0,0,0,259200
24097,23632913,23632913,23892113,0,0,0,259200
24098,23633000,23633000,23892200,0,0,0,259200
24465,23859538,23864967,23892213,0,0,5429,32675
24104,23634651,23634651,23893851,0,0,0,259200
24105,23634677,23634677,23893877,0,0,0,259200
24106,23634718,23634718,23893918,0,0,0,259200
24244,23721218,23721218,23894156,0,0,0,172938
24467,23873967,23874030,23894654,0,0,63,20687
24468,23874154,23874164,23894695,0,0,10,20541
24466,23862435,23864967,23894860,0,0,2532,32425
24469,23874711,23874756,23895725,0,0,45,21014
24470,23874759,23874791,23895738,0,0,32,20979
24387,23811037,23811067,23897467,0,0,30,86430
24495,23897778,23897778,23897902,0,0,0,124
24291,23790190,23790190,23900287,0,0,0,110097
24143,23644034,23644034,23903234,0,0,0,259200
24472,23880133,23881337,23904127,0,0,1204,23994
24473,23880238,23881337,23904201,0,0,1099,23963
24243,23721185,23721185,23908710,0,0,0,187525
24259,23727961,23727961,23911333,0,0,0,183372
24475,23885478,23885478,23912094,0,0,0,26616
24476,23886098,23886098,23912814,0,0,0,26716
24388,23811096,23827428,23912891,0,0,16332,101795
24477,23886208,23886208,23913414,0,0,0,27206
24478,23886726,23886726,23913933,0,0,0,27207
24482,23894544,23894544,23915034,0,0,0,20490
24483,23894648,23894648,23915180,0,0,0,20532
24485,23895652,23895652,23916543,0,0,0,20891
24484,23895637,23895637,23916575,0,0,0,20938
24509,23916511,23916511,23916606,0,0,0,95
24480,23892275,23892275,23921451,0,0,0,29176
24513,23921389,23921389,23921563,0,0,0,174
24514,23921501,23921501,23921672,0,0,0,171
24446,23829189,23841524,23921936,0,0,12335,92747
24241,23721128,23721128,23922704,0,0,0,201576
24512,23918664,23918664,23923464,0,0,0,4800
24500,23902944,23902944,23926665,0,0,0,23721
24501,23903102,23903102,23926811,0,0,0,23709
24474,23881201,23881367,23928923,0,0,166,47722
24242,23721154,23721154,23932264,0,0,0,211110
24435,23817829,23836448,23932579,0,0,18619,114750
24507,23915123,23915123,23935531,0,0,0,20408
24506,23914968,23914968,23935895,0,0,0,20927
24508,23916487,23916487,23937345,0,0,0,20858
24510,23916512,23916512,23937376,0,0,0,20864
24167,23702333,23702333,23937586,0,0,0,235253
24502,23912039,23912039,23938136,0,0,0,26097
24503,23912752,23912752,23938994,0,0,0,26242
24504,23913408,23913408,23940139,0,0,0,26731
24505,23913932,23913932,23940714,0,0,0,26782
24511,23916543,23916543,23945343,0,0,0,28800
24261,23728061,23728061,23946297,0,0,0,218236
24408,23815014,23815904,23948843,0,0,890,133829
24516,23926631,23926631,23950480,0,0,0,23849
24409,23816264,23816264,23950675,0,0,0,134411
24517,23926764,23926764,23950707,0,0,0,23943
24515,23921610,23921610,23951388,0,0,0,29778
24531,23951325,23951325,23954988,0,0,0,3663
24521,23935468,23935468,23955912,0,0,0,20444
24522,23935842,23935842,23956304,0,0,0,20462
24481,23892582,23892582,23957078,0,0,0,64496
24445,23826261,23837788,23957548,0,0,11527,131287
24523,23937276,23937276,23958121,0,0,0,20845
24524,23937324,23937324,23958156,0,0,0,20832
24390,23811256,23851094,23960900,0,0,39838,149644
24391,23811269,23851721,23963250,0,0,40452,151981
24525,23938074,23938074,23964615,0,0,0,26541
24526,23938931,23938931,23965526,0,0,0,26595
24527,23940104,23940104,23966677,0,0,0,26573
24528,23940648,23940648,23967165,0,0,0,26517
24440,23819828,23837788,23970786,0,0,17960,150958
24433,23817600,23836448,23971919,0,0,18848,154319
24518,23929523,23929523,23972266,0,0,0,42743
24479,23888561,23888561,23972289,0,0,0,83728
24392,23811280,23855531,23972914,0,0,44251,161634
24529,23950420,23950420,23973514,0,0,0,23094
24530,23950650,23950650,23973712,0,0,0,23062
24439,23819769,23837788,23974228,0,0,18019,154459
24533,23955843,23955843,23976422,0,0,0,20579
24534,23956242,23956242,23976789,0,0,0,20547
24535,23958080,23958080,23979089,0,0,0,21009
24536,23958093,23958093,23979122,0,0,0,21029
24415,23816374,23825771,23979373,0,0,9397,162999
24496,23897898,23897898,23979590,0,0,0,81692
24554,23981243,23981243,23981324,0,0,0,81
24555,23981294,23981294,23981387,0,0,0,93
24556,23981450,23981450,23981575,0,0,0,125
24557,23981594,23981594,23981729,0,0,0,135
24558,23981691,23981691,23981815,0,0,0,124
24431,23817547,23832513,23982383,0,0,14966,164836
24559,23982845,23982845,23982938,0,0,0,93
24560,23982992,23982992,23983148,0,0,0,156
24561,23983447,23983447,23983789,0,0,0,342
24541,23970038,23970038,23984219,0,0,0,14181
24532,23954919,23954919,23984890,0,0,0,29971
24538,23965458,23965458,23988443,0,0,0,22985
24519,23929836,23929836,23988480,0,0,0,58644
24537,23964553,23964553,23990869,0,0,0,26316
24564,23990818,23990818,23990985,0,0,0,167
24567,23990931,23990931,23991097,0,0,0,166
24568,23991035,23991035,23991203,0,0,0,168
24539,23966625,23966625,23993438,0,0,0,26813
24540,23967107,23967107,23993982,0,0,0,26875
24406,23814622,23827428,23994199,0,0,12806,179577
24574,23995427,23995427,23995507,0,0,0,80
24545,23973452,23973452,23995548,0,0,0,22096
24546,23973648,23973648,23995757,0,0,0,22109
24579,23996068,23996068,23996141,0,0,0,73
24548,23976367,23976367,23996941,0,0,0,20574
24549,23976726,23976726,23997323,0,0,0,20597
24441,23819882,23837788,23999789,0,0,17906,179907
24550,23979030,23979030,23999995,0,0,0,20965
24551,23979060,23979060,24000026,0,0,0,20966
24425,23816662,23827428,24000772,0,0,10766,184110
24494,23897620,23897620,24001119,0,0,0,103499
24562,23984832,23984832,24014113,0,0,0,29281
24586,24014054,24014054,24014468,0,0,0,414
24563,23988386,23988386,24014604,0,0,0,26218
24587,24014427,24014427,24014857,0,0,0,430
24443,23820135,23837788,24017441,0,0,17653,197306
24580,23996879,23996879,24017485,0,0,0,20606
24543,23971805,23971805,24017578,0,0,0,45773
24569,23991141,23991141,24017651,0,0,0,26510
24591,24017607,24017607,24017784,0,0,0,177
24581,23997276,23997276,24017946,0,0,0,20670
24585,24008838,24008838,24018076,0,0,0,9238
24577,23995506,23995506,24019291,0,0,0,23785
24578,23995696,23995696,24019427,0,0,0,23731
24570,23993359,23993359,24020361,0,0,0,27002
24582,23999949,23999949,24021002,0,0,0,21053
24572,23993920,23993920,24021044,0,0,0,27124
24583,23999964,23999964,24021075,0,0,0,21111
24434,23817669,23836448,24022938,0,0,18779,205269
24424,23816521,23827428,24025789,0,0,10907,209268
24547,23973890,23973890,24026234,0,0,0,52344
24552,23979404,23979404,24028512,0,0,0,49108
24426,23816885,23831238,24037176,0,0,14353,220291
24590,24017422,24017422,24037896,0,0,0,20474
24593,24017882,24017882,24038402,0,0,0,20520
24588,24014539,24014539,24041040,0,0,0,26501
24553,23979420,23979420,24041318,0,0,0,61898
24369,23806635,23806635,24041661,0,0,0,235026
24599,24021004,24021004,24041872,0,0,0,20868
24597,24020951,24020951,24041903,0,0,0,20952
24589,24014808,24014808,24042797,0,0,0,27989
24437,23817943,23836448,24043005,0,0,18505,225062
24594,24019229,24019229,24043459,0,0,0,24230
24595,24019382,24019382,24043560,0,0,0,24178
24499,23902008,23902008,24043785,0,0,0,141777
24575,23995476,23995476,24044163,0,0,0,48687
24592,24017714,24017714,24044544,0,0,0,26830
24444,23820138,23837788,24044641,0,0,17650,224503
24394,23811471,23815864,24046797,0,0,4393,235326
24596,24020298,24020298,24047410,0,0,0,27112
24610,24047503,24047503,24047689,0,0,0,186
24611,24047505,24047505,24047692,0,0,0,187
24598,24020964,24020964,24047860,0,0,0,26896
24576,23995501,23995501,24048130,0,0,0,52629
24615,24048738,24048738,24048967,0,0,0,229
24614,24048729,24048729,24048989,0,0,0,260
24616,24049835,24049835,24050053,0,0,0,218
24542,23970062,23970062,24050576,0,0,0,80514
24617,24050249,24050249,24050745,0,0,0,496
24619,24050683,24050683,24050776,0,0,0,93
24622,24050932,24050932,24051222,0,0,0,290
24621,24050870,24050870,24051405,0,0,0,535
24623,24051373,24051373,24051495,0,0,0,122
24630,24052605,24052605,24052691,0,0,0,86
24632,24053163,24053163,24053231,0,0,0,68
24635,24053619,24053619,24053686,0,0,0,67
24634,24053366,24053366,24054037,0,0,0,671
24520,23929869,23929869,24054829,0,0,0,124960
24627,24051575,24051575,24054973,0,0,0,3398
24638,24055376,24055376,24055485,0,0,0,109
24639,24055498,24055498,24055565,0,0,0,67
24640,24055731,24055731,24055798,0,0,0,67
24544,23972293,23972293,24055876,0,0,0,83583
24642,24055827,24055827,24055905,0,0,0,78
24643,24055927,24055927,24056051,0,0,0,124
24644,24056215,24056215,24056357,0,0,0,142
24307,23796545,23797240,24056440,0,0,695,259895
24625,24051464,24051464,24056546,0,0,0,5082
24626,24051513,24051513,24056546,0,0,0,5033
24647,24057014,24057014,24057073,0,0,0,59
24645,24056562,24056562,24057513,0,0,0,951
24649,24058213,24058213,24058318,0,0,0,105
24600,24037833,24037833,24058349,0,0,0,20516
24651,24058592,24058592,24058665,0,0,0,73
24601,24038347,24038347,24058889,0,0,0,20542
24378,23808663,23811665,24059709,0,0,3002,251046
24656,24060293,24060293,24060417,0,0,0,124
24658,24060700,24060700,24060835,0,0,0,135
24659,24060789,24060789,24060862,0,0,0,73
24657,24060675,24060675,24060893,0,0,0,218
24660,24061093,24061093,24061186,0,0,0,93
24661,24061208,24061208,24061301,0,0,0,93
24662,24061379,24061379,24061535,0,0,0,156
24648,24057078,24057078,24062162,0,0,0,5084
24663,24062057,24062057,24062186,0,0,0,129
24633,24053225,24053225,24062311,0,0,0,9086
24665,24062497,24062497,24062621,0,0,0,124
24604,24041851,24041851,24062775,0,0,0,20924
24603,24041827,24041827,24062821,0,0,0,20994
24668,24062791,24062791,24062946,0,0,0,155
24671,24063008,24063008,24063143,0,0,0,135
24672,24063511,24063511,24063636,0,0,0,125
24664,24062369,24062369,24064678,0,0,0,2309
24677,24064777,24064777,24064932,0,0,0,155
24678,24065165,24065165,24065301,0,0,0,136
24679,24065308,24065308,24065448,0,0,0,140
24372,23807506,23807506,24066706,0,0,0,259200
24373,23807521,23807768,24066968,0,0,247,259447
24641,24055825,24055825,24067156,0,0,0,11331
24602,24040980,24040980,24067327,0,0,0,26347
24606,24043392,24043392,24067672,0,0,0,24280
24607,24043520,24043520,24067707,0,0,0,24187
24687,24067738,24067738,24067816,0,0,0,78
24684,24067548,24067548,24067941,0,0,0,393
24688,24067936,24067936,24068040,0,0,0,104
24689,24068470,24068470,24068538,0,0,0,68
24690,24069151,24069151,24069435,0,0,0,284
24676,24064647,24064647,24069751,0,0,0,5104
24618,24050293,24050293,24069933,0,0,0,19640
24608,24044491,24044491,24070868,0,0,0,26377
24696,24071857,24071857,24072012,0,0,0,155
24605,24042734,24042734,24072350,0,0,0,29616
24699,24072404,24072404,24072470,0,0,0,66
24691,24069957,24069957,24072540,0,0,0,2583
24700,24072427,24072427,24073339,0,0,0,912
24704,24073306,24073306,24073461,0,0,0,155
24705,24073561,24073561,24073685,0,0,0,124
24706,24073782,24073782,24073886,0,0,0,104
24609,24047363,24047363,24074218,0,0,0,26855
24708,24074517,24074517,24074672,0,0,0,155
24709,24074921,24074921,24075025,0,0,0,104
24396,23811814,23815864,24075064,0,0,4050,263250
24397,23811906,23815864,24075064,0,0,3958,263158
24710,24075162,24075162,24075304,0,0,0,142
24711,24075218,24075218,24075343,0,0,0,125
24712,24075341,24075341,24077123,0,0,0,1782
24703,24072603,24072603,24077683,0,0,0,5080
24613,24047980,24047980,24078095,0,0,0,30115
24650,24058284,24058284,24078692,0,0,0,20408
24692,24070420,24070420,24078943,0,0,0,8523
24652,24058816,24058816,24079218,0,0,0,20402
24698,24072305,24072305,24079999,0,0,0,7694
24695,24071649,24071649,24080121,0,0,0,8472
24715,24077062,24077062,24080662,0,0,0,3600
24702,24072555,24072555,24081092,0,0,0,8537
24719,24081714,24081714,24081808,0,0,0,94
24666,24062728,24062728,24083490,0,0,0,20762
24667,24062736,24062736,24083529,0,0,0,20793
24427,23816935,23831238,24085210,0,0,14303,268275
24724,24084736,24084736,24085254,0,0,0,518
24725,24084770,24084770,24085277,0,0,0,507
24727,24085632,24085632,24086310,0,0,0,678
24654,24059354,24059354,24088288,0,0,0,28934
24734,24088391,24088391,24088511,0,0,0,120
24429,23817252,23831692,24090892,0,0,14440,273640
24612,24047805,24047805,24091005,0,0,0,43200
24685,24067603,24067603,24091497,0,0,0,23894
24686,24067644,24067644,24091538,0,0,0,23894
24739,24092554,24092554,24092991,0,0,0,437
24682,24067284,24067284,24093569,0,0,0,26285
24669,24062946,24062946,24095396,0,0,0,32450
24670,24062977,24062977,24095476,0,0,0,32499
24436,23817883,23836448,24095648,0,0,18565,277765
24442,23819938,23837788,24096988,0,0,17850,277050
24675,24064367,24064367,24096988,0,0,0,32621
24693,24070806,24070806,24097298,0,0,0,26492
24680,24065420,24065420,24097903,0,0,0,32483
24731,24087202,24087202,24098343,0,0,0,11141
24717,24078652,24078652,24098767,0,0,0,20115
24718,24079156,24079156,24099305,0,0,0,20149
24681,24066238,24066238,24099383,0,0,0,33145
24707,24074151,24074151,24100685,0,0,0,26534
24683,24067341,24067341,24102047,0,0,0,34706
24745,24098475,24098475,24102189,0,0,0,3714
24697,24072301,24072301,24102279,0,0,0,29978
24721,24083431,24083431,24104000,0,0,0,20569
24722,24083491,24083491,24104074,0,0,0,20583
24742,24096739,24096739,24107400,0,0,0,10661
24743,24096939,24096939,24107618,0,0,0,10679
24716,24078030,24078030,24107850,0,0,0,29820
24754,24107790,24107790,24107970,0,0,0,180
24290,23762889,23762889,24108489,0,0,0,345600
24646,24056955,24056955,24110297,0,0,0,53342
24723,24083976,24083976,24111287,0,0,0,27311
24571,23993397,23993397,24114118,0,0,0,120721
24738,24091495,24091495,24115074,0,0,0,23579
24747,24098705,24098705,24119377,0,0,0,20672
24741,24093507,24093507,24119761,0,0,0,26254
24748,24099235,24099235,24119794,0,0,0,20559
24720,24081945,24081945,24123557,0,0,0,41612
24744,24097227,24097227,24123591,0,0,0,26364
24637,24054874,24054874,24123624,0,0,0,68750
24752,24103933,24103933,24124927,0,0,0,20994
24753,24104015,24104015,24124975,0,0,0,20960
24763,24123933,24123933,24125410,0,0,0,1477
24766,24125746,24125746,24126958,0,0,0,1212
24749,24100646,24100646,24127397,0,0,0,26751
24768,24127560,24127560,24128639,0,0,0,1079
24701,24072487,24072487,24128973,0,0,0,56486
24769,24129373,24129373,24130346,0,0,0,973
24756,24108533,24108533,24130465,0,0,0,21932
24770,24131185,24131185,24132106,0,0,0,921
24750,24102218,24102218,24132198,0,0,0,29980
24772,24132400,24132400,24132463,0,0,0,63
24774,24132998,24132998,24133888,0,0,0,890
24737,24091427,24091427,24134627,0,0,0,43200
24775,24133918,24133918,24134758,0,0,0,840
24776,24134833,24134833,24135634,0,0,0,801
24777,24135546,24135546,24135733,0,0,0,187
24735,24088470,24088470,24135986,0,0,0,47516
24779,24136156,24136156,24136357,0,0,0,201
24778,24135739,24135739,24136540,0,0,0,801
24781,24136646,24136646,24137418,0,0,0,772
24755,24107970,24107970,24137994,0,0,0,30024
24758,24115014,24115014,24138264,0,0,0,23250
24783,24137553,24137553,24138292,0,0,0,739
24785,24138208,24138208,24138354,0,0,0,146
24788,24138695,24138695,24138749,0,0,0,54
24471,23875651,23879998,24139198,0,0,4347,263547
24787,24138460,24138460,24139203,0,0,0,743
24792,24139277,24139277,24139401,0,0,0,124
24790,24139031,24139031,24139530,0,0,0,499
24714,24077016,24077016,24139669,0,0,0,62653
24653,24058851,24058851,24139908,0,0,0,81057
24793,24139725,24139725,24139916,0,0,0,191
24773,24132589,24132589,24139938,0,0,0,7349
24636,24053799,24053799,24140038,0,0,0,86239
24794,24139971,24139971,24140118,0,0,0,147
24759,24119377,24119377,24140124,0,0,0,20747
24796,24140114,24140114,24140287,0,0,0,173
24798,24140148,24140148,24140302,0,0,0,154
24799,24140251,24140251,24140333,0,0,0,82
24795,24140082,24140082,24140460,0,0,0,378
24761,24119800,24119800,24140537,0,0,0,20737
24746,24098561,24098561,24140899,0,0,0,42338
24802,24140732,24140732,24140950,0,0,0,218
24800,24140286,24140286,24141091,0,0,0,805
24803,24140893,24140893,24141599,0,0,0,706
24791,24139047,24139047,24141771,0,0,0,2724
24804,24141360,24141360,24142214,0,0,0,854
24807,24142333,24142333,24142391,0,0,0,58
24789,24138748,24138748,24143332,0,0,0,4584
24805,24141605,24141605,24143333,0,0,0,1728
24808,24142361,24142361,24144321,0,0,0,1960
24760,24119688,24119688,24145912,0,0,0,26224
24764,24124933,24124933,24146046,0,0,0,21113
24765,24124996,24124996,24146109,0,0,0,21113
24815,24145942,24145942,24146568,0,0,0,626
24811,24144253,24144253,24146785,0,0,0,2532
24819,24146535,24146535,24147673,0,0,0,1138
24821,24147659,24147659,24147752,0,0,0,93
24822,24147870,24147870,24148212,0,0,0,342
24824,24148511,24148511,24148666,0,0,0,155
24825,24148569,24148569,24148724,0,0,0,155
24829,24148702,24148702,24148795,0,0,0,93
24826,24148580,24148580,24148797,0,0,0,217
24733,24088328,24088328,24148886,0,0,0,60558
24827,24148592,24148592,24148964,0,0,0,372
24828,24148603,24148603,24149223,0,0,0,620
24782,24137513,24137513,24149481,0,0,0,11968
24823,24148151,24148151,24149950,0,0,0,1799
24762,24123553,24123553,24149997,0,0,0,26444
24655,24060198,24060198,24150075,0,0,0,89877
24831,24149964,24149964,24151773,0,0,0,1809
24620,24050840,24050840,24153097,0,0,0,102257
24631,24052957,24052957,24153745,0,0,0,100788
24767,24127380,24127380,24153942,0,0,0,26562
24380,23808690,23809057,24154657,0,0,367,345967
24801,24140335,24140335,24154780,0,0,0,14445
24812,24145757,24145757,24155836,0,0,0,10079
24486,23897087,23897087,24156287,0,0,0,259200
24487,23897122,23897122,24156322,0,0,0,259200
24836,24155738,24155738,24156377,0,0,0,639
24488,23897358,23897358,24156558,0,0,0,259200
24489,23897359,23897359,24156559,0,0,0,259200
24490,23897360,23897360,24156560,0,0,0,259200
24491,23897360,23897360,24156560,0,0,0,259200
24492,23897480,23897480,24156680,0,0,0,259200
24493,23897481,23897481,24156681,0,0,0,259200
24841,24156645,24156645,24157065,0,0,0,420
24838,24156395,24156395,24157171,0,0,0,776
24839,24156601,24156601,24157172,0,0,0,571
24847,24157326,24157326,24157420,0,0,0,94
24846,24157240,24157240,24157506,0,0,0,266
24845,24157112,24157112,24157777,0,0,0,665
24497,23898964,23898964,24158164,0,0,0,259200
24850,24158207,24158207,24158287,0,0,0,80
24498,23899141,23899141,24158341,0,0,0,259200
24849,24157710,24157710,24159509,0,0,0,1799
24628,24052111,24052111,24159562,0,0,0,107451
24859,24159473,24159473,24159573,0,0,0,100
24858,24159308,24159308,24159574,0,0,0,266
24860,24159558,24159558,24159653,0,0,0,95
24797,24140134,24140134,24160201,0,0,0,20067
24786,24138255,24138255,24161276,0,0,0,23021
24867,24161326,24161326,24161481,0,0,0,155
24771,24132199,24132199,24161909,0,0,0,29710
24844,24157004,24157004,24162060,0,0,0,5056
24869,24162987,24162987,24163054,0,0,0,67
24870,24163301,24163301,24163390,0,0,0,89
24871,24163356,24163356,24163480,0,0,0,124
24873,24163796,24163796,24163920,0,0,0,124
24810,24144252,24144252,24164327,0,0,0,20075
24834,24152596,24152596,24164781,0,0,0,12185
24624,24051443,24051443,24165223,0,0,0,113780
24674,24064139,24064139,24165374,0,0,0,101235
24673,24063797,24063797,24165476,0,0,0,101679
24816,24146003,24146003,24166434,0,0,0,20431
24818,24146053,24146053,24166497,0,0,0,20444
24784,24137994,24137994,24167119,0,0,0,29125
24876,24167111,24167111,24167283,0,0,0,172
24879,24168731,24168731,24168799,0,0,0,68
24880,24168885,24168885,24169107,0,0,0,222
24814,24145920,24145920,24169539,0,0,0,23619
24751,24103122,24103122,24172328,0,0,0,69206
24817,24146008,24146008,24172410,0,0,0,26402
24813,24145867,24145867,24172732,0,0,0,26865
24865,24161236,24161236,24174673,0,0,0,13437
24832,24150007,24150007,24176096,0,0,0,26089
24887,24177910,24177910,24178081,0,0,0,171
24835,24153879,24153879,24180553,0,0,0,26674
24864,24160149,24160149,24180714,0,0,0,20565
24886,24176695,24176695,24181795,0,0,0,5100
24881,24169141,24169141,24184471,0,0,0,15330
24874,24164265,24164265,24184892,0,0,0,20627
24866,24161254,24161254,24184974,0,0,0,23720
24893,24186994,24186994,24187067,0,0,0,73
24875,24166473,24166473,24187353,0,0,0,20880
24729,24085814,24085814,24189160,0,0,0,103346
24780,24136235,24136235,24191192,0,0,0,54957
24868,24161846,24161846,24191516,0,0,0,29670
24883,24170456,24170456,24191557,0,0,0,21101
24882,24169603,24169603,24192890,0,0,0,23287
24894,24187021,24187021,24193465,0,0,0,6444
24877,24167229,24167229,24196591,0,0,0,29362
24884,24172460,24172460,24198200,0,0,0,25740
24854,24158321,24158321,24198756,0,0,0,40435
24885,24172669,24172669,24199289,0,0,0,26620
24809,24143270,24143270,24200918,0,0,0,57648
24872,24163755,24163755,24201962,0,0,0,38207
24890,24181819,24181819,24202349,0,0,0,20530
24820,24146751,24146751,24204535,0,0,0,57784
24888,24178019,24178019,24204654,0,0,0,26635
24891,24184821,24184821,24205337,0,0,0,20516
24852,24158289,24158289,24206561,0,0,0,48272
24730,24085876,24085876,24207497,0,0,0,121621
24889,24180554,24180554,24207701,0,0,0,27147
24892,24185721,24185721,24207879,0,0,0,22158
24895,24187314,24187314,24208260,0,0,0,20946
24896,24191490,24191490,24212353,0,0,0,20863
24726,24085556,24085556,24214107,0,0,0,128551
24728,24085685,24085685,24215078,0,0,0,129393
24898,24192826,24192826,24215864,0,0,0,23038
24573,23994815,23994815,24219635,0,0,0,224820
24910,24219822,24219822,24219957,0,0,0,135
24915,24221361,24221361,24221454,0,0,0,93
24912,24221310,24221310,24221474,0,0,0,164
24911,24221296,24221296,24221475,0,0,0,179
24916,24221381,24221381,24221475,0,0,0,94
24913,24221323,24221323,24221478,0,0,0,155
24914,24221337,24221337,24221524,0,0,0,187
24897,24192755,24192755,24222033,0,0,0,29278
24917,24221964,24221964,24222154,0,0,0,190
24918,24222084,24222084,24222247,0,0,0,163
24920,24222100,24222100,24222272,0,0,0,172
24921,24222111,24222111,24222272,0,0,0,161
24922,24222129,24222129,24222284,0,0,0,155
24902,24202286,24202286,24222768,0,0,0,20482
24924,24222730,24222730,24222843,0,0,0,113
24925,24222751,24222751,24222909,0,0,0,158
24926,24222768,24222768,24222934,0,0,0,166
24928,24222791,24222791,24222939,0,0,0,148
24927,24222781,24222781,24222940,0,0,0,159
24929,24222816,24222816,24222940,0,0,0,124
24900,24198137,24198137,24224515,0,0,0,26378
24904,24205283,24205283,24225519,0,0,0,20236
24935,24225358,24225358,24225552,0,0,0,194
24901,24199226,24199226,24225758,0,0,0,26532
24931,24224270,24224270,24226136,0,0,0,1866
24899,24196520,24196520,24226648,0,0,0,30128
24837,24156337,24156337,24227103,0,0,0,70766
24940,24226944,24226944,24227266,0,0,0,322
24941,24227021,24227021,24227327,0,0,0,306
24942,24228312,24228312,24228645,0,0,0,333
24907,24208189,24208189,24228793,0,0,0,20604
24944,24228756,24228756,24228882,0,0,0,126
24948,24229092,24229092,24229186,0,0,0,94
24949,24229116,24229116,24229210,0,0,0,94
24947,24229065,24229065,24229239,0,0,0,174
24946,24228839,24228839,24229420,0,0,0,581
24930,24222977,24222977,24229607,0,0,0,6630
24950,24229662,24229662,24229849,0,0,0,187
24903,24204591,24204591,24231292,0,0,0,26701
24906,24207816,24207816,24231520,0,0,0,23704
24954,24232833,24232833,24232896,0,0,0,63
24908,24212316,24212316,24232926,0,0,0,20610
24955,24232846,24232846,24232940,0,0,0,94
24957,24232884,24232896,24232990,0,0,12,106
24958,24232902,24232940,24233045,0,0,38,143
24960,24233431,24233431,24233515,0,0,0,84
24905,24207639,24207639,24234680,0,0,0,27041
24965,24234675,24234675,24234749,0,0,0,74
24978,24236770,24236770,24236899,0,0,0,129
24968,24235663,24235663,24238056,0,0,0,2393
24971,24235933,24235933,24238357,0,0,0,2424
24909,24215804,24215804,24239514,0,0,0,23710
24584,24006244,24006244,24240559,0,0,0,234315
24961,24233472,24233472,24241252,0,0,0,7780
24984,24242763,24242763,24242857,0,0,0,94
24970,24235884,24235884,24242881,0,0,0,6997
24962,24233890,24233890,24242919,0,0,0,9029
24985,24242853,24242853,24242957,0,0,0,104
24986,24243007,24243007,24243097,0,0,0,90
24923,24222686,24222686,24243151,0,0,0,20465
24989,24243121,24243121,24243591,0,0,0,470
24966,24235038,24235038,24243941,0,0,0,8903
24990,24244046,24244046,24244120,0,0,0,74
24732,24088257,24088257,24244635,0,0,0,156378
24936,24225458,24225458,24245887,0,0,0,20429
24987,24243046,24243046,24246427,0,0,0,3381
24991,24246373,24246373,24246447,0,0,0,74
24996,24249061,24249061,24249185,0,0,0,124
24945,24228762,24228762,24249551,0,0,0,20789
24999,24249509,24249509,24249562,0,0,0,53
24565,23990829,23990829,24250029,0,0,0,259200
24566,23990889,23990889,24250089,0,0,0,259200
24933,24224446,24224446,24250888,0,0,0,26442
24919,24222090,24222090,24250993,0,0,0,28903
24977,24236655,24236655,24251570,0,0,0,14915
24994,24246858,24246858,24251842,0,0,0,4984
24937,24225696,24225696,24252218,0,0,0,26522
24956,24232883,24232883,24253667,0,0,0,20784
24953,24231475,24231475,24253838,0,0,0,22363
24995,24247579,24247579,24254506,0,0,0,6927
24952,24231228,24231228,24254622,0,0,0,23394
24983,24242237,24242237,24254963,0,0,0,12726
24938,24226595,24226595,24255689,0,0,0,29094
24997,24249300,24249300,24256587,0,0,0,7287
25000,24249530,24249530,24256743,0,0,0,7213
25013,24259705,24259705,24260082,0,0,0,377
25012,24258304,24258304,24260163,0,0,0,1859
25011,24258299,24258299,24260169,0,0,0,1870
24964,24234635,24234635,24260710,0,0,0,26075
24830,24149029,24149029,24261158,0,0,0,112129
24981,24239451,24239451,24261601,0,0,0,22150
25014,24260123,24260123,24261991,0,0,0,1868
25015,24260128,24260128,24262016,0,0,0,1888
24988,24243064,24243064,24263221,0,0,0,20157
24980,24236989,24236989,24263351,0,0,0,26362
25019,24261950,24261950,24263833,0,0,0,1883
25020,24261959,24261959,24263862,0,0,0,1903
24833,24150720,24150720,24264136,0,0,0,113416
25025,24264714,24264714,24264807,0,0,0,93
25023,24263794,24263794,24265683,0,0,0,1889
25024,24263802,24263802,24265711,0,0,0,1909
24932,24224396,24224396,24266365,0,0,0,41969
24992,24246504,24246504,24266651,0,0,0,20147
25026,24265641,24265641,24267522,0,0,0,1881
25027,24265647,24265647,24267578,0,0,0,1931
25002,24250823,24250823,24269193,0,0,0,18370
25029,24267479,24267479,24269585,0,0,0,2106
25030,24267518,24267518,24269613,0,0,0,2095
24998,24249495,24249495,24270011,0,0,0,20516
24963,24234219,24234219,24270219,0,0,0,36000
24967,24235551,24235551,24271551,0,0,0,36000
24969,24235786,24235786,24271786,0,0,0,36000
24972,24235995,24235995,24271995,0,0,0,36000
24973,24236071,24236071,24272071,0,0,0,36000
24974,24236092,24236092,24272092,0,0,0,36000
24975,24236133,24236133,24272133,0,0,0,36000
24976,24236160,24236160,24272160,0,0,0,36000
25005,24253623,24253623,24274132,0,0,0,20509
25006,24253779,24253779,24276180,0,0,0,22401
25004,24252624,24252624,24278751,0,0,0,26127
24993,24246791,24246791,24279496,0,0,0,32705
25007,24254561,24254561,24280393,0,0,0,25832
25003,24250930,24250930,24280759,0,0,0,29829
25041,24280751,24280751,24280928,0,0,0,177
25042,24280863,24280863,24281035,0,0,0,172
25043,24280979,24280979,24281148,0,0,0,169
25044,24281085,24281085,24281267,0,0,0,182
25022,24263252,24263252,24283452,0,0,0,20200
25008,24255618,24255618,24283497,0,0,0,27879
24736,24088650,24088650,24283815,0,0,0,195165
25018,24261623,24261623,24285311,0,0,0,23688
25028,24266674,24266674,24286986,0,0,0,20312
25017,24260710,24260710,24287375,0,0,0,26665
25034,24271348,24271348,24291960,0,0,0,20612
24806,24142090,24142090,24294527,0,0,0,152437
25036,24274287,24274287,24294838,0,0,0,20551
25031,24269306,24269306,24295377,0,0,0,26071
25021,24262883,24262883,24298883,0,0,0,36000
25037,24276957,24276957,24299664,0,0,0,22707
25047,24283389,24283389,24303994,0,0,0,20605
25032,24269533,24269533,24305533,0,0,0,36000
25033,24269554,24269554,24305554,0,0,0,36000
25040,24279724,24279724,24306372,0,0,0,26648
25050,24286923,24286923,24307540,0,0,0,20617
25049,24285258,24285258,24307617,0,0,0,22359
25045,24281192,24281192,24307763,0,0,0,26571
24878,24168454,24168454,24309056,0,0,0,140602
25067,24308289,24308289,24309429,0,0,0,1140
25010,24256245,24256245,24309652,0,0,0,53407
25075,24310009,24310009,24310108,0,0,0,99
25076,24310020,24310020,24310113,0,0,0,93
25077,24310064,24310064,24310158,0,0,0,94
25061,24308086,24308086,24310338,0,0,0,2252
25079,24310594,24310594,24310749,0,0,0,155
25046,24282455,24282455,24310855,0,0,0,28400
25074,24309371,24309371,24311400,0,0,0,2029
24629,24052310,24052310,24311510,0,0,0,259200
25082,24311573,24311573,24311688,0,0,0,115
25071,24308445,24308445,24312306,0,0,0,3861
25078,24310294,24310294,24312597,0,0,0,2303
25052,24291891,24291891,24312881,0,0,0,20990
25048,24283505,24283505,24313436,0,0,0,29931
25081,24311330,24311330,24313583,0,0,0,2253
25087,24313508,24313508,24313590,0,0,0,82
25080,24310799,24310799,24313830,0,0,0,3031
25051,24287316,24287316,24313872,0,0,0,26556
25084,24312552,24312552,24314510,0,0,0,1958
25088,24313529,24313529,24314557,0,0,0,1028
25053,24294791,24294791,24315782,0,0,0,20991
25094,24314514,24314514,24316492,0,0,0,1978
25083,24312239,24312239,24317422,0,0,0,5183
25098,24317518,24317518,24317586,0,0,0,68
25099,24317633,24317633,24317700,0,0,0,67
25096,24316430,24316430,24318594,0,0,0,2164
25102,24318928,24318928,24319107,0,0,0,179
25104,24318957,24318957,24319138,0,0,0,181
25105,24318973,24318973,24319169,0,0,0,196
25106,24318988,24318988,24319199,0,0,0,211
25107,24319002,24319002,24319220,0,0,0,218
25103,24318942,24318942,24319386,0,0,0,444
25097,24317370,24317370,24319521,0,0,0,2151
25090,24313798,24313798,24319552,0,0,0,5754
25109,24320016,24320016,24320153,0,0,0,137
24934,24224532,24224532,24320403,0,0,0,95871
25101,24318547,24318547,24320799,0,0,0,2252
25054,24295310,24295310,24321679,0,0,0,26369
25110,24320539,24320539,24321726,0,0,0,1187
25108,24319456,24319456,24321733,0,0,0,2277
25112,24321613,24321613,24321790,0,0,0,177
25055,24299607,24299607,24321841,0,0,0,22234
25116,24322423,24322423,24322697,0,0,0,274
25016,24260486,24260486,24322941,0,0,0,62455
25111,24320742,24320742,24323022,0,0,0,2280
25118,24323064,24323064,24323131,0,0,0,67
25100,24317980,24317980,24323176,0,0,0,5196
25119,24323186,24323186,24323280,0,0,0,94
25113,24321689,24321689,24323931,0,0,0,2242
25092,24313914,24313914,24324060,0,0,0,10146
25056,24303924,24303924,24324355,0,0,0,20431
25122,24324312,24324312,24324417,0,0,0,105
25124,24324617,24324617,24324691,0,0,0,74
25117,24322960,24322960,24324879,0,0,0,1919
25126,24324880,24324880,24324974,0,0,0,94
25127,24324999,24324999,24325104,0,0,0,105
25125,24324838,24324838,24326324,0,0,0,1486
25070,24308301,24308301,24326910,0,0,0,18609
25129,24325777,24325777,24326939,0,0,0,1162
25069,24308297,24308297,24327216,0,0,0,18919
25132,24326261,24326261,24327420,0,0,0,1159
25135,24327582,24327582,24327696,0,0,0,114
25137,24327723,24327723,24327817,0,0,0,94
25058,24307480,24307480,24327905,0,0,0,20425
25139,24327864,24327864,24327957,0,0,0,93
25062,24308229,24308229,24328010,0,0,0,19781
25140,24327963,24327963,24328062,0,0,0,99
25066,24308285,24308285,24328307,0,0,0,20022
25133,24326401,24326401,24328347,0,0,0,1946
25143,24328374,24328374,24328479,0,0,0,105
25134,24327376,24327376,24329252,0,0,0,1876
25146,24329023,24329023,24329349,0,0,0,326
25147,24329079,24329079,24329407,0,0,0,328
25148,24329192,24329192,24329516,0,0,0,324
25150,24329254,24329254,24329577,0,0,0,323
25059,24307554,24307554,24329788,0,0,0,22234
25151,24329375,24329375,24329866,0,0,0,491
25142,24328284,24328284,24330159,0,0,0,1875
25156,24330202,24330202,24330296,0,0,0,94
25144,24328479,24328479,24330695,0,0,0,2216
25149,24329204,24329204,24330725,0,0,0,1521
24694,24071577,24071577,24330777,0,0,0,259200
25064,24308277,24308277,24331129,0,0,0,22852
25068,24308293,24308293,24331196,0,0,0,22903
25158,24331290,24331290,24331383,0,0,0,93
25159,24331442,24331442,24331536,0,0,0,94
25153,24330006,24330006,24331671,0,0,0,1665
25065,24308280,24308280,24332189,0,0,0,23909
25162,24332245,24332245,24332339,0,0,0,94
25163,24332348,24332348,24332439,0,0,0,91
25164,24332404,24332404,24332471,0,0,0,67
25154,24330086,24330086,24332609,0,0,0,2523
25167,24332700,24332700,24332773,0,0,0,73
25165,24332526,24332526,24332837,0,0,0,311
25166,24332570,24332570,24332896,0,0,0,326
25057,24306309,24306309,24333099,0,0,0,26790
25063,24308241,24308241,24333237,0,0,0,24996
25170,24333179,24333179,24333505,0,0,0,326
25085,24312826,24312826,24333734,0,0,0,20908
25168,24332903,24332903,24333789,0,0,0,886
25161,24331943,24331943,24333843,0,0,0,1900
25172,24333803,24333803,24334140,0,0,0,337
25060,24307701,24307701,24334466,0,0,0,26765
25175,24334399,24334399,24334572,0,0,0,173
25177,24334622,24334622,24334747,0,0,0,125
24713,24076099,24076099,24335299,0,0,0,259200
25136,24327669,24327669,24335635,0,0,0,7966
24939,24226683,24226683,24335702,0,0,0,109019
25095,24315724,24315724,24336566,0,0,0,20842
25178,24334929,24334929,24336803,0,0,0,1874
25131,24326233,24326233,24336863,0,0,0,10630
25186,24337264,24337264,24337378,0,0,0,114
25183,24336759,24336759,24338410,0,0,0,1651
25185,24337102,24337102,24338440,0,0,0,1338
25184,24336775,24336775,24338446,0,0,0,1671
25155,24330121,24330121,24339696,0,0,0,9575
25192,24340178,24340178,24340242,0,0,0,64
25091,24313825,24313825,24340270,0,0,0,26445
25194,24340343,24340343,24340941,0,0,0,598
25009,24255902,24255902,24341654,0,0,0,85752
24943,24228365,24228365,24341949,0,0,0,113584
25160,24331670,24331670,24343086,0,0,0,11416
25089,24313780,24313780,24343253,0,0,0,29473
25086,24313373,24313373,24343512,0,0,0,30139
25115,24321799,24321799,24343884,0,0,0,22085
25123,24324316,24324316,24344473,0,0,0,20157
25181,24336122,24336122,24347940,0,0,0,11818
25114,24321730,24321730,24347975,0,0,0,26245
25138,24327863,24327863,24348013,0,0,0,20150
24951,24231181,24231181,24349846,0,0,0,118665
25093,24314446,24314446,24350446,0,0,0,36000
25120,24323475,24323475,24351355,0,0,0,27880
24740,24092690,24092690,24351890,0,0,0,259200
25152,24329726,24329726,24352408,0,0,0,22682
25171,24333664,24333664,24354223,0,0,0,20559
25189,24338366,24338366,24354320,0,0,0,15954
25191,24339858,24339858,24354351,0,0,0,14493
25206,24354277,24354277,24356194,0,0,0,1917
25207,24354281,24354281,24357067,0,0,0,2786
25182,24336523,24336523,24357072,0,0,0,20549
25209,24356123,24356123,24357976,0,0,0,1853
25208,24354916,24354916,24358196,0,0,0,3280
25212,24357031,24357031,24358927,0,0,0,1896
25169,24333063,24333063,24359247,0,0,0,26184
25213,24357937,24357937,24359813,0,0,0,1876
25176,24334514,24334514,24360572,0,0,0,26058
25216,24359771,24359771,24363451,0,0,0,3680
24982,24240599,24240599,24363953,0,0,0,123354
25200,24344414,24344414,24364915,0,0,0,20501
25193,24340213,24340213,24366622,0,0,0,26409
25199,24343824,24343824,24366905,0,0,0,23081
25202,24347947,24347947,24368455,0,0,0,20508
25197,24343189,24343189,24371423,0,0,0,28234
25223,24371362,24371362,24371534,0,0,0,172
25224,24371471,24371471,24371642,0,0,0,171
25225,24371579,24371579,24371747,0,0,0,168
25204,24353363,24353363,24372949,0,0,0,19586
25187,24337357,24337357,24373357,0,0,0,36000
25188,24337411,24337411,24373411,0,0,0,36000
25198,24343469,24343469,24373532,0,0,0,30063
25201,24347903,24347903,24373890,0,0,0,25987
25228,24373833,24373833,24374004,0,0,0,171
25190,24338384,24338384,24374384,0,0,0,36000
25203,24352362,24352362,24374690,0,0,0,22328
25205,24354169,24354169,24375036,0,0,0,20867
25211,24356998,24356998,24377834,0,0,0,20836
25145,24328953,24328953,24380918,0,0,0,51965
25219,24364850,24364850,24385339,0,0,0,20489
25215,24359207,24359207,24385925,0,0,0,26718
25217,24360500,24360500,24386713,0,0,0,26213
25236,24388196,24388196,24388290,0,0,0,94
25222,24368396,24368396,24388924,0,0,0,20528
25221,24366852,24366852,24390496,0,0,0,23644
24979,24236882,24236882,24391979,0,0,0,155097
25001,24249804,24249804,24392874,0,0,0,143070
25220,24366551,24366551,24392940,0,0,0,26389
25214,24358866,24358866,24394866,0,0,0,36000
25240,24393896,24393896,24394900,0,0,0,1004
25242,24395689,24395689,24395771,0,0,0,82
25231,24374974,24374974,24395876,0,0,0,20902
25245,24395740,24395771,24395939,0,0,31,199
25243,24395710,24395710,24396404,0,0,0,694
25244,24395715,24395771,24396735,0,0,56,1020
25230,24374622,24374622,24397211,0,0,0,22589
25232,24377775,24377775,24398729,0,0,0,20954
25250,24398549,24398549,24398884,0,0,0,335
25251,24398579,24398579,24398915,0,0,0,336
25218,24363394,24363394,24399394,0,0,0,36000
25226,24371686,24371686,24400002,0,0,0,28316
25253,24399939,24399939,24400136,0,0,0,197
25255,24400105,24400105,24400229,0,0,0,124
25229,24373941,24373941,24400312,0,0,0,26371
25257,24400875,24400875,24400935,0,0,0,60
25259,24401540,24401540,24401579,0,0,0,39
25260,24401969,24401969,24402119,0,0,0,150
25262,24402220,24402220,24402324,0,0,0,104
25173,24333851,24333851,24402442,0,0,0,68591
25174,24333949,24333949,24402467,0,0,0,68518
25258,24401431,24401431,24403125,0,0,0,1694
25227,24373472,24373472,24403246,0,0,0,29774
25233,24385279,24385279,24405676,0,0,0,20397
25263,24402371,24402371,24406329,0,0,0,3958
25274,24407580,24407580,24407674,0,0,0,94
25275,24407594,24407594,24407729,0,0,0,135
25276,24407613,24407729,24407823,0,0,116,210
25237,24388861,24388861,24409240,0,0,0,20379
25073,24308915,24308915,24409797,0,0,0,100882
25235,24386660,24386660,24412396,0,0,0,25736
25283,24412349,24412349,24412526,0,0,0,177
25234,24385863,24385863,24412615,0,0,0,26752
25284,24412466,24412466,24412663,0,0,0,197
25072,24308834,24308834,24413070,0,0,0,104236
25238,24390426,24390426,24413275,0,0,0,22849
25288,24413714,24413714,24413793,0,0,0,79
25289,24413939,24413939,24414006,0,0,0,67
25290,24414099,24414099,24414259,0,0,0,160
24840,24156601,24156601,24415801,0,0,0,259200
24842,24156709,24156709,24415909,0,0,0,259200
25246,24395833,24395833,24416555,0,0,0,20722
25241,24395232,24395232,24416586,0,0,0,21354
24848,24157599,24157599,24416799,0,0,0,259200
24851,24158264,24158264,24417464,0,0,0,259200
24853,24158299,24158299,24417499,0,0,0,259200
24855,24158338,24158338,24417538,0,0,0,259200
24856,24158379,24158379,24417579,0,0,0,259200
25280,24409941,24409941,24418165,0,0,0,8224
24857,24159112,24159112,24418312,0,0,0,259200
24861,24159667,24159667,24418867,0,0,0,259200
24862,24159702,24159702,24418902,0,0,0,259200
25239,24392878,24392878,24419046,0,0,0,26168
24863,24160019,24160019,24419219,0,0,0,259200
25252,24398666,24398666,24419403,0,0,0,20737
25247,24397177,24397177,24420287,0,0,0,23110
25121,24323776,24323776,24425887,0,0,0,102111
25272,24405605,24405605,24426124,0,0,0,20519
25256,24400250,24400250,24426481,0,0,0,26231
25196,24341653,24341653,24426941,0,0,0,85288
25254,24400049,24400049,24428861,0,0,0,28812
25279,24409172,24409172,24429700,0,0,0,20528
25291,24415140,24417464,24430785,0,0,2324,15645
25039,24279170,24279170,24430944,0,0,0,151774
25038,24279079,24279079,24431287,0,0,0,152208
25310,24429105,24429105,24432537,0,0,0,3432
25266,24403209,24403209,24432982,0,0,0,29773
25249,24398410,24398410,24434410,0,0,0,36000
25287,24413220,24413220,24436216,0,0,0,22996
25294,24416494,24416494,24437404,0,0,0,20910
25286,24412582,24412615,24438590,0,0,33,26008
25285,24412537,24412537,24439031,0,0,0,26494
25265,24403198,24403198,24439198,0,0,0,36000
25267,24403211,24403211,24439211,0,0,0,36000
25268,24403609,24403609,24439609,0,0,0,36000
25304,24419340,24419340,24440262,0,0,0,20922
25270,24404364,24404364,24440364,0,0,0,36000
25305,24420227,24420227,24443902,0,0,0,23675
25301,24419011,24419011,24445820,0,0,0,26809
25306,24426066,24426066,24446638,0,0,0,20572
25311,24429638,24429638,24450081,0,0,0,20443
25248,24397367,24397367,24450086,0,0,0,52719
25319,24441409,24441409,24452071,0,0,0,10662
25307,24426413,24426413,24452372,0,0,0,25959
25325,24452316,24452316,24452485,0,0,0,169
25326,24452422,24452422,24452592,0,0,0,170
25327,24452529,24452529,24452696,0,0,0,167
24757,24108787,24108787,24454387,0,0,0,345600
25309,24428777,24428777,24457216,0,0,0,28439
25330,24457174,24457174,24457344,0,0,0,170
25315,24437334,24437334,24458278,0,0,0,20944
25314,24436153,24436153,24459509,0,0,0,23356
25318,24440191,24440191,24461061,0,0,0,20870
25312,24432922,24432922,24462332,0,0,0,29410
25316,24438497,24438497,24465041,0,0,0,26544
25336,24464997,24464997,24465174,0,0,0,177
25337,24465108,24465108,24465276,0,0,0,168
25338,24465221,24465221,24465389,0,0,0,168
25339,24465327,24465327,24465496,0,0,0,169
25317,24438994,24438994,24465816,0,0,0,26822
25321,24443839,24443839,24466610,0,0,0,22771
25323,24446569,24446569,24467197,0,0,0,20628
25324,24450024,24450024,24470595,0,0,0,20571
25322,24445774,24445774,24472298,0,0,0,26524
24843,24156995,24156995,24475167,0,0,0,318172
25328,24452634,24452634,24479089,0,0,0,26455
25332,24458240,24458240,24479189,0,0,0,20949
25313,24435997,24435997,24481833,0,0,0,45836
25334,24461001,24461001,24481979,0,0,0,20978
25333,24459442,24459442,24482407,0,0,0,22965
25335,24462285,24462285,24485087,0,0,0,22802
25331,24457288,24457288,24485251,0,0,0,27963
25343,24467137,24467137,24487712,0,0,0,20575
25342,24466548,24466548,24489517,0,0,0,22969
25345,24470532,24470532,24491131,0,0,0,20599
25340,24465433,24465433,24491768,0,0,0,26335
25356,24491707,24491707,24491867,0,0,0,160
25357,24491815,24491815,24491971,0,0,0,156
25358,24491923,24491923,24492111,0,0,0,188
25341,24465753,24465753,24492146,0,0,0,26393
24959,24233266,24233266,24492466,0,0,0,259200
25035,24273567,24273567,24495908,0,0,0,222341
25346,24472241,24472241,24498552,0,0,0,26311
25195,24340413,24340413,24500086,0,0,0,159673
25348,24479146,24479146,24500166,0,0,0,21020
25141,24328104,24328104,24500904,0,0,0,172800
25264,24402407,24402407,24501102,0,0,0,98695
25349,24481916,24481916,24502922,0,0,0,21006
25273,24405665,24405665,24504999,0,0,0,99334
25347,24479021,24479021,24505656,0,0,0,26635
25350,24482349,24482349,24505859,0,0,0,23510
25180,24336072,24336072,24507203,0,0,0,171131
25351,24485029,24485029,24508066,0,0,0,23037
25353,24487673,24487673,24508261,0,0,0,20588
25278,24408957,24408957,24509072,0,0,0,100115
25355,24491060,24491060,24511614,0,0,0,20554
25281,24410249,24410249,24511863,0,0,0,101614
25277,24408706,24408706,24512577,0,0,0,103871
25354,24489455,24489455,24512824,0,0,0,23369
25282,24410317,24413070,24513867,0,0,2753,103550
25352,24485187,24485187,24514160,0,0,0,28973
25308,24426920,24426920,24515076,0,0,0,88156
25364,24501509,24501509,24515414,0,0,0,13905
25359,24492034,24492034,24517843,0,0,0,25809
25360,24492081,24492081,24518368,0,0,0,26287
25363,24500110,24500110,24521028,0,0,0,20918
25366,24502868,24502868,24523842,0,0,0,20974
25362,24498489,24498489,24525300,0,0,0,26811
25269,24404119,24404119,24525641,0,0,0,121522
25271,24404959,24404959,24527969,0,0,0,123010
25370,24508201,24508201,24528667,0,0,0,20466
25368,24505795,24505795,24528774,0,0,0,22979
25369,24508015,24508015,24530705,0,0,0,22690
25261,24402031,24402031,24530988,0,0,0,128957
25367,24505600,24505600,24531549,0,0,0,25949
25388,24531486,24531486,24531656,0,0,0,170
25389,24531593,24531593,24531764,0,0,0,171
25390,24531701,24531701,24531868,0,0,0,167
25371,24511561,24511561,24532067,0,0,0,20506
25372,24512780,24512780,24535694,0,0,0,22914
25377,24520982,24520982,24541875,0,0,0,20893
25373,24514106,24514106,24543486,0,0,0,29380
25375,24517788,24517788,24543968,0,0,0,26180
25396,24543908,24543908,24544066,0,0,0,158
25378,24523795,24523795,24544693,0,0,0,20898
25376,24518311,24518311,24545391,0,0,0,27080
25380,24528605,24528605,24548753,0,0,0,20148
25379,24525256,24525256,24552059,0,0,0,26803
25392,24532005,24532005,24552216,0,0,0,20211
25381,24528714,24528714,24552246,0,0,0,23532
25391,24531820,24531820,24558005,0,0,0,26185
25404,24557966,24557966,24558143,0,0,0,177
25405,24558076,24558076,24558242,0,0,0,166
25406,24558187,24558187,24558366,0,0,0,179
25393,24535649,24535649,24559127,0,0,0,23478
25386,24530642,24530642,24559478,0,0,0,28836
25407,24558305,24558305,24560085,0,0,0,1780
25394,24541817,24541817,24562366,0,0,0,20549
25398,24544631,24544631,24565175,0,0,0,20544
25400,24548691,24548691,24569267,0,0,0,20576
25397,24544017,24544017,24570252,0,0,0,26235
25414,24570189,24570189,24570359,0,0,0,170
25409,24559437,24559437,24570688,0,0,0,11251
25399,24545319,24545319,24572000,0,0,0,26681
25395,24543414,24543414,24572072,0,0,0,28658
25402,24552162,24552162,24572721,0,0,0,20559
25403,24552184,24552184,24576063,0,0,0,23879
25401,24551994,24551994,24578387,0,0,0,26393
25416,24570631,24570631,24581887,0,0,0,11256
25408,24559063,24559063,24582107,0,0,0,23044
25411,24562319,24562319,24583237,0,0,0,20918
25128,24325209,24325209,24584409,0,0,0,259200
25130,24326000,24326000,24585200,0,0,0,259200
25412,24565112,24565112,24586042,0,0,0,20930
25410,24560015,24560015,24586392,0,0,0,26377
25413,24569207,24569207,24589609,0,0,0,20402
25320,24443818,24450086,24589756,0,0,6268,145938
25157,24330975,24330975,24590175,0,0,0,259200
25344,24470374,24470374,24592044,0,0,0,121670
25419,24572662,24572662,24593112,0,0,0,20450
25179,24335641,24335641,24594841,0,0,0,259200
25415,24570296,24570296,24596313,0,0,0,26017
25374,24515020,24515020,24598336,0,0,0,83316
25417,24571947,24571947,24598595,0,0,0,26648
25420,24576001,24576001,24599661,0,0,0,23660
25418,24572015,24572015,24600626,0,0,0,28611
25433,24600569,24600569,24600721,0,0,0,152
25434,24600678,24600678,24600856,0,0,0,178
25435,24600785,24600785,24600954,0,0,0,169
25436,24600900,24600900,24601072,0,0,0,172
25424,24583174,24583174,24604030,0,0,0,20856
25421,24578330,24578330,24604853,0,0,0,26523
25423,24582048,24582048,24605583,0,0,0,23535
25425,24585985,24585985,24606808,0,0,0,20823
25427,24589569,24589569,24610062,0,0,0,20493
25422,24581844,24581844,24611739,0,0,0,29895
25426,24586336,24586336,24612338,0,0,0,26002
25428,24593043,24593043,24613533,0,0,0,20490
25210,24356756,24356756,24615956,0,0,0,259200
25448,24615855,24615855,24619390,0,0,0,3535
25449,24615912,24615912,24620022,0,0,0,4110
25429,24596250,24596250,24622314,0,0,0,26064
25450,24622271,24622271,24622449,0,0,0,178
25451,24622380,24622380,24622552,0,0,0,172
25452,24622497,24622497,24622665,0,0,0,168
25453,24622602,24622602,24622770,0,0,0,168
25454,24622708,24622708,24622998,0,0,0,290
25432,24599595,24599595,24623460,0,0,0,23865
25447,24615815,24615815,24623990,0,0,0,8175
25438,24603968,24603968,24624869,0,0,0,20901
25431,24598549,24598549,24625185,0,0,0,26636
25446,24615773,24615773,24625779,0,0,0,10006
25384,24530377,24530377,24626530,0,0,0,96153
25383,24530292,24530292,24626631,0,0,0,96339
25385,24530572,24530572,24627022,0,0,0,96450
25441,24606760,24606760,24627624,0,0,0,20864
25440,24605525,24605525,24629359,0,0,0,23834
25437,24601010,24601010,24630086,0,0,0,29076
25461,24630039,24630039,24630217,0,0,0,178
25462,24630151,24630151,24630317,0,0,0,166
25463,24630258,24630258,24630427,0,0,0,169
25442,24609995,24609995,24630499,0,0,0,20504
25464,24630369,24630369,24630537,0,0,0,168
25466,24630475,24630475,24630646,0,0,0,171
25439,24604786,24604786,24631286,0,0,0,26500
25387,24531040,24531040,24632855,0,0,0,101815
25445,24613471,24613471,24633976,0,0,0,20505
25444,24612269,24612269,24638642,0,0,0,26373
25443,24611677,24611677,24639707,0,0,0,28030
25457,24624812,24624812,24645975,0,0,0,21163
25456,24623393,24623393,24646442,0,0,0,23049
25459,24627585,24627585,24648504,0,0,0,20919
25455,24622954,24622954,24648980,0,0,0,26026
25475,24648913,24648913,24649080,0,0,0,167
25465,24630441,24630441,24651115,0,0,0,20674
25458,24625127,24625127,24651624,0,0,0,26497
25460,24629313,24629313,24652979,0,0,0,23666
25469,24633939,24633939,24654589,0,0,0,20650
25482,24657230,24657230,24657297,0,0,0,67
25481,24656890,24656890,24657399,0,0,0,509
25484,24657659,24657659,24657764,0,0,0,105
25468,24631228,24631228,24657903,0,0,0,26675
25485,24657834,24657834,24658092,0,0,0,258
25483,24657473,24657473,24658126,0,0,0,653
25486,24658023,24658023,24658164,0,0,0,141
25487,24658159,24658159,24658295,0,0,0,136
25488,24658382,24658382,24658449,0,0,0,67
25490,24658792,24658792,24658980,0,0,0,188
25491,24658918,24658918,24659012,0,0,0,94
25467,24630584,24630584,24659192,0,0,0,28608
25493,24659129,24659129,24659280,0,0,0,151
25495,24659231,24659231,24659413,0,0,0,182
25494,24659223,24659223,24659622,0,0,0,399
25489,24658468,24658468,24660239,0,0,0,1771
25497,24660133,24660133,24660521,0,0,0,388
25492,24658970,24658970,24661212,0,0,0,2242
25499,24660833,24660833,24661723,0,0,0,890
25500,24661279,24661279,24661911,0,0,0,632
25303,24419129,24419129,24661967,0,0,0,242838
25329,24455064,24455064,24661970,0,0,0,206906
25292,24416113,24416113,24661974,0,0,0,245861
25293,24416155,24416155,24661974,0,0,0,245819
25300,24418572,24418572,24661977,0,0,0,243405
25302,24419097,24419097,24661978,0,0,0,242881
25297,24417683,24418165,24662456,0,0,482,244773
25470,24638588,24638588,24664717,0,0,0,26129
25502,24662880,24662880,24665089,0,0,0,2209
25472,24645913,24645913,24666989,0,0,0,21076
25507,24667964,24667964,24668031,0,0,0,67
25509,24668113,24668113,24668149,0,0,0,36
25471,24639644,24639644,24669350,0,0,0,29706
25474,24648438,24648438,24669479,0,0,0,21041
25473,24646384,24646384,24670438,0,0,0,24054
25503,24663274,24663274,24670598,0,0,0,7324
25504,24663390,24663390,24670598,0,0,0,7208
25515,24671119,24671119,24671507,0,0,0,388
25477,24651054,24651054,24671658,0,0,0,20604
25518,24671800,24671800,24672276,0,0,0,476
25519,24672242,24672242,24672601,0,0,0,359
25513,24670120,24670120,24672641,0,0,0,2521
25521,24672553,24672553,24672672,0,0,0,119
25520,24672421,24672421,24672869,0,0,0,448
25476,24649025,24649025,24675060,0,0,0,26035
25480,24654528,24654528,24675158,0,0,0,20630
25527,24675013,24675013,24675185,0,0,0,172
25479,24652921,24652921,24676782,0,0,0,23861
25295,24417600,24417600,24676800,0,0,0,259200
25296,24417644,24417644,24676844,0,0,0,259200
25532,24676898,24676898,24677035,0,0,0,137
25530,24676056,24676056,24677143,0,0,0,1087
25298,24417733,24418165,24677365,0,0,432,259632
25299,24417773,24418165,24677365,0,0,392,259592
25478,24651553,24651553,24677817,0,0,0,26264
25535,24677949,24677949,24678009,0,0,0,60
25536,24677982,24677982,24678129,0,0,0,147
25544,24678773,24678773,24678858,0,0,0,85
25547,24679036,24679036,24679813,0,0,0,777
25542,24678236,24678236,24679844,0,0,0,1608
25549,24679969,24679969,24680031,0,0,0,62
25548,24679911,24679911,24680544,0,0,0,633
25539,24678082,24678082,24681544,0,0,0,3462
25534,24677898,24677898,24681664,0,0,0,3766
25553,24681624,24681624,24681810,0,0,0,186
25517,24671747,24671747,24682157,0,0,0,10410
25430,24598274,24598274,24682729,0,0,0,84455
25525,24672904,24672904,24684646,0,0,0,11742
25498,24660428,24660428,24687249,0,0,0,26821
25506,24666924,24666924,24687954,0,0,0,21030
25496,24659346,24659346,24688511,0,0,0,29165
25382,24529353,24529353,24689057,0,0,0,159704
25559,24689345,24689345,24689501,0,0,0,156
25512,24669413,24669413,24690426,0,0,0,21013
25501,24662636,24662636,24690463,0,0,0,27827
25554,24682236,24682236,24691024,0,0,0,8788
25516,24671595,24671595,24692080,0,0,0,20485
25514,24670376,24670376,24694000,0,0,0,23624
25562,24692661,24692661,24694718,0,0,0,2057
25528,24675084,24675084,24695495,0,0,0,20411
25511,24669287,24669287,24697337,0,0,0,28050
25567,24697290,24697290,24697467,0,0,0,177
25565,24696647,24696647,24697745,0,0,0,1098
25508,24668043,24668043,24698172,0,0,0,30129
25569,24698140,24698140,24698265,0,0,0,125
25566,24697262,24697262,24698484,0,0,0,1222
25531,24676720,24676720,24699809,0,0,0,23089
25523,24672609,24672609,24700212,0,0,0,27603
25573,24698695,24698695,24700484,0,0,0,1789
25545,24678828,24678828,24700822,0,0,0,21994
25529,24675127,24675127,24701521,0,0,0,26394
25365,24502139,24502139,24701570,0,0,0,199431
25576,24701567,24701567,24701598,0,0,0,31
25575,24701458,24701458,24701639,0,0,0,181
25533,24677733,24677733,24701661,0,0,0,23928
25568,24697404,24697404,24701665,0,0,0,4261
25556,24687194,24687194,24701670,0,0,0,14476
25558,24688456,24688456,24701670,0,0,0,13214
25522,24672587,24672587,24701941,0,0,0,29354
25537,24678063,24678063,24701948,0,0,0,23885
25526,24674521,24674521,24701981,0,0,0,27460
25551,24681487,24681487,24701981,0,0,0,20494
25552,24681611,24681611,24701981,0,0,0,20370
25541,24678124,24678124,24702038,0,0,0,23914
25555,24685660,24685660,24702095,0,0,0,16435
25505,24664649,24664649,24707849,0,0,0,43200
25557,24687894,24687894,24708668,0,0,0,20774
25584,24705346,24705346,24708946,0,0,0,3600
25581,24702389,24702389,24709531,0,0,0,7142
25560,24690390,24690390,24711193,0,0,0,20803
25561,24692012,24692012,24712560,0,0,0,20548
25564,24695423,24695423,24715989,0,0,0,20566
25563,24693934,24693934,24717800,0,0,0,23866
25574,24699739,24699739,24723762,0,0,0,24023
25585,24708620,24708620,24729636,0,0,0,21016
25586,24711124,24711124,24732080,0,0,0,20956
25587,24712505,24712505,24733001,0,0,0,20496
25588,24715936,24715936,24736435,0,0,0,20499
25595,24736495,24736495,24736555,0,0,0,60
25524,24672681,24672681,24737409,0,0,0,64728
25570,24698328,24698328,24738406,0,0,0,40078
25596,24738350,24738350,24738465,0,0,0,115
25597,24738482,24738482,24738576,0,0,0,94
25598,24739407,24739407,24739466,0,0,0,59
25361,24495971,24495971,24740483,0,0,0,244512
25589,24717746,24717746,24741592,0,0,0,23846
25599,24739457,24739457,24742438,0,0,0,2981
25578,24702207,24702207,24743586,0,0,0,41379
25603,24743516,24743516,24743786,0,0,0,270
25601,24743434,24743434,24743856,0,0,0,422
25606,24744304,24744304,24744397,0,0,0,93
25607,24744500,24744500,24744567,0,0,0,67
25602,24743462,24743462,24744699,0,0,0,1237
25604,24743523,24743523,24746600,0,0,0,3077
25611,24747328,24747328,24747388,0,0,0,60
25590,24723707,24723707,24747466,0,0,0,23759
25613,24747709,24747709,24747844,0,0,0,135
25608,24745257,24745257,24748651,0,0,0,3394
25605,24743743,24743743,24749096,0,0,0,5353
25620,24749303,24749303,24749551,0,0,0,248
25629,24749905,24749905,24750154,0,0,0,249
25591,24729596,24729596,24750617,0,0,0,21021
25577,24702176,24702176,24750618,0,0,0,48442
25630,24750560,24750560,24750664,0,0,0,104
25632,24750565,24750565,24750700,0,0,0,135
25614,24747928,24747928,24751528,0,0,0,3600
25592,24732028,24732028,24753073,0,0,0,21045
25593,24732958,24732958,24753425,0,0,0,20467
25641,24756020,24756020,24756198,0,0,0,178
25644,24756130,24756130,24756253,0,0,0,123
25645,24756144,24756144,24756309,0,0,0,165
25646,24756167,24756167,24756344,0,0,0,177
25647,24756257,24756257,24756426,0,0,0,169
25594,24736372,24736372,24756900,0,0,0,20528
25579,24702356,24702356,24758886,0,0,0,56530
25580,24702372,24702372,24758959,0,0,0,56587
25583,24702402,24702402,24758980,0,0,0,56578
25582,24702396,24702396,24758985,0,0,0,56589
25628,24749859,24749859,24758989,0,0,0,9130
25634,24750585,24750585,24759466,0,0,0,8881
25660,24760178,24760178,24760349,0,0,0,171
25658,24759523,24759523,24760689,0,0,0,1166
25656,24759075,24759075,24761515,0,0,0,2440
25657,24759439,24759439,24761626,0,0,0,2187
25654,24758911,24758911,24761668,0,0,0,2757
25655,24758927,24758927,24761728,0,0,0,2801
25676,24761727,24761727,24761821,0,0,0,94
25671,24761367,24761367,24761890,0,0,0,523
25662,24760882,24760882,24762382,0,0,0,1500
25664,24760967,24760967,24762467,0,0,0,1500
25665,24761025,24761025,24762525,0,0,0,1500
25666,24761112,24761112,24762612,0,0,0,1500
25668,24761182,24761182,24762682,0,0,0,1500
25673,24761563,24761563,24764657,0,0,0,3094
25661,24760255,24760255,24764701,0,0,0,4446
25672,24761454,24761454,24764714,0,0,0,3260
25652,24758836,24758836,24764730,0,0,0,5894
25653,24758886,24758886,24764744,0,0,0,5858
25675,24761684,24761684,24764763,0,0,0,3079
25674,24761630,24761630,24764769,0,0,0,3139
25692,24764866,24764866,24764996,0,0,0,130
25691,24764845,24764845,24765036,0,0,0,191
25693,24765008,24765008,24765176,0,0,0,168
25694,24765417,24765417,24765576,0,0,0,159
25600,24741524,24741524,24765685,0,0,0,24161
25697,24765760,24765760,24765915,0,0,0,155
25615,24748174,24748174,24766174,0,0,0,18000
25616,24748271,24748271,24766271,0,0,0,18000
25700,24766099,24766099,24766273,0,0,0,174
25617,24748313,24748313,24766313,0,0,0,18000
25618,24748341,24748341,24766341,0,0,0,18000
25705,24766788,24766788,24766881,0,0,0,93
25677,24761859,24761859,24766957,0,0,0,5098
25659,24759675,24759675,24767542,0,0,0,7867
25633,24750569,24750569,24767908,0,0,0,17339
25684,24764667,24764667,24768267,0,0,0,3600
25635,24750640,24750640,24768347,0,0,0,17707
25670,24761300,24761300,24769189,0,0,0,7889
25612,24747412,24747412,24771407,0,0,0,23995
25631,24750563,24750563,24771485,0,0,0,20922
25707,24770799,24770799,24773306,0,0,0,2507
25637,24753011,24753011,24773827,0,0,0,20816
25638,24753363,24753363,24773900,0,0,0,20537
25714,24775373,24775373,24775466,0,0,0,93
25711,24773366,24773366,24776966,0,0,0,3600
25651,24756837,24756837,24777091,0,0,0,20254
25706,24768325,24768325,24777174,0,0,0,8849
25636,24750764,24750764,24777866,0,0,0,27102
25669,24761197,24761197,24779197,0,0,0,18000
25648,24756276,24756276,24782834,0,0,0,26558
25716,24782778,24782778,24782951,0,0,0,173
25717,24782888,24782888,24783056,0,0,0,168
25718,24782994,24782994,24783163,0,0,0,169
25643,24756125,24756125,24783296,0,0,0,27171
25642,24756095,24756095,24783433,0,0,0,27338
25650,24756367,24756367,24783474,0,0,0,27107
25722,24783394,24783394,24783571,0,0,0,177
25723,24783507,24783507,24783673,0,0,0,166
25640,24755934,24755934,24784722,0,0,0,28788
25619,24748841,24748841,24784841,0,0,0,36000
25621,24749600,24749600,24785600,0,0,0,36000
25622,24749635,24749635,24785635,0,0,0,36000
25623,24749651,24749651,24785651,0,0,0,36000
25649,24756350,24756350,24785769,0,0,0,29419
25727,24785757,24785757,24786023,0,0,0,266
25728,24786381,24786381,24786463,0,0,0,82
25729,24786431,24786431,24786525,0,0,0,94
25730,24786807,24786807,24786962,0,0,0,155
25732,24787309,24787309,24787402,0,0,0,93
25733,24787835,24787835,24787908,0,0,0,73
25571,24698486,24698486,24789238,0,0,0,90752
25696,24765629,24765629,24789591,0,0,0,23962
25734,24788264,24788264,24790149,0,0,0,1885
25736,24790387,24790387,24790480,0,0,0,93
25709,24771446,24771446,24792071,0,0,0,20625
25737,24790541,24790541,24792901,0,0,0,2360
25713,24773853,24773853,24794375,0,0,0,20522
25712,24773763,24773763,24794378,0,0,0,20615
25609,24746201,24746201,24794966,0,0,0,48765
25708,24771354,24771354,24795237,0,0,0,23883
25731,24787131,24787131,24796124,0,0,0,8993
25715,24777028,24777028,24797524,0,0,0,20496
25572,24698628,24698628,24799122,0,0,0,100494
25510,24668147,24668147,24800879,0,0,0,132732
25724,24783617,24783617,24809635,0,0,0,26018
25719,24783101,24783101,24809698,0,0,0,26597
25720,24783235,24783235,24809728,0,0,0,26493
25721,24783387,24783387,24810015,0,0,0,26628
25738,24792010,24792010,24812906,0,0,0,20896
25725,24784659,24784659,24813196,0,0,0,28537
25735,24789591,24789591,24813281,0,0,0,23690
25748,24813128,24813128,24813305,0,0,0,177
25750,24813247,24813247,24813418,0,0,0,171
25739,24794302,24794302,24814635,0,0,0,20333
25726,24785706,24785706,24814895,0,0,0,29189
25740,24794337,24794337,24815188,0,0,0,20851
25742,24797489,24797489,24817848,0,0,0,20359
25741,24795174,24795174,24819196,0,0,0,24022
25757,24823591,24823591,24823695,0,0,0,104
25759,24825143,24825143,24825396,0,0,0,253
25758,24823697,24823697,24825785,0,0,0,2088
25683,24764650,24764650,24826532,0,0,0,61882
25685,24764671,24764671,24826618,0,0,0,61947
25686,24764682,24764682,24826629,0,0,0,61947
25687,24764692,24764692,24826685,0,0,0,61993
25688,24764720,24764720,24826704,0,0,0,61984
25689,24764731,24764731,24826715,0,0,0,61984
25690,24764744,24764744,24826759,0,0,0,62015
25769,24827245,24827245,24827556,0,0,0,311
25770,24827587,24827587,24828285,0,0,0,698
25772,24828175,24828175,24828618,0,0,0,443
25773,24828328,24828328,24828866,0,0,0,538
25775,24828427,24828427,24829019,0,0,0,592
25776,24828491,24828491,24829154,0,0,0,663
25787,24832305,24832305,24832398,0,0,0,93
25747,24812842,24812842,24833616,0,0,0,20774
25752,24814579,24814579,24835120,0,0,0,20541
25743,24809575,24809575,24835563,0,0,0,25988
25754,24815143,24815143,24835892,0,0,0,20749
25744,24809646,24809646,24836214,0,0,0,26568
25746,24809954,24809954,24836315,0,0,0,26361
25794,24836172,24836172,24836345,0,0,0,173
25745,24809666,24809666,24836421,0,0,0,26755
25749,24813230,24813230,24836923,0,0,0,23693
25755,24817789,24817789,24838286,0,0,0,20497
25765,24826677,24826677,24838629,0,0,0,11952
25767,24826736,24826736,24838629,0,0,0,11893
25768,24826759,24826759,24838660,0,0,0,11901
25786,24831470,24831470,24838781,0,0,0,7311
25785,24831059,24831059,24838784,0,0,0,7725
25760,24825239,24825239,24840797,0,0,0,15558
25751,24813358,24813358,24841759,0,0,0,28401
25810,24842736,24842736,24842766,0,0,0,30
25756,24819129,24819129,24843043,0,0,0,23914
25811,24842962,24842962,24843110,0,0,0,148
25807,24840566,24840566,24844456,0,0,0,3890
25753,24814833,24814833,24844607,0,0,0,29774
25816,24844538,24844538,24844612,0,0,0,74
25819,24844626,24844626,24844712,0,0,0,86
25804,24838565,24838565,24846168,0,0,0,7603
25774,24828405,24828405,24846405,0,0,0,18000
25771,24827943,24827943,24846681,0,0,0,18738
25610,24746599,24746599,24847037,0,0,0,100438
25830,24848150,24848150,24848495,0,0,0,345
25832,24848812,24848812,24848886,0,0,0,74
25806,24838587,24838587,24848940,0,0,0,10353
25805,24838579,24838579,24848943,0,0,0,10364
25824,24846106,24846106,24848952,0,0,0,2846
25835,24849035,24849035,24849128,0,0,0,93
25836,24849271,24849271,24849365,0,0,0,94
25837,24849392,24849392,24849702,0,0,0,310
25838,24849674,24849674,24849830,0,0,0,156
25788,24832421,24832421,24850421,0,0,0,18000
25831,24848298,24848298,24850919,0,0,0,2621
25840,24851049,24851049,24851122,0,0,0,73
25827,24846566,24846566,24851550,0,0,0,4984
25839,24850168,24850168,24851640,0,0,0,1472
25841,24851239,24851239,24851870,0,0,0,631
25550,24681257,24681257,24852010,0,0,0,170753
25842,24851884,24851884,24852368,0,0,0,484
25846,24852336,24852336,24852398,0,0,0,62
25843,24851896,24851896,24852399,0,0,0,503
25833,24848827,24848827,24852427,0,0,0,3600
25845,24851918,24851918,24852428,0,0,0,510
25844,24851906,24851906,24852493,0,0,0,587
25789,24833556,24833556,24854466,0,0,0,20910
25790,24835057,24835057,24855511,0,0,0,20454
25828,24847010,24847010,24855665,0,0,0,8655
25859,24855477,24855477,24855942,0,0,0,465
25829,24847045,24847045,24856420,0,0,0,9375
25834,24849025,24849025,24856428,0,0,0,7403
25793,24835825,24835825,24856719,0,0,0,20894
25853,24853134,24853134,24856722,0,0,0,3588
25854,24853564,24853564,24856759,0,0,0,3195
25866,24857456,24857456,24857777,0,0,0,321
25803,24838223,24838223,24858605,0,0,0,20382
25766,24826709,24826709,24858793,0,0,0,32084
25814,24843267,24843267,24858795,0,0,0,15528
25817,24844541,24844541,24858795,0,0,0,14254
25849,24852529,24852529,24858795,0,0,0,6266
25860,24856678,24856678,24858795,0,0,0,2117
25879,24858764,24858764,24858795,0,0,0,31
25862,24856679,24856679,24858796,0,0,0,2117
25864,24856690,24856690,24858796,0,0,0,2106
25825,24846490,24846490,24858797,0,0,0,12307
25857,24855431,24855431,24858797,0,0,0,3366
25781,24829076,24829076,24858798,0,0,0,29722
25871,24858018,24858018,24858798,0,0,0,780
25851,24852576,24852576,24858800,0,0,0,6224
25808,24841695,24841695,24858801,0,0,0,17106
25847,24852513,24852513,24858801,0,0,0,6288
25867,24857720,24857720,24858801,0,0,0,1081
25873,24858032,24858032,24858801,0,0,0,769
25877,24858563,24858563,24858802,0,0,0,239
25777,24829021,24829021,24858803,0,0,0,29782
25791,24835502,24835502,24858803,0,0,0,23301
25799,24836379,24836379,24858803,0,0,0,22424
25820,24844680,24844680,24858803,0,0,0,14123
25822,24845439,24845439,24858803,0,0,0,13364
25869,24857930,24857930,24858803,0,0,0,873
25875,24858067,24858067,24858803,0,0,0,736
25779,24829050,24829050,24858804,0,0,0,29754
25783,24829546,24829546,24858804,0,0,0,29258
25795,24836232,24836232,24858804,0,0,0,22572
25797,24836286,24836286,24858804,0,0,0,22518
25801,24836870,24836870,24858804,0,0,0,21934
25812,24842985,24842985,24858804,0,0,0,15819
25855,24854404,24854404,24858804,0,0,0,4400
25762,24826520,24826520,24858871,0,0,0,32351
25763,24826596,24826596,24858912,0,0,0,32316
25764,24826621,24826621,24858913,0,0,0,32292
25861,24856678,24856678,24859027,0,0,0,2349
25874,24858032,24858032,24859033,0,0,0,1001
25865,24856690,24856690,24859121,0,0,0,2431
25885,24860118,24860118,24860258,0,0,0,140
25667,24761120,24761120,24860987,0,0,0,99867
25802,24836870,24836870,24861074,0,0,0,24204
25815,24843267,24843267,24861267,0,0,0,18000
25868,24857720,24857720,24861610,0,0,0,3890
25792,24835502,24835502,24861749,0,0,0,26247
25887,24861687,24861687,24861977,0,0,0,290
25888,24861906,24861906,24862165,0,0,0,259
25798,24836286,24836286,24862285,0,0,0,25999
25821,24844680,24844680,24862680,0,0,0,18000
25796,24836232,24836232,24862747,0,0,0,26515
25800,24836379,24836379,24862831,0,0,0,26452
25823,24845439,24845439,24863439,0,0,0,18000
25826,24846490,24846490,24864490,0,0,0,18000
25893,24864633,24864633,24864727,0,0,0,94
25678,24762761,24762761,24864872,0,0,0,102111
25663,24760917,24760917,24864935,0,0,0,104018
25894,24864942,24864942,24865006,0,0,0,64
25813,24842985,24842985,24866686,0,0,0,23701
25809,24841695,24841695,24869510,0,0,0,27815
25901,24872065,24872065,24872125,0,0,0,60
25899,24871366,24871366,24872655,0,0,0,1289
25626,24749707,24749707,24873399,0,0,0,123692
25818,24844541,24844541,24873879,0,0,0,29338
25856,24854404,24854404,24875213,0,0,0,20809
25900,24871851,24871851,24875265,0,0,0,3414
25858,24855431,24855431,24875530,0,0,0,20099
25680,24763048,24763048,24876897,0,0,0,113849
25863,24856679,24856679,24877473,0,0,0,20794
25679,24762994,24762994,24877910,0,0,0,114916
25872,24858018,24858018,24878436,0,0,0,20418
25878,24858563,24858563,24878676,0,0,0,20113
25540,24678090,24678090,24882560,0,0,0,204470
25886,24861012,24861012,24884743,0,0,0,23731
25681,24763107,24763107,24884949,0,0,0,121842
25852,24852576,24852576,24887365,0,0,0,34789
25889,24862131,24862131,24888040,0,0,0,25909
25890,24862223,24862223,24888176,0,0,0,25953
25909,24888133,24888133,24888310,0,0,0,177
25682,24763174,24763174,24888439,0,0,0,125265
25908,24887994,24887994,24888689,0,0,0,695
25911,24888648,24888648,24889321,0,0,0,673
25891,24862680,24862680,24889410,0,0,0,26730
25892,24862772,24862772,24889511,0,0,0,26739
25639,24755502,24755502,24889790,0,0,0,134288
25912,24889283,24889283,24889987,0,0,0,704
25897,24866624,24866624,24890371,0,0,0,23747
25848,24852513,24852513,24892580,0,0,0,40067
25850,24852529,24852529,24893329,0,0,0,40800
25624,24749668,24749668,24893668,0,0,0,144000
25625,24749687,24749687,24893687,0,0,0,144000
25627,24749721,24749721,24893721,0,0,0,144000
25903,24875150,24875150,24895644,0,0,0,20494
25904,24875474,24875474,24896026,0,0,0,20552
25702,24766180,24766180,24897280,0,0,0,131100
25896,24865050,24865050,24897556,0,0,0,32506
25905,24877409,24877409,24897942,0,0,0,20533
25898,24869450,24869450,24898667,0,0,0,29217
25920,24898590,24898590,24898770,0,0,0,180
25701,24766102,24766102,24899171,0,0,0,133069
25906,24878615,24878615,24899184,0,0,0,20569
25902,24873825,24873825,24903535,0,0,0,29710
25870,24857930,24857930,24905127,0,0,0,47197
25907,24884678,24884678,24908376,0,0,0,23698
25704,24766241,24766241,24908987,0,0,0,142746
25703,24766210,24766210,24909693,0,0,0,143483
25925,24910026,24910026,24910093,0,0,0,67
25926,24910130,24910130,24910378,0,0,0,248
25927,24910421,24910421,24910494,0,0,0,73
25928,24910459,24910459,24910552,0,0,0,93
25695,24765481,24765481,24911525,0,0,0,146044
25931,24911583,24911583,24911656,0,0,0,73
25930,24911330,24911330,24911899,0,0,0,569
25932,24911960,24911960,24912054,0,0,0,94
25929,24910620,24910620,24912237,0,0,0,1617
25933,24912328,24912328,24912401,0,0,0,73
25934,24912696,24912696,24912770,0,0,0,74
25937,24913279,24913279,24913346,0,0,0,67
25916,24890300,24890300,24914488,0,0,0,24188
25910,24888244,24888244,24914491,0,0,0,26247
25943,24914449,24914449,24914812,0,0,0,363
25913,24889349,24889349,24915942,0,0,0,26593
25914,24889457,24889457,24916046,0,0,0,26589
25918,24895964,24895964,24916122,0,0,0,20158
25915,24889921,24889921,24916503,0,0,0,26582
25917,24895581,24895581,24916508,0,0,0,20927
25950,24916472,24916472,24916604,0,0,0,132
25948,24916421,24916421,24916608,0,0,0,187
25952,24916551,24916551,24916673,0,0,0,122
25951,24916524,24916524,24916677,0,0,0,153
25955,24916677,24916677,24916781,0,0,0,104
25883,24858870,24858870,24916897,0,0,0,58027
25882,24858854,24858854,24916923,0,0,0,58069
25881,24858828,24858828,24916929,0,0,0,58101
25880,24858764,24858764,24916951,0,0,0,58187
25963,24917304,24917304,24917398,0,0,0,94
25940,24914151,24914151,24917581,0,0,0,3430
25876,24858067,24858067,24917855,0,0,0,59788
25884,24859018,24859018,24917929,0,0,0,58911
25966,24918657,24918657,24918905,0,0,0,248
25919,24897889,24897889,24919050,0,0,0,21161
25922,24899122,24899122,24919322,0,0,0,20200
25970,24919347,24919347,24919440,0,0,0,93
25972,24921316,24921316,24921415,0,0,0,99
25973,24921496,24921496,24921589,0,0,0,93
25969,24919290,24919290,24921661,0,0,0,2371
25974,24921659,24921659,24921775,0,0,0,116
25975,24921747,24921747,24921841,0,0,0,94
25976,24921925,24921925,24922018,0,0,0,93
25977,24923079,24923079,24923160,0,0,0,81
25978,24923128,24923128,24923190,0,0,0,62
25979,24923637,24923637,24923700,0,0,0,63
25980,24923751,24923751,24923855,0,0,0,104
25981,24923855,24923855,24923948,0,0,0,93
25985,24927179,24927179,24927290,0,0,0,111
25987,24927296,24927296,24927391,0,0,0,95
25989,24927390,24927390,24927461,0,0,0,71
25698,24766040,24766040,24927463,0,0,0,161423
25990,24927416,24927416,24928406,0,0,0,990
25921,24898699,24898699,24928476,0,0,0,29777
25992,24928443,24928443,24928589,0,0,0,146
25964,24917794,24917794,24928705,0,0,0,10911
25993,24928548,24928548,24928736,0,0,0,188
25965,24917863,24917863,24928774,0,0,0,10911
25959,24916888,24916888,24929100,0,0,0,12212
25956,24916864,24916864,24929214,0,0,0,12350
25958,24916880,24916880,24929260,0,0,0,12380
25957,24916870,24916870,24929261,0,0,0,12391
26002,24929653,24929653,24929746,0,0,0,93
26003,24930224,24930224,24930318,0,0,0,94
26004,24930330,24930330,24930424,0,0,0,94
25991,24927544,24927544,24930621,0,0,0,3077
25935,24912729,24912729,24930729,0,0,0,18000
26005,24930576,24930576,24930878,0,0,0,302
26006,24930777,24930777,24930905,0,0,0,128
25936,24913153,24913153,24931153,0,0,0,18000
26008,24931065,24931065,24931182,0,0,0,117
26010,24931186,24931186,24931292,0,0,0,106
26011,24931269,24931269,24931363,0,0,0,94
26009,24931088,24931088,24931435,0,0,0,347
26013,24931466,24931466,24931581,0,0,0,115
26014,24931542,24931542,24931783,0,0,0,241
26015,24931760,24931760,24931854,0,0,0,94
25924,24908317,24908317,24932121,0,0,0,23804
25923,24903473,24903473,24932247,0,0,0,28774
25941,24914375,24914375,24932375,0,0,0,18000
25939,24913672,24913672,24932515,0,0,0,18843
25971,24919501,24919501,24932519,0,0,0,13018
26017,24932131,24932131,24932830,0,0,0,699
26012,24931395,24931395,24932925,0,0,0,1530
26019,24932943,24932943,24934153,0,0,0,1210
25994,24928653,24928653,24934372,0,0,0,5719
25996,24928709,24928709,24934386,0,0,0,5677
25953,24916570,24916570,24934570,0,0,0,18000
26025,24934428,24934428,24935125,0,0,0,697
26026,24934440,24934440,24935126,0,0,0,686
26027,24934448,24934448,24935154,0,0,0,706
25761,24825754,24825754,24935318,0,0,0,109564
25947,24916061,24916061,24935959,0,0,0,19898
26029,24936371,24936371,24936477,0,0,0,106
25949,24916465,24916465,24936928,0,0,0,20463
26033,24937035,24937035,24937191,0,0,0,156
25538,24678080,24678080,24937280,0,0,0,259200
25543,24678312,24678312,24937512,0,0,0,259200
26022,24934327,24934327,24937861,0,0,0,3534
26023,24934349,24934349,24937923,0,0,0,3574
26020,24934170,24934170,24938016,0,0,0,3846
25942,24914423,24914423,24938112,0,0,0,23689
25546,24678962,24678962,24938162,0,0,0,259200
25968,24919277,24919277,24939118,0,0,0,19841
25967,24918989,24918989,24939444,0,0,0,20455
26040,24939496,24939496,24939526,0,0,0,30
26034,24937826,24937826,24939894,0,0,0,2068
26035,24937861,24937861,24939928,0,0,0,2067
26024,24934388,24934388,24940651,0,0,0,6263
26043,24939865,24939865,24940833,0,0,0,968
26042,24939846,24939846,24940858,0,0,0,1012
25944,24914774,24914774,24941214,0,0,0,26440
26046,24941153,24941153,24941326,0,0,0,173
26050,24941712,24941712,24941788,0,0,0,76
26051,24941725,24941725,24941867,0,0,0,142
25945,24915879,24915879,24942250,0,0,0,26371
25946,24916000,24916000,24942798,0,0,0,26798
25954,24916632,24916632,24942900,0,0,0,26268
26057,24942856,24942856,24943039,0,0,0,183
26041,24939649,24939649,24943064,0,0,0,3415
26021,24934303,24934303,24943625,0,0,0,9322
26055,24942416,24942416,24946025,0,0,0,3609
25938,24913522,24913522,24946117,0,0,0,32595
25998,24929104,24929104,24947104,0,0,0,18000
25960,24917011,24917011,24947593,0,0,0,30582
25961,24917103,24917103,24947669,0,0,0,30566
25962,24917162,24917162,24947671,0,0,0,30509
26030,24936463,24936463,24947978,0,0,0,11515
25982,24926667,24926667,24948009,0,0,0,21342
25895,24864976,24864976,24948011,0,0,0,83035
25986,24927269,24927269,24948011,0,0,0,20742
25699,24766073,24766073,24948012,0,0,0,181939
25983,24927029,24927029,24948012,0,0,0,20983
25984,24927178,24927178,24948012,0,0,0,20834
25988,24927364,24927364,24948012,0,0,0,20648
26036,24938037,24938037,24948012,0,0,0,9975
26052,24942159,24942159,24948012,0,0,0,5853
26060,24946614,24946614,24948032,0,0,0,1418
26054,24942214,24942214,24948099,0,0,0,5885
26016,24932059,24932059,24956097,0,0,0,24038
26028,24935897,24935897,24956128,0,0,0,20231
25995,24928666,24928666,24957065,0,0,0,28399
26032,24936883,24936883,24957101,0,0,0,20218
26076,24957543,24957543,24957792,0,0,0,249
26038,24939055,24939055,24959286,0,0,0,20231
26048,24941400,24941400,24959400,0,0,0,18000
26049,24941438,24941438,24959438,0,0,0,18000
25784,24829546,24829546,24959445,0,0,0,129899
26039,24939399,24939399,24959627,0,0,0,20228
26007,24930795,24930795,24961252,0,0,0,30457
26037,24938069,24938069,24961718,0,0,0,23649
26018,24932184,24932184,24962071,0,0,0,29887
26081,24962007,24962007,24962182,0,0,0,175
26084,24962823,24962823,24962916,0,0,0,93
25778,24829021,24829021,24965980,0,0,0,136959
26083,24962722,24962722,24966290,0,0,0,3568
25782,24829076,24829076,24966486,0,0,0,137410
26047,24941264,24941264,24967605,0,0,0,26341
26087,24967541,24967541,24967708,0,0,0,167
26053,24942177,24942177,24968869,0,0,0,26692
26059,24942968,24942968,24969257,0,0,0,26289
26090,24969203,24969203,24969375,0,0,0,172
26056,24942735,24942735,24969456,0,0,0,26721
26091,24969312,24969312,24969489,0,0,0,177
26093,24969420,24969420,24969590,0,0,0,170
26094,24969535,24969535,24969701,0,0,0,166
25780,24829050,24829050,24969794,0,0,0,140744
26031,24936583,24936583,24973801,0,0,0,37218
26073,24956065,24956065,24976684,0,0,0,20619
26075,24957040,24957040,24977696,0,0,0,20656
26077,24957897,24957897,24979566,0,0,0,21669
26072,24956036,24956036,24979824,0,0,0,23788
26078,24959226,24959226,24979824,0,0,0,20598
26079,24959566,24959566,24980214,0,0,0,20648
26080,24961657,24961657,24985460,0,0,0,23803
26074,24956990,24956990,24985943,0,0,0,28953
26063,24947608,24947608,24988634,0,0,0,41026
26082,24962121,24962121,24991418,0,0,0,29297
26061,24947539,24947539,24991634,0,0,0,44095
26088,24967647,24967647,24993837,0,0,0,26190
26089,24968827,24968827,24995856,0,0,0,27029
26095,24969654,24969654,24995904,0,0,0,26250
26092,24969384,24969384,24995939,0,0,0,26555
26062,24947592,24947592,24996095,0,0,0,48503
26096,24976623,24976623,24996650,0,0,0,20027
25710,24772998,24772998,24997470,0,0,0,224472
26097,24977633,24977633,24998640,0,0,0,21007
26098,24979783,24979783,24999876,0,0,0,20093
26114,24999752,24999752,25000997,0,0,0,1245
26118,25000567,25000567,25001033,0,0,0,466
26100,24980152,24980152,25001168,0,0,0,21016
26001,24929213,24929213,25002842,0,0,0,73629
26044,24940785,24940785,25002930,0,0,0,62145
26045,24940796,24940796,25002930,0,0,0,62134
26099,24979784,24979784,25003477,0,0,0,23693
26000,24929208,24929208,25003575,0,0,0,74367
25999,24929147,24929147,25003576,0,0,0,74429
25997,24929067,24929067,25003580,0,0,0,74513
26122,25003837,25003837,25003905,0,0,0,68
26124,25004404,25004404,25004472,0,0,0,68
26125,25004526,25004526,25004594,0,0,0,68
26126,25004607,25004607,25004737,0,0,0,130
26127,25004647,25004647,25004737,0,0,0,90
26128,25004680,25004680,25004769,0,0,0,89
26129,25004688,25004688,25004777,0,0,0,89
26130,25004734,25004734,25004826,0,0,0,92
26131,25004834,25004834,25004927,0,0,0,93
26132,25005033,25005033,25005126,0,0,0,93
26133,25005297,25005297,25005390,0,0,0,93
26134,25005637,25005637,25005741,0,0,0,104
26136,25006459,25006459,25006568,0,0,0,109
26137,25006537,25006537,25006630,0,0,0,93
26138,25006655,25006655,25006749,0,0,0,94
26123,25004216,25004216,25007457,0,0,0,3241
26186,25008811,25008811,25008904,0,0,0,93
26187,25009070,25009070,25009219,0,0,0,149
26188,25009189,25009189,25009283,0,0,0,94
26120,25002284,25002284,25009345,0,0,0,7061
26101,24985388,24985388,25009462,0,0,0,24074
26190,25009413,25009413,25009590,0,0,0,177
26184,25007650,25007650,25009619,0,0,0,1969
26192,25009433,25009433,25009723,0,0,0,290
26194,25010813,25010813,25010912,0,0,0,99
26191,25009414,25009414,25011032,0,0,0,1618
26195,25011034,25011034,25011113,0,0,0,79
26196,25011351,25011351,25011443,0,0,0,92
26197,25011357,25011357,25012150,0,0,0,793
26198,25011381,25011381,25012186,0,0,0,805
26203,25013037,25013037,25013136,0,0,0,99
26199,25011622,25011622,25013784,0,0,0,2162
26205,25013875,25013875,25013942,0,0,0,67
26102,24985881,24985881,25015251,0,0,0,29370
26207,25015188,25015188,25015357,0,0,0,169
26111,24997366,24997366,25015366,0,0,0,18000
26112,24997432,24997432,25015432,0,0,0,18000
26208,25015295,25015295,25015468,0,0,0,173
26209,25015404,25015404,25015565,0,0,0,161
26210,25015517,25015517,25015699,0,0,0,182
26211,25015626,25015626,25015705,0,0,0,79
26213,25015741,25015741,25015834,0,0,0,93
26201,25012691,25012691,25016116,0,0,0,3425
26214,25016181,25016181,25016260,0,0,0,79
26217,25016314,25016314,25016407,0,0,0,93
26216,25016290,25016290,25016438,0,0,0,148
26215,25016234,25016234,25016496,0,0,0,262
26218,25016579,25016579,25016964,0,0,0,385
26109,24996579,24996579,25017014,0,0,0,20435
26220,25016770,25016770,25017222,0,0,0,452
26223,25017439,25017439,25017905,0,0,0,466
26224,25018111,25018111,25018258,0,0,0,147
26225,25018512,25018512,25018729,0,0,0,217
26113,24998596,24998596,25019005,0,0,0,20409
26227,25019169,25019169,25019564,0,0,0,395
26228,25019522,25019522,25019575,0,0,0,53
26230,25019574,25019574,25019641,0,0,0,67
26229,25019534,25019534,25019693,0,0,0,159
26231,25019695,25019695,25019830,0,0,0,135
26185,25008480,25008480,25019924,0,0,0,11444
26104,24993776,24993776,25020002,0,0,0,26226
26233,25019938,25019938,25020128,0,0,0,190
26115,24999813,24999813,25020357,0,0,0,20544
26239,25020539,25020539,25021165,0,0,0,626
26103,24991373,24991373,25021265,0,0,0,29892
26244,25020911,25020911,25021361,0,0,0,450
26232,25019815,25019815,25021387,0,0,0,1572
26241,25020832,25020832,25021425,0,0,0,593
26240,25020825,25020825,25021429,0,0,0,604
26243,25020845,25020845,25021449,0,0,0,604
26119,25001126,25001126,25021546,0,0,0,20420
26234,25020032,25020032,25021556,0,0,0,1524
26235,25020044,25020044,25021608,0,0,0,1564
26236,25020056,25020056,25021608,0,0,0,1552
26248,25021521,25021521,25021641,0,0,0,120
26107,24995862,24995862,25022057,0,0,0,26195
26206,25014745,25014745,25022211,0,0,0,7466
26249,25022019,25022019,25022213,0,0,0,194
26246,25021498,25021498,25022394,0,0,0,896
26254,25022293,25022293,25022419,0,0,0,126
26106,24995822,24995822,25022422,0,0,0,26600
26108,24995868,24995868,25022554,0,0,0,26686
26257,25022375,25022375,25022820,0,0,0,445
26263,25022651,25022651,25023104,0,0,0,453
26268,25023706,25023706,25023830,0,0,0,124
26266,25023657,25023657,25024124,0,0,0,467
26270,25024150,25024150,25024223,0,0,0,73
26271,25025531,25025531,25025624,0,0,0,93
26193,25009629,25009629,25025710,0,0,0,16081
26273,25025906,25025906,25025999,0,0,0,93
26272,25025833,25025833,25026298,0,0,0,465
26275,25026920,25026920,25027038,0,0,0,118
26121,25003425,25003425,25027068,0,0,0,23643
26276,25026995,25026995,25027099,0,0,0,104
26242,25020844,25020844,25027231,0,0,0,6387
26200,25011649,25011649,25027944,0,0,0,16295
26279,25028092,25028092,25028196,0,0,0,104
26280,25028159,25028159,25028287,0,0,0,128
26281,25028262,25028262,25028387,0,0,0,125
26282,25028574,25028574,25028715,0,0,0,141
26283,25028693,25028693,25028798,0,0,0,105
26284,25028761,25028761,25028854,0,0,0,93
26285,25028915,25028915,25029042,0,0,0,127
26287,25029010,25029010,25029135,0,0,0,125
26288,25029138,25029138,25029262,0,0,0,124
26289,25029281,25029281,25029406,0,0,0,125
26290,25029526,25029526,25029599,0,0,0,73
26291,25029600,25029600,25029704,0,0,0,104
26135,25006281,25006281,25030729,0,0,0,24448
26293,25032613,25032613,25032687,0,0,0,74
26294,25032615,25032615,25032689,0,0,0,74
26286,25028916,25028916,25033057,0,0,0,4141
26189,25009379,25009379,25033169,0,0,0,23790
26221,25016964,25016964,25037354,0,0,0,20390
26219,25016653,25016653,25038317,0,0,0,21664
26226,25018944,25018944,25039778,0,0,0,20834
26238,25020289,25020289,25040748,0,0,0,20459
26301,25039567,25039567,25041204,0,0,0,1637
26222,25017035,25017035,25041362,0,0,0,24327
26274,25026019,25026019,25042138,0,0,0,16119
26247,25021514,25021514,25042344,0,0,0,20830
26292,25030507,25030507,25042402,0,0,0,11895
26278,25027200,25027200,25043347,0,0,0,16147
26212,25015632,25015632,25044456,0,0,0,28824
26308,25044410,25044410,25044564,0,0,0,154
26116,25000504,25000504,25044702,0,0,0,44198
26309,25044527,25044527,25044704,0,0,0,177
26237,25020058,25020058,25046258,0,0,0,26200
26250,25022140,25022140,25048388,0,0,0,26248
26256,25022371,25022371,25049086,0,0,0,26715
26261,25022518,25022518,25049157,0,0,0,26639
26117,25000548,25000548,25050020,0,0,0,49472
26311,25046201,25046201,25050464,0,0,0,4263
26245,25021205,25021205,25050679,0,0,0,29474
26319,25050616,25050616,25050789,0,0,0,173
26320,25050726,25050726,25050908,0,0,0,182
26277,25027000,25027000,25050933,0,0,0,23933
26163,25007124,25007124,25053734,0,0,0,46610
26152,25007119,25007119,25053960,0,0,0,46841
26169,25007126,25007126,25054139,0,0,0,47013
26147,25007118,25007118,25054207,0,0,0,47089
26165,25007125,25007125,25054231,0,0,0,47106
26153,25007119,25007119,25054239,0,0,0,47120
26166,25007125,25007125,25054418,0,0,0,47293
26173,25007127,25007127,25054451,0,0,0,47324
26157,25007120,25007120,25054458,0,0,0,47338
26158,25007120,25007120,25054520,0,0,0,47400
26159,25007120,25007120,25054582,0,0,0,47462
26167,25007125,25007125,25054604,0,0,0,47479
26154,25007119,25007119,25054612,0,0,0,47493
26164,25007124,25007124,25054634,0,0,0,47510
26155,25007119,25007119,25054674,0,0,0,47555
26160,25007120,25007120,25054706,0,0,0,47586
26161,25007120,25007120,25054737,0,0,0,47617
26148,25007118,25007118,25054766,0,0,0,47648
26168,25007125,25007125,25054790,0,0,0,47665
26142,25007117,25007117,25054796,0,0,0,47679
26143,25007117,25007117,25054951,0,0,0,47834
26144,25007117,25007117,25054982,0,0,0,47865
26149,25007118,25007118,25055045,0,0,0,47927
26162,25007120,25007120,25055109,0,0,0,47989
26139,25007116,25007116,25055136,0,0,0,48020
26170,25007126,25007126,25055163,0,0,0,48037
26174,25007127,25007127,25055164,0,0,0,48037
26140,25007116,25007116,25055229,0,0,0,48113
26150,25007118,25007118,25055231,0,0,0,48113
26145,25007117,25007117,25055427,0,0,0,48310
26317,25050419,25050419,25055589,0,0,0,5170
26171,25007126,25007126,25055663,0,0,0,48537
26323,25055530,25055530,25055698,0,0,0,168
26141,25007116,25007116,25055760,0,0,0,48644
26146,25007117,25007117,25056040,0,0,0,48923
26151,25007118,25007118,25056258,0,0,0,49140
26172,25007126,25007126,25056593,0,0,0,49467
26298,25033114,25033114,25056782,0,0,0,23668
26300,25037295,25037295,25057486,0,0,0,20191
26305,25042091,25042091,25057864,0,0,0,15773
26304,25041847,25041847,25057942,0,0,0,16095
26307,25043288,25043288,25059343,0,0,0,16055
26302,25039714,25039714,25060530,0,0,0,20816
26303,25040691,25040691,25060931,0,0,0,20240
26306,25042282,25042282,25063108,0,0,0,20826
26312,25047760,25047760,25063597,0,0,0,15837
26058,24942866,24942866,25070751,0,0,0,127885
26327,25057826,25057826,25073781,0,0,0,15955
26310,25044635,25044635,25073894,0,0,0,29259
26328,25057875,25057875,25073929,0,0,0,16054
26334,25073829,25073829,25074007,0,0,0,178
26322,25050871,25050871,25074077,0,0,0,23206
26336,25073938,25073938,25074108,0,0,0,170
26313,25048323,25048323,25074557,0,0,0,26234
26339,25074493,25074493,25074752,0,0,0,259
26340,25074693,25074693,25074964,0,0,0,271
26329,25059279,25059279,25075137,0,0,0,15858
26341,25074903,25074903,25075170,0,0,0,267
26315,25049098,25049098,25075748,0,0,0,26650
26314,25049024,25049024,25075884,0,0,0,26860
26251,25022193,25022193,25076193,0,0,0,54000
26252,25022214,25022214,25076214,0,0,0,54000
26253,25022243,25022243,25076243,0,0,0,54000
26255,25022296,25022296,25076296,0,0,0,54000
26326,25057442,25057442,25077758,0,0,0,20316
26325,25056719,25056719,25080385,0,0,0,23666
26321,25050835,25050835,25080665,0,0,0,29830
26330,25060468,25060468,25081046,0,0,0,20578
26331,25060869,25060869,25081187,0,0,0,20318
26324,25055640,25055640,25082278,0,0,0,26638
26332,25063045,25063045,25083656,0,0,0,20611
26316,25050384,25050384,25085496,0,0,0,35112
26318,25050424,25050424,25085926,0,0,0,35502
26355,25087708,25087708,25087769,0,0,0,61
26356,25087742,25087742,25087779,0,0,0,37
26357,25087990,25087990,25088037,0,0,0,47
26358,25088280,25088280,25088317,0,0,0,37
26333,25073735,25073735,25089668,0,0,0,15933
26335,25073871,25073871,25089703,0,0,0,15832
26299,25034997,25034997,25090302,0,0,0,55305
26361,25090146,25090146,25090674,0,0,0,528
26342,25075084,25075084,25091153,0,0,0,16069
26297,25033090,25033090,25092227,0,0,0,59137
26156,25007119,25007119,25093519,0,0,0,86400
26175,25007127,25007127,25093527,0,0,0,86400
26176,25007127,25007127,25093527,0,0,0,86400
26177,25007128,25007128,25093528,0,0,0,86400
26178,25007128,25007128,25093528,0,0,0,86400
26179,25007128,25007128,25093528,0,0,0,86400
26180,25007128,25007128,25093528,0,0,0,86400
26181,25007129,25007129,25093529,0,0,0,86400
26182,25007129,25007129,25093529,0,0,0,86400
26183,25007129,25007129,25093529,0,0,0,86400
26337,25074027,25074027,25096274,0,0,0,22247
26366,25097033,25097033,25097151,0,0,0,118
26367,25097102,25097102,25097208,0,0,0,106
26368,25097126,25097126,25097243,0,0,0,117
26346,25077697,25077697,25097973,0,0,0,20276
26202,25012772,25012772,25099172,0,0,0,86400
26204,25013660,25013660,25100060,0,0,0,86400
26343,25075107,25075107,25101334,0,0,0,26227
26350,25081125,25081125,25101417,0,0,0,20292
26371,25101271,25101271,25101449,0,0,0,178
26373,25101381,25101381,25101551,0,0,0,170
26374,25101494,25101494,25101684,0,0,0,190
26349,25080976,25080976,25101705,0,0,0,20729
26375,25101611,25101611,25101789,0,0,0,178
26377,25101719,25101719,25101892,0,0,0,173
26345,25075837,25075837,25102632,0,0,0,26795
26344,25075685,25075685,25102771,0,0,0,27086
26338,25074052,25074052,25102999,0,0,0,28947
26353,25085517,25085517,25103517,0,0,0,18000
26354,25085691,25085691,25103691,0,0,0,18000
26347,25080319,25080319,25104245,0,0,0,23926
26352,25083593,25083593,25104292,0,0,0,20699
26360,25089633,25089633,25105627,0,0,0,15994
26359,25089630,25089630,25105747,0,0,0,16117
26105,24995400,24995400,25106202,0,0,0,110802
26370,25100878,25100878,25106555,0,0,0,5677
26364,25093361,25093361,25106675,0,0,0,13314
26362,25091086,25091086,25107057,0,0,0,15971
26363,25093318,25093318,25108091,0,0,0,14773
26351,25082234,25082234,25108416,0,0,0,26182
26348,25080603,25080603,25110394,0,0,0,29791
26085,24962954,24962954,25113500,0,0,0,150546
26086,24966305,24966305,25113507,0,0,0,147202
26265,25022881,25022881,25114718,0,0,0,91837
26264,25022866,25022866,25116648,0,0,0,93782
26369,25097930,25097930,25118029,0,0,0,20099
26365,25096202,25096202,25119105,0,0,0,22903
26372,25101372,25101372,25121470,0,0,0,20098
26384,25105568,25105568,25121609,0,0,0,16041
26385,25105686,25105686,25121867,0,0,0,16181
26376,25101650,25101650,25122375,0,0,0,20725
26296,25032655,25032655,25122742,0,0,0,90087
26295,25032654,25032654,25123098,0,0,0,90444
26386,25107015,25107015,25123135,0,0,0,16120
26390,25113503,25113503,25124654,0,0,0,11151
26383,25104250,25104250,25125000,0,0,0,20750
26382,25104181,25104181,25127353,0,0,0,23172
26378,25101837,25101837,25128199,0,0,0,26362
26379,25102590,25102590,25128796,0,0,0,26206
26380,25102707,25102707,25129200,0,0,0,26493
26258,25022383,25022383,25130383,0,0,0,108000
26259,25022448,25022448,25130448,0,0,0,108000
26260,25022514,25022514,25130514,0,0,0,108000
26262,25022582,25022582,25130582,0,0,0,108000
26381,25102954,25102954,25132086,0,0,0,29132
26405,25132131,25132131,25132415,0,0,0,284
26387,25108346,25108346,25134995,0,0,0,26649
26406,25134936,25134936,25135110,0,0,0,174
26394,25121553,25121553,25137743,0,0,0,16190
26395,25121806,25121806,25138070,0,0,0,16264
26391,25117968,25117968,25138429,0,0,0,20461
26397,25123078,25123078,25139288,0,0,0,16210
26388,25110347,25110347,25140043,0,0,0,29696
26413,25139985,25139985,25140152,0,0,0,167
26414,25140090,25140090,25140260,0,0,0,170
26415,25140198,25140198,25140368,0,0,0,170
26416,25140305,25140305,25140474,0,0,0,169
26417,25140412,25140412,25140581,0,0,0,169
26393,25121408,25121408,25141705,0,0,0,20297
26396,25122316,25122316,25142747,0,0,0,20431
26392,25119045,25119045,25143250,0,0,0,24205
26398,25124940,25124940,25145464,0,0,0,20524
26389,25113366,25113366,25146737,0,0,0,33371
26399,25127297,25127297,25149534,0,0,0,22237
26408,25137674,25137674,25153927,0,0,0,16253
26409,25137997,25137997,25154262,0,0,0,16265
26401,25128137,25128137,25154870,0,0,0,26733
26411,25139225,25139225,25155440,0,0,0,16215
26403,25129139,25129139,25155729,0,0,0,26590
26402,25128731,25128731,25155827,0,0,0,27096
26410,25138359,25138359,25158751,0,0,0,20392
26407,25135055,25135055,25161546,0,0,0,26491
26431,25161483,25161483,25161655,0,0,0,172
26404,25132027,25132027,25161800,0,0,0,29773
26419,25141642,25141642,25162037,0,0,0,20395
26420,25142684,25142684,25163649,0,0,0,20965
26412,25139849,25139849,25165284,0,0,0,25435
26422,25145409,25145409,25166076,0,0,0,20667
26421,25143195,25143195,25166867,0,0,0,23672
26110,24996766,24996766,25169566,0,0,0,172800
26418,25140519,25140519,25170082,0,0,0,29563
26424,25153869,25153869,25170161,0,0,0,16292
26425,25154217,25154217,25170532,0,0,0,16315
26427,25155373,25155373,25171601,0,0,0,16228
26423,25149473,25149473,25172434,0,0,0,22961
26430,25158696,25158696,25178981,0,0,0,20285
26426,25154808,25154808,25180812,0,0,0,26004
26445,25180741,25180741,25180908,0,0,0,167
26446,25180854,25180854,25181024,0,0,0,170
26447,25180962,25180962,25181131,0,0,0,169
26448,25181069,25181069,25181267,0,0,0,198
26449,25181177,25181177,25181346,0,0,0,169
26450,25181284,25181284,25181453,0,0,0,169
26451,25181391,25181391,25181560,0,0,0,169
26452,25181498,25181498,25181668,0,0,0,170
26428,25155661,25155661,25182138,0,0,0,26477
26434,25161979,25161979,25182202,0,0,0,20223
26429,25155763,25155763,25182224,0,0,0,26461
26435,25163581,25163581,25184342,0,0,0,20761
26439,25170019,25170019,25185498,0,0,0,15479
26458,25185431,25185431,25185603,0,0,0,172
26440,25170102,25170102,25186364,0,0,0,16262
26436,25166015,25166015,25186709,0,0,0,20694
26441,25170493,25170493,25186808,0,0,0,16315
26432,25161592,25161592,25187382,0,0,0,25790
26442,25171561,25171561,25187897,0,0,0,16336
26437,25166809,25166809,25190780,0,0,0,23971
26433,25161737,25161737,25191070,0,0,0,29333
26443,25172367,25172367,25196544,0,0,0,24177
26444,25178910,25178910,25199610,0,0,0,20700
26460,25186317,25186317,25202670,0,0,0,16353
26455,25182159,25182159,25202867,0,0,0,20708
26462,25186750,25186750,25203063,0,0,0,16313
26464,25187837,25187837,25204170,0,0,0,16333
26472,25204089,25204089,25204217,0,0,0,128
26457,25184280,25184280,25204950,0,0,0,20670
26461,25186664,25186664,25207326,0,0,0,20662
26453,25181605,25181605,25207898,0,0,0,26293
26476,25207834,25207834,25208005,0,0,0,171
26454,25182082,25182082,25208587,0,0,0,26505
26456,25182160,25182160,25208940,0,0,0,26780
26064,24950956,24950956,25210156,0,0,0,259200
26065,24952529,24952529,25211729,0,0,0,259200
26066,24952578,24952578,25211778,0,0,0,259200
26067,24952931,24952931,25212131,0,0,0,259200
26068,24952964,24952964,25212164,0,0,0,259200
26069,24953028,24953028,25212228,0,0,0,259200
26070,24953330,24953330,25212530,0,0,0,259200
26071,24953794,24953794,25212994,0,0,0,259200
26463,25187336,25187336,25213829,0,0,0,26493
26400,25127440,25127440,25213840,0,0,0,86400
26480,25213788,25213788,25213928,0,0,0,140
26465,25190718,25190718,25214634,0,0,0,23916
26481,25214390,25214390,25214687,0,0,0,297
26483,25214552,25214552,25214692,0,0,0,140
26482,25214471,25214471,25214782,0,0,0,311
26484,25214586,25214586,25214866,0,0,0,280
26485,25214785,25214785,25215080,0,0,0,295
26459,25185545,25185545,25215831,0,0,0,30286
26486,25215768,25215768,25215908,0,0,0,140
26267,25023687,25023687,25218087,0,0,0,194400
26269,25023960,25023960,25218360,0,0,0,194400
26469,25202611,25202611,25218954,0,0,0,16343
26487,25218910,25218910,25219038,0,0,0,128
26471,25202993,25202993,25219225,0,0,0,16232
26488,25219171,25219171,25219299,0,0,0,128
26467,25196486,25196486,25220148,0,0,0,23662
26489,25220086,25220086,25220226,0,0,0,140
26468,25199549,25199549,25220252,0,0,0,20703
26490,25220197,25220197,25220337,0,0,0,140
26473,25204124,25204124,25220483,0,0,0,16359
26491,25220425,25220425,25220553,0,0,0,128
26466,25191023,25191023,25220772,0,0,0,29749
26492,25220712,25220712,25220852,0,0,0,140
26470,25202788,25202788,25223484,0,0,0,20696
26493,25223421,25223421,25223561,0,0,0,140
26474,25204889,25204889,25225992,0,0,0,21103
26494,25225930,25225930,25226070,0,0,0,140
26475,25207265,25207265,25228355,0,0,0,21090
26495,25228288,25228288,25228428,0,0,0,140
26438,25167044,25167044,25231844,0,0,0,64800
26477,25207945,25207945,25234074,0,0,0,26129
26496,25234011,25234011,25234151,0,0,0,140
26478,25208518,25208518,25234793,0,0,0,26275
26497,25234738,25234738,25234890,0,0,0,152
26479,25208888,25208888,25235372,0,0,0,26484
26498,25235309,25235309,25235449,0,0,0,140
26499,25427821,25427821,25428074,0,0,0,253
26501,25432982,25432982,25433018,0,0,0,36
26500,25432936,25432936,25433084,0,0,0,148
26502,25433530,25433530,25433624,0,0,0,94
26503,25433690,25433690,25433768,0,0,0,78
26504,25433731,25433731,25433981,0,0,0,250
26505,25433736,25433768,25433997,0,0,32,261
26506,25442000,25442000,25442106,0,0,0,106
26507,25442074,25442074,25442329,0,0,0,255
26508,25442330,25442330,25442425,0,0,0,95
26510,25442450,25442450,25442576,0,0,0,126
26509,25442445,25442445,25442664,0,0,0,219
26511,25443118,25443118,25443192,0,0,0,74
26512,25443364,25443364,25443459,0,0,0,95
26513,25443508,25443508,25443743,0,0,0,235
26514,25443796,25443796,25443891,0,0,0,95
26515,25444048,25444048,25444143,0,0,0,95
26516,25444297,25444297,25444392,0,0,0,95
26517,25444946,25444946,25445072,0,0,0,126
26518,25445836,25445836,25446436,0,0,0,600
26519,25455524,25455524,25455713,0,0,0,189
26520,25455541,25455541,25455759,0,0,0,218
26521,25456008,25456008,25456232,0,0,0,224
26522,25456378,25456378,25456602,0,0,0,224
26528,25456819,25456819,25456895,0,0,0,76
26525,25456737,25456737,25456919,0,0,0,182
26524,25456563,25456563,25456993,0,0,0,430
26523,25456398,25456398,25457139,0,0,0,741
26531,25457264,25457264,25457338,0,0,0,74
26532,25457316,25457316,25457400,0,0,0,84
26529,25456874,25456874,25457529,0,0,0,655
26533,25457395,25457395,25457621,0,0,0,226
26537,25457635,25457635,25457727,0,0,0,92
26538,25457796,25457796,25457899,0,0,0,103
26539,25457833,25457833,25457905,0,0,0,72
26541,25458015,25458015,25458099,0,0,0,84
26542,25458131,25458131,25458222,0,0,0,91
26543,25458188,25458188,25458307,0,0,0,119
26544,25458203,25458203,25458310,0,0,0,107
26546,25458291,25458291,25458387,0,0,0,96
26526,25456778,25456778,25458411,0,0,0,1633
26547,25458401,25458401,25458493,0,0,0,92
26545,25458287,25458287,25458542,0,0,0,255
26549,25458534,25458534,25458597,0,0,0,63
26551,25458843,25458843,25458907,0,0,0,64
26550,25458745,25458745,25458932,0,0,0,187
26552,25458861,25458861,25458983,0,0,0,122
26548,25458434,25458434,25459073,0,0,0,639
26553,25458965,25458965,25459113,0,0,0,148
26565,25459197,25459197,25459302,0,0,0,105
26566,25459258,25459258,25459348,0,0,0,90
26567,25459335,25459335,25459403,0,0,0,68
26568,25459440,25459440,25459514,0,0,0,74
26556,25459119,25459119,25459547,0,0,0,428
26569,25459598,25459598,25459666,0,0,0,68
26570,25459608,25459608,25459676,0,0,0,68
26572,25459704,25459704,25460424,0,0,0,720
26579,25460411,25460411,25460526,0,0,0,115
26534,25457491,25457491,25460927,0,0,0,3436
26577,25460286,25460286,25461003,0,0,0,717
26571,25459654,25459654,25461137,0,0,0,1483
26580,25460691,25460691,25461242,0,0,0,551
26586,25460945,25460945,25461360,0,0,0,415
26578,25460304,25460304,25461781,0,0,0,1477
26559,25459179,25459179,25461941,0,0,0,2762
26593,25462698,25462698,25462771,0,0,0,73
26540,25457868,25457868,25463167,0,0,0,5299
26536,25457623,25457623,25464739,0,0,0,7116
26595,25464780,25464780,25465469,0,0,0,689
26594,25463253,25463253,25465516,0,0,0,2263
26587,25461479,25461479,25465621,0,0,0,4142
26555,25459111,25459111,25465779,0,0,0,6668
26601,25466679,25466679,25466752,0,0,0,73
26602,25466802,25466802,25467129,0,0,0,327
26604,25467233,25467233,25467565,0,0,0,332
26603,25467218,25467218,25467614,0,0,0,396
26589,25461848,25461848,25468267,0,0,0,6419
26581,25460691,25460691,25468670,0,0,0,7979
26596,25465684,25465684,25468715,0,0,0,3031
26597,25465797,25465797,25470394,0,0,0,4597
26599,25466108,25466108,25472246,0,0,0,6138
26588,25461774,25461774,25475058,0,0,0,13284
26609,25473729,25473729,25475158,0,0,0,1429
26611,25476968,25476968,25477084,0,0,0,116
26612,25477048,25477048,25477121,0,0,0,73
26613,25477161,25477161,25477234,0,0,0,73
26614,25477325,25477325,25477696,0,0,0,371
26615,25477328,25477328,25477761,0,0,0,433
26590,25461873,25461873,25481681,0,0,0,19808
26610,25473924,25473924,25481792,0,0,0,7868
26605,25468802,25468802,25486164,0,0,0,17362
26608,25473118,25473118,25487052,0,0,0,13934
26616,25477549,25477549,25491000,0,0,0,13451
26618,25496801,25496801,25496885,0,0,0,84
26617,25496790,25496790,25496886,0,0,0,96
26592,25462122,25462122,25500277,0,0,0,38155
26621,25497133,25497133,25504343,0,0,0,7210
26606,25470449,25470449,25504579,0,0,0,34130
26598,25465890,25465890,25505969,0,0,0,40079
26574,25459889,25459889,25507762,0,0,0,47873
26530,25457156,25457156,25510492,0,0,0,53336
26619,25496890,25496890,25510640,0,0,0,13750
26622,25510691,25510691,25511429,0,0,0,738
26624,25511348,25511348,25511865,0,0,0,517
26625,25511619,25511619,25512095,0,0,0,476
26627,25512229,25512229,25512358,0,0,0,129
26629,25512347,25512347,25512540,0,0,0,193
26626,25512169,25512169,25512609,0,0,0,440
26628,25512319,25512319,25512852,0,0,0,533
26632,25512835,25512835,25512910,0,0,0,75
26630,25512561,25512561,25512915,0,0,0,354
26633,25512888,25512888,25513031,0,0,0,143
26631,25512632,25512632,25513117,0,0,0,485
26634,25512995,25512995,25513204,0,0,0,209
26636,25513229,25513229,25513429,0,0,0,200
26635,25513014,25513014,25513744,0,0,0,730
26637,25513676,25513676,25513915,0,0,0,239
26639,25513894,25513915,25513988,0,0,21,94
26638,25513893,25513893,25514131,0,0,0,238
26642,25514110,25514110,25514179,0,0,0,69
26643,25514495,25514495,25514614,0,0,0,119
26644,25515235,25515235,25515320,0,0,0,85
26647,25517523,25517523,25517583,0,0,0,60
26650,25517812,25517812,25517872,0,0,0,60
26641,25514098,25514098,25517918,0,0,0,3820
26651,25518416,25518416,25518441,0,0,0,25
26648,25517652,25517652,25518880,0,0,0,1228
26649,25517715,25517715,25518901,0,0,0,1186
26654,25519321,25519321,25519351,0,0,0,30
26655,25519474,25519474,25519504,0,0,0,30
26656,25519882,25519882,25519904,0,0,0,22
26659,25520359,25520359,25520364,0,0,0,5
26657,25520173,25520173,25520441,0,0,0,268
26661,25520447,25520447,25520560,0,0,0,113
26640,25514079,25514079,25520592,0,0,0,6513
26535,25457615,25457615,25520624,0,0,0,63009
26663,25520559,25520559,25520688,0,0,0,129
26665,25520705,25520705,25520811,0,0,0,106
26668,25521277,25521277,25521344,0,0,0,67
26667,25521044,25521044,25521488,0,0,0,444
26664,25520574,25520574,25521603,0,0,0,1029
26670,25523389,25523389,25523457,0,0,0,68
26671,25523551,25523551,25523622,0,0,0,71
26673,25523694,25523694,25523767,0,0,0,73
26672,25523566,25523566,25523858,0,0,0,292
26674,25523867,25523867,25523962,0,0,0,95
26675,25523920,25523920,25523969,0,0,0,49
26660,25520365,25520365,25524129,0,0,0,3764
26676,25524138,25524138,25524187,0,0,0,49
26678,25524223,25524223,25524330,0,0,0,107
26527,25456783,25456783,25524348,0,0,0,67565
26677,25524166,25524166,25524399,0,0,0,233
26680,25524517,25524517,25524568,0,0,0,51
26682,25524725,25524725,25524777,0,0,0,52
26646,25516860,25516860,25524798,0,0,0,7938
26683,25524911,25524911,25525026,0,0,0,115
26684,25525017,25525017,25525124,0,0,0,107
26690,25525674,25525674,25525799,0,0,0,125
26691,25526249,25526249,25526341,0,0,0,92
26692,25526289,25526289,25526397,0,0,0,108
26662,25520542,25520542,25526560,0,0,0,6018
26696,25526893,25526893,25526972,0,0,0,79
26607,25472557,25472557,25527301,0,0,0,54744
26669,25521667,25521667,25527369,0,0,0,5702
26701,25527404,25527404,25527480,0,0,0,76
26708,25528242,25528242,25528880,0,0,0,638
26710,25528269,25528269,25528896,0,0,0,627
26709,25528257,25528257,25528906,0,0,0,649
26575,25459899,25459899,25529155,0,0,0,69256
26694,25526788,25526788,25529365,0,0,0,2577
26645,25516691,25516691,25529423,0,0,0,12732
26666,25520789,25520789,25529912,0,0,0,9123
26718,25530015,25530015,25530048,0,0,0,33
26702,25527409,25527409,25530056,0,0,0,2647
26719,25530357,25530357,25530418,0,0,0,61
26721,25530617,25530617,25530650,0,0,0,33
26722,25530705,25530705,25530834,0,0,0,129
26715,25529773,25529773,25530917,0,0,0,1144
26723,25531114,25531114,25531241,0,0,0,127
26725,25531499,25531499,25531614,0,0,0,115
26591,25461939,25461939,25531978,0,0,0,70039
26728,25532584,25532584,25532621,0,0,0,37
26729,25532626,25532626,25532670,0,0,0,44
26730,25532660,25532660,25532690,0,0,0,30
26686,25525313,25525313,25532857,0,0,0,7544
26711,25528527,25528527,25532904,0,0,0,4377
26573,25459834,25459834,25533213,0,0,0,73379
26734,25533739,25533739,25533762,0,0,0,23
26735,25534237,25534237,25534286,0,0,0,49
26736,25534425,25534425,25534448,0,0,0,23
26653,25518942,25518942,25534489,0,0,0,15547
26738,25534507,25534507,25534562,0,0,0,55
26652,25518902,25518902,25535527,0,0,0,16625
26740,25535704,25535704,25535743,0,0,0,39
26741,25535710,25535710,25535743,0,0,0,33
26743,25536401,25536401,25536448,0,0,0,47
26658,25520352,25520352,25536547,0,0,0,16195
26720,25530424,25530424,25536734,0,0,0,6310
26712,25528984,25528984,25536765,0,0,0,7781
26706,25527829,25527829,25536830,0,0,0,9001
26744,25536786,25536786,25536840,0,0,0,54
26745,25536787,25536787,25537019,0,0,0,232
26747,25537068,25537068,25537184,0,0,0,116
26733,25533612,25533612,25537212,0,0,0,3600
26748,25537318,25537318,25537384,0,0,0,66
26557,25459178,25459178,25537393,0,0,0,78215
26560,25459179,25459179,25537394,0,0,0,78215
26561,25459179,25459179,25537406,0,0,0,78227
26562,25459179,25459179,25537406,0,0,0,78227
26563,25459180,25459180,25537407,0,0,0,78227
26564,25459180,25459180,25537407,0,0,0,78227
26576,25459911,25459911,25537407,0,0,0,77496
26600,25466186,25466186,25537409,0,0,0,71223
26554,25459018,25459018,25537412,0,0,0,78394
26583,25460692,25460692,25537414,0,0,0,76722
26584,25460692,25460692,25537414,0,0,0,76722
26585,25460692,25460692,25537414,0,0,0,76722
26726,25531698,25531698,25537415,0,0,0,5717
26558,25459178,25459178,25537416,0,0,0,78238
26688,25525386,25525386,25537494,0,0,0,12108
26697,25526919,25526919,25537494,0,0,0,10575
26623,25511174,25511174,25537495,0,0,0,26321
26689,25525452,25525452,25537495,0,0,0,12043
26699,25527308,25527308,25537495,0,0,0,10187
26705,25527607,25527607,25537496,0,0,0,9889
26698,25527256,25527256,25537498,0,0,0,10242
26700,25527392,25527392,25537500,0,0,0,10108
26707,25527972,25527972,25537500,0,0,0,9528
26727,25532268,25532268,25537501,0,0,0,5233
26620,25496911,25496911,25537503,0,0,0,40592
26732,25533205,25533205,25537503,0,0,0,4298
26687,25525339,25525339,25537504,0,0,0,12165
26685,25525270,25525270,25537507,0,0,0,12237
26681,25524577,25524577,25537509,0,0,0,12932
26679,25524269,25524269,25537510,0,0,0,13241
26731,25533055,25533055,25537510,0,0,0,4455
26704,25527565,25527565,25537511,0,0,0,9946
26739,25534528,25534528,25537511,0,0,0,2983
26714,25529112,25529112,25537538,0,0,0,8426
26703,25527444,25527444,25537590,0,0,0,10146
26754,25537606,25537606,25537645,0,0,0,39
26713,25528986,25528986,25537707,0,0,0,8721
26742,25535867,25535867,25537727,0,0,0,1860
26717,25529861,25529861,25537815,0,0,0,7954
26746,25537067,25537067,25537840,0,0,0,773
26716,25529829,25529829,25537849,0,0,0,8020
26724,25531378,25531378,25537880,0,0,0,6502
26761,25537861,25537861,25537899,0,0,0,38
26762,25537861,25537861,25537961,0,0,0,100
26737,25534441,25534441,25537994,0,0,0,3553
26582,25460691,25460691,25537998,0,0,0,77307
26759,25537814,25537814,25538099,0,0,0,285
26755,25537672,25537672,25538882,0,0,0,1210
26760,25537828,25537828,25538919,0,0,0,1091
26756,25537688,25537688,25538951,0,0,0,1263
26770,25539187,25539187,25539573,0,0,0,386
26752,25537580,25537580,25539582,0,0,0,2002
26772,25539629,25539629,25539746,0,0,0,117
26775,25539779,25539779,25539801,0,0,0,22
26774,25539735,25539735,25539838,0,0,0,103
26768,25538855,25538855,25539853,0,0,0,998
26753,25537599,25537599,25539859,0,0,0,2260
26776,25539867,25539867,25539900,0,0,0,33
26777,25539906,25539906,25539996,0,0,0,90
26779,25539948,25539948,25540048,0,0,0,100
26780,25540063,25540063,25540163,0,0,0,100
26781,25540243,25540243,25540342,0,0,0,99
26751,25537567,25537567,25540362,0,0,0,2795
26771,25539441,25539441,25540473,0,0,0,1032
26782,25540691,25540691,25541345,0,0,0,654
26766,25538279,25538279,25542013,0,0,0,3734
26786,25542090,25542090,25542163,0,0,0,73
26789,25543435,25543435,25543528,0,0,0,93
26788,25543100,25543100,25543756,0,0,0,656
26750,25537518,25537518,25543956,0,0,0,6438
26796,25544376,25544376,25544401,0,0,0,25
26797,25544411,25544411,25544434,0,0,0,23
26798,25544569,25544569,25544608,0,0,0,39
26801,25544795,25544795,25544872,0,0,0,77
26802,25544857,25544857,25544918,0,0,0,61
26785,25541152,25541152,25545595,0,0,0,4443
26773,25539644,25539644,25545599,0,0,0,5955
26795,25544351,25544351,25545637,0,0,0,1286
26811,25546582,25546582,25546605,0,0,0,23
26809,25546392,25546392,25546915,0,0,0,523
26763,25537921,25537921,25546921,0,0,0,9000
26749,25537516,25537516,25547081,0,0,0,9565
26814,25547238,25547238,25547262,0,0,0,24
26800,25544763,25544763,25548014,0,0,0,3251
26787,25542512,25542512,25548533,0,0,0,6021
26813,25547094,25547094,25548729,0,0,0,1635
26816,25548488,25548488,25548799,0,0,0,311
26806,25545927,25545927,25551702,0,0,0,5775
26817,25549798,25549798,25551777,0,0,0,1979
26757,25537705,25537705,25552063,0,0,0,14358
26812,25547075,25547075,25552710,0,0,0,5635
26764,25538018,25538018,25553289,0,0,0,15271
26819,25554204,25554204,25554275,0,0,0,71
26820,25555065,25555065,25555302,0,0,0,237
26778,25539907,25539907,25555489,0,0,0,15582
26693,25526325,25526325,25555649,0,0,0,29324
26822,25555583,25555583,25555672,0,0,0,89
26823,25556884,25556884,25556964,0,0,0,80
26824,25557428,25557428,25557504,0,0,0,76
26810,25546581,25546581,25557909,0,0,0,11328
26825,25557860,25557860,25557938,0,0,0,78
26826,25557977,25557977,25558058,0,0,0,81
26827,25558106,25558106,25558188,0,0,0,82
26828,25558432,25558432,25558514,0,0,0,82
26758,25537794,25537794,25559218,0,0,0,21424
26829,25558652,25558652,25559758,0,0,0,1106
26790,25543551,25543551,25559855,0,0,0,16304
26791,25543685,25543685,25559923,0,0,0,16238
26792,25543778,25543778,25560010,0,0,0,16232
26804,25545561,25545561,25560373,0,0,0,14812
26837,25561344,25561344,25561398,0,0,0,54
26834,25561267,25561267,25561433,0,0,0,166
26839,25561389,25561389,25561540,0,0,0,151
26842,25561501,25561501,25561656,0,0,0,155
26765,25538130,25538130,25561723,0,0,0,23593
26844,25561612,25561612,25561754,0,0,0,142
26769,25538946,25538946,25561815,0,0,0,22869
26818,25553361,25553361,25561838,0,0,0,8477
26767,25538841,25538841,25562036,0,0,0,23195
26853,25561738,25561738,25562046,0,0,0,308
26846,25561653,25561653,25562247,0,0,0,594
26848,25561687,25561687,25562252,0,0,0,565
26860,25562335,25562335,25562357,0,0,0,22
26854,25561803,25561803,25562378,0,0,0,575
26861,25562437,25562437,25562470,0,0,0,33
26862,25562505,25562505,25562527,0,0,0,22
26864,25562931,25562931,25562954,0,0,0,23
26866,25562977,25562977,25563001,0,0,0,24
26865,25562973,25562973,25563007,0,0,0,34
26867,25563070,25563070,25563127,0,0,0,57
26868,25563486,25563486,25563514,0,0,0,28
26870,25563572,25563572,25563605,0,0,0,33
26871,25563633,25563633,25563658,0,0,0,25
26863,25562508,25562508,25563784,0,0,0,1276
26873,25563963,25563963,25563988,0,0,0,25
26874,25565284,25565284,25565307,0,0,0,23
26875,25565332,25565332,25565365,0,0,0,33
26876,25565370,25565370,25565403,0,0,0,33
26856,25562049,25562049,25565429,0,0,0,3380
26878,25565713,25565713,25567575,0,0,0,1862
26869,25563492,25563492,25570623,0,0,0,7131
26880,25571140,25571140,25571163,0,0,0,23
26872,25563634,25563634,25571169,0,0,0,7535
26881,25571226,25571226,25571248,0,0,0,22
26882,25571275,25571275,25571297,0,0,0,22
26857,25562205,25562205,25575458,0,0,0,13253
26832,25559969,25559969,25576167,0,0,0,16198
26831,25559883,25559883,25576187,0,0,0,16304
26883,25571278,25571278,25576188,0,0,0,4910
26830,25559814,25559814,25576206,0,0,0,16392
26879,25571114,25571114,25576844,0,0,0,5730
26859,25562308,25562308,25577411,0,0,0,15103
26695,25526855,25526855,25580855,0,0,0,54000
26887,25581332,25581332,25581595,0,0,0,263
26799,25544677,25544677,25581850,0,0,0,37173
26852,25561737,25561737,25582304,0,0,0,20567
26850,25561715,25561715,25582339,0,0,0,20624
26815,25547266,25547266,25582617,0,0,0,35351
26847,25561679,25561679,25582739,0,0,0,21060
26849,25561696,25561696,25582883,0,0,0,21187
26877,25565444,25565444,25584171,0,0,0,18727
26843,25561593,25561593,25584323,0,0,0,22730
26845,25561647,25561647,25585548,0,0,0,23901
26840,25561400,25561400,25587326,0,0,0,25926
26841,25561425,25561425,25587354,0,0,0,25929
26895,25587324,25587324,25587469,0,0,0,145
26836,25561327,25561327,25587542,0,0,0,26215
26838,25561379,25561379,25587885,0,0,0,26506
26851,25561716,25561716,25590430,0,0,0,28714
26835,25561293,25561293,25591177,0,0,0,29884
26900,25591146,25591146,25591295,0,0,0,149
26821,25555562,25555562,25591338,0,0,0,35776
26901,25591253,25591253,25591401,0,0,0,148
26884,25576126,25576126,25592391,0,0,0,16265
26885,25576134,25576134,25592422,0,0,0,16288
26886,25576163,25576163,25592436,0,0,0,16273
26906,25597545,25597545,25597577,0,0,0,32
26803,25545541,25545541,25598725,0,0,0,53184
26907,25599297,25599297,25599329,0,0,0,32
26807,25545961,25545961,25599961,0,0,0,54000
26890,25582693,25582693,25600300,0,0,0,17607
26902,25591361,25591361,25600300,0,0,0,8939
26794,25543834,25543834,25600302,0,0,0,56468
26891,25582837,25582837,25600304,0,0,0,17467
26896,25587433,25587433,25600307,0,0,0,12874
26894,25587283,25587283,25600311,0,0,0,13028
26903,25592345,25592345,25600311,0,0,0,7966
26793,25543822,25543822,25600312,0,0,0,56490
26808,25545974,25545974,25600312,0,0,0,54338
26897,25587511,25587511,25600312,0,0,0,12801
26904,25592372,25592372,25600314,0,0,0,7942
26905,25592396,25592396,25600316,0,0,0,7920
26783,25540820,25540820,25600319,0,0,0,59499
26888,25582299,25582299,25600319,0,0,0,18020
26899,25590386,25590386,25600319,0,0,0,9933
26893,25585509,25585509,25600320,0,0,0,14811
26898,25587843,25587843,25600320,0,0,0,12477
26892,25584275,25584275,25600321,0,0,0,16046
26784,25540889,25540889,25600322,0,0,0,59433
26858,25562238,25562238,25600803,0,0,0,38565
26805,25545601,25545601,25600814,0,0,0,55213
26855,25561986,25561986,25600814,0,0,0,38828
26833,25560473,25560473,25600815,0,0,0,40342
26908,25601018,25601018,25601114,0,0,0,96
26889,25582350,25582350,25601570,0,0,0,19220
26909,25601640,25601640,25601665,0,0,0,25
26910,25601877,25601877,25602023,0,0,0,146
26912,25602385,25602385,25602409,0,0,0,24
26911,25601989,25601989,25602454,0,0,0,465
26914,25603047,25603047,25603078,0,0,0,31
26913,25603034,25603034,25603188,0,0,0,154
26915,25603059,25603059,25603213,0,0,0,154
26918,25604812,25604812,25605388,0,0,0,576
26919,25604986,25604986,25605392,0,0,0,406
26917,25604598,25604598,25605408,0,0,0,810
26929,25606462,25606462,25606494,0,0,0,32
26930,25606541,25606541,25606628,0,0,0,87
26931,25606633,25606633,25606726,0,0,0,93
26934,25608170,25608170,25608264,0,0,0,94
26935,25608456,25608456,25608487,0,0,0,31
26939,25608703,25608703,25608734,0,0,0,31
26942,25608751,25608751,25608782,0,0,0,31
26936,25608672,25608672,25608814,0,0,0,142
26937,25608684,25608684,25608845,0,0,0,161
26938,25608693,25608693,25608873,0,0,0,180
26941,25608724,25608724,25608902,0,0,0,178
26940,25608715,25608715,25608904,0,0,0,189
26944,25609151,25609151,25609327,0,0,0,176
26945,25609161,25609161,25609368,0,0,0,207
26946,25609172,25609172,25609462,0,0,0,290
26943,25609140,25609140,25609815,0,0,0,675
26950,25611136,25611136,25611221,0,0,0,85
26951,25611194,25611194,25611408,0,0,0,214
26952,25611216,25611221,25611511,0,0,5,295
26949,25611032,25611032,25611560,0,0,0,528
26953,25611230,25611408,25611688,0,0,178,458
26954,25611288,25611688,25611761,0,0,400,473
26958,25612503,25612503,25612658,0,0,0,155
26955,25611596,25611596,25612664,0,0,0,1068
26956,25612014,25612014,25612698,0,0,0,684
26957,25612491,25612491,25612896,0,0,0,405
26948,25610395,25610395,25613478,0,0,0,3083
26966,25613460,25613460,25613491,0,0,0,31
26965,25613446,25613446,25613533,0,0,0,87
26967,25613671,25613671,25613745,0,0,0,74
26947,25610146,25610146,25613783,0,0,0,3637
26962,25613121,25613121,25613802,0,0,0,681
26933,25607358,25607358,25613849,0,0,0,6491
26923,25605373,25605373,25613854,0,0,0,8481
26963,25613190,25613190,25613857,0,0,0,667
26961,25612901,25612901,25613862,0,0,0,961
26932,25607355,25607355,25613901,0,0,0,6546
26973,25613861,25613861,25614016,0,0,0,155
26972,25613852,25613852,25614085,0,0,0,233
26974,25614064,25614064,25614095,0,0,0,31
26978,25614118,25614118,25614149,0,0,0,31
26976,25614090,25614090,25614182,0,0,0,92
26977,25614109,25614109,25614183,0,0,0,74
26979,25614338,25614338,25614501,0,0,0,163
26975,25614079,25614079,25614571,0,0,0,492
26985,25614466,25614466,25614637,0,0,0,171
26993,25614867,25614867,25614961,0,0,0,94
26970,25613807,25613807,25615853,0,0,0,2046
26971,25613826,25613826,25615872,0,0,0,2046
26996,25616377,25616377,25616451,0,0,0,74
26997,25616492,25616492,25616566,0,0,0,74
26998,25616493,25616566,25616640,0,0,73,147
26999,25616958,25616958,25617140,0,0,0,182
27003,25618227,25618227,25618388,0,0,0,161
27008,25618373,25618373,25618407,0,0,0,34
27011,25618382,25618382,25618408,0,0,0,26
27004,25618237,25618237,25618409,0,0,0,172
27005,25618247,25618247,25618419,0,0,0,172
27007,25618357,25618357,25618435,0,0,0,78
27006,25618344,25618344,25618444,0,0,0,100
27013,25618545,25618545,25618659,0,0,0,114
27015,25618982,25618982,25619073,0,0,0,91
27017,25619081,25619081,25619141,0,0,0,60
27016,25619062,25619062,25619239,0,0,0,177
27018,25619156,25619156,25619344,0,0,0,188
27022,25619401,25619401,25619469,0,0,0,68
27020,25619386,25619386,25619487,0,0,0,101
27019,25619383,25619383,25619574,0,0,0,191
27021,25619394,25619394,25619574,0,0,0,180
27023,25619676,25619676,25619771,0,0,0,95
27024,25619851,25619851,25619920,0,0,0,69
26959,25612659,25612659,25620190,0,0,0,7531
26960,25612740,25612740,25620198,0,0,0,7458
27025,25619932,25619932,25620236,0,0,0,304
26994,25616260,25616260,25620587,0,0,0,4327
26995,25616263,25616263,25620636,0,0,0,4373
26968,25613729,25613729,25620647,0,0,0,6918
26969,25613757,25613757,25620755,0,0,0,6998
27030,25621590,25621590,25621663,0,0,0,73
27031,25621850,25621850,25622039,0,0,0,189
27032,25622028,25622028,25622340,0,0,0,312
26926,25606153,25606153,25622386,0,0,0,16233
26927,25606243,25606243,25622483,0,0,0,16240
26928,25606261,25606261,25622596,0,0,0,16335
27036,25623373,25623373,25624043,0,0,0,670
27039,25626251,25626251,25626324,0,0,0,73
27040,25626324,25626324,25626563,0,0,0,239
27042,25627205,25627205,25627278,0,0,0,73
27037,25625588,25625588,25627498,0,0,0,1910
27028,25620614,25620614,25627681,0,0,0,7067
27029,25620716,25620716,25627683,0,0,0,6967
27046,25628205,25628205,25628278,0,0,0,73
27045,25628146,25628146,25628459,0,0,0,313
27047,25628289,25628289,25628786,0,0,0,497
27044,25627766,25627766,25628948,0,0,0,1182
27026,25620548,25620548,25629449,0,0,0,8901
27027,25620588,25620588,25629461,0,0,0,8873
27049,25628867,25628867,25629479,0,0,0,612
27050,25628882,25628882,25629484,0,0,0,602
27052,25628922,25628922,25629503,0,0,0,581
27051,25628903,25628903,25629518,0,0,0,615
27054,25631053,25631053,25631166,0,0,0,113
27057,25631241,25631241,25631264,0,0,0,23
27048,25628583,25628583,25632862,0,0,0,4279
26992,25614605,25614605,25635239,0,0,0,20634
26988,25614540,25614540,25635574,0,0,0,21034
26989,25614568,25614568,25635602,0,0,0,21034
26991,25614587,25614587,25635748,0,0,0,21161
27041,25626470,25626470,25636403,0,0,0,9933
26986,25614480,25614480,25637213,0,0,0,22733
27043,25627332,25627332,25638085,0,0,0,10753
26987,25614506,25614506,25638391,0,0,0,23885
27033,25622345,25622345,25638575,0,0,0,16230
27034,25622443,25622443,25638684,0,0,0,16241
27035,25622555,25622555,25638816,0,0,0,16261
26984,25614454,25614454,25640581,0,0,0,26127
26982,25614416,25614416,25640837,0,0,0,26421
26981,25614396,25614396,25640934,0,0,0,26538
26983,25614432,25614432,25641114,0,0,0,26682
27073,25641073,25641073,25641225,0,0,0,152
26980,25614363,25614363,25643846,0,0,0,29483
26916,25604430,25604430,25650758,0,0,0,46328
27067,25638535,25638535,25654768,0,0,0,16233
27068,25638647,25638647,25654899,0,0,0,16252
27061,25635197,25635197,25655696,0,0,0,20499
27064,25635715,25635715,25656249,0,0,0,20534
27062,25635525,25635525,25656614,0,0,0,21089
27063,25635564,25635564,25656635,0,0,0,21071
26990,25614570,25614570,25657770,0,0,0,43200
27065,25637172,25637172,25660551,0,0,0,23379
27066,25638346,25638346,25661155,0,0,0,22809
27070,25640539,25640539,25666900,0,0,0,26361
27072,25640902,25640902,25666959,0,0,0,26057
27074,25641233,25641233,25667255,0,0,0,26022
27071,25640796,25640796,25667787,0,0,0,26991
27076,25654730,25654730,25671017,0,0,0,16287
27077,25654850,25654850,25671126,0,0,0,16276
27038,25626057,25626057,25672098,0,0,0,46041
27075,25643801,25643801,25673449,0,0,0,29648
27078,25655655,25655655,25676088,0,0,0,20433
27079,25656211,25656211,25676670,0,0,0,20459
27080,25656579,25656579,25677519,0,0,0,20940
27081,25656593,25656593,25677553,0,0,0,20960
26922,25605368,25605368,25681369,0,0,0,76001
27069,25638776,25638776,25681976,0,0,0,43200
27083,25661160,25661160,25683824,0,0,0,22664
27082,25660556,25660556,25683917,0,0,0,23361
27088,25670976,25670976,25687064,0,0,0,16088
27089,25671088,25671088,25687301,0,0,0,16213
27009,25618377,25618377,25687884,0,0,0,69507
27084,25666902,25666902,25692820,0,0,0,25918
27099,25692784,25692784,25692952,0,0,0,168
27100,25692904,25692904,25693088,0,0,0,184
27085,25666969,25666969,25693113,0,0,0,26144
27086,25667248,25667248,25693179,0,0,0,25931
27101,25693057,25693057,25693202,0,0,0,145
27087,25667795,25667795,25695048,0,0,0,27253
27103,25693144,25693144,25695873,0,0,0,2729
27091,25676046,25676046,25696777,0,0,0,20731
27092,25676627,25676627,25697327,0,0,0,20700
27093,25677480,25677480,25698355,0,0,0,20875
27094,25677517,25677517,25698369,0,0,0,20852
27097,25687022,25687022,25703155,0,0,0,16133
27090,25673452,25673452,25703247,0,0,0,29795
27098,25687261,25687261,25703426,0,0,0,16165
27095,25683787,25683787,25707165,0,0,0,23378
27096,25683880,25683880,25707314,0,0,0,23434
27113,25707266,25707266,25707334,0,0,0,68
27000,25617893,25617893,25710000,0,0,0,92107
27115,25711221,25711221,25711562,0,0,0,341
27109,25703114,25703114,25719121,0,0,0,16007
27104,25693164,25693164,25719404,0,0,0,26240
27102,25693071,25693071,25719418,0,0,0,26347
27108,25698332,25698332,25719418,0,0,0,21086
27107,25698304,25698304,25719440,0,0,0,21136
27111,25703379,25703379,25719446,0,0,0,16067
27117,25719360,25719360,25719507,0,0,0,147
27120,25719464,25719464,25719614,0,0,0,150
27055,25631209,25631209,25719615,0,0,0,88406
27121,25719572,25719572,25719728,0,0,0,156
27122,25719677,25719677,25719827,0,0,0,150
27058,25631242,25631242,25720512,0,0,0,89270
27105,25695000,25695000,25721215,0,0,0,26215
27125,25721645,25721645,25721718,0,0,0,73
27106,25695830,25695830,25721923,0,0,0,26093
27127,25722380,25722380,25722454,0,0,0,74
27056,25631221,25631221,25722541,0,0,0,91320
27139,25723975,25723975,25724048,0,0,0,73
27141,25724583,25724583,25724656,0,0,0,73
27142,25725067,25725067,25725141,0,0,0,74
27143,25725246,25725246,25725330,0,0,0,84
27144,25725315,25725315,25725419,0,0,0,104
27145,25726309,25726309,25726413,0,0,0,104
27146,25726591,25726591,25726858,0,0,0,267
27147,25727617,25727617,25728135,0,0,0,518
27148,25728592,25728592,25728727,0,0,0,135
27149,25729095,25729095,25729169,0,0,0,74
27112,25707117,25707117,25730572,0,0,0,23455
27114,25707270,25707270,25730892,0,0,0,23622
27152,25731022,25731022,25731095,0,0,0,73
27153,25731121,25731121,25731194,0,0,0,73
27001,25618039,25618039,25731918,0,0,0,113879
27110,25703207,25703207,25732851,0,0,0,29644
26964,25613301,25613301,25732854,0,0,0,119553
27154,25732808,25732808,25732959,0,0,0,151
27116,25719078,25719078,25734993,0,0,0,15915
27119,25719401,25719401,25735438,0,0,0,16037
27123,25719786,25719786,25745511,0,0,0,25725
27158,25745470,25745470,25745658,0,0,0,188
27118,25719384,25719384,25745992,0,0,0,26608
27124,25721182,25721182,25747875,0,0,0,26693
27002,25618064,25618064,25747981,0,0,0,129917
27126,25721880,25721880,25748229,0,0,0,26349
27162,25748185,25748185,25748334,0,0,0,149
27156,25734952,25734952,25750929,0,0,0,15977
27157,25735392,25735392,25751312,0,0,0,15920
27150,25730538,25730538,25753935,0,0,0,23397
27151,25730853,25730853,25754352,0,0,0,23499
26921,25605353,25605353,25756053,0,0,0,150700
27155,25732917,25732917,25762524,0,0,0,29607
27060,25631441,25631441,25766661,0,0,0,135220
27164,25750893,25750893,25766716,0,0,0,15823
27165,25751274,25751274,25767209,0,0,0,15935
27159,25745617,25745617,25771338,0,0,0,25721
27160,25745951,25745951,25772401,0,0,0,26450
27161,25747828,25747828,25773963,0,0,0,26135
27163,25748293,25748293,25773998,0,0,0,25705
27166,25753890,25753890,25777430,0,0,0,23540
27167,25754310,25754310,25778352,0,0,0,24042
27169,25766673,25766673,25782447,0,0,0,15774
27170,25767168,25767168,25782971,0,0,0,15803
26920,25605344,25605344,25783757,0,0,0,178413
27179,25787253,25787253,25787276,0,0,0,23
27168,25762480,25762480,25792155,0,0,0,29675
27187,25793617,25793617,25793640,0,0,0,23
27171,25771296,25771296,25797655,0,0,0,26359
27177,25782403,25782403,25798115,0,0,0,15712
27178,25782933,25782933,25798735,0,0,0,15802
27172,25772359,25772359,25798903,0,0,0,26544
27174,25773954,25773954,25800021,0,0,0,26067
27173,25773917,25773917,25800138,0,0,0,26221
27175,25777389,25777389,25800786,0,0,0,23397
27176,25778310,25778310,25802567,0,0,0,24257
27198,25805559,25805559,25805636,0,0,0,77
27199,25805760,25805760,25805831,0,0,0,71
27200,25806566,25806566,25806645,0,0,0,79
27201,25807071,25807071,25807217,0,0,0,146
27202,25810428,25810428,25810506,0,0,0,78
27203,25810984,25810984,25811085,0,0,0,101
27204,25811108,25811108,25811209,0,0,0,101
27206,25811213,25811213,25811237,0,0,0,24
27205,25811180,25811180,25811302,0,0,0,122
27208,25811474,25811474,25811497,0,0,0,23
27209,25813738,25813738,25813796,0,0,0,58
27191,25798070,25798070,25813967,0,0,0,15897
27192,25798691,25798691,25814414,0,0,0,15723
27010,25618380,25618380,25814598,0,0,0,196218
27212,25814674,25814674,25814697,0,0,0,23
27012,25618433,25618433,25814707,0,0,0,196274
27207,25811263,25811263,25814792,0,0,0,3529
27213,25815688,25815688,25815711,0,0,0,23
27185,25792112,25792112,25822140,0,0,0,30028
27218,25824077,25824077,25824116,0,0,0,39
27190,25797614,25797614,25824228,0,0,0,26614
27196,25800742,25800742,25824828,0,0,0,24086
27193,25798854,25798854,25825490,0,0,0,26636
27194,25799979,25799979,25826212,0,0,0,26233
27197,25802523,25802523,25826530,0,0,0,24007
27195,25800102,25800102,25826739,0,0,0,26637
27210,25813932,25813932,25830035,0,0,0,16103
27211,25814368,25814368,25830319,0,0,0,15951
27214,25818159,25818159,25834454,0,0,0,16295
27188,25793676,25793676,25836532,0,0,0,42856
27217,25824038,25824038,25837039,0,0,0,13001
27053,25629761,25629761,25838561,0,0,0,208800
27059,25631370,25631370,25840170,0,0,0,208800
27226,25829994,25829994,25846149,0,0,0,16155
27227,25830274,25830274,25846367,0,0,0,16093
27219,25824129,25824129,25846389,0,0,0,22260
27215,25818275,25818275,25848098,0,0,0,29823
27231,25848048,25848048,25848199,0,0,0,151
27221,25824778,25824778,25848985,0,0,0,24207
27220,25824178,25824178,25849872,0,0,0,25694
27228,25834412,25834412,25850694,0,0,0,16282
27224,25826489,25826489,25850708,0,0,0,24219
27216,25822092,25822092,25851501,0,0,0,29409
27222,25825454,25825454,25851977,0,0,0,26523
27223,25826170,25826170,25852361,0,0,0,26191
27225,25826696,25826696,25853544,0,0,0,26848
27242,25860128,25860128,25860152,0,0,0,24
27244,25860780,25860780,25860803,0,0,0,23
27241,25857424,25857424,25861106,0,0,0,3682
27246,25862151,25862151,25862180,0,0,0,29
27247,25862166,25862166,25862193,0,0,0,27
27248,25862176,25862193,25862261,0,0,17,85
27249,25862184,25862261,25862333,0,0,77,149
27229,25846108,25846108,25862351,0,0,0,16243
27250,25862309,25862333,25862510,0,0,24,201
27230,25846319,25846319,25862548,0,0,0,16229
27253,25862586,25862586,25862636,0,0,0,50
27255,25862750,25862750,25862773,0,0,0,23
27257,25863109,25863109,25863132,0,0,0,23
27258,25863302,25863302,25863325,0,0,0,23
27259,25863316,25863316,25863339,0,0,0,23
27261,25863415,25863415,25863439,0,0,0,24
27262,25863585,25863585,25863608,0,0,0,23
27256,25862926,25862926,25863658,0,0,0,732
27263,25864069,25864069,25864093,0,0,0,24
27264,25864084,25864084,25864167,0,0,0,83
27189,25793732,25793732,25864371,0,0,0,70639
27265,25864595,25864595,25864678,0,0,0,83
26924,25606086,25606086,25865286,0,0,0,259200
26925,25606088,25606088,25865288,0,0,0,259200
27266,25865329,25865329,25865422,0,0,0,93
27235,25850653,25850653,25866884,0,0,0,16231
27277,25867268,25867268,25867292,0,0,0,24
27278,25867586,25867586,25867624,0,0,0,38
27279,25867860,25867860,25867909,0,0,0,49
27281,25867941,25867941,25867990,0,0,0,49
27282,25868015,25868015,25868069,0,0,0,54
27284,25868050,25868050,25868088,0,0,0,38
27269,25866548,25866548,25868097,0,0,0,1549
27272,25866588,25866588,25868116,0,0,0,1528
27243,25860470,25860470,25868416,0,0,0,7946
27276,25867162,25867162,25868453,0,0,0,1291
27273,25866596,25866596,25868561,0,0,0,1965
27287,25868733,25868733,25868786,0,0,0,53
27288,25868759,25868759,25868845,0,0,0,86
27290,25869064,25869064,25869107,0,0,0,43
27291,25869075,25869075,25869259,0,0,0,184
27270,25866562,25866562,25869301,0,0,0,2739
27271,25866571,25866571,25869305,0,0,0,2734
27268,25865833,25865833,25869314,0,0,0,3481
27014,25618629,25618629,25869315,0,0,0,250686
27274,25866636,25866636,25869315,0,0,0,2679
27128,25722892,25722892,25869330,0,0,0,146438
27129,25722892,25722892,25869330,0,0,0,146438
27130,25722893,25722893,25869331,0,0,0,146438
27131,25722893,25722893,25869331,0,0,0,146438
27132,25722893,25722893,25869331,0,0,0,146438
27133,25722893,25722893,25869331,0,0,0,146438
27134,25722893,25722893,25869331,0,0,0,146438
27294,25869330,25869330,25869367,0,0,0,37
27280,25867912,25867912,25869406,0,0,0,1494
27289,25868779,25868779,25869408,0,0,0,629
27251,25862312,25862312,25869414,0,0,0,7102
27240,25853503,25853503,25869416,0,0,0,15913
27286,25868586,25868586,25869416,0,0,0,830
27237,25851456,25851456,25869418,0,0,0,17962
27239,25852313,25852313,25869420,0,0,0,17107
27252,25862517,25862517,25869420,0,0,0,6903
27232,25848165,25848165,25869421,0,0,0,21256
27236,25850666,25850666,25869421,0,0,0,18755
27233,25848949,25848949,25869422,0,0,0,20473
27285,25868236,25868236,25869422,0,0,0,1186
27238,25851931,25851931,25869423,0,0,0,17492
27275,25866846,25866846,25869423,0,0,0,2577
27292,25869146,25869146,25869423,0,0,0,277
27234,25849838,25849838,25869426,0,0,0,19588
27283,25868015,25868015,25869426,0,0,0,1411
27295,25869401,25869401,25869485,0,0,0,84
27267,25865603,25865603,25869530,0,0,0,3927
27186,25793490,25793490,25869531,0,0,0,76041
27137,25723192,25723192,25869532,0,0,0,146340
27182,25788237,25788237,25869533,0,0,0,81296
27245,25862054,25862054,25869534,0,0,0,7480
27135,25723029,25723029,25869538,0,0,0,146509
27254,25862747,25862747,25869538,0,0,0,6791
27136,25723191,25723191,25869543,0,0,0,146352
27140,25724293,25724293,25869543,0,0,0,145250
27180,25787799,25787799,25869543,0,0,0,81744
27181,25787952,25787952,25869543,0,0,0,81591
27183,25788373,25788373,25869543,0,0,0,81170
27184,25788500,25788500,25869543,0,0,0,81043
27260,25863346,25863346,25869565,0,0,0,6219
27293,25869272,25869272,25869602,0,0,0,330
27297,25869752,25869752,25869792,0,0,0,40
27138,25723192,25723192,25870137,0,0,0,146945
27298,25871044,25871044,25871111,0,0,0,67
27300,25871212,25871212,25871235,0,0,0,23
27302,25871684,25871684,25871718,0,0,0,34
27303,25871822,25871822,25871860,0,0,0,38
27296,25869671,25869671,25872165,0,0,0,2494
27299,25871161,25871161,25872179,0,0,0,1018
27312,25872773,25872773,25872797,0,0,0,24
27313,25873366,25873366,25873438,0,0,0,72
27317,25874964,25874964,25875029,0,0,0,65
27308,25872029,25872029,25875224,0,0,0,3195
27320,25875362,25875362,25875387,0,0,0,25
27322,25876563,25876563,25876614,0,0,0,51
27323,25876592,25876592,25876693,0,0,0,101
27315,25873435,25873435,25876704,0,0,0,3269
27324,25876999,25876999,25877097,0,0,0,98
27301,25871436,25871436,25877288,0,0,0,5852
27325,25877470,25877470,25877493,0,0,0,23
27327,25877537,25877537,25877634,0,0,0,97
27328,25877553,25877553,25877657,0,0,0,104
27326,25877504,25877504,25877699,0,0,0,195
27329,25877946,25877946,25878015,0,0,0,69
27330,25877972,25877972,25878070,0,0,0,98
27331,25878051,25878051,25878124,0,0,0,73
27332,25878122,25878122,25878213,0,0,0,91
27333,25878154,25878154,25878229,0,0,0,75
27335,25878270,25878270,25878292,0,0,0,22
27334,25878242,25878242,25878303,0,0,0,61
27336,25878271,25878271,25878392,0,0,0,121
27337,25878322,25878322,25878419,0,0,0,97
27338,25878614,25878614,25878718,0,0,0,104
27341,25878697,25878697,25878730,0,0,0,33
27339,25878650,25878650,25878731,0,0,0,81
27316,25874682,25874682,25878765,0,0,0,4083
27343,25878911,25878911,25878973,0,0,0,62
27344,25878999,25878999,25879105,0,0,0,106
27345,25879185,25879185,25879252,0,0,0,67
27342,25878769,25878769,25879282,0,0,0,513
27348,25879380,25879380,25879449,0,0,0,69
27347,25879265,25879265,25879568,0,0,0,303
27349,25879520,25879520,25879575,0,0,0,55
27350,25879536,25879536,25879667,0,0,0,131
27351,25879659,25879659,25879770,0,0,0,111
27353,25879867,25879867,25879936,0,0,0,69
27354,25879957,25879957,25880035,0,0,0,78
27352,25879754,25879754,25880069,0,0,0,315
27355,25880019,25880019,25880074,0,0,0,55
27357,25880048,25880048,25880120,0,0,0,72
27356,25880038,25880038,25880165,0,0,0,127
27360,25880134,25880134,25880212,0,0,0,78
27366,25880412,25880412,25880689,0,0,0,277
27369,25880695,25880695,25880750,0,0,0,55
27361,25880206,25880206,25880754,0,0,0,548
27346,25879215,25879215,25881239,0,0,0,2024
27370,25880710,25880710,25881310,0,0,0,600
27371,25880809,25880809,25881409,0,0,0,600
27372,25881169,25881169,25881568,0,0,0,399
27374,25882613,25882613,25882636,0,0,0,23
27318,25875007,25875007,25883917,0,0,0,8910
27311,25872731,25872731,25884022,0,0,0,11291
27306,25871975,25871975,25884124,0,0,0,12149
27340,25878651,25878651,25884124,0,0,0,5473
27367,25880591,25880591,25884124,0,0,0,3533
27368,25880613,25880613,25884124,0,0,0,3511
27314,25873402,25873402,25884125,0,0,0,10723
27365,25880359,25880359,25884125,0,0,0,3766
27362,25880255,25880255,25884127,0,0,0,3872
27363,25880290,25880290,25884128,0,0,0,3838
27307,25871994,25871994,25884132,0,0,0,12138
27309,25872195,25872195,25884132,0,0,0,11937
27319,25875256,25875256,25884132,0,0,0,8876
27304,25871830,25871830,25884134,0,0,0,12304
27358,25880107,25880107,25884134,0,0,0,4027
27305,25871974,25871974,25884135,0,0,0,12161
27310,25872228,25872228,25884135,0,0,0,11907
27321,25875653,25875653,25884135,0,0,0,8482
27364,25880325,25880325,25884135,0,0,0,3810
27375,25884201,25884201,25884438,0,0,0,237
27380,25884659,25884659,25884692,0,0,0,33
27381,25884690,25884690,25884907,0,0,0,217
27382,25884716,25884716,25885000,0,0,0,284
27383,25884926,25884926,25885242,0,0,0,316
27385,25885275,25885275,25885363,0,0,0,88
27379,25884493,25884493,25885819,0,0,0,1326
27386,25885780,25885780,25885952,0,0,0,172
27387,25886089,25886089,25886164,0,0,0,75
27388,25886312,25886312,25886401,0,0,0,89
27402,25887277,25887277,25887362,0,0,0,85
27403,25887355,25887362,25887437,0,0,7,82
27404,25887618,25887618,25887788,0,0,0,170
27405,25887619,25887619,25887800,0,0,0,181
27406,25887619,25887619,25888146,0,0,0,527
27413,25890875,25890875,25890899,0,0,0,24
27414,25891193,25891193,25891381,0,0,0,188
27415,25891258,25891258,25891422,0,0,0,164
27419,25891572,25891572,25891681,0,0,0,109
27420,25891879,25891879,25892069,0,0,0,190
27422,25892426,25892426,25892474,0,0,0,48
27421,25892232,25892232,25892751,0,0,0,519
27430,25892664,25892664,25892818,0,0,0,154
27426,25892571,25892571,25892847,0,0,0,276
27433,25892802,25892802,25893070,0,0,0,268
27435,25894053,25894053,25894104,0,0,0,51
27436,25894661,25894661,25894683,0,0,0,22
27437,25895126,25895126,25895149,0,0,0,23
27438,25895819,25895819,25895841,0,0,0,22
27441,25895890,25895890,25895913,0,0,0,23
27439,25895871,25895871,25896113,0,0,0,242
27440,25895882,25895882,25896113,0,0,0,231
27442,25896171,25896171,25896193,0,0,0,22
27445,25897044,25897044,25897066,0,0,0,22
27431,25892706,25892706,25898344,0,0,0,5638
27447,25899535,25899535,25899588,0,0,0,53
27449,25899618,25899618,25899640,0,0,0,22
27448,25899577,25899577,25899708,0,0,0,131
27450,25900181,25900181,25900204,0,0,0,23
27452,25900230,25900230,25900252,0,0,0,22
27444,25896619,25896619,25900336,0,0,0,3717
27454,25900349,25900349,25903390,0,0,0,3041
27457,25903486,25903486,25903508,0,0,0,22
27456,25903473,25903473,25903640,0,0,0,167
27458,25903841,25903841,25903863,0,0,0,22
27459,25904211,25904211,25904234,0,0,0,23
27451,25900215,25900215,25907009,0,0,0,6794
27418,25891488,25891488,25907695,0,0,0,16207
27416,25891434,25891434,25907762,0,0,0,16328
27417,25891458,25891458,25907762,0,0,0,16304
27463,25908004,25908004,25908026,0,0,0,22
27464,25908137,25908137,25908160,0,0,0,23
27466,25908969,25908969,25909023,0,0,0,54
27467,25909027,25909027,25909049,0,0,0,22
27423,25892499,25892499,25916107,0,0,0,23608
27424,25892519,25892519,25916603,0,0,0,24084
27428,25892613,25892613,25918574,0,0,0,25961
27432,25892779,25892779,25919092,0,0,0,26313
27429,25892644,25892644,25919130,0,0,0,26486
27478,25919050,25919050,25919215,0,0,0,165
27427,25892592,25892592,25919442,0,0,0,26850
27434,25893073,25893073,25920960,0,0,0,27887
27425,25892541,25892541,25921906,0,0,0,29365
27460,25907650,25907650,25923803,0,0,0,16153
27461,25907712,25907712,25924038,0,0,0,16326
27462,25907728,25907728,25924067,0,0,0,16339
27470,25913769,25913769,25924966,0,0,0,11197
27471,25913795,25913795,25929715,0,0,0,15920
27472,25913844,25913844,25935301,0,0,0,21457
27475,25916064,25916064,25939591,0,0,0,23527
27483,25923760,25923760,25939919,0,0,0,16159
27484,25924003,25924003,25940311,0,0,0,16308
27485,25924082,25924082,25940420,0,0,0,16338
27476,25916559,25916559,25940787,0,0,0,24228
27408,25889559,25889559,25942846,0,0,0,53287
27486,25942863,25942863,25942938,0,0,0,75
27465,25908507,25908507,25943072,0,0,0,34565
27373,25881881,25881881,25944794,0,0,0,62913
27479,25919087,25919087,25945119,0,0,0,26032
27477,25918687,25918687,25945684,0,0,0,26997
27480,25919402,25919402,25946115,0,0,0,26713
27376,25884331,25884331,25947657,0,0,0,63326
27446,25899471,25899471,25948468,0,0,0,48997
27474,25913921,25913921,25948958,0,0,0,35037
27481,25920971,25920971,25949781,0,0,0,28810
27492,25950367,25950367,25950657,0,0,0,290
27482,25921864,25921864,25951531,0,0,0,29667
27493,25952364,25952364,25952652,0,0,0,288
27494,25952604,25952604,25953204,0,0,0,600
27489,25947070,25947070,25954453,0,0,0,7383
27496,25954782,25954782,25954960,0,0,0,178
27497,25954843,25954843,25954982,0,0,0,139
27498,25954977,25954977,25955116,0,0,0,139
27495,25954718,25954718,25955675,0,0,0,957
27500,25957587,25957587,25957657,0,0,0,70
27501,25957829,25957829,25957900,0,0,0,71
27499,25957528,25957528,25958198,0,0,0,670
27502,25958333,25958333,25958491,0,0,0,158
27503,25958792,25958792,25958861,0,0,0,69
27504,25958972,25958972,25959134,0,0,0,162
27505,25959655,25959655,25960127,0,0,0,472
27506,25960440,25960440,25960587,0,0,0,147
27507,25961926,25961926,25962020,0,0,0,94
27508,25962138,25962138,25962317,0,0,0,179
27509,25962240,25962240,25962327,0,0,0,87
27510,25962998,25962998,25963305,0,0,0,307
27511,25963007,25963305,25963484,0,0,298,477
27512,25963009,25963305,25963484,0,0,296,475
27513,25963011,25963305,25963495,0,0,294,484
27514,25964211,25964211,25964390,0,0,0,179
27515,25964625,25964625,25964712,0,0,0,87
27516,25965004,25965004,25965185,0,0,0,181
27455,25903408,25903408,25965455,0,0,0,62047
27443,25896505,25896505,25965465,0,0,0,68960
27517,25965251,25965251,25965533,0,0,0,282
27518,25967031,25967031,25967209,0,0,0,178
27519,25967364,25967364,25967412,0,0,0,48
27520,25967593,25967593,25967632,0,0,0,39
27521,25967766,25967766,25967813,0,0,0,47
27522,25968310,25968310,25968354,0,0,0,44
27395,25886818,25886818,25970914,0,0,0,84096
27391,25886817,25886817,25976910,0,0,0,90093
27528,25976450,25976450,25976986,0,0,0,536
27529,25976955,25976955,25977072,0,0,0,117
27530,25977378,25977378,25977978,0,0,0,600
27527,25975084,25975084,25978648,0,0,0,3564
27491,25949098,25949098,25980159,0,0,0,31061
27409,25889599,25889599,25980369,0,0,0,90770
27410,25889659,25889659,25980419,0,0,0,90760
27473,25913875,25913875,25981847,0,0,0,67972
27359,25880124,25880124,25982656,0,0,0,102532
27396,25886818,25886818,25988683,0,0,0,101865
27397,25886818,25886818,25990713,0,0,0,103895
27536,25994562,25994562,25994713,0,0,0,151
27523,25968696,25968696,25994792,0,0,0,26096
27537,25994675,25994675,25994825,0,0,0,150
27487,25946088,25946088,25995515,0,0,0,49427
27542,25997336,25997336,25997482,0,0,0,146
27412,25889732,25889732,25997813,0,0,0,108081
27544,25998196,25998196,25998342,0,0,0,146
27545,25998299,25998299,25998449,0,0,0,150
27531,25984680,25984680,26000688,0,0,0,16008
27532,25984834,25984834,26001194,0,0,0,16360
27533,25984868,25984868,26001213,0,0,0,16345
27389,25886605,25886605,26001912,0,0,0,115307
27392,25886817,25886817,26005823,0,0,0,119006
27534,25992053,25992053,26015939,0,0,0,23886
27535,25992758,25992758,26016382,0,0,0,23624
27547,26000654,26000654,26016594,0,0,0,15940
27549,26001172,26001172,26017437,0,0,0,16265
27548,26001144,26001144,26017451,0,0,0,16307
27538,25994753,25994753,26020954,0,0,0,26201
27525,25971788,25971788,26020963,0,0,0,49175
27539,25994784,25994784,26020967,0,0,0,26183
27554,26020913,26020913,26021068,0,0,0,155
27556,26021027,26021027,26021177,0,0,0,150
27557,26021138,26021138,26021294,0,0,0,156
27558,26021253,26021253,26021400,0,0,0,147
27559,26021359,26021359,26021506,0,0,0,147
27540,25995238,25995238,26021689,0,0,0,26451
27555,26020927,26020927,26021851,0,0,0,924
27541,25995526,25995526,26021894,0,0,0,26368
27562,26021805,26021805,26022734,0,0,0,929
27543,25997444,25997444,26027931,0,0,0,30487
27546,25998407,25998407,26028115,0,0,0,29708
27566,26028073,26028073,26028221,0,0,0,148
27569,26029065,26029065,26029545,0,0,0,480
27571,26029202,26029202,26029743,0,0,0,541
27570,26029113,26029113,26029749,0,0,0,636
27568,26028959,26028959,26030185,0,0,0,1226
27384,25885149,25885149,26032531,0,0,0,147382
27490,25947704,25947704,26032565,0,0,0,84861
27551,26016551,26016551,26032577,0,0,0,16026
27526,25974062,25974062,26032659,0,0,0,58597
27488,25946318,25946318,26032718,0,0,0,86400
27574,26032510,26032510,26032744,0,0,0,234
27572,26032335,26032335,26032899,0,0,0,564
27578,26032666,26032666,26032927,0,0,0,261
27581,26032823,26032823,26032981,0,0,0,158
27583,26033087,26033087,26033171,0,0,0,84
27577,26032637,26032637,26033237,0,0,0,600
27584,26033222,26033222,26033299,0,0,0,77
27585,26033320,26033320,26033396,0,0,0,76
27586,26033475,26033475,26033539,0,0,0,64
27580,26032727,26032727,26033557,0,0,0,830
27582,26032867,26032867,26033616,0,0,0,749
27588,26033543,26033543,26033632,0,0,0,89
27552,26017393,26017393,26033673,0,0,0,16280
27587,26033521,26033521,26033696,0,0,0,175
27553,26017410,26017410,26033698,0,0,0,16288
27573,26032404,26032404,26033736,0,0,0,1332
27589,26033574,26033574,26033748,0,0,0,174
27593,26033692,26033692,26033788,0,0,0,96
27377,25884337,25884337,26033855,0,0,0,149518
27378,25884343,25884343,26033861,0,0,0,149518
27595,26033765,26033765,26033870,0,0,0,105
27596,26033845,26033845,26033963,0,0,0,118
27598,26033954,26033954,26034178,0,0,0,224
27599,26034165,26034165,26034299,0,0,0,134
27600,26034275,26034275,26034361,0,0,0,86
27594,26033714,26033714,26034396,0,0,0,682
27601,26034409,26034409,26034505,0,0,0,96
27602,26034493,26034493,26034625,0,0,0,132
27524,25969407,25969407,26034823,0,0,0,65416
27579,26032689,26032689,26034841,0,0,0,2152
27591,26033642,26033642,26034929,0,0,0,1287
27603,26034802,26034802,26034937,0,0,0,135
27597,26033927,26033927,26035056,0,0,0,1129
27605,26035355,26035355,26035440,0,0,0,85
27607,26035790,26035790,26035848,0,0,0,58
27614,26036775,26036775,26036848,0,0,0,73
27610,26036175,26036175,26037078,0,0,0,903
27617,26037045,26037045,26037129,0,0,0,84
27576,26032565,26032565,26037262,0,0,0,4697
27618,26037181,26037181,26037269,0,0,0,88
27619,26037330,26037330,26037426,0,0,0,96
27620,26037485,26037485,26037541,0,0,0,56
27628,26038800,26038800,26038873,0,0,0,73
27627,26038786,26038786,26038881,0,0,0,95
27608,26035843,26035843,26038994,0,0,0,3151
27606,26035435,26035435,26039035,0,0,0,3600
27623,26038650,26038650,26039325,0,0,0,675
27624,26038671,26038671,26039344,0,0,0,673
27625,26038680,26038680,26039352,0,0,0,672
27626,26038699,26038699,26039375,0,0,0,676
27550,26016335,26016335,26039601,0,0,0,23266
27629,26039239,26039239,26039605,0,0,0,366
27621,26037561,26037561,26039929,0,0,0,2368
27631,26039684,26039684,26040025,0,0,0,341
27632,26040165,26040165,26040228,0,0,0,63
27635,26040253,26040253,26040326,0,0,0,73
27636,26040324,26040324,26040402,0,0,0,78
27633,26040165,26040165,26040518,0,0,0,353
27637,26040331,26040331,26040684,0,0,0,353
27639,26040696,26040696,26040739,0,0,0,43
27640,26040717,26040717,26040757,0,0,0,40
27634,26040193,26040193,26040924,0,0,0,731
27643,26041038,26041038,26041122,0,0,0,84
27641,26040811,26040811,26041182,0,0,0,371
27642,26040992,26040992,26041202,0,0,0,210
27644,26041219,26041219,26041454,0,0,0,235
27622,26038507,26038507,26041724,0,0,0,3217
27638,26040352,26040352,26041747,0,0,0,1395
27646,26041782,26041782,26041850,0,0,0,68
27648,26041875,26041875,26041964,0,0,0,89
27652,26042345,26042345,26042431,0,0,0,86
27653,26042409,26042409,26042489,0,0,0,80
27651,26042064,26042064,26042547,0,0,0,483
27654,26042435,26042435,26042798,0,0,0,363
27655,26042730,26042730,26042824,0,0,0,94
27647,26041792,26041792,26045059,0,0,0,3267
27407,25887633,25887633,26045200,0,0,0,157567
27657,26045408,26045408,26045481,0,0,0,73
27649,26041910,26041910,26045523,0,0,0,3613
27650,26042015,26042015,26045977,0,0,0,3962
27656,26045049,26045049,26046537,0,0,0,1488
27658,26046143,26046143,26047284,0,0,0,1141
27666,26047271,26047271,26047350,0,0,0,79
27662,26047226,26047226,26047427,0,0,0,201
27667,26047318,26047318,26047508,0,0,0,190
27670,26047454,26047454,26047771,0,0,0,317
27664,26047252,26047252,26047829,0,0,0,577
27673,26047603,26047603,26047839,0,0,0,236
27560,26021474,26021474,26047976,0,0,0,26502
27663,26047250,26047250,26048048,0,0,0,798
27665,26047265,26047265,26048052,0,0,0,787
27676,26047934,26047934,26048095,0,0,0,161
27668,26047396,26047396,26048138,0,0,0,742
27677,26048054,26048054,26048203,0,0,0,149
27561,26021652,26021652,26048220,0,0,0,26568
27672,26047544,26047544,26048267,0,0,0,723
27575,26032531,26032531,26048483,0,0,0,15952
27564,26022686,26022686,26048558,0,0,0,25872
27563,26021845,26021845,26048667,0,0,0,26822
27684,26048541,26048541,26048692,0,0,0,151
27675,26047749,26047749,26048714,0,0,0,965
27674,26047703,26047703,26048880,0,0,0,1177
27689,26049106,26049106,26049270,0,0,0,164
27688,26049057,26049057,26049307,0,0,0,250
27687,26049051,26049051,26049369,0,0,0,318
27690,26049129,26049129,26049390,0,0,0,261
27411,25889713,25889713,26049445,0,0,0,159732
27590,26033628,26033628,26049890,0,0,0,16262
27592,26033651,26033651,26049911,0,0,0,16260
27693,26050255,26050255,26050410,0,0,0,155
27694,26050448,26050448,26050604,0,0,0,156
27696,26051251,26051251,26051401,0,0,0,150
27695,26050935,26050935,26051466,0,0,0,531
27697,26051982,26051982,26052139,0,0,0,157
27698,26052288,26052288,26052376,0,0,0,88
27680,26048212,26048212,26052407,0,0,0,4195
27700,26052764,26052764,26052952,0,0,0,188
27701,26052782,26052782,26053310,0,0,0,528
27705,26053688,26053688,26053743,0,0,0,55
27393,25886817,25886817,26054074,0,0,0,167257
27704,26053464,26053464,26054178,0,0,0,714
27707,26054289,26054289,26054378,0,0,0,89
27706,26053741,26053741,26054622,0,0,0,881
27671,26047504,26047504,26055164,0,0,0,7660
27710,26055330,26055330,26055400,0,0,0,70
27660,26046584,26046584,26055797,0,0,0,9213
27703,26053445,26053445,26055893,0,0,0,2448
27711,26055527,26055527,26055924,0,0,0,397
27713,26056110,26056110,26056297,0,0,0,187
27659,26046555,26046555,26056312,0,0,0,9757
27715,26056656,26056656,26056791,0,0,0,135
27714,26056427,26056427,26056836,0,0,0,409
27699,26052659,26052659,26056980,0,0,0,4321
27681,26048269,26048269,26056992,0,0,0,8723
27604,26034802,26034802,26057281,0,0,0,22479
27565,26027883,26027883,26057732,0,0,0,29849
27719,26057695,26057695,26057847,0,0,0,152
27720,26057800,26057800,26057962,0,0,0,162
27567,26028179,26028179,26058121,0,0,0,29942
27717,26056933,26056933,26059555,0,0,0,2622
27716,26056931,26056931,26059582,0,0,0,2651
27723,26059537,26059537,26059865,0,0,0,328
27724,26059557,26059557,26059869,0,0,0,312
27718,26057552,26057552,26061132,0,0,0,3580
27725,26059821,26059821,26061612,0,0,0,1791
27728,26062726,26062726,26062773,0,0,0,47
27729,26062930,26062930,26062977,0,0,0,47
27730,26063021,26063021,26063079,0,0,0,58
27630,26039563,26039563,26063465,0,0,0,23902
27712,26055870,26055870,26063545,0,0,0,7675
27732,26063482,26063482,26063545,0,0,0,63
27682,26048443,26048443,26064292,0,0,0,15849
27735,26065701,26065701,26065810,0,0,0,109
27691,26049842,26049842,26066156,0,0,0,16314
27692,26049877,26049877,26066213,0,0,0,16336
27453,25900256,25900256,26069802,0,0,0,169546
27678,26048167,26048167,26074481,0,0,0,26314
27683,26048516,26048516,26074574,0,0,0,26058
27679,26048177,26048177,26074876,0,0,0,26699
27685,26048632,26048632,26075040,0,0,0,26408
27645,26041612,26041612,26075280,0,0,0,33668
27734,26064260,26064260,26079978,0,0,0,15718
27745,26076055,26076055,26080507,0,0,0,4452
27468,25909071,25909071,26081871,0,0,0,172800
27738,26066163,26066163,26082458,0,0,0,16295
27737,26066121,26066121,26082469,0,0,0,16348
27609,26036002,26036002,26084786,0,0,0,48784
27731,26063147,26063147,26084878,0,0,0,21731
27613,26036627,26036627,26085420,0,0,0,48793
27722,26058071,26058071,26087924,0,0,0,29853
27721,26057911,26057911,26088278,0,0,0,30367
27753,26087890,26087890,26088742,0,0,0,852
27755,26088701,26088701,26089548,0,0,0,847
27727,26061566,26061566,26091985,0,0,0,30419
27394,25886817,25886817,26095075,0,0,0,208258
27750,26079941,26079941,26095988,0,0,0,16047
27748,26076610,26076610,26097906,0,0,0,21296
27752,26082428,26082428,26098719,0,0,0,16291
27751,26082426,26082426,26098757,0,0,0,16331
27741,26074438,26074438,26100187,0,0,0,25749
27742,26074539,26074539,26100695,0,0,0,26156
27726,26059842,26059842,26101147,0,0,0,41305
27743,26074835,26074835,26101382,0,0,0,26547
27744,26074998,26074998,26101614,0,0,0,26616
27740,26072389,26072389,26106829,0,0,0,34440
27757,26095946,26095946,26112209,0,0,0,16263
27758,26098685,26098685,26114867,0,0,0,16182
27759,26098717,26098717,26114985,0,0,0,16268
27747,26076586,26076586,26116912,0,0,0,40326
27616,26036990,26036990,26117874,0,0,0,80884
27754,26088237,26088237,26118070,0,0,0,29833
27756,26089512,26089512,26119158,0,0,0,29646
27772,26119478,26119478,26119522,0,0,0,44
27773,26119758,26119758,26119829,0,0,0,71
27774,26120577,26120577,26120650,0,0,0,73
27775,26121035,26121035,26121111,0,0,0,76
27777,26123024,26123024,26123459,0,0,0,435
27778,26123338,26123338,26123532,0,0,0,194
27779,26123479,26123479,26123564,0,0,0,85
27780,26123622,26123622,26123670,0,0,0,48
27781,26123871,26123871,26124052,0,0,0,181
27782,26124065,26124065,26124138,0,0,0,73
27783,26124152,26124152,26124220,0,0,0,68
27784,26124196,26124196,26124316,0,0,0,120
27785,26124313,26124313,26124403,0,0,0,90
27786,26124575,26124575,26124687,0,0,0,112
27788,26124678,26124678,26124796,0,0,0,118
27790,26124824,26124824,26124944,0,0,0,120
27789,26124780,26124780,26124965,0,0,0,185
27794,26124955,26124955,26125071,0,0,0,116
27787,26124668,26124668,26125091,0,0,0,423
27791,26124922,26124922,26125117,0,0,0,195
27796,26125105,26125105,26125251,0,0,0,146
27749,26076924,26076924,26125295,0,0,0,48371
27797,26125261,26125261,26125409,0,0,0,148
27792,26124933,26125117,26125411,0,0,184,478
27469,25913682,25913682,26125645,0,0,0,211963
27793,26124948,26125411,26125674,0,0,463,726
27799,26125683,26125683,26125779,0,0,0,96
27798,26125406,26125406,26125848,0,0,0,442
27800,26125747,26125747,26125904,0,0,0,157
27801,26125876,26125876,26125915,0,0,0,39
27802,26126041,26126041,26126081,0,0,0,40
27760,26100144,26100144,26126209,0,0,0,26065
27804,26126166,26126166,26126316,0,0,0,150
27806,26126428,26126428,26126460,0,0,0,32
27803,26126149,26126149,26126475,0,0,0,326
27761,26100644,26100644,26126893,0,0,0,26249
27807,26126534,26126534,26126956,0,0,0,422
27611,26036340,26036340,26127110,0,0,0,90770
27816,26127363,26127363,26127489,0,0,0,126
27812,26127268,26127268,26127524,0,0,0,256
27763,26101570,26101570,26128193,0,0,0,26623
27764,26112163,26112163,26128349,0,0,0,16186
27762,26101340,26101340,26128365,0,0,0,27025
27820,26128018,26128018,26128417,0,0,0,399
27824,26128342,26128342,26129918,0,0,0,1576
27825,26128354,26128354,26129971,0,0,0,1617
27827,26130376,26130376,26130491,0,0,0,115
27828,26130447,26130447,26130529,0,0,0,82
27829,26130478,26130478,26130554,0,0,0,76
27831,26130831,26130831,26130926,0,0,0,95
27765,26114825,26114825,26131060,0,0,0,16235
27830,26130528,26130528,26131079,0,0,0,551
27767,26114938,26114938,26131113,0,0,0,16175
27835,26131969,26131969,26132037,0,0,0,68
27836,26131986,26131986,26132054,0,0,0,68
27826,26128780,26128780,26132359,0,0,0,3579
27837,26132161,26132161,26132450,0,0,0,289
27838,26132177,26132177,26132463,0,0,0,286
27839,26132383,26132383,26132793,0,0,0,410
27661,26046602,26046602,26133002,0,0,0,86400
27840,26133356,26133356,26133766,0,0,0,410
27669,26047402,26047402,26133802,0,0,0,86400
27733,26063525,26063525,26134277,0,0,0,70752
27841,26134170,26134170,26134425,0,0,0,255
27842,26134596,26134596,26134721,0,0,0,125
27686,26048848,26048848,26135248,0,0,0,86400
27843,26135504,26135504,26135563,0,0,0,59
27866,26135697,26135697,26135753,0,0,0,56
27854,26135694,26135694,26135828,0,0,0,134
27873,26135698,26135753,26135839,0,0,55,141
27858,26135695,26135695,26135845,0,0,0,150
27863,26135696,26135696,26135846,0,0,0,150
27844,26135654,26135654,26135851,0,0,0,197
27846,26135655,26135655,26135879,0,0,0,224
27848,26135686,26135686,26135879,0,0,0,193
27893,26135805,26135839,26135881,0,0,34,76
27860,26135695,26135695,26135885,0,0,0,190
27859,26135695,26135695,26135894,0,0,0,199
27880,26135699,26135828,26135903,0,0,129,204
27898,26135806,26135851,26135909,0,0,45,103
27847,26135655,26135655,26135912,0,0,0,257
27851,26135693,26135693,26135914,0,0,0,221
27855,26135694,26135694,26135915,0,0,0,221
27919,26135809,26135881,26135924,0,0,72,115
27867,26135697,26135846,26135943,0,0,149,246
27926,26135810,26135903,26135952,0,0,93,142
27869,26135697,26135845,26135953,0,0,148,256
27845,26135654,26135654,26135961,0,0,0,307
27849,26135692,26135692,26135980,0,0,0,288
27874,26135698,26135885,26135982,0,0,187,284
27875,26135698,26135879,26135987,0,0,181,289
27894,26135805,26135912,26135992,0,0,107,187
27852,26135693,26135693,26135993,0,0,0,300
27868,26135697,26135885,26135993,0,0,188,296
27850,26135692,26135692,26136000,0,0,0,308
27912,26135808,26135924,26136000,0,0,116,192
27856,26135694,26135694,26136004,0,0,0,310
27888,26135700,26135915,26136006,0,0,215,306
27899,26135806,26135943,26136023,0,0,137,217
27876,26135698,26135894,26136028,0,0,196,330
27864,26135696,26135885,26136035,0,0,189,339
27920,26135809,26135953,26136036,0,0,144,227
27906,26135807,26135879,26136037,0,0,72,230
27881,26135699,26135912,26136046,0,0,213,347
27887,26135700,26135912,26136046,0,0,212,346
27895,26135805,26135993,26136069,0,0,188,264
27882,26135699,26135980,26136071,0,0,281,372
27900,26135806,26136004,26136075,0,0,198,269
27928,26135810,26135987,26136076,0,0,177,266
27905,26135807,26136000,26136076,0,0,193,269
27913,26135808,26136006,26136077,0,0,198,269
27870,26135697,26135993,26136083,0,0,296,386
27889,26135700,26135982,26136084,0,0,282,384
27901,26135806,26136028,26136095,0,0,222,289
27927,26135810,26136023,26136101,0,0,213,291
27907,26135807,26136035,26136113,0,0,228,306
27934,26135827,26136046,26136135,0,0,219,308
27951,26136018,26136076,26136145,0,0,58,127
27914,26135808,26136069,26136147,0,0,261,339
27921,26135809,26136071,26136149,0,0,262,340
27929,26135810,26136071,26136149,0,0,261,339
27935,26135827,26136075,26136153,0,0,248,326
27865,26135696,26135961,26136157,0,0,265,461
27947,26136017,26136037,26136161,0,0,20,144
27922,26135809,26136095,26136173,0,0,286,364
27884,26135699,26136083,26136183,0,0,384,484
27861,26135695,26136000,26136197,0,0,305,502
27958,26136019,26136101,26136200,0,0,82,181
27972,26136021,26136145,26136205,0,0,124,184
27948,26136017,26136046,26136214,0,0,29,197
27908,26135807,26135914,26136218,0,0,107,411
27930,26135810,26136147,26136225,0,0,337,415
27961,26136019,26136149,26136230,0,0,130,211
27877,26135698,26136157,26136245,0,0,459,547
27966,26136020,26136149,26136248,0,0,129,228
27857,26135694,26135961,26136250,0,0,267,556
27938,26136014,26136014,26136259,0,0,0,245
27883,26135699,26135912,26136264,0,0,213,565
27965,26136020,26136076,26136266,0,0,56,246
27974,26136021,26136153,26136268,0,0,132,247
27952,26136018,26136113,26136271,0,0,95,253
27890,26135700,26136183,26136280,0,0,483,580
27871,26135697,26136197,26136284,0,0,500,587
27979,26136022,26136200,26136293,0,0,178,271
27980,26136022,26136218,26136322,0,0,196,300
27939,26136015,26136036,26136337,0,0,21,322
27959,26136019,26136264,26136345,0,0,245,326
27891,26135700,26136250,26136347,0,0,550,647
27902,26135806,26136280,26136355,0,0,474,549
27885,26135699,26136245,26136364,0,0,546,665
27949,26136017,26136225,26136371,0,0,208,354
27967,26136020,26136271,26136375,0,0,251,355
27943,26136016,26136076,26136377,0,0,60,361
27944,26136016,26136084,26136390,0,0,68,374
27878,26135698,26136284,26136397,0,0,586,699
27903,26135806,26136347,26136424,0,0,541,618
27909,26135807,26136355,26136424,0,0,548,617
27973,26136021,26136322,26136426,0,0,301,405
27910,26135807,26136364,26136434,0,0,557,627
27960,26136019,26136135,26136441,0,0,116,422
27915,26135808,26136375,26136444,0,0,567,636
27953,26136018,26136077,26136461,0,0,59,443
27975,26136021,26136149,26136462,0,0,128,441
27968,26136020,26136135,26136464,0,0,115,444
27940,26136015,26136173,26136479,0,0,158,464
27886,26135699,26136397,26136491,0,0,698,792
27916,26135808,26136424,26136494,0,0,616,686
27923,26135809,26136424,26136494,0,0,615,685
27936,26135827,26136426,26136496,0,0,599,669
27931,26135810,26136434,26136501,0,0,624,691
27896,26135805,26136491,26136564,0,0,686,759
27937,26135827,26136494,26136564,0,0,667,737
27962,26136019,26136496,26136582,0,0,477,563
27904,26135806,26136564,26136637,0,0,758,831
27954,26136018,26136494,26136645,0,0,476,627
27969,26136020,26136582,26136682,0,0,562,662
27917,26135808,26136637,26136712,0,0,829,904
27955,26136018,26136564,26136716,0,0,546,698
27981,26136022,26136645,26136748,0,0,623,726
27945,26136016,26136444,26136756,0,0,428,740
27924,26135809,26136712,26136785,0,0,903,976
27963,26136019,26136716,26136804,0,0,697,785
27946,26136016,26136501,26136815,0,0,485,799
27976,26136021,26136748,26136843,0,0,727,822
27932,26135810,26136785,26136858,0,0,975,1048
27982,26136022,26136804,26136910,0,0,782,888
27950,26136017,26136858,26137017,0,0,841,1000
27815,26127335,26127335,26137100,0,0,0,9765
27956,26136018,26137017,26137101,0,0,999,1083
27941,26136015,26136843,26137156,0,0,828,1141
27970,26136020,26137100,26137199,0,0,1080,1179
27977,26136021,26137101,26137201,0,0,1080,1180
27853,26135693,26137199,26137574,0,0,1506,1881
27862,26135695,26137574,26137809,0,0,1879,2114
27872,26135697,26137809,26137902,0,0,2112,2205
27879,26135698,26137902,26138038,0,0,2204,2340
27834,26131742,26131742,26138084,0,0,0,6342
27892,26135700,26138038,26138154,0,0,2338,2454
27897,26135805,26138154,26138222,0,0,2349,2417
27911,26135807,26138222,26138298,0,0,2415,2491
27918,26135808,26138298,26138373,0,0,2490,2565
27925,26135809,26138373,26138449,0,0,2564,2640
27933,26135826,26138449,26138534,0,0,2623,2708
27942,26136015,26138534,26138940,0,0,2519,2925
27746,26076369,26076369,26139072,0,0,0,62703
27957,26136018,26138940,26139107,0,0,2922,3089
27964,26136019,26139107,26139212,0,0,3088,3193
27971,26136020,26139212,26139328,0,0,3192,3308
27978,26136021,26139328,26139428,0,0,3307,3407
27983,26136051,26136345,26139916,0,0,294,3865
27984,26139710,26139710,26140575,0,0,0,865
27988,26140921,26140921,26140994,0,0,0,73
27990,26141313,26141313,26141567,0,0,0,254
27819,26127796,26127796,26142141,0,0,0,14345
27991,26142138,26142138,26142192,0,0,0,54
27992,26142323,26142323,26142427,0,0,0,104
27993,26142743,26142743,26142840,0,0,0,97
27994,26143188,26143188,26143241,0,0,0,53
27995,26143288,26143288,26143381,0,0,0,93
27769,26117679,26117679,26143472,0,0,0,25793
27822,26128303,26128303,26144562,0,0,0,16259
27996,26144001,26144001,26144601,0,0,0,600
28000,26145092,26145092,26145522,0,0,0,430
28001,26145529,26145529,26145809,0,0,0,280
27390,25886675,25886675,26145875,0,0,0,259200
28002,26145599,26145599,26145889,0,0,0,290
27399,25887050,25887050,26146250,0,0,0,259200
27400,25887050,25887050,26146250,0,0,0,259200
27401,25887050,25887050,26146250,0,0,0,259200
27814,26127306,26127306,26146572,0,0,0,19266
28003,26146023,26146023,26146772,0,0,0,749
28005,26146085,26146085,26146837,0,0,0,752
27770,26118035,26118035,26146870,0,0,0,28835
28006,26146165,26146165,26146902,0,0,0,737
27832,26131018,26131018,26147139,0,0,0,16121
27833,26131077,26131077,26147204,0,0,0,16127
27998,26144526,26144526,26147210,0,0,0,2684
27818,26127512,26127512,26147398,0,0,0,19886
27985,26139740,26139740,26147700,0,0,0,7960
27808,26126618,26126618,26148461,0,0,0,21843
27771,26119122,26119122,26148531,0,0,0,29409
28013,26148486,26148486,26148643,0,0,0,157
28015,26150002,26150002,26150041,0,0,0,39
28016,26150565,26150565,26150603,0,0,0,38
28017,26151058,26151058,26151415,0,0,0,357
27805,26126278,26126278,26152302,0,0,0,26024
27809,26126860,26126860,26153650,0,0,0,26790
27739,26072167,26072167,26153736,0,0,0,81569
27811,26126945,26126945,26153736,0,0,0,26791
27810,26126900,26126900,26153744,0,0,0,26844
28020,26153605,26153605,26153765,0,0,0,160
27989,26141083,26141083,26153872,0,0,0,12789
28025,26153998,26153998,26154109,0,0,0,111
27821,26128152,26128152,26154725,0,0,0,26573
27986,26139881,26139881,26155003,0,0,0,15122
27823,26128320,26128320,26155171,0,0,0,26851
28026,26154443,26154443,26155809,0,0,0,1366
28031,26157926,26157926,26158030,0,0,0,104
28030,26156872,26156872,26158146,0,0,0,1274
28012,26147292,26147292,26159405,0,0,0,12113
28021,26153713,26153713,26161510,0,0,0,7797
28024,26153751,26153751,26162333,0,0,0,8582
27813,26127288,26127288,26162959,0,0,0,35671
28011,26147093,26147093,26163189,0,0,0,16096
27795,26124959,26162959,26163292,0,0,38000,38333
28004,26146082,26146082,26164291,0,0,0,18209
28023,26153734,26153734,26165461,0,0,0,11727
28032,26165366,26165366,26165920,0,0,0,554
27615,26036839,26036839,26165944,0,0,0,129105
28039,26166106,26166106,26166173,0,0,0,67
27768,26117451,26117451,26166272,0,0,0,48821
28049,26169165,26169165,26169204,0,0,0,39
28019,26153344,26153344,26169410,0,0,0,16066
28043,26166176,26166176,26169599,0,0,0,3423
28048,26166237,26166237,26169652,0,0,0,3415
28045,26166200,26166200,26169741,0,0,0,3541
28056,26169699,26169699,26169752,0,0,0,53
28042,26166165,26166165,26169804,0,0,0,3639
28041,26166153,26166153,26169876,0,0,0,3723
28038,26166092,26166092,26170493,0,0,0,4401
28047,26166224,26166224,26170731,0,0,0,4507
28037,26166078,26166078,26170740,0,0,0,4662
28040,26166141,26166141,26170869,0,0,0,4728
28044,26166190,26166190,26171334,0,0,0,5144
28036,26166065,26166065,26171439,0,0,0,5374
28046,26166212,26166212,26171743,0,0,0,5531
28035,26166052,26166052,26172340,0,0,0,6288
28034,26166038,26166038,26174664,0,0,0,8626
28050,26169209,26169209,26174765,0,0,0,5556
28051,26169314,26169314,26174878,0,0,0,5564
28053,26169431,26169431,26175001,0,0,0,5570
28054,26169514,26169514,26175006,0,0,0,5492
28055,26169635,26169635,26175138,0,0,0,5503
28010,26146827,26146827,26175348,0,0,0,28521
28058,26175306,26175306,26175456,0,0,0,150
28057,26170016,26170016,26175539,0,0,0,5523
28018,26152255,26152255,26178096,0,0,0,25841
28014,26148598,26148598,26178966,0,0,0,30368
28022,26153717,26153717,26180470,0,0,0,26753
28033,26166022,26166022,26181115,0,0,0,15093
28027,26154674,26154674,26181422,0,0,0,26748
28028,26155125,26155125,26182062,0,0,0,26937
28052,26169373,26169373,26185442,0,0,0,16069
28060,26175505,26175505,26199633,0,0,0,24128
28066,26185396,26185396,26201303,0,0,0,15907
27766,26114920,26114920,26201320,0,0,0,86400
28070,26201045,26201045,26201451,0,0,0,406
27612,26036520,26036520,26201654,0,0,0,165134
28073,26202030,26202030,26202115,0,0,0,85
28075,26204392,26204392,26204432,0,0,0,40
28059,26175415,26175415,26204525,0,0,0,29110
28061,26178056,26178056,26204617,0,0,0,26561
28077,26204488,26204488,26204638,0,0,0,150
28076,26204435,26204435,26204672,0,0,0,237
28078,26204574,26204574,26204724,0,0,0,150
28079,26204597,26204597,26204746,0,0,0,149
28080,26204693,26204693,26204841,0,0,0,148
28082,26204793,26204793,26204945,0,0,0,152
28083,26204905,26204905,26205056,0,0,0,151
28085,26206118,26206118,26206153,0,0,0,35
28086,26206155,26206155,26206567,0,0,0,412
28063,26180435,26180435,26206724,0,0,0,26289
28064,26181383,26181383,26207678,0,0,0,26295
28089,26207651,26207651,26207710,0,0,0,59
28090,26207696,26207696,26207743,0,0,0,47
28091,26207732,26207732,26207837,0,0,0,105
28092,26207909,26207909,26207949,0,0,0,40
28093,26207962,26207962,26208068,0,0,0,106
28094,26208103,26208103,26208163,0,0,0,60
28095,26208156,26208156,26208214,0,0,0,58
28096,26208232,26208232,26208273,0,0,0,41
28062,26178930,26178930,26208332,0,0,0,29402
28097,26208289,26208289,26208437,0,0,0,148
28099,26208509,26208509,26208727,0,0,0,218
28101,26208860,26208860,26208900,0,0,0,40
28065,26182025,26182025,26209046,0,0,0,27021
28102,26208910,26208910,26209150,0,0,0,240
28106,26209156,26209156,26209206,0,0,0,50
28104,26209034,26209034,26209264,0,0,0,230
28108,26209221,26209221,26209301,0,0,0,80
28109,26209242,26209242,26209322,0,0,0,80
28107,26209182,26209182,26209414,0,0,0,232
28105,26209095,26209095,26209445,0,0,0,350
28110,26209298,26209298,26209511,0,0,0,213
28111,26209318,26209318,26209542,0,0,0,224
28100,26208595,26208595,26209593,0,0,0,998
28112,26209360,26209360,26209709,0,0,0,349
28116,26209681,26209681,26209734,0,0,0,53
28117,26209761,26209761,26209801,0,0,0,40
28113,26209495,26209495,26209873,0,0,0,378
28115,26209592,26209592,26209989,0,0,0,397
28114,26209582,26209582,26210031,0,0,0,449
28119,26209996,26209996,26210257,0,0,0,261
28120,26209999,26209999,26210548,0,0,0,549
28121,26210658,26210658,26210789,0,0,0,131
28122,26210691,26210691,26210819,0,0,0,128
28123,26210744,26210744,26210870,0,0,0,126
28124,26210792,26210792,26210929,0,0,0,137
28125,26210849,26210849,26210974,0,0,0,125
28126,26210878,26210878,26210993,0,0,0,115
28127,26210946,26210946,26211074,0,0,0,128
28128,26210976,26210976,26211097,0,0,0,121
28118,26209822,26209822,26211460,0,0,0,1638
28131,26211717,26211717,26211843,0,0,0,126
28132,26212089,26212089,26212190,0,0,0,101
28130,26211434,26211434,26212230,0,0,0,796
28134,26212524,26212524,26212573,0,0,0,49
28133,26212312,26212312,26212835,0,0,0,523
28136,26212807,26212807,26212902,0,0,0,95
28137,26213135,26213135,26213187,0,0,0,52
28138,26213144,26213144,26213483,0,0,0,339
28068,26200227,26200227,26213551,0,0,0,13324
28139,26213490,26213490,26213738,0,0,0,248
27817,26127467,26127467,26213867,0,0,0,86400
28140,26213768,26213768,26214073,0,0,0,305
28144,26214426,26214426,26214474,0,0,0,48
28142,26214114,26214114,26214665,0,0,0,551
28141,26214104,26214104,26214885,0,0,0,781
28145,26214491,26214491,26215091,0,0,0,600
28143,26214197,26214197,26215152,0,0,0,955
28069,26200749,26200749,26215220,0,0,0,14471
28146,26215296,26215296,26216021,0,0,0,725
28071,26201265,26201265,26217232,0,0,0,15967
28150,26218505,26218505,26218546,0,0,0,41
28152,26218628,26218628,26218667,0,0,0,39
28151,26218599,26218599,26218834,0,0,0,235
28153,26218818,26218818,26218954,0,0,0,136
28155,26219283,26219283,26219367,0,0,0,84
28154,26219282,26219282,26219377,0,0,0,95
28156,26219451,26219451,26219520,0,0,0,69
28157,26219472,26219472,26219592,0,0,0,120
28158,26219526,26219526,26219599,0,0,0,73
28159,26219674,26219674,26219746,0,0,0,72
28161,26219725,26219725,26219769,0,0,0,44
28160,26219700,26219700,26219772,0,0,0,72
28164,26220059,26220059,26220098,0,0,0,39
28165,26220132,26220132,26220171,0,0,0,39
28168,26220267,26220267,26220372,0,0,0,105
28166,26220256,26220256,26220389,0,0,0,133
28162,26219742,26219742,26220412,0,0,0,670
28170,26220381,26220381,26220457,0,0,0,76
28171,26220390,26220390,26220494,0,0,0,104
28172,26220465,26220465,26220598,0,0,0,133
28148,26217074,26217074,26220674,0,0,0,3600
28174,26220892,26220892,26220994,0,0,0,102
28175,26221008,26221008,26221066,0,0,0,58
28176,26221059,26221059,26221128,0,0,0,69
28173,26220667,26220667,26221267,0,0,0,600
28177,26221242,26221242,26221397,0,0,0,155
28178,26221381,26221381,26221467,0,0,0,86
28180,26221457,26221457,26221515,0,0,0,58
28181,26221527,26221527,26221574,0,0,0,47
28179,26221449,26221449,26221672,0,0,0,223
28182,26221648,26221648,26221725,0,0,0,77
28183,26221778,26221778,26221900,0,0,0,122
27736,26065924,26065924,26222232,0,0,0,156308
28186,26222186,26222186,26222306,0,0,0,120
28185,26221978,26221978,26222410,0,0,0,432
28187,26222706,26222706,26222810,0,0,0,104
28188,26222888,26222888,26222957,0,0,0,69
28190,26223006,26223006,26223121,0,0,0,115
28189,26222902,26222902,26223909,0,0,0,1007
28191,26223939,26223939,26224044,0,0,0,105
28192,26224035,26224035,26224212,0,0,0,177
28194,26224341,26224341,26224425,0,0,0,84
28195,26224455,26224455,26224559,0,0,0,104
28196,26224542,26224542,26224619,0,0,0,77
28193,26224268,26224268,26224658,0,0,0,390
28197,26224737,26224737,26224817,0,0,0,80
28198,26224758,26224758,26224827,0,0,0,69
27776,26121057,26121057,26224916,0,0,0,103859
28200,26224853,26224853,26225032,0,0,0,179
28199,26224847,26224847,26225278,0,0,0,431
28202,26225298,26225298,26225371,0,0,0,73
28203,26225682,26225682,26225867,0,0,0,185
28204,26226096,26226096,26226154,0,0,0,58
28205,26226147,26226147,26226187,0,0,0,40
28207,26226489,26226489,26226532,0,0,0,43
28206,26226215,26226215,26226539,0,0,0,324
28209,26226555,26226555,26226628,0,0,0,73
27987,26140580,26140580,26226980,0,0,0,86400
28208,26226508,26226508,26227108,0,0,0,600
28210,26226982,26226982,26227114,0,0,0,132
27997,26144501,26144501,26227447,0,0,0,82946
27708,26055156,26055156,26227956,0,0,0,172800
27709,26055212,26055212,26228012,0,0,0,172800
28214,26228502,26228502,26228612,0,0,0,110
28216,26228651,26228651,26228711,0,0,0,60
28217,26229397,26229397,26229446,0,0,0,49
28218,26229457,26229457,26229545,0,0,0,88
28212,26227501,26227501,26229554,0,0,0,2053
28084,26205020,26205020,26231383,0,0,0,26363
28220,26231466,26231466,26231524,0,0,0,58
28221,26231882,26231882,26231913,0,0,0,31
28222,26232112,26232112,26232202,0,0,0,90
27398,25886887,25886887,26232487,0,0,0,345600
28223,26232450,26232450,26232543,0,0,0,93
28224,26232514,26232514,26232603,0,0,0,89
28225,26232573,26232573,26232623,0,0,0,50
28087,26206681,26206681,26232871,0,0,0,26190
28149,26217182,26217182,26233142,0,0,0,15960
28228,26233344,26233344,26233385,0,0,0,41
28081,26204703,26204703,26233773,0,0,0,29070
28088,26207642,26207642,26234439,0,0,0,26797
28229,26233373,26233373,26235022,0,0,0,1649
28235,26234986,26234986,26235036,0,0,0,50
28234,26234969,26234969,26235053,0,0,0,84
28236,26235067,26235067,26235104,0,0,0,37
28239,26235240,26235240,26235297,0,0,0,57
28241,26235282,26235282,26235321,0,0,0,39
28240,26235249,26235249,26235355,0,0,0,106
28244,26235658,26235658,26235696,0,0,0,38
28242,26235318,26235318,26235698,0,0,0,380
28245,26235681,26235681,26235833,0,0,0,152
28247,26235803,26235803,26235853,0,0,0,50
28243,26235504,26235504,26236120,0,0,0,616
28248,26236104,26236104,26236153,0,0,0,49
28103,26208996,26208996,26236162,0,0,0,27166
28251,26236258,26236258,26236298,0,0,0,40
28252,26236633,26236633,26236672,0,0,0,39
28253,26237587,26237587,26237702,0,0,0,115
28163,26220013,26220013,26238013,0,0,0,18000
28246,26235721,26235721,26238161,0,0,0,2440
28098,26208392,26208392,26238175,0,0,0,29783
28255,26238137,26238137,26238290,0,0,0,153
28233,26234946,26234946,26238546,0,0,0,3600
28258,26238458,26238458,26238633,0,0,0,175
28257,26238426,26238426,26238791,0,0,0,365
28254,26237761,26237761,26242318,0,0,0,4557
28227,26233108,26233108,26249279,0,0,0,16171
28147,26215473,26215473,26250691,0,0,0,35218
28219,26231332,26231332,26257901,0,0,0,26569
28226,26232823,26232823,26259211,0,0,0,26388
28129,26211222,26211222,26259993,0,0,0,48771
28231,26234394,26234394,26261244,0,0,0,26850
28249,26236125,26236125,26262570,0,0,0,26445
28230,26233731,26233731,26262976,0,0,0,29245
28264,26262934,26262934,26263089,0,0,0,155
28265,26263044,26263044,26263194,0,0,0,150
28259,26249228,26249228,26265555,0,0,0,16327
28256,26238250,26238250,26268352,0,0,0,30102
28267,26265521,26265521,26281820,0,0,0,16299
28260,26257868,26257868,26284470,0,0,0,26602
28261,26259170,26259170,26285478,0,0,0,26308
28262,26261203,26261203,26287716,0,0,0,26513
28263,26262519,26262519,26289456,0,0,0,26937
28266,26263154,26263154,26293129,0,0,0,29975
28074,26202517,26202517,26296272,0,0,0,93755
28067,26199718,26199718,26296277,0,0,0,96559
28029,26155845,26155845,26296288,0,0,0,140443
28275,26296645,26296645,26296703,0,0,0,58
28269,26281777,26281777,26298061,0,0,0,16284
28268,26268309,26268309,26298073,0,0,0,29764
28278,26297376,26297376,26298601,0,0,0,1225
28135,26212727,26212727,26299127,0,0,0,86400
28279,26297400,26297400,26304589,0,0,0,7189
28211,26227407,26227407,26310675,0,0,0,83268
28169,26220270,26220270,26311016,0,0,0,90746
28270,26284424,26284424,26311181,0,0,0,26757
28201,26225083,26225083,26311483,0,0,0,86400
27702,26053321,26053321,26312521,0,0,0,259200
28281,26298019,26298019,26314332,0,0,0,16313
28271,26287674,26287674,26314826,0,0,0,27152
28215,26228586,26228586,26314986,0,0,0,86400
28167,26220262,26220262,26316492,0,0,0,96230
28280,26297415,26297415,26318838,0,0,0,21423
28237,26235178,26235178,26321578,0,0,0,86400
28238,26235199,26235199,26321599,0,0,0,86400
28272,26293086,26293086,26322642,0,0,0,29556
28295,26326250,26326250,26326323,0,0,0,73
28296,26326524,26326524,26326597,0,0,0,73
28282,26298034,26298034,26327394,0,0,0,29360
28286,26314294,26314294,26330611,0,0,0,16317
28285,26311138,26311138,26337369,0,0,0,26231
28184,26221840,26221840,26340085,0,0,0,118245
28287,26314784,26314784,26341524,0,0,0,26740
28298,26330561,26330561,26346863,0,0,0,16302
28304,26347536,26347536,26347646,0,0,0,110
28305,26347634,26347634,26347726,0,0,0,92
28306,26347671,26347671,26347780,0,0,0,109
28308,26347774,26347774,26347988,0,0,0,214
28307,26347758,26347758,26347994,0,0,0,236
28310,26348215,26348215,26349695,0,0,0,1480
28290,26322596,26322596,26352684,0,0,0,30088
28297,26327351,26327351,26356769,0,0,0,29418
27999,26144762,26144762,26358635,0,0,0,213873
28274,26296594,26296594,26359840,0,0,0,63246
28277,26296811,26296811,26361603,0,0,0,64792
28276,26296764,26296764,26361786,0,0,0,65022
28303,26346828,26346828,26363147,0,0,0,16319
28299,26337322,26337322,26363826,0,0,0,26504
28300,26341481,26341481,26368167,0,0,0,26686
28288,26321241,26321241,26372633,0,0,0,51392
28072,26201995,26201995,26373128,0,0,0,171133
28289,26322339,26322339,26373875,0,0,0,51536
28291,26323216,26323216,26374698,0,0,0,51482
28292,26323359,26323359,26374971,0,0,0,51612
28293,26323594,26323594,26375292,0,0,0,51698
28294,26325651,26325651,26377194,0,0,0,51543
28319,26363099,26363099,26379431,0,0,0,16332
28317,26352647,26352647,26382804,0,0,0,30157
28322,26382763,26382763,26382913,0,0,0,150
28323,26382883,26382883,26383034,0,0,0,151
28324,26382997,26382997,26383146,0,0,0,149
28325,26383104,26383104,26383254,0,0,0,150
28309,26348198,26348198,26383999,0,0,0,35801
28311,26348219,26348219,26385459,0,0,0,37240
28318,26356725,26356725,26386572,0,0,0,29847
28343,26388582,26388582,26388655,0,0,0,73
28347,26390778,26390778,26390835,0,0,0,57
28316,26351176,26351176,26390940,0,0,0,39764
28356,26391078,26391078,26391164,0,0,0,86
28357,26391598,26391598,26391663,0,0,0,65
28358,26391791,26391791,26391864,0,0,0,73
28374,26392371,26392371,26392444,0,0,0,73
28375,26392540,26392540,26392613,0,0,0,73
28376,26392878,26392878,26392950,0,0,0,72
28377,26393028,26393028,26393113,0,0,0,85
28378,26393414,26393414,26393498,0,0,0,84
28250,26236147,26236147,26393564,0,0,0,157417
28284,26310633,26310633,26393565,0,0,0,82932
28379,26393568,26393568,26393649,0,0,0,81
28213,26227679,26227679,26394033,0,0,0,166354
28380,26394457,26394457,26394541,0,0,0,84
28381,26394617,26394617,26394706,0,0,0,89
28382,26394864,26394864,26394949,0,0,0,85
28320,26368126,26368126,26395275,0,0,0,27149
28383,26395333,26395333,26395417,0,0,0,84
28337,26387699,26387699,26395786,0,0,0,8087
28321,26379389,26379389,26395818,0,0,0,16429
28342,26387721,26387721,26395851,0,0,0,8130
28339,26387709,26387709,26396079,0,0,0,8370
28336,26387693,26387693,26396274,0,0,0,8581
28335,26387688,26387688,26396453,0,0,0,8765
28354,26391010,26391010,26396656,0,0,0,5646
28355,26391040,26391040,26396697,0,0,0,5657
28353,26390986,26390986,26397775,0,0,0,6789
28341,26387717,26387717,26397971,0,0,0,10254
28333,26387680,26387680,26398186,0,0,0,10506
28352,26390908,26390908,26398538,0,0,0,7630
28332,26387675,26387675,26398728,0,0,0,11053
28334,26387684,26387684,26398925,0,0,0,11241
28351,26390884,26390884,26398939,0,0,0,8055
28338,26387705,26387705,26399946,0,0,0,12241
28345,26390745,26390745,26400240,0,0,0,9495
28331,26387672,26387672,26400603,0,0,0,12931
28340,26387712,26387712,26400838,0,0,0,13126
28385,26402072,26402072,26402157,0,0,0,85
28373,26392205,26392205,26402307,0,0,0,10102
28368,26392192,26392192,26402392,0,0,0,10200
28387,26402586,26402586,26402685,0,0,0,99
28330,26387667,26387667,26402689,0,0,0,15022
28370,26392197,26392197,26402737,0,0,0,10540
28367,26392188,26392188,26403076,0,0,0,10888
28366,26392185,26392185,26403289,0,0,0,11104
28349,26390829,26390829,26404251,0,0,0,13422
28346,26390773,26390773,26404763,0,0,0,13990
28348,26390808,26390808,26404837,0,0,0,14029
28344,26390725,26390725,26405125,0,0,0,14400
28350,26390855,26390855,26405255,0,0,0,14400
28372,26392202,26392202,26405294,0,0,0,13092
28007,26146545,26146545,26405745,0,0,0,259200
28008,26146546,26146546,26405746,0,0,0,259200
28009,26146546,26146546,26405746,0,0,0,259200
28363,26392177,26392177,26406163,0,0,0,13986
28365,26392182,26392182,26406354,0,0,0,14172
28369,26392194,26392194,26407766,0,0,0,15572
28388,26407893,26407893,26407968,0,0,0,75
28329,26387664,26387664,26408076,0,0,0,20412
28302,26342964,26342964,26408158,0,0,0,65194
28273,26296379,26296379,26408169,0,0,0,111790
28301,26342459,26342459,26408171,0,0,0,65712
28364,26392179,26392179,26408253,0,0,0,16074
28362,26392171,26392171,26408403,0,0,0,16232
28371,26392199,26392199,26408709,0,0,0,16510
28361,26392168,26392168,26411126,0,0,0,18958
28384,26395783,26395783,26412121,0,0,0,16338
28326,26383213,26383213,26413381,0,0,0,30168
28399,26413311,26413311,26414069,0,0,0,758
28389,26407937,26407937,26414666,0,0,0,6729
28409,26414750,26414750,26415558,0,0,0,808
28395,26408805,26408805,26415665,0,0,0,6860
28396,26408826,26408826,26415683,0,0,0,6857
28397,26408849,26408849,26415705,0,0,0,6856
28392,26408741,26408741,26415998,0,0,0,7257
28393,26408760,26408760,26416032,0,0,0,7272
28327,26386531,26386531,26416159,0,0,0,29628
28328,26387658,26387658,26416458,0,0,0,28800
28360,26392165,26392165,26417845,0,0,0,25680
28402,26413350,26413350,26418993,0,0,0,5643
28394,26408781,26408781,26419577,0,0,0,10796
28400,26413330,26413330,26420477,0,0,0,7147
28359,26392161,26392161,26420961,0,0,0,28800
28411,26415546,26415546,26426341,0,0,0,10795
28390,26407949,26407949,26426440,0,0,0,18491
28398,26412079,26412079,26428398,0,0,0,16319
28403,26413367,26413367,26442340,0,0,0,28973
28401,26413332,26413332,26443416,0,0,0,30084
28419,26443377,26443377,26443528,0,0,0,151
28410,26415086,26415086,26444002,0,0,0,28916
28418,26428354,26428354,26444665,0,0,0,16311
28412,26416117,26416117,26445486,0,0,0,29369
28422,26445446,26445446,26445603,0,0,0,157
28283,26308263,26308263,26447031,0,0,0,138768
28404,26413388,26413388,26454807,0,0,0,41419
28421,26444616,26444616,26460994,0,0,0,16378
28391,26408228,26408228,26462370,0,0,0,54142
28427,26462375,26462375,26462442,0,0,0,67
28429,26462961,26462961,26463349,0,0,0,388
28315,26350102,26350102,26464179,0,0,0,114077
28431,26464364,26464364,26464405,0,0,0,41
28433,26464474,26464474,26464543,0,0,0,69
28434,26464483,26464483,26464553,0,0,0,70
28436,26464528,26464528,26464606,0,0,0,78
28438,26464663,26464663,26464732,0,0,0,69
28440,26464794,26464794,26464874,0,0,0,80
28442,26464846,26464846,26464926,0,0,0,80
28443,26464893,26464893,26464968,0,0,0,75
28452,26465909,26465909,26466014,0,0,0,105
28451,26465357,26465357,26466529,0,0,0,1172
28453,26467036,26467036,26467076,0,0,0,40
28455,26467605,26467605,26467722,0,0,0,117
28460,26467831,26467831,26467935,0,0,0,104
28462,26468058,26468058,26468941,0,0,0,883
28461,26467929,26467929,26469115,0,0,0,1186
28463,26469153,26469153,26469193,0,0,0,40
28454,26467421,26467421,26470059,0,0,0,2638
28464,26470065,26470065,26470115,0,0,0,50
28465,26470103,26470103,26470146,0,0,0,43
28466,26470124,26470124,26470213,0,0,0,89
28467,26470148,26470148,26470235,0,0,0,87
28469,26470346,26470346,26470448,0,0,0,102
28470,26470436,26470436,26470536,0,0,0,100
28471,26470502,26470502,26470598,0,0,0,96
28468,26470286,26470286,26470644,0,0,0,358
28472,26470616,26470616,26470687,0,0,0,71
28435,26464512,26464512,26470976,0,0,0,6464
28437,26464557,26464557,26471028,0,0,0,6471
28475,26471038,26471038,26471122,0,0,0,84
28459,26467727,26467727,26472357,0,0,0,4630
28457,26467684,26467684,26472358,0,0,0,4674
28458,26467696,26467696,26472359,0,0,0,4663
28456,26467668,26467668,26472364,0,0,0,4696
28476,26471174,26471174,26472486,0,0,0,1312
28420,26443488,26443488,26473271,0,0,0,29783
28423,26445556,26445556,26473490,0,0,0,27934
28477,26471645,26471645,26474617,0,0,0,2972
28489,26474342,26474342,26475646,0,0,0,1304
28491,26475652,26475652,26475715,0,0,0,63
28490,26475651,26475651,26475726,0,0,0,75
28492,26475787,26475787,26475861,0,0,0,74
28495,26476100,26476100,26476173,0,0,0,73
28496,26476826,26476826,26476899,0,0,0,73
28314,26349617,26349617,26477163,0,0,0,127546
28439,26464773,26464773,26477175,0,0,0,12402
28425,26460952,26460952,26477182,0,0,0,16230
28499,26477266,26477266,26477341,0,0,0,75
28500,26477277,26477277,26477341,0,0,0,64
28498,26477252,26477252,26477391,0,0,0,139
28503,26477390,26477390,26477443,0,0,0,53
28507,26477448,26477448,26477497,0,0,0,49
28502,26477323,26477323,26477511,0,0,0,188
28501,26477316,26477316,26477526,0,0,0,210
28506,26477436,26477436,26477591,0,0,0,155
28510,26477611,26477611,26477699,0,0,0,88
28511,26477639,26477639,26477790,0,0,0,151
28513,26477759,26477759,26477808,0,0,0,49
28514,26477996,26477996,26478040,0,0,0,44
28430,26464161,26464161,26479259,0,0,0,15098
28516,26479786,26479786,26479834,0,0,0,48
28515,26478034,26478034,26480306,0,0,0,2272
28518,26480403,26480403,26480455,0,0,0,52
28517,26479823,26479823,26480983,0,0,0,1160
28519,26481071,26481071,26481134,0,0,0,63
28520,26481112,26481112,26481158,0,0,0,46
28522,26481339,26481339,26481377,0,0,0,38
28521,26481153,26481153,26481378,0,0,0,225
28524,26481994,26481994,26482052,0,0,0,58
28525,26482081,26482081,26482121,0,0,0,40
28523,26481356,26481356,26483011,0,0,0,1655
28529,26483394,26483394,26483536,0,0,0,142
28530,26483446,26483446,26483597,0,0,0,151
28531,26483612,26483612,26483758,0,0,0,146
28532,26483906,26483906,26483979,0,0,0,73
28312,26349136,26349136,26484520,0,0,0,135384
28533,26484508,26484508,26484610,0,0,0,102
28313,26349156,26349156,26484651,0,0,0,135495
28526,26482370,26482370,26484675,0,0,0,2305
28527,26482384,26482384,26484681,0,0,0,2297
28528,26482393,26482393,26484690,0,0,0,2297
28432,26464463,26464463,26484789,0,0,0,20326
28536,26484950,26484950,26485010,0,0,0,60
28535,26484929,26484929,26485053,0,0,0,124
28534,26484866,26484866,26485090,0,0,0,224
28537,26485705,26485705,26485745,0,0,0,40
28538,26485717,26485717,26485752,0,0,0,35
28541,26485815,26485815,26485948,0,0,0,133
28539,26485767,26485767,26486947,0,0,0,1180
28543,26487026,26487026,26487130,0,0,0,104
28544,26488540,26488540,26488613,0,0,0,73
28512,26477667,26477667,26490696,0,0,0,13029
28497,26477143,26477143,26493354,0,0,0,16211
28232,26234534,26234534,26493734,0,0,0,259200
28553,26494164,26494164,26494223,0,0,0,59
28545,26488714,26488714,26494373,0,0,0,5659
28551,26493908,26493908,26494506,0,0,0,598
28555,26494752,26494752,26494811,0,0,0,59
28554,26494527,26494527,26495072,0,0,0,545
28546,26488760,26488760,26495085,0,0,0,6325
28556,26495032,26495032,26495285,0,0,0,253
28557,26495570,26495570,26495727,0,0,0,157
28558,26495689,26495689,26495841,0,0,0,152
28560,26495925,26495925,26495963,0,0,0,38
28561,26495929,26495929,26496098,0,0,0,169
28405,26413410,26413410,26497967,0,0,0,84557
28447,26465049,26465049,26498065,0,0,0,33016
28448,26465069,26465069,26498082,0,0,0,33013
28449,26465086,26465086,26498170,0,0,0,33084
28450,26465105,26465105,26498183,0,0,0,33078
28562,26498651,26498651,26499069,0,0,0,418
28406,26413435,26413435,26499835,0,0,0,86400
28407,26413459,26413459,26499859,0,0,0,86400
28408,26413481,26413481,26499881,0,0,0,86400
28441,26464819,26464819,26501101,0,0,0,36282
28488,26473444,26473444,26502236,0,0,0,28792
28563,26502204,26502204,26502355,0,0,0,151
28487,26473234,26473234,26502739,0,0,0,29505
28494,26475914,26475914,26502987,0,0,0,27073
28493,26475913,26475913,26503019,0,0,0,27106
28504,26477409,26477409,26503056,0,0,0,25647
28505,26477433,26477433,26503131,0,0,0,25698
28508,26477469,26477469,26503327,0,0,0,25858
28509,26477484,26477484,26503342,0,0,0,25858
28570,26503285,26503285,26506199,0,0,0,2914
28571,26503311,26503311,26506221,0,0,0,2910
28582,26507081,26507081,26507746,0,0,0,665
28584,26507227,26507227,26508302,0,0,0,1075
28549,26493305,26493305,26509429,0,0,0,16124
28580,26506820,26506820,26510171,0,0,0,3351
28581,26506836,26506836,26514822,0,0,0,7986
28547,26490926,26490926,26518439,0,0,0,27513
28473,26470629,26470629,26522537,0,0,0,51908
28474,26470896,26470896,26522537,0,0,0,51641
28480,26471959,26471959,26523555,0,0,0,51596
28479,26471865,26471865,26523677,0,0,0,51812
28481,26472274,26472274,26524147,0,0,0,51873
28482,26472514,26472514,26524330,0,0,0,51816
28586,26509394,26509394,26525438,0,0,0,16044
28565,26502689,26502689,26532636,0,0,0,29947
28564,26502313,26502313,26532655,0,0,0,30342
28591,26532619,26532619,26533060,0,0,0,441
28577,26506488,26506488,26533447,0,0,0,26959
28414,26417289,26417289,26535726,0,0,0,118437
28590,26525387,26525387,26541369,0,0,0,15982
28585,26508317,26508317,26544551,0,0,0,36234
28583,26507194,26507194,26544593,0,0,0,37399
28594,26546366,26546366,26546439,0,0,0,73
28596,26548771,26548771,26548892,0,0,0,121
28597,26548953,26548953,26549000,0,0,0,47
28575,26506483,26506483,26550432,0,0,0,43949
28576,26506487,26506487,26550448,0,0,0,43961
28599,26550091,26550091,26553739,0,0,0,3648
28606,26556019,26556019,26556154,0,0,0,135
28609,26557189,26557189,26557305,0,0,0,116
28593,26541337,26541337,26557403,0,0,0,16066
28603,26554854,26554854,26557587,0,0,0,2733
28598,26549631,26549631,26557702,0,0,0,8071
28611,26557822,26557822,26557939,0,0,0,117
28613,26558032,26558032,26558212,0,0,0,180
28615,26558192,26558192,26558241,0,0,0,49
28622,26558654,26558654,26558730,0,0,0,76
28483,26472687,26472687,26559087,0,0,0,86400
28484,26472698,26472698,26559098,0,0,0,86400
28626,26559026,26559026,26559101,0,0,0,75
28485,26472707,26472707,26559107,0,0,0,86400
28486,26472718,26472718,26559118,0,0,0,86400
28627,26559075,26559075,26559152,0,0,0,77
28628,26559131,26559131,26559208,0,0,0,77
28629,26559260,26559260,26559324,0,0,0,64
28630,26559450,26559450,26559527,0,0,0,77
28631,26559472,26559472,26559600,0,0,0,128
28632,26559604,26559604,26559678,0,0,0,74
28633,26559702,26559702,26559773,0,0,0,71
28634,26559764,26559764,26559807,0,0,0,43
28635,26559836,26559836,26559911,0,0,0,75
28637,26560020,26560020,26560111,0,0,0,91
28638,26560188,26560188,26560370,0,0,0,182
28640,26560501,26560501,26560585,0,0,0,84
28641,26561539,26561539,26561629,0,0,0,90
28642,26561926,26561926,26561993,0,0,0,67
28643,26562205,26562205,26562277,0,0,0,72
28644,26562429,26562429,26562507,0,0,0,78
28645,26562572,26562572,26562650,0,0,0,78
28646,26562813,26562813,26562891,0,0,0,78
28592,26533021,26533021,26563002,0,0,0,29981
28648,26563344,26563344,26563453,0,0,0,109
28649,26563529,26563529,26563607,0,0,0,78
28559,26495849,26495849,26563650,0,0,0,67801
28650,26564075,26564075,26564148,0,0,0,73
28651,26564105,26564105,26564183,0,0,0,78
28608,26557150,26557150,26564328,0,0,0,7178
28652,26564730,26564730,26564808,0,0,0,78
28653,26565069,26565069,26565142,0,0,0,73
28654,26565177,26565177,26565289,0,0,0,112
28655,26565228,26565228,26565299,0,0,0,71
28656,26565306,26565306,26565379,0,0,0,73
28657,26565395,26565395,26565470,0,0,0,75
28659,26565451,26565451,26565531,0,0,0,80
28660,26565502,26565502,26565574,0,0,0,72
28604,26555466,26555466,26565576,0,0,0,10110
28661,26565515,26565515,26565615,0,0,0,100
28605,26555486,26555486,26565618,0,0,0,10132
28662,26565553,26565553,26565631,0,0,0,78
28665,26565779,26565779,26565852,0,0,0,73
28658,26565410,26565410,26565929,0,0,0,519
28667,26566227,26566227,26566340,0,0,0,113
28671,26566284,26566284,26566435,0,0,0,151
28672,26566356,26566356,26566437,0,0,0,81
28666,26565992,26565992,26566505,0,0,0,513
28674,26566481,26566481,26566574,0,0,0,93
28676,26566704,26566704,26566796,0,0,0,92
28677,26566881,26566881,26566957,0,0,0,76
28675,26566483,26566483,26566993,0,0,0,510
28679,26567135,26567135,26567273,0,0,0,138
28681,26567287,26567287,26567327,0,0,0,40
28680,26567272,26567272,26567367,0,0,0,95
28668,26566246,26566246,26567706,0,0,0,1460
28670,26566270,26566270,26567731,0,0,0,1461
28669,26566251,26566251,26567908,0,0,0,1657
28682,26568410,26568410,26568493,0,0,0,83
28683,26568681,26568681,26568763,0,0,0,82
28567,26503001,26503001,26568884,0,0,0,65883
28569,26503091,26503091,26568886,0,0,0,65795
28601,26550409,26550409,26568886,0,0,0,18477
28568,26503027,26503027,26568888,0,0,0,65861
28573,26506156,26506156,26568888,0,0,0,62732
28600,26550389,26550389,26568888,0,0,0,18499
28566,26502984,26502984,26568889,0,0,0,65905
28572,26503825,26503825,26568892,0,0,0,65067
28574,26506189,26506189,26568892,0,0,0,62703
28684,26568850,26568850,26568934,0,0,0,84
28607,26556227,26556227,26568944,0,0,0,12717
28664,26565597,26565597,26569061,0,0,0,3464
28673,26566409,26566409,26569061,0,0,0,2652
28663,26565570,26565570,26569067,0,0,0,3497
28686,26569030,26569030,26569131,0,0,0,101
28697,26569209,26569209,26569291,0,0,0,82
28698,26569365,26569365,26569460,0,0,0,95
28639,26560376,26560376,26569539,0,0,0,9163
28700,26569514,26569514,26569602,0,0,0,88
28701,26569699,26569699,26569800,0,0,0,101
28703,26569910,26569910,26569994,0,0,0,84
28704,26570036,26570036,26570112,0,0,0,76
28706,26571053,26571053,26571192,0,0,0,139
28707,26571062,26571062,26571200,0,0,0,138
28708,26571076,26571076,26571212,0,0,0,136
28710,26571468,26571468,26571569,0,0,0,101
28712,26571739,26571739,26571823,0,0,0,84
28714,26571874,26571874,26571978,0,0,0,104
28715,26572035,26572035,26572119,0,0,0,84
28717,26572183,26572183,26572267,0,0,0,84
28718,26572526,26572526,26572622,0,0,0,96
28720,26572659,26572659,26572744,0,0,0,85
28719,26572632,26572632,26572845,0,0,0,213
28685,26569022,26569022,26572926,0,0,0,3904
28722,26572951,26572951,26572996,0,0,0,45
28687,26569041,26569041,26572997,0,0,0,3956
28724,26572971,26572971,26573083,0,0,0,112
28610,26557362,26557362,26573311,0,0,0,15949
28725,26573222,26573222,26573324,0,0,0,102
28727,26573386,26573386,26573479,0,0,0,93
28386,26402436,26402436,26573534,0,0,0,171098
28728,26573760,26573760,26573883,0,0,0,123
28729,26574216,26574216,26574342,0,0,0,126
28730,26574321,26574321,26574374,0,0,0,53
28734,26575049,26575049,26575162,0,0,0,113
28735,26575141,26575141,26575209,0,0,0,68
28721,26572883,26572883,26575429,0,0,0,2546
28723,26572958,26572958,26575537,0,0,0,2579
28738,26575409,26575409,26575574,0,0,0,165
28733,26574853,26574853,26575818,0,0,0,965
28739,26575508,26575508,26576728,0,0,0,1220
28740,26575535,26575535,26576744,0,0,0,1209
28743,26575916,26575916,26576859,0,0,0,943
28742,26575559,26575559,26577066,0,0,0,1507
28741,26575555,26575555,26577169,0,0,0,1614
28749,26577361,26577361,26577490,0,0,0,129
28746,26577050,26577050,26577875,0,0,0,825
28750,26577609,26577609,26578433,0,0,0,824
28752,26578380,26578380,26579109,0,0,0,729
28416,26424195,26424195,26579151,0,0,0,154956
28756,26579449,26579449,26579502,0,0,0,53
28751,26577840,26577840,26580064,0,0,0,2224
28758,26580520,26580520,26580573,0,0,0,53
28759,26582296,26582296,26582356,0,0,0,60
28760,26582662,26582662,26582722,0,0,0,60
28614,26558058,26558058,26583371,0,0,0,25313
28747,26577212,26577212,26583855,0,0,0,6643
28748,26577235,26577235,26584545,0,0,0,7310
28731,26574522,26574522,26585577,0,0,0,11055
28732,26574527,26574527,26587012,0,0,0,12485
28726,26573275,26573275,26589104,0,0,0,15829
28612,26557875,26557875,26590351,0,0,0,32476
28617,26558294,26558294,26592015,0,0,0,33721
28616,26558215,26558215,26592035,0,0,0,33820
28578,26506498,26506498,26592898,0,0,0,86400
28579,26506517,26506517,26592917,0,0,0,86400
28647,26562965,26562965,26593222,0,0,0,30257
28762,26593180,26593180,26593330,0,0,0,150
28763,26593290,26593290,26593448,0,0,0,158
28764,26593411,26593411,26593568,0,0,0,157
28618,26558455,26558455,26593813,0,0,0,35358
28623,26558719,26558719,26594021,0,0,0,35302
28619,26558559,26558559,26594268,0,0,0,35709
28624,26558909,26558909,26594595,0,0,0,35686
28595,26546601,26546601,26596339,0,0,0,49738
28625,26559017,26559017,26596374,0,0,0,37357
28761,26589065,26589065,26604857,0,0,0,15792
28696,26569101,26569101,26605491,0,0,0,36390
28699,26569462,26569462,26605710,0,0,0,36248
28709,26571401,26571401,26607612,0,0,0,36211
28711,26571698,26571698,26608033,0,0,0,36335
28713,26571818,26571818,26608159,0,0,0,36341
28716,26572078,26572078,26608372,0,0,0,36294
28736,26575350,26575350,26618550,0,0,0,43200
28737,26575359,26575359,26618559,0,0,0,43200
28768,26604814,26604814,26620876,0,0,0,16062
28765,26593525,26593525,26623417,0,0,0,29892
28769,26623375,26623375,26624301,0,0,0,926
28770,26624260,26624260,26625188,0,0,0,928
28767,26594718,26594718,26627572,0,0,0,32854
28636,26559989,26559989,26631115,0,0,0,71126
28426,26461136,26461136,26633936,0,0,0,172800
28773,26636321,26636321,26636775,0,0,0,454
28775,26637054,26637054,26637497,0,0,0,443
28444,26464986,26464986,26637786,0,0,0,172800
28445,26465010,26465010,26637810,0,0,0,172800
28446,26465026,26465026,26637826,0,0,0,172800
28542,26485831,26485831,26638244,0,0,0,152413
28602,26551895,26551895,26638295,0,0,0,86400
28745,26576706,26576706,26638377,0,0,0,61671
28744,26576684,26576684,26638378,0,0,0,61694
28694,26569065,26569065,26638945,0,0,0,69880
28540,26485810,26485810,26639287,0,0,0,153477
28478,26471714,26471714,26639366,0,0,0,167652
28780,26639138,26639138,26639697,0,0,0,559
28788,26642464,26642464,26642548,0,0,0,84
28790,26643142,26643142,26643181,0,0,0,39
28791,26643204,26643204,26643325,0,0,0,121
28793,26644262,26644262,26644378,0,0,0,116
28620,26558590,26558590,26644990,0,0,0,86400
28693,26569063,26569063,26645024,0,0,0,75961
28621,26558642,26558642,26645042,0,0,0,86400
28789,26642946,26642946,26645501,0,0,0,2555
28690,26569055,26569055,26645507,0,0,0,76452
28695,26569066,26569066,26645507,0,0,0,76441
28688,26569048,26569048,26645511,0,0,0,76463
28691,26569059,26569059,26645511,0,0,0,76452
28689,26569049,26569049,26645512,0,0,0,76463
28692,26569061,26569061,26645513,0,0,0,76452
28814,26646987,26646987,26647046,0,0,0,59
28815,26647761,26647761,26647920,0,0,0,159
28817,26647947,26647947,26648005,0,0,0,58
28822,26649706,26649706,26649790,0,0,0,84
28823,26649936,26649936,26650816,0,0,0,880
28766,26594700,26594700,26651717,0,0,0,57017
28824,26653249,26653249,26653303,0,0,0,54
28771,26625144,26625144,26653808,0,0,0,28664
28825,26653764,26653764,26653921,0,0,0,157
28827,26653881,26653881,26654029,0,0,0,148
28826,26653878,26653878,26654564,0,0,0,686
28772,26636150,26636150,26655341,0,0,0,19191
28831,26655638,26655638,26656106,0,0,0,468
28702,26569717,26569717,26656117,0,0,0,86400
28829,26654569,26654569,26657957,0,0,0,3388
28550,26493774,26493774,26666574,0,0,0,172800
28784,26641268,26641268,26666682,0,0,0,25414
28781,26639648,26639648,26666723,0,0,0,27075
28782,26639662,26639662,26666742,0,0,0,27080
28816,26647937,26647937,26667017,0,0,0,19080
28995,26666609,26666723,26667057,0,0,114,448
28818,26649394,26649394,26668320,0,0,0,18926
28819,26649476,26649476,26668517,0,0,0,19041
28820,26649572,26649572,26668529,0,0,0,18957
28821,26649659,26649659,26668569,0,0,0,18910
28424,26455715,26455715,26668802,0,0,0,213087
29001,26671857,26671857,26672059,0,0,0,202
29002,26673630,26673630,26673787,0,0,0,157
29003,26674192,26674192,26674369,0,0,0,177
28413,26417288,26417288,26676488,0,0,0,259200
28415,26417289,26417289,26676489,0,0,0,259200
28828,26653988,26653988,26682553,0,0,0,28565
28996,26666633,26682553,26682669,0,0,15920,16036
28587,26509988,26509988,26682788,0,0,0,172800
28588,26515148,26515148,26687948,0,0,0,172800
28589,26515215,26515215,26688015,0,0,0,172800
28792,26643958,26643958,26690795,0,0,0,46837
28798,26644997,26644997,26691349,0,0,0,46352
28799,26644997,26644997,26691588,0,0,0,46591
28794,26644996,26644996,26691733,0,0,0,46737
28800,26644997,26644997,26691889,0,0,0,46892
28795,26644996,26644996,26692145,0,0,0,47149
28796,26644996,26644996,26692187,0,0,0,47191
28804,26644998,26644998,26692304,0,0,0,47306
28801,26644997,26644997,26692345,0,0,0,47348
28802,26644997,26644997,26692429,0,0,0,47432
28803,26644997,26644997,26692803,0,0,0,47806
28797,26644996,26644996,26693035,0,0,0,48039
28774,26636756,26636756,26696788,0,0,0,60032
28932,26656111,26696788,26697257,0,0,40677,41146
28839,26656021,26656021,26704627,0,0,0,48606
28835,26656020,26656020,26704653,0,0,0,48633
28887,26656078,26656078,26704689,0,0,0,48611
28836,26656020,26656020,26704839,0,0,0,48819
28884,26656077,26656077,26704908,0,0,0,48831
28840,26656021,26656021,26704940,0,0,0,48919
28892,26656078,26656078,26704996,0,0,0,48918
28882,26656076,26656076,26705038,0,0,0,48962
28837,26656020,26656020,26705161,0,0,0,49141
28841,26656021,26656021,26705173,0,0,0,49152
28883,26656077,26656077,26705229,0,0,0,49152
28833,26656019,26656019,26705320,0,0,0,49301
28890,26656078,26656078,26705453,0,0,0,49375
28886,26656078,26656078,26705499,0,0,0,49421
28832,26656018,26656018,26705509,0,0,0,49491
28834,26656019,26656019,26705583,0,0,0,49564
28885,26656077,26656077,26705604,0,0,0,49527
28838,26656020,26656020,26705899,0,0,0,49879
28889,26656078,26656078,26705928,0,0,0,49850
28870,26656027,26656027,26705933,0,0,0,49906
28888,26656078,26656078,26706019,0,0,0,49941
28863,26656026,26656026,26706209,0,0,0,50183
28861,26656025,26656025,26706624,0,0,0,50599
28871,26656027,26656027,26706654,0,0,0,50627
28866,26656026,26656026,26706884,0,0,0,50858
28864,26656026,26656026,26706974,0,0,0,50948
28865,26656026,26656026,26707058,0,0,0,51032
28868,26656026,26656026,26707204,0,0,0,51178
28867,26656026,26656026,26707213,0,0,0,51187
28850,26656024,26656024,26707306,0,0,0,51282
28869,26656026,26656026,26707417,0,0,0,51391
28891,26656078,26656078,26707521,0,0,0,51443
28899,26656080,26656106,26707696,0,0,26,51616
28847,26656023,26656023,26707784,0,0,0,51761
28894,26656079,26656079,26708076,0,0,0,51997
28843,26656022,26656022,26708096,0,0,0,52074
28842,26656021,26656021,26708173,0,0,0,52152
28900,26656080,26656106,26708275,0,0,26,52195
28844,26656022,26656022,26708384,0,0,0,52362
28897,26656079,26656079,26708440,0,0,0,52361
28848,26656023,26656023,26708507,0,0,0,52484
28893,26656079,26656079,26708511,0,0,0,52432
28896,26656079,26656079,26708608,0,0,0,52529
28895,26656079,26656079,26708641,0,0,0,52562
28851,26656024,26656024,26708698,0,0,0,52674
28845,26656022,26656022,26708940,0,0,0,52918
28898,26656079,26656106,26708992,0,0,27,52913
28846,26656022,26656022,26709378,0,0,0,53356
28857,26656025,26656025,26709800,0,0,0,53775
28994,26666547,26666682,26709882,0,0,135,43335
28852,26656024,26656024,26710119,0,0,0,54095
29005,26682511,26710119,26710276,0,0,27608,27765
28901,26656080,26657957,26710519,0,0,1877,54439
29008,26687223,26710519,26710592,0,0,23296,23369
29009,26687331,26710592,26710665,0,0,23261,23334
29010,26687415,26710665,26710749,0,0,23250,23334
29012,26687891,26710749,26710837,0,0,22858,22946
29013,26688123,26710837,26710957,0,0,22714,22834
29017,26688375,26710957,26711077,0,0,22582,22702
29018,26688924,26711077,26711197,0,0,22153,22273
28853,26656024,26656024,26711305,0,0,0,55281
28858,26656025,26656025,26711434,0,0,0,55409
29019,26711743,26711743,26711908,0,0,0,165
28860,26656025,26656025,26712022,0,0,0,55997
28859,26656025,26656025,26712029,0,0,0,56004
29014,26688334,26712022,26712110,0,0,23688,23776
29004,26674371,26674371,26712171,0,0,0,37800
28983,26658892,26712110,26712183,0,0,53218,53291
28862,26656025,26656025,26712247,0,0,0,56222
28879,26656028,26656028,26712407,0,0,0,56379
28854,26656024,26656024,26712419,0,0,0,56395
28985,26660132,26712247,26712421,0,0,52115,52289
28855,26656024,26656024,26712463,0,0,0,56439
28986,26660279,26712421,26712494,0,0,52142,52215
28856,26656024,26656024,26712628,0,0,0,56604
28984,26659225,26712183,26712642,0,0,52958,53417
28987,26660437,26712494,26712959,0,0,52057,52522
28989,26660944,26712642,26713100,0,0,51698,52156
28872,26656027,26656027,26713145,0,0,0,57118
28880,26656028,26656028,26713290,0,0,0,57262
28993,26666464,26712959,26713421,0,0,46495,46957
28877,26656028,26656028,26713529,0,0,0,57501
28873,26656027,26656027,26713706,0,0,0,57679
28878,26656028,26656028,26714016,0,0,0,57988
28876,26656028,26656028,26714095,0,0,0,58067
28874,26656027,26656027,26714782,0,0,0,58755
28875,26656027,26656027,26715046,0,0,0,59019
28881,26656028,26656028,26715717,0,0,0,59689
28905,26656081,26666574,26720623,0,0,10493,64542
28902,26656080,26666574,26721634,0,0,10494,65554
28906,26656081,26666574,26721723,0,0,10493,65642
28907,26656081,26666742,26722161,0,0,10661,66080
28903,26656080,26666574,26722432,0,0,10494,66352
28908,26656081,26668802,26723011,0,0,12721,66930
29021,26724829,26724829,26724867,0,0,0,38
28909,26656081,26668802,26725016,0,0,12721,68935
29022,26725460,26725460,26725507,0,0,0,47
28997,26666641,26682669,26725869,0,0,16028,59228
28912,26656082,26676489,26726245,0,0,20407,70163
28830,26655426,26655426,26726249,0,0,0,70823
28990,26664218,26722432,26727183,0,0,58214,62965
29025,26727765,26727765,26727951,0,0,0,186
29023,26725541,26725541,26728428,0,0,0,2887
28904,26656080,26666574,26728475,0,0,10494,72395
29031,26728463,26728463,26728655,0,0,0,192
29032,26728672,26728672,26728908,0,0,0,236
29033,26728881,26728881,26729025,0,0,0,144
29034,26730259,26730259,26730410,0,0,0,151
28805,26644998,26644998,26731398,0,0,0,86400
28806,26644998,26644998,26731398,0,0,0,86400
28807,26644998,26644998,26731398,0,0,0,86400
28808,26644999,26644999,26731399,0,0,0,86400
28809,26644999,26644999,26731399,0,0,0,86400
28810,26644999,26644999,26731399,0,0,0,86400
28811,26644999,26644999,26731399,0,0,0,86400
28812,26644999,26644999,26731399,0,0,0,86400
28813,26645001,26645001,26731401,0,0,0,86400
28913,26656082,26682553,26732657,0,0,26471,76575
28914,26656082,26682788,26733289,0,0,26706,77207
28915,26656082,26682788,26733736,0,0,26706,77654
29036,26732015,26732657,26733756,0,0,642,1741
28910,26656081,26668802,26735964,0,0,12721,79883
29039,26735199,26735199,26736116,0,0,0,917
28785,26641360,26641360,26737272,0,0,0,95912
28919,26656083,26688015,26738041,0,0,31932,81958
28918,26656083,26688015,26738506,0,0,31932,82423
29040,26738507,26738507,26738842,0,0,0,335
29041,26738825,26738825,26738951,0,0,0,126
29026,26727816,26727816,26739138,0,0,0,11322
29006,26682664,26710276,26739355,0,0,27612,56691
29048,26739600,26739600,26739674,0,0,0,74
29049,26739600,26739600,26739674,0,0,0,74
28783,26639724,26639724,26739713,0,0,0,99989
29050,26739600,26739600,26739727,0,0,0,127
29051,26739600,26739600,26739738,0,0,0,138
29043,26739599,26739599,26739749,0,0,0,150
29044,26739599,26739599,26739749,0,0,0,150
29045,26739600,26739600,26739750,0,0,0,150
29046,26739600,26739600,26739750,0,0,0,150
29052,26739601,26739601,26739750,0,0,0,149
29047,26739600,26739600,26739761,0,0,0,161
29030,26728454,26737272,26739867,0,0,8818,11413
28916,26656082,26687948,26740362,0,0,31866,84280
29053,26740360,26740360,26740422,0,0,0,62
29054,26740360,26740360,26740422,0,0,0,62
29055,26740360,26740360,26740422,0,0,0,62
29056,26740360,26740360,26740433,0,0,0,73
29057,26740360,26740360,26740433,0,0,0,73
29058,26740360,26740360,26740444,0,0,0,84
29059,26740361,26740361,26740445,0,0,0,84
29060,26740361,26740361,26740456,0,0,0,95
29061,26740361,26740361,26740456,0,0,0,95
29062,26740361,26740361,26740456,0,0,0,95
29063,26740451,26740451,26740528,0,0,0,77
29064,26740453,26740453,26740541,0,0,0,88
29066,26740852,26740852,26740899,0,0,0,47
29073,26740963,26740963,26741011,0,0,0,48
29074,26741055,26741055,26741113,0,0,0,58
29067,26740945,26740945,26741116,0,0,0,171
29068,26740945,26740945,26741116,0,0,0,171
29069,26740945,26740945,26741116,0,0,0,171
29070,26740945,26740945,26741127,0,0,0,182
29071,26740945,26740945,26741127,0,0,0,182
29072,26740945,26740945,26741127,0,0,0,182
29075,26741141,26741141,26741189,0,0,0,48
29082,26741221,26741221,26741279,0,0,0,58
29083,26741323,26741323,26741371,0,0,0,48
29084,26741323,26741323,26741383,0,0,0,60
29085,26741324,26741324,26741384,0,0,0,60
29086,26741324,26741324,26741395,0,0,0,71
29087,26741324,26741324,26741395,0,0,0,71
28921,26656083,26691349,26741746,0,0,35266,85663
28920,26656083,26690795,26741935,0,0,34712,85852
28849,26656023,26656023,26742423,0,0,0,86400
29027,26727836,26731398,26742612,0,0,3562,14776
29020,26712952,26713100,26742690,0,0,148,29738
29088,26742542,26742542,26742735,0,0,0,193
29090,26742687,26742687,26742745,0,0,0,58
29091,26742687,26742687,26742745,0,0,0,58
29092,26742687,26742687,26742756,0,0,0,69
29093,26742687,26742687,26742756,0,0,0,69
29094,26742687,26742687,26742767,0,0,0,80
29095,26742859,26742859,26742906,0,0,0,47
29096,26742859,26742859,26742918,0,0,0,59
29097,26742859,26742859,26742929,0,0,0,70
29098,26742859,26742859,26742929,0,0,0,70
28705,26570156,26570156,26742956,0,0,0,172800
29099,26742859,26742859,26742977,0,0,0,118
29100,26742935,26742935,26743016,0,0,0,81
29101,26742935,26742935,26743027,0,0,0,92
29102,26742935,26742935,26743038,0,0,0,103
29103,26742936,26742936,26743039,0,0,0,103
29104,26742936,26742936,26743050,0,0,0,114
29105,26743092,26743092,26743170,0,0,0,78
29106,26743092,26743092,26743181,0,0,0,89
29107,26743093,26743093,26743193,0,0,0,100
29108,26743093,26743093,26743193,0,0,0,100
29109,26743093,26743093,26743193,0,0,0,100
28911,26656081,26676488,26743807,0,0,20407,87726
29110,26744678,26744678,26744726,0,0,0,48
29111,26744684,26744684,26744727,0,0,0,43
29112,26744684,26744684,26744738,0,0,0,54
29113,26744685,26744685,26744739,0,0,0,54
29114,26744685,26744685,26744739,0,0,0,54
29115,26744828,26744828,26745128,0,0,0,300
29116,26744828,26744828,26745128,0,0,0,300
29117,26744828,26744828,26745128,0,0,0,300
29118,26744828,26744828,26745128,0,0,0,300
29119,26744828,26744828,26745128,0,0,0,300
29120,26745107,26745107,26745145,0,0,0,38
29121,26745241,26745241,26745325,0,0,0,84
29122,26745242,26745242,26745337,0,0,0,95
29123,26745242,26745242,26745337,0,0,0,95
29124,26745242,26745242,26745348,0,0,0,106
29125,26745242,26745242,26745348,0,0,0,106
28935,26656123,26697257,26745571,0,0,41134,89448
28933,26656122,26697257,26745930,0,0,41135,89808
28934,26656123,26697257,26745941,0,0,41134,89818
29028,26728234,26731399,26746254,0,0,3165,18020
29029,26728253,26731401,26746256,0,0,3148,18003
28548,26490956,26490956,26746556,0,0,0,255600
28922,26656083,26691588,26748210,0,0,35505,92127
28928,26656085,26692345,26749224,0,0,36260,93139
28929,26656085,26692429,26749422,0,0,36344,93337
28927,26656085,26692304,26749686,0,0,36219,93601
28925,26656084,26692145,26749864,0,0,36061,93780
28923,26656083,26691733,26749984,0,0,35650,93901
28931,26656086,26693035,26750351,0,0,36949,94265
29130,26750333,26750333,26750419,0,0,0,86
29146,26750343,26750343,26750424,0,0,0,81
29131,26750339,26750339,26750425,0,0,0,86
29132,26750339,26750339,26750425,0,0,0,86
29147,26750343,26750343,26750425,0,0,0,82
29134,26750340,26750340,26750426,0,0,0,86
29142,26750342,26750342,26750427,0,0,0,85
29140,26750341,26750341,26750432,0,0,0,91
29145,26750342,26750342,26750434,0,0,0,92
29148,26750343,26750343,26750436,0,0,0,93
29143,26750342,26750342,26750438,0,0,0,96
29144,26750342,26750342,26750438,0,0,0,96
29149,26750343,26750343,26750447,0,0,0,104
29133,26750339,26750339,26750451,0,0,0,112
29135,26750340,26750340,26750452,0,0,0,112
29136,26750340,26750340,26750473,0,0,0,133
29137,26750340,26750340,26750473,0,0,0,133
29138,26750341,26750341,26750474,0,0,0,133
29139,26750341,26750341,26750474,0,0,0,133
29141,26750341,26750341,26750595,0,0,0,254
28926,26656084,26692187,26750620,0,0,36103,94536
29150,26750481,26750481,26750644,0,0,0,163
28924,26656083,26691889,26750680,0,0,35806,94597
29038,26734668,26734668,26750755,0,0,0,16087
29016,26688370,26712628,26751399,0,0,24258,63029
28930,26656085,26692803,26751652,0,0,36718,95567
28754,26579217,26579217,26752017,0,0,0,172800
28757,26579484,26579484,26752284,0,0,0,172800
29128,26750236,26750236,26752739,0,0,0,2503
29129,26750239,26750239,26752753,0,0,0,2514
28940,26656124,26704908,26752951,0,0,48784,96827
29000,26666772,26709882,26753082,0,0,43110,86310
28552,26493910,26493910,26753110,0,0,0,259200
28937,26656123,26704653,26753375,0,0,48530,97252
28936,26656123,26704627,26753529,0,0,48504,97406
29158,26753341,26753341,26753532,0,0,0,191
29157,26753333,26753333,26753641,0,0,0,308
28938,26656123,26704689,26753721,0,0,48566,97598
29156,26753319,26753319,26753829,0,0,0,510
28941,26656124,26704940,26753870,0,0,48816,97746
29163,26753896,26753896,26754003,0,0,0,107
29164,26753896,26753896,26754003,0,0,0,107
29165,26753897,26753897,26754004,0,0,0,107
29166,26753897,26753897,26754004,0,0,0,107
29167,26753897,26753897,26754004,0,0,0,107
29168,26753897,26753897,26754004,0,0,0,107
29169,26753897,26753897,26754004,0,0,0,107
29162,26753890,26753890,26754014,0,0,0,124
29170,26753898,26753898,26754027,0,0,0,129
29171,26753898,26753898,26754027,0,0,0,129
29172,26753898,26753898,26754038,0,0,0,140
29173,26753898,26753898,26754038,0,0,0,140
29174,26753899,26753899,26754050,0,0,0,151
29175,26753899,26753899,26754050,0,0,0,151
29176,26753899,26753899,26754061,0,0,0,162
29177,26753899,26753899,26754061,0,0,0,162
29178,26753900,26753900,26754185,0,0,0,285
29180,26754073,26754073,26754185,0,0,0,112
29181,26754073,26754073,26754185,0,0,0,112
29179,26753901,26753901,26754186,0,0,0,285
29182,26754074,26754074,26754186,0,0,0,112
29183,26754074,26754074,26754186,0,0,0,112
29184,26754074,26754074,26754186,0,0,0,112
29185,26754074,26754074,26754186,0,0,0,112
29186,26754074,26754074,26754186,0,0,0,112
29187,26754074,26754074,26754197,0,0,0,123
29188,26754074,26754074,26754197,0,0,0,123
29189,26754075,26754075,26754209,0,0,0,134
29127,26747677,26747677,26754212,0,0,0,6535
29190,26754075,26754075,26754220,0,0,0,145
29191,26754075,26754075,26754220,0,0,0,145
29192,26754075,26754075,26754220,0,0,0,145
29193,26754075,26754075,26754231,0,0,0,156
29194,26754075,26754075,26754242,0,0,0,167
29195,26754075,26754075,26754242,0,0,0,167
29196,26754076,26754076,26754243,0,0,0,167
29197,26754076,26754076,26754254,0,0,0,178
29198,26754076,26754076,26754254,0,0,0,178
29199,26754076,26754076,26754265,0,0,0,189
29215,26754323,26754323,26754409,0,0,0,86
29216,26754323,26754323,26754409,0,0,0,86
29217,26754323,26754323,26754420,0,0,0,97
29218,26754323,26754323,26754420,0,0,0,97
29203,26754321,26754321,26754495,0,0,0,174
29204,26754321,26754321,26754495,0,0,0,174
29205,26754321,26754321,26754495,0,0,0,174
29206,26754322,26754322,26754496,0,0,0,174
29207,26754322,26754322,26754496,0,0,0,174
29208,26754322,26754322,26754496,0,0,0,174
29209,26754322,26754322,26754496,0,0,0,174
29210,26754322,26754322,26754496,0,0,0,174
29211,26754322,26754322,26754507,0,0,0,185
29212,26754322,26754322,26754507,0,0,0,185
29213,26754323,26754323,26754519,0,0,0,196
29214,26754323,26754323,26754519,0,0,0,196
29220,26754445,26754445,26754553,0,0,0,108
29221,26754445,26754445,26754553,0,0,0,108
29219,26754323,26754323,26754623,0,0,0,300
28939,26656123,26704839,26754719,0,0,48716,98596
29246,26754657,26754657,26754733,0,0,0,76
29247,26754657,26754657,26754744,0,0,0,87
29235,26754656,26754656,26754755,0,0,0,99
29236,26754656,26754656,26754755,0,0,0,99
29237,26754656,26754656,26754755,0,0,0,99
29238,26754656,26754656,26754755,0,0,0,99
28942,26656124,26704996,26754760,0,0,48872,98636
29239,26754656,26754656,26754766,0,0,0,110
29240,26754656,26754656,26754766,0,0,0,110
29241,26754657,26754657,26754778,0,0,0,121
29242,26754657,26754657,26754778,0,0,0,121
29243,26754657,26754657,26754789,0,0,0,132
29244,26754657,26754657,26754789,0,0,0,132
29245,26754657,26754657,26754789,0,0,0,132
29222,26754654,26754654,26754853,0,0,0,199
29223,26754654,26754654,26754853,0,0,0,199
29224,26754654,26754654,26754853,0,0,0,199
29225,26754654,26754654,26754853,0,0,0,199
29226,26754654,26754654,26754853,0,0,0,199
29227,26754654,26754654,26754853,0,0,0,199
29228,26754655,26754655,26754854,0,0,0,199
29229,26754655,26754655,26754854,0,0,0,199
29230,26754655,26754655,26754854,0,0,0,199
29231,26754655,26754655,26754854,0,0,0,199
29232,26754655,26754655,26754854,0,0,0,199
29233,26754655,26754655,26754854,0,0,0,199
29248,26754779,26754779,26754877,0,0,0,98
29249,26754846,26754846,26754944,0,0,0,98
29234,26754655,26754655,26754955,0,0,0,300
28428,26462437,26462437,26755301,0,0,0,292864
29250,26755245,26755245,26755326,0,0,0,81
29152,26752166,26752166,26755776,0,0,0,3610
29126,26745927,26745927,26755891,0,0,0,9964
28943,26656124,26705038,26756771,0,0,48914,100647
28952,26656125,26705604,26757272,0,0,49479,101147
28944,26656124,26705161,26757282,0,0,49037,101158
28945,26656124,26705173,26757637,0,0,49049,101513
28959,26656127,26706654,26757809,0,0,50527,101682
28960,26656127,26706884,26758007,0,0,50757,101880
28947,26656125,26705320,26758255,0,0,49195,102130
28948,26656125,26705453,26758432,0,0,49328,102307
28966,26656128,26707417,26758452,0,0,51289,102324
28968,26656129,26707696,26758478,0,0,51567,102349
28967,26656129,26707521,26758525,0,0,51392,102396
28949,26656125,26705499,26758594,0,0,49374,102469
28969,26656129,26707784,26758753,0,0,51655,102624
28950,26656125,26705509,26759013,0,0,49384,102888
28946,26656124,26705229,26759075,0,0,49105,102951
28971,26656130,26708096,26759133,0,0,51966,103003
28972,26656130,26708173,26759150,0,0,52043,103020
28970,26656129,26708076,26759246,0,0,51947,103117
29252,26759283,26759283,26759356,0,0,0,73
28961,26656127,26706974,26759545,0,0,50847,103418
29253,26759462,26759462,26759578,0,0,0,116
29256,26760173,26760173,26760288,0,0,0,115
28951,26656125,26705583,26760846,0,0,49458,104721
28953,26656126,26705899,26761021,0,0,49773,104895
29251,26757824,26757824,26761424,0,0,0,3600
28962,26656127,26707058,26761507,0,0,50931,105380
28957,26656126,26706209,26761642,0,0,50083,105516
28963,26656127,26707204,26762215,0,0,51077,106088
28955,26656126,26705933,26762238,0,0,49807,106112
28956,26656126,26706019,26762275,0,0,49893,106149
28964,26656127,26707213,26762548,0,0,51086,106421
28954,26656126,26705928,26762722,0,0,49802,106596
28965,26656127,26707306,26763368,0,0,51179,107241
28958,26656126,26706624,26763771,0,0,50498,107645
28973,26656130,26708275,26765268,0,0,52145,109138
28975,26656131,26708440,26765544,0,0,52309,109413
28979,26656132,26708641,26765666,0,0,52509,109534
28976,26656131,26708507,26766623,0,0,52376,110492
28977,26656131,26708511,26766947,0,0,52380,110816
28978,26656131,26708608,26767223,0,0,52477,111092
28974,26656130,26708384,26767428,0,0,52254,111298
28980,26656132,26708698,26767450,0,0,52566,111318
29151,26751634,26751634,26767699,0,0,0,16065
28992,26666135,26713290,26768692,0,0,47155,102557
29042,26739111,26739111,26768995,0,0,0,29884
28786,26641430,26641430,26771030,0,0,0,129600
28787,26641479,26641479,26771079,0,0,0,129600
29037,26733504,26733504,26771304,0,0,0,37800
28981,26656132,26708940,26771702,0,0,52808,115570
29089,26742685,26742685,26771929,0,0,0,29244
29007,26685864,26726249,26772096,0,0,40385,86232
28982,26656132,26708992,26773522,0,0,52860,117390
28917,26656082,26687948,26774348,0,0,31866,118266
28991,26666127,26713706,26777605,0,0,47579,111478
29257,26767660,26767660,26783513,0,0,0,15853
29154,26753220,26753220,26796231,0,0,0,43011
28998,26666683,26709378,26796425,0,0,42695,129742
28999,26666699,26709800,26796768,0,0,43101,130069
29201,26754292,26754292,26796780,0,0,0,42488
29161,26753841,26753841,26797183,0,0,0,43342
29160,26753838,26753838,26797269,0,0,0,43431
29200,26754284,26754284,26798034,0,0,0,43750
29159,26753833,26753833,26798277,0,0,0,44444
29202,26754296,26754296,26798527,0,0,0,44231
29262,26783471,26783471,26799470,0,0,0,15999
29261,26771937,26771937,26801454,0,0,0,29517
29266,26806676,26806676,26806742,0,0,0,66
29268,26807899,26807899,26807984,0,0,0,85
29269,26808309,26808309,26808414,0,0,0,105
29153,26753213,26753213,26810134,0,0,0,56921
28776,26637445,26637445,26810245,0,0,0,172800
29265,26806532,26806532,26810590,0,0,0,4058
28777,26638311,26638311,26811111,0,0,0,172800
28778,26638326,26638326,26811126,0,0,0,172800
28779,26638336,26638336,26811136,0,0,0,172800
29277,26812401,26812401,26812540,0,0,0,139
29278,26812847,26812847,26812993,0,0,0,146
29279,26813845,26813845,26813903,0,0,0,58
29280,26813911,26813911,26813952,0,0,0,41
29281,26814028,26814028,26814069,0,0,0,41
29282,26814086,26814086,26814788,0,0,0,702
29263,26799427,26799427,26815390,0,0,0,15963
29284,26815367,26815367,26815485,0,0,0,118
29285,26815473,26815473,26815986,0,0,0,513
29286,26816920,26816920,26816993,0,0,0,73
29267,26806807,26806807,26817197,0,0,0,10390
29338,26817185,26817185,26817258,0,0,0,73
29337,26817159,26817159,26817381,0,0,0,222
29260,26771431,26771431,26820257,0,0,0,48826
29388,26817677,26820257,26820634,0,0,2580,2957
29035,26731792,26737272,26820656,0,0,5480,88864
29394,26820608,26820608,26820694,0,0,0,86
29393,26820588,26820588,26820719,0,0,0,131
29387,26817578,26820656,26820721,0,0,3078,3143
29395,26820678,26820678,26820731,0,0,0,53
29396,26820762,26820762,26820810,0,0,0,48
29389,26818112,26820721,26820836,0,0,2609,2724
29390,26818370,26820836,26820910,0,0,2466,2540
29398,26821295,26821295,26821500,0,0,0,205
29399,26821295,26821295,26821500,0,0,0,205
29400,26821295,26821295,26821500,0,0,0,205
29401,26821295,26821295,26821500,0,0,0,205
29391,26818387,26820910,26821510,0,0,2523,3123
29397,26821293,26821293,26821593,0,0,0,300
29402,26821295,26821500,26821705,0,0,205,410
29403,26821295,26821500,26821705,0,0,205,410
29404,26821296,26821500,26821705,0,0,204,409
29405,26821296,26821500,26821705,0,0,204,409
29406,26821296,26821593,26821798,0,0,297,502
29407,26821296,26821705,26821910,0,0,409,614
29408,26821296,26821705,26821910,0,0,409,614
29409,26821296,26821705,26821910,0,0,409,614
29410,26821297,26821705,26821910,0,0,408,613
29413,26821297,26821910,26821994,0,0,613,697
29411,26821297,26821798,26822003,0,0,501,706
29414,26821297,26821910,26822005,0,0,613,708
29415,26821297,26821910,26822016,0,0,613,719
29417,26821298,26822003,26822109,0,0,705,811
29416,26821297,26821994,26822111,0,0,697,814
29412,26821297,26821910,26822115,0,0,613,818
29418,26821298,26822005,26822122,0,0,707,824
29419,26821298,26822016,26822133,0,0,718,835
29420,26821298,26822109,26822237,0,0,811,939
29421,26821298,26822111,26822239,0,0,813,941
29422,26821298,26822115,26822254,0,0,817,956
29423,26821298,26822122,26822261,0,0,824,963
29424,26821426,26822133,26822283,0,0,707,857
29275,26811830,26811830,26823816,0,0,0,11986
29276,26811835,26811835,26824023,0,0,0,12188
29386,26817465,26817465,26824492,0,0,0,7027
29426,26824682,26824682,26824720,0,0,0,38
29427,26824817,26824817,26825196,0,0,0,379
28678,26566902,26566902,26826102,0,0,0,259200
29428,26827063,26827063,26827180,0,0,0,117
29429,26827683,26827683,26827723,0,0,0,40
29430,26827791,26827791,26827849,0,0,0,58
29435,26829927,26829927,26829967,0,0,0,40
29436,26830004,26830004,26830043,0,0,0,39
29437,26830078,26830078,26830117,0,0,0,39
29438,26830210,26830210,26830361,0,0,0,151
29264,26801411,26801411,26830603,0,0,0,29192
29439,26830557,26830557,26830722,0,0,0,165
29441,26830684,26830684,26830841,0,0,0,157
29440,26830678,26830678,26831045,0,0,0,367
29283,26815344,26815344,26831543,0,0,0,16199
29432,26828445,26828445,26833010,0,0,0,4565
29433,26829789,26833010,26833083,0,0,3221,3294
29434,26829886,26833010,26833373,0,0,3124,3487
28755,26579413,26579413,26838613,0,0,0,259200
29448,26832104,26832104,26840716,0,0,0,8612
29449,26836559,26836559,26844168,0,0,0,7609
29447,26831501,26831501,26847683,0,0,0,16182
29454,26847634,26847634,26847707,0,0,0,73
29455,26847673,26847673,26847748,0,0,0,75
29456,26847712,26847712,26847786,0,0,0,74
29457,26847743,26847743,26847817,0,0,0,74
29458,26847777,26847777,26847855,0,0,0,78
29459,26847806,26847806,26847879,0,0,0,73
29460,26847839,26847839,26847919,0,0,0,80
29461,26847872,26847872,26847945,0,0,0,73
29462,26847901,26847901,26847979,0,0,0,78
29463,26847930,26847930,26848007,0,0,0,77
29464,26847963,26847963,26848040,0,0,0,77
29465,26847993,26847993,26848059,0,0,0,66
29466,26848022,26848022,26848099,0,0,0,77
29467,26848051,26848051,26848129,0,0,0,78
29468,26848083,26848083,26848150,0,0,0,67
29469,26848111,26848111,26848189,0,0,0,78
29470,26848140,26848140,26848217,0,0,0,77
29471,26848173,26848173,26848246,0,0,0,73
29472,26848201,26848201,26848276,0,0,0,75
29473,26848239,26848239,26848307,0,0,0,68
29474,26848263,26848263,26848332,0,0,0,69
29475,26848291,26848291,26848370,0,0,0,79
29015,26688358,26712419,26852039,0,0,24061,163681
29442,26830803,26830803,26860755,0,0,0,29952
29476,26860711,26860711,26860784,0,0,0,73
29477,26860739,26860739,26860817,0,0,0,78
29478,26860766,26860766,26860832,0,0,0,66
29479,26860792,26860792,26860863,0,0,0,71
29480,26860821,26860821,26860889,0,0,0,68
29481,26860855,26860855,26860928,0,0,0,73
29287,26817111,26817111,26865123,0,0,0,48012
29346,26817188,26817188,26865163,0,0,0,47975
29341,26817187,26817187,26865387,0,0,0,48200
29345,26817188,26817188,26865512,0,0,0,48324
29342,26817187,26817187,26865545,0,0,0,48358
29339,26817186,26817186,26865584,0,0,0,48398
29347,26817188,26817188,26865675,0,0,0,48487
29291,26817112,26817112,26865725,0,0,0,48613
29348,26817188,26817188,26865947,0,0,0,48759
29290,26817112,26817112,26865961,0,0,0,48849
29296,26817113,26817113,26866128,0,0,0,49015
29288,26817111,26817111,26866240,0,0,0,49129
29343,26817187,26817187,26866421,0,0,0,49234
29293,26817112,26817112,26866619,0,0,0,49507
29344,26817187,26817187,26866695,0,0,0,49508
29292,26817112,26817112,26866717,0,0,0,49605
29325,26817121,26817121,26866946,0,0,0,49825
29366,26817193,26817193,26866984,0,0,0,49791
29373,26817194,26817381,26867014,0,0,187,49820
29289,26817111,26817111,26867017,0,0,0,49906
29321,26817120,26817120,26867202,0,0,0,50082
29315,26817119,26817119,26867233,0,0,0,50114
29370,26817193,26817258,26867383,0,0,65,50190
29316,26817119,26817119,26867417,0,0,0,50298
29319,26817120,26817120,26867502,0,0,0,50382
29320,26817120,26817120,26867559,0,0,0,50439
29322,26817120,26817120,26867681,0,0,0,50561
29374,26817194,26817381,26867842,0,0,187,50648
29369,26817193,26817258,26867873,0,0,65,50680
29367,26817193,26817193,26867904,0,0,0,50711
29326,26817121,26817121,26867986,0,0,0,50865
29353,26817190,26817190,26867993,0,0,0,50803
29371,26817193,26817258,26868091,0,0,65,50898
29358,26817191,26817191,26868092,0,0,0,50901
29304,26817116,26817116,26868101,0,0,0,50985
29368,26817193,26817193,26868209,0,0,0,51016
29352,26817189,26817189,26868304,0,0,0,51115
29300,26817113,26817113,26868320,0,0,0,51207
29372,26817193,26817381,26868355,0,0,188,51162
29302,26817115,26817115,26868416,0,0,0,51301
29299,26817113,26817113,26868525,0,0,0,51412
29323,26817120,26817120,26868591,0,0,0,51471
29349,26817189,26817189,26868641,0,0,0,51452
29297,26817113,26817113,26868725,0,0,0,51612
29298,26817113,26817113,26868804,0,0,0,51691
29350,26817189,26817189,26868953,0,0,0,51764
29351,26817189,26817189,26869144,0,0,0,51955
29306,26817116,26817116,26869264,0,0,0,52148
29354,26817190,26817190,26869573,0,0,0,52383
29355,26817190,26817190,26869696,0,0,0,52506
29305,26817116,26817116,26869868,0,0,0,52752
29357,26817191,26817191,26870038,0,0,0,52847
29361,26817192,26817192,26870078,0,0,0,52886
29301,26817113,26817113,26870093,0,0,0,52980
29303,26817115,26817115,26870182,0,0,0,53067
29311,26817118,26817118,26870494,0,0,0,53376
29317,26817119,26817119,26870601,0,0,0,53482
29375,26817194,26820257,26870646,0,0,3063,53452
29307,26817116,26817116,26871295,0,0,0,54179
29024,26727045,26727045,26871654,0,0,0,144609
29312,26817118,26817118,26871694,0,0,0,54576
29362,26817192,26817192,26871697,0,0,0,54505
29359,26817191,26817191,26871935,0,0,0,54744
29365,26817192,26817192,26872170,0,0,0,54978
29308,26817117,26817117,26872198,0,0,0,55081
29363,26817192,26817192,26872258,0,0,0,55066
29309,26817117,26817117,26872302,0,0,0,55185
29360,26817191,26817191,26872325,0,0,0,55134
29364,26817192,26817192,26872539,0,0,0,55347
29313,26817118,26817118,26872558,0,0,0,55440
29318,26817119,26817119,26872734,0,0,0,55615
29327,26817121,26817121,26872868,0,0,0,55747
29333,26817122,26817122,26873212,0,0,0,56090
29336,26817122,26817122,26873220,0,0,0,56098
29332,26817122,26817122,26873360,0,0,0,56238
29331,26817122,26817122,26873490,0,0,0,56368
29310,26817117,26817117,26873521,0,0,0,56404
29314,26817118,26817118,26873564,0,0,0,56446
29334,26817122,26817122,26874349,0,0,0,57227
29328,26817121,26817121,26874403,0,0,0,57282
29335,26817122,26817122,26874506,0,0,0,57384
29294,26817112,26817112,26875189,0,0,0,58077
29295,26817112,26817112,26875847,0,0,0,58735
29330,26817121,26817121,26875938,0,0,0,58817
29329,26817121,26817121,26876172,0,0,0,59051
29376,26817194,26820257,26876561,0,0,3063,59367
29382,26817195,26820257,26876894,0,0,3062,59699
29380,26817195,26820257,26877181,0,0,3062,59986
29379,26817195,26820257,26877402,0,0,3062,60207
29324,26817120,26817120,26877491,0,0,0,60371
29384,26817195,26820257,26877963,0,0,3062,60768
29385,26817195,26820257,26878083,0,0,3062,60888
29383,26817195,26820257,26878412,0,0,3062,61217
29381,26817195,26820257,26878468,0,0,3062,61273
29377,26817194,26820257,26878494,0,0,3063,61300
29378,26817194,26820257,26878581,0,0,3063,61387
29356,26817190,26817190,26881735,0,0,0,64545
29011,26687431,26711305,26884105,0,0,23874,196674
28988,26660884,26715717,26888517,0,0,54833,227633
29274,26810224,26810224,26896803,0,0,0,86579
29270,26810159,26810159,26897691,0,0,0,87532
29272,26810188,26810188,26897778,0,0,0,87590
29340,26817186,26817186,26899233,0,0,0,82047
29273,26810214,26810214,26900565,0,0,0,90351
29258,26771381,26771381,26900981,0,0,0,129600
29259,26771400,26771400,26901000,0,0,0,129600
28417,26424219,26424219,26907233,0,0,0,483014
29392,26819199,26821510,26907910,0,0,2311,88711
29425,26824530,26824530,26908700,0,0,0,84170
29482,26908645,26908645,26908945,0,0,0,300
29483,26908645,26908645,26908945,0,0,0,300
29484,26908646,26908646,26908946,0,0,0,300
29485,26908646,26908646,26908946,0,0,0,300
29486,26908646,26908646,26908946,0,0,0,300
29487,26908646,26908646,26908946,0,0,0,300
29488,26908646,26908646,26908946,0,0,0,300
29489,26908646,26908646,26908946,0,0,0,300
29490,26908646,26908646,26908946,0,0,0,300
29491,26908647,26908647,26908947,0,0,0,300
29492,26908647,26908647,26908947,0,0,0,300
29493,26908647,26908647,26908947,0,0,0,300
29494,26908647,26908647,26908947,0,0,0,300
29495,26908647,26908647,26908947,0,0,0,300
29496,26908647,26908647,26908947,0,0,0,300
29497,26908647,26908647,26908947,0,0,0,300
29498,26908821,26908821,26908954,0,0,0,133
29499,26908821,26908821,26908954,0,0,0,133
29500,26908821,26908821,26908954,0,0,0,133
29501,26908821,26908821,26908954,0,0,0,133
29503,26908822,26908822,26908955,0,0,0,133
29504,26908822,26908822,26908955,0,0,0,133
29505,26908822,26908822,26908955,0,0,0,133
29506,26908822,26908822,26908955,0,0,0,133
29507,26908823,26908823,26908956,0,0,0,133
29508,26908823,26908823,26908968,0,0,0,145
29509,26908823,26908823,26908968,0,0,0,145
29510,26908824,26908824,26908980,0,0,0,156
29511,26908824,26908824,26908980,0,0,0,156
29512,26908824,26908824,26908980,0,0,0,156
29515,26908825,26908825,26908981,0,0,0,156
29513,26908824,26908824,26908991,0,0,0,167
29514,26908824,26908824,26909002,0,0,0,178
29516,26908825,26908825,26909003,0,0,0,178
29519,26908826,26908826,26909004,0,0,0,178
29517,26908825,26908825,26909014,0,0,0,189
29518,26908825,26908825,26909014,0,0,0,189
29520,26908826,26908826,26909026,0,0,0,200
29502,26908821,26908821,26909032,0,0,0,211
29521,26908826,26908826,26909037,0,0,0,211
29523,26909897,26909897,26909992,0,0,0,95
29524,26909903,26909903,26909992,0,0,0,89
29525,26910062,26910062,26910156,0,0,0,94
29526,26910063,26910063,26910157,0,0,0,94
29527,26910176,26910176,26910270,0,0,0,94
29528,26910177,26910177,26910271,0,0,0,94
29529,26910285,26910285,26910368,0,0,0,83
29530,26910285,26910285,26910379,0,0,0,94
29531,26910401,26910401,26910538,0,0,0,137
29532,26910407,26910407,26910542,0,0,0,135
29533,26910571,26910571,26910713,0,0,0,142
29534,26910576,26910576,26910713,0,0,0,137
29535,26910743,26910743,26910875,0,0,0,132
29536,26910749,26910749,26910881,0,0,0,132
29537,26910900,26910900,26910958,0,0,0,58
29538,26911137,26911137,26911185,0,0,0,48
29539,26911188,26911188,26911247,0,0,0,59
29540,26911316,26911316,26911374,0,0,0,58
29541,26911455,26911455,26911504,0,0,0,49
29542,26911570,26911570,26911660,0,0,0,90
29543,26912147,26912147,26912236,0,0,0,89
29065,26740617,26740617,26913417,0,0,0,172800
29544,26914098,26914098,26914230,0,0,0,132
29545,26914104,26914104,26914231,0,0,0,127
29561,26914907,26914907,26915050,0,0,0,143
29562,26914907,26914907,26915050,0,0,0,143
29563,26914907,26914907,26915050,0,0,0,143
29564,26914907,26914907,26915050,0,0,0,143
29565,26914907,26914907,26915050,0,0,0,143
29566,26914908,26914908,26915051,0,0,0,143
29567,26914908,26914908,26915051,0,0,0,143
29568,26914908,26914908,26915051,0,0,0,143
29569,26914908,26914908,26915051,0,0,0,143
29570,26914908,26914908,26915051,0,0,0,143
29571,26914908,26914908,26915051,0,0,0,143
29572,26914909,26914909,26915064,0,0,0,155
29573,26914909,26914909,26915064,0,0,0,155
29574,26914909,26914909,26915064,0,0,0,155
29575,26914909,26914909,26915075,0,0,0,166
29576,26914909,26914909,26915086,0,0,0,177
29577,26914909,26914909,26915086,0,0,0,177
29578,26914909,26914909,26915086,0,0,0,177
29579,26914910,26914910,26915098,0,0,0,188
29580,26914910,26914910,26915098,0,0,0,188
29581,26914910,26914910,26915109,0,0,0,199
29582,26914910,26914910,26915109,0,0,0,199
29583,26914910,26914910,26915109,0,0,0,199
29584,26914910,26914910,26915120,0,0,0,210
29546,26914905,26914905,26915205,0,0,0,300
29547,26914905,26914905,26915205,0,0,0,300
29548,26914905,26914905,26915205,0,0,0,300
29549,26914905,26914905,26915205,0,0,0,300
29550,26914905,26914905,26915205,0,0,0,300
29551,26914905,26914905,26915205,0,0,0,300
29552,26914906,26914906,26915206,0,0,0,300
29553,26914906,26914906,26915206,0,0,0,300
29554,26914906,26914906,26915206,0,0,0,300
29555,26914906,26914906,26915206,0,0,0,300
29556,26914906,26914906,26915206,0,0,0,300
29557,26914906,26914906,26915206,0,0,0,300
29558,26914906,26914906,26915206,0,0,0,300
29559,26914907,26914907,26915207,0,0,0,300
29560,26914907,26914907,26915207,0,0,0,300
29585,26915084,26915084,26915305,0,0,0,221
29586,26915084,26915084,26915384,0,0,0,300
29587,26915375,26915375,26915675,0,0,0,300
29588,26915376,26915376,26915676,0,0,0,300
29589,26915376,26915376,26915676,0,0,0,300
29590,26915376,26915376,26915676,0,0,0,300
29591,26915376,26915376,26915676,0,0,0,300
29592,26915376,26915376,26915676,0,0,0,300
29593,26915376,26915376,26915676,0,0,0,300
29594,26915377,26915377,26915677,0,0,0,300
29595,26915377,26915377,26915677,0,0,0,300
29596,26915377,26915377,26915677,0,0,0,300
29613,26916538,26916538,26916631,0,0,0,93
29614,26916539,26916539,26916632,0,0,0,93
29615,26916539,26916539,26916632,0,0,0,93
29616,26916539,26916539,26916632,0,0,0,93
29617,26916539,26916539,26916632,0,0,0,93
29618,26916539,26916539,26916632,0,0,0,93
29619,26916539,26916539,26916632,0,0,0,93
29620,26916539,26916539,26916632,0,0,0,93
29621,26916540,26916540,26916645,0,0,0,105
29622,26916540,26916540,26916645,0,0,0,105
29623,26916540,26916540,26916645,0,0,0,105
29624,26916540,26916540,26916656,0,0,0,116
29625,26916540,26916540,26916656,0,0,0,116
29626,26916540,26916540,26916656,0,0,0,116
29627,26916540,26916540,26916667,0,0,0,127
29628,26916582,26916582,26916720,0,0,0,138
29597,26916535,26916535,26916756,0,0,0,221
29598,26916535,26916535,26916756,0,0,0,221
29599,26916535,26916535,26916756,0,0,0,221
29600,26916535,26916535,26916756,0,0,0,221
29601,26916536,26916536,26916757,0,0,0,221
29602,26916536,26916536,26916757,0,0,0,221
29603,26916536,26916536,26916757,0,0,0,221
29604,26916536,26916536,26916757,0,0,0,221
29605,26916537,26916537,26916758,0,0,0,221
29606,26916537,26916537,26916758,0,0,0,221
29607,26916537,26916537,26916758,0,0,0,221
29608,26916538,26916538,26916759,0,0,0,221
29609,26916538,26916538,26916759,0,0,0,221
29610,26916538,26916538,26916759,0,0,0,221
29611,26916538,26916538,26916759,0,0,0,221
29612,26916538,26916538,26916759,0,0,0,221
29450,26839873,26839873,26926273,0,0,0,86400
29451,26839886,26839886,26926286,0,0,0,86400
29452,26840695,26840695,26927095,0,0,0,86400
29453,26841371,26841371,26927771,0,0,0,86400
29629,26930399,26930399,26930593,0,0,0,194
29630,26930399,26930399,26930593,0,0,0,194
29631,26930399,26930399,26930593,0,0,0,194
29632,26930400,26930400,26930594,0,0,0,194
29633,26930400,26930400,26930594,0,0,0,194
29634,26930400,26930400,26930594,0,0,0,194
29635,26930400,26930400,26930594,0,0,0,194
29636,26930400,26930400,26930594,0,0,0,194
29637,26930401,26930401,26930595,0,0,0,194
29638,26930401,26930401,26930595,0,0,0,194
29639,26930401,26930401,26930595,0,0,0,194
29640,26930401,26930401,26930595,0,0,0,194
29641,26930401,26930401,26930595,0,0,0,194
29642,26930401,26930401,26930595,0,0,0,194
29643,26930402,26930402,26930596,0,0,0,194
29644,26930402,26930402,26930596,0,0,0,194
29645,26930402,26930402,26930596,0,0,0,194
29646,26930402,26930402,26930596,0,0,0,194
29647,26930402,26930402,26930596,0,0,0,194
29648,26930402,26930402,26930596,0,0,0,194
29649,26930402,26930402,26930596,0,0,0,194
29650,26930403,26930403,26930597,0,0,0,194
29651,26930403,26930403,26930597,0,0,0,194
29652,26930403,26930403,26930597,0,0,0,194
29653,26930403,26930403,26930597,0,0,0,194
29654,26930403,26930403,26930597,0,0,0,194
29655,26930403,26930403,26930597,0,0,0,194
29656,26930404,26930404,26930598,0,0,0,194
29657,26930404,26930404,26930610,0,0,0,206
29658,26930404,26930404,26930610,0,0,0,206
29659,26930404,26930404,26930610,0,0,0,206
29660,26930404,26930404,26930621,0,0,0,217
29661,26930404,26930404,26930621,0,0,0,217
29662,26930404,26930404,26930632,0,0,0,228
29663,26930405,26930405,26930633,0,0,0,228
29664,26930405,26930405,26930644,0,0,0,239
29254,26759699,26759699,26932499,0,0,0,172800
29255,26759754,26759754,26932554,0,0,0,172800
29665,26932587,26932587,26932780,0,0,0,193
29666,26932587,26932587,26932780,0,0,0,193
29667,26932588,26932588,26932781,0,0,0,193
29668,26932588,26932588,26932781,0,0,0,193
29669,26932588,26932588,26932781,0,0,0,193
29670,26932588,26932588,26932781,0,0,0,193
29671,26932588,26932588,26932781,0,0,0,193
29672,26932589,26932589,26932782,0,0,0,193
29673,26932589,26932589,26932782,0,0,0,193
29674,26932589,26932589,26932782,0,0,0,193
29675,26932589,26932589,26932782,0,0,0,193
29676,26932590,26932590,26932783,0,0,0,193
29677,26932590,26932590,26932783,0,0,0,193
29678,26932590,26932590,26932783,0,0,0,193
29679,26932590,26932590,26932783,0,0,0,193
29680,26932591,26932591,26932784,0,0,0,193
29681,26932591,26932591,26932784,0,0,0,193
29682,26932591,26932591,26932784,0,0,0,193
29683,26932591,26932591,26932784,0,0,0,193
29684,26932592,26932592,26932785,0,0,0,193
29685,26932592,26932592,26932785,0,0,0,193
29686,26932592,26932592,26932785,0,0,0,193
29687,26932592,26932592,26932785,0,0,0,193
29688,26932592,26932592,26932785,0,0,0,193
29689,26932592,26932592,26932785,0,0,0,193
29690,26932592,26932592,26932785,0,0,0,193
29691,26932593,26932593,26932893,0,0,0,300
29692,26932593,26932593,26932893,0,0,0,300
29693,26932593,26932593,26932893,0,0,0,300
29694,26932593,26932593,26932893,0,0,0,300
29695,26932593,26932593,26932893,0,0,0,300
29696,26932593,26932593,26932893,0,0,0,300
29697,26932593,26932593,26932893,0,0,0,300
29698,26932594,26932594,26932894,0,0,0,300
29699,26932594,26932594,26932894,0,0,0,300
29700,26932594,26932594,26932894,0,0,0,300
29701,26932780,26932780,26933080,0,0,0,300
29702,26933624,26933624,26933817,0,0,0,193
29703,26933625,26933625,26933818,0,0,0,193
29723,26933629,26933629,26933822,0,0,0,193
29704,26933625,26933625,26933925,0,0,0,300
29705,26933625,26933625,26933925,0,0,0,300
29706,26933626,26933626,26933926,0,0,0,300
29707,26933626,26933626,26933926,0,0,0,300
29708,26933626,26933626,26933926,0,0,0,300
29709,26933626,26933626,26933926,0,0,0,300
29710,26933627,26933627,26933927,0,0,0,300
29711,26933627,26933627,26933927,0,0,0,300
29712,26933627,26933627,26933927,0,0,0,300
29713,26933627,26933627,26933927,0,0,0,300
29714,26933627,26933627,26933927,0,0,0,300
29715,26933627,26933627,26933927,0,0,0,300
29716,26933627,26933627,26933927,0,0,0,300
29717,26933628,26933628,26933928,0,0,0,300
29718,26933628,26933628,26933928,0,0,0,300
29719,26933628,26933628,26933928,0,0,0,300
29720,26933628,26933628,26933928,0,0,0,300
29721,26933628,26933628,26933928,0,0,0,300
29722,26933628,26933628,26933928,0,0,0,300
29724,26933629,26933629,26933929,0,0,0,300
29725,26933629,26933629,26933929,0,0,0,300
29726,26933629,26933629,26933929,0,0,0,300
29727,26933629,26933629,26933929,0,0,0,300
29728,26933629,26933629,26933929,0,0,0,300
29729,26933630,26933630,26933930,0,0,0,300
29730,26933630,26933630,26933930,0,0,0,300
29731,26933630,26933630,26933930,0,0,0,300
29732,26933630,26933630,26933930,0,0,0,300
29733,26933630,26933630,26933930,0,0,0,300
29734,26933630,26933630,26933930,0,0,0,300
29735,26933630,26933630,26933930,0,0,0,300
29736,26933631,26933631,26933931,0,0,0,300
29737,26933631,26933631,26933931,0,0,0,300
29738,26934737,26934737,26935075,0,0,0,338
29739,26934737,26934737,26935086,0,0,0,349
29740,26934738,26934738,26935087,0,0,0,349
29741,26934738,26934738,26935098,0,0,0,360
29742,26934738,26934738,26935109,0,0,0,371
29743,26934738,26934738,26935109,0,0,0,371
29744,26934738,26934738,26935109,0,0,0,371
29745,26934738,26934738,26935120,0,0,0,382
29746,26934739,26934739,26935121,0,0,0,382
29747,26934739,26934739,26935132,0,0,0,393
29748,26934739,26934739,26935132,0,0,0,393
29749,26934739,26934739,26935132,0,0,0,393
29750,26934739,26934739,26935143,0,0,0,404
29751,26934739,26934739,26935154,0,0,0,415
29752,26934739,26934739,26935154,0,0,0,415
29753,26934740,26934740,26935166,0,0,0,426
29754,26934740,26934740,26935166,0,0,0,426
29755,26934740,26934740,26935166,0,0,0,426
29756,26934740,26934740,26935177,0,0,0,437
29757,26934740,26934740,26935177,0,0,0,437
29758,26934740,26934740,26935188,0,0,0,448
29760,26934741,26934741,26935189,0,0,0,448
29759,26934740,26934740,26935199,0,0,0,459
29761,26934741,26934741,26935200,0,0,0,459
29762,26934741,26934741,26935211,0,0,0,470
29763,26934741,26934741,26935211,0,0,0,470
29764,26934741,26934741,26935222,0,0,0,481
29765,26934741,26934741,26935222,0,0,0,481
29767,26934888,26934888,26935223,0,0,0,335
29766,26934741,26934741,26935233,0,0,0,492
29768,26934889,26934889,26935235,0,0,0,346
29769,26934889,26934889,26935246,0,0,0,357
29770,26934889,26934889,26935246,0,0,0,357
29771,26934889,26934889,26935257,0,0,0,368
29772,26934890,26934890,26935258,0,0,0,368
29773,26934890,26934890,26935269,0,0,0,379
29802,26936241,26936241,26936362,0,0,0,121
29795,26936239,26936239,26936371,0,0,0,132
29796,26936240,26936240,26936372,0,0,0,132
29797,26936240,26936240,26936383,0,0,0,143
29798,26936240,26936240,26936383,0,0,0,143
29799,26936240,26936240,26936394,0,0,0,154
29800,26936240,26936240,26936394,0,0,0,154
29801,26936240,26936240,26936405,0,0,0,165
29803,26936241,26936241,26936406,0,0,0,165
29804,26936241,26936241,26936417,0,0,0,176
29805,26936241,26936241,26936417,0,0,0,176
29806,26936241,26936241,26936428,0,0,0,187
29807,26936241,26936241,26936428,0,0,0,187
29808,26936241,26936241,26936428,0,0,0,187
29809,26936242,26936242,26936440,0,0,0,198
29810,26936242,26936242,26936451,0,0,0,209
29811,26936242,26936242,26936462,0,0,0,220
29774,26936235,26936235,26936496,0,0,0,261
29775,26936236,26936236,26936497,0,0,0,261
29776,26936236,26936236,26936497,0,0,0,261
29777,26936236,26936236,26936497,0,0,0,261
29778,26936236,26936236,26936497,0,0,0,261
29779,26936237,26936237,26936498,0,0,0,261
29780,26936237,26936237,26936498,0,0,0,261
29781,26936237,26936237,26936498,0,0,0,261
29782,26936238,26936238,26936499,0,0,0,261
29783,26936238,26936238,26936499,0,0,0,261
29784,26936238,26936238,26936499,0,0,0,261
29785,26936238,26936238,26936499,0,0,0,261
29786,26936238,26936238,26936499,0,0,0,261
29787,26936238,26936238,26936499,0,0,0,261
29788,26936238,26936238,26936499,0,0,0,261
29789,26936239,26936239,26936500,0,0,0,261
29790,26936239,26936239,26936500,0,0,0,261
29791,26936239,26936239,26936500,0,0,0,261
29792,26936239,26936239,26936512,0,0,0,273
29793,26936239,26936239,26936523,0,0,0,284
29794,26936239,26936239,26936523,0,0,0,284
29271,26810174,26810174,26939774,0,0,0,129600
29816,26946339,26946339,26946395,0,0,0,56
29817,26946339,26946339,26946395,0,0,0,56
29818,26946339,26946339,26946406,0,0,0,67
29819,26946339,26946339,26946406,0,0,0,67
29820,26946339,26946339,26946417,0,0,0,78
29821,26946339,26946339,26946417,0,0,0,78
29822,26946340,26946340,26946429,0,0,0,89
29823,26946340,26946340,26946429,0,0,0,89
29824,26946340,26946340,26946429,0,0,0,89
29825,26946709,26946709,26946784,0,0,0,75
29826,26946709,26946709,26946796,0,0,0,87
29827,26946709,26946709,26947609,0,0,0,900
29828,26946709,26946709,26947609,0,0,0,900
29829,26946709,26946709,26947609,0,0,0,900
29830,26946709,26946709,26947609,0,0,0,900
29831,26946709,26946709,26947609,0,0,0,900
29832,26946710,26946710,26947610,0,0,0,900
29833,26946710,26946710,26947610,0,0,0,900
29835,26948866,26948866,26949096,0,0,0,230
29836,26948866,26948866,26949096,0,0,0,230
29837,26948866,26948866,26949096,0,0,0,230
29838,26948866,26948866,26949096,0,0,0,230
29839,26948866,26948866,26949096,0,0,0,230
29840,26948867,26948867,26949097,0,0,0,230
29841,26948867,26948867,26949097,0,0,0,230
29842,26948867,26948867,26949097,0,0,0,230
29843,26948867,26948867,26949097,0,0,0,230
29844,26948867,26948867,26949097,0,0,0,230
29845,26948867,26948867,26949097,0,0,0,230
29846,26948868,26948868,26949098,0,0,0,230
29847,26948868,26948868,26949098,0,0,0,230
29848,26948868,26948868,26949098,0,0,0,230
29849,26948868,26948868,26949098,0,0,0,230
29850,26948868,26948868,26949109,0,0,0,241
29851,26948868,26948868,26949109,0,0,0,241
29834,26948858,26948858,26949110,0,0,0,252
29852,26948868,26948868,26949120,0,0,0,252
29856,26949013,26949013,26949150,0,0,0,137
29857,26949013,26949013,26949150,0,0,0,137
29858,26949013,26949013,26949161,0,0,0,148
29859,26949013,26949013,26949161,0,0,0,148
29860,26949014,26949014,26949173,0,0,0,159
29861,26949014,26949014,26949173,0,0,0,159
29862,26949014,26949014,26949184,0,0,0,170
29863,26949014,26949014,26949184,0,0,0,170
29864,26949015,26949015,26949185,0,0,0,170
29865,26949015,26949015,26949185,0,0,0,170
29866,26949015,26949015,26949196,0,0,0,181
29867,26949015,26949015,26949196,0,0,0,181
29868,26949016,26949016,26949208,0,0,0,192
29855,26949012,26949012,26949215,0,0,0,203
29853,26949012,26949012,26949264,0,0,0,252
29854,26949012,26949012,26949275,0,0,0,263
29889,26950342,26950342,26950490,0,0,0,148
29890,26950342,26950342,26950490,0,0,0,148
29891,26950342,26950342,26950490,0,0,0,148
29892,26950342,26950342,26950490,0,0,0,148
29895,26950343,26950343,26950491,0,0,0,148
29893,26950342,26950342,26950502,0,0,0,160
29894,26950342,26950342,26950502,0,0,0,160
29896,26950343,26950343,26950503,0,0,0,160
29897,26950343,26950343,26950514,0,0,0,171
29898,26950343,26950343,26950514,0,0,0,171
29899,26950343,26950343,26950525,0,0,0,182
29900,26950343,26950343,26950525,0,0,0,182
29901,26950343,26950343,26950525,0,0,0,182
29902,26950344,26950344,26950537,0,0,0,193
29903,26950344,26950344,26950548,0,0,0,204
29904,26950344,26950344,26950548,0,0,0,204
29905,26950344,26950344,26950559,0,0,0,215
29906,26950344,26950344,26950559,0,0,0,215
29907,26950344,26950344,26950570,0,0,0,226
29908,26950344,26950344,26950570,0,0,0,226
29909,26950345,26950345,26950571,0,0,0,226
29910,26950345,26950345,26950582,0,0,0,237
29911,26950345,26950345,26950582,0,0,0,237
29912,26950345,26950345,26950593,0,0,0,248
29913,26950345,26950345,26950593,0,0,0,248
29869,26950335,26950335,26950594,0,0,0,259
29914,26950345,26950345,26950604,0,0,0,259
29870,26950338,26950338,26950665,0,0,0,327
29871,26950338,26950338,26950665,0,0,0,327
29872,26950338,26950338,26950665,0,0,0,327
29873,26950339,26950339,26950666,0,0,0,327
29874,26950339,26950339,26950666,0,0,0,327
29875,26950339,26950339,26950666,0,0,0,327
29876,26950340,26950340,26950667,0,0,0,327
29877,26950340,26950340,26950667,0,0,0,327
29878,26950340,26950340,26950667,0,0,0,327
29879,26950340,26950340,26950667,0,0,0,327
29880,26950340,26950340,26950667,0,0,0,327
29881,26950340,26950340,26950667,0,0,0,327
29882,26950341,26950341,26950668,0,0,0,327
29883,26950341,26950341,26950668,0,0,0,327
29884,26950341,26950341,26950668,0,0,0,327
29885,26950341,26950341,26950668,0,0,0,327
29886,26950341,26950341,26950668,0,0,0,327
29887,26950341,26950341,26950668,0,0,0,327
29888,26950342,26950342,26950669,0,0,0,327
29925,26951182,26951182,26951310,0,0,0,128
29915,26951180,26951180,26951733,0,0,0,553
29916,26951180,26951180,26951733,0,0,0,553
29917,26951180,26951180,26951744,0,0,0,564
29919,26951181,26951181,26951756,0,0,0,575
29918,26951180,26951180,26951766,0,0,0,586
29920,26951181,26951181,26951778,0,0,0,597
29921,26951181,26951181,26951778,0,0,0,597
29922,26951181,26951181,26951778,0,0,0,597
29923,26951181,26951181,26951789,0,0,0,608
29924,26951181,26951181,26951789,0,0,0,608
29926,26951182,26951182,26951790,0,0,0,608
29927,26951182,26951182,26951801,0,0,0,619
29928,26951182,26951182,26951812,0,0,0,630
29929,26951182,26951182,26951812,0,0,0,630
29932,26951183,26951183,26951813,0,0,0,630
29930,26951182,26951182,26951823,0,0,0,641
29931,26951182,26951182,26951823,0,0,0,641
29933,26951183,26951183,26951846,0,0,0,663
29934,26951183,26951183,26951846,0,0,0,663
29935,26951183,26951183,26951857,0,0,0,674
29936,26953033,26953033,26953309,0,0,0,276
29937,26953033,26953033,26953309,0,0,0,276
29938,26953033,26953033,26953320,0,0,0,287
29939,26953033,26953033,26953320,0,0,0,287
29940,26953033,26953033,26953331,0,0,0,298
29941,26953034,26953034,26953332,0,0,0,298
29942,26953034,26953034,26953343,0,0,0,309
29943,26953034,26953034,26953343,0,0,0,309
29944,26953034,26953034,26953354,0,0,0,320
29945,26953034,26953034,26953365,0,0,0,331
29946,26953034,26953034,26953365,0,0,0,331
29948,26953035,26953035,26953366,0,0,0,331
29949,26953035,26953035,26953366,0,0,0,331
29947,26953034,26953034,26953376,0,0,0,342
29950,26953035,26953035,26953388,0,0,0,353
29951,26953035,26953035,26953388,0,0,0,353
29952,26953035,26953035,26953399,0,0,0,364
29953,26953035,26953035,26953399,0,0,0,364
29954,26953036,26953036,26953400,0,0,0,364
29955,26953036,26953036,26953400,0,0,0,364
29956,26953036,26953036,26953411,0,0,0,375
29957,26953036,26953036,26953422,0,0,0,386
29958,26953036,26953036,26953433,0,0,0,397
29959,26953036,26953036,26953433,0,0,0,397
29960,26953036,26953036,26953433,0,0,0,397
29961,26953164,26953164,26953445,0,0,0,281
29962,26953164,26953164,26953445,0,0,0,281
29963,26953164,26953164,26953456,0,0,0,292
29964,26953165,26953165,26953457,0,0,0,292
29965,26953165,26953165,26953457,0,0,0,292
29966,26953165,26953165,26953468,0,0,0,303
29967,26953165,26953165,26953468,0,0,0,303
29968,26953166,26953166,26953480,0,0,0,314
29969,26953166,26953166,26953491,0,0,0,325
29970,26953166,26953166,26953491,0,0,0,325
29971,26953166,26953166,26953491,0,0,0,325
29972,26953167,26953167,26953492,0,0,0,325
29973,26953167,26953167,26953503,0,0,0,336
29974,26953167,26953167,26953503,0,0,0,336
29975,26953167,26953167,26953514,0,0,0,347
29976,26953168,26953168,26953515,0,0,0,347
29977,26953168,26953168,26953515,0,0,0,347
29978,26953168,26953168,26953537,0,0,0,369
29979,26953168,26953168,26953537,0,0,0,369
29980,26953169,26953169,26953549,0,0,0,380
29981,26953169,26953169,26953549,0,0,0,380
29982,26953169,26953169,26953549,0,0,0,380
29983,26953169,26953169,26953560,0,0,0,391
29984,26953169,26953169,26953560,0,0,0,391
29985,26953169,26953169,26953571,0,0,0,402
30011,26954217,26954217,26954352,0,0,0,135
30012,26954218,26954218,26954353,0,0,0,135
30013,26954218,26954218,26954364,0,0,0,146
30014,26954218,26954218,26954364,0,0,0,146
30015,26954218,26954218,26954375,0,0,0,157
30016,26954218,26954218,26954386,0,0,0,168
30017,26954218,26954218,26954386,0,0,0,168
29986,26954208,26954208,26954387,0,0,0,179
29988,26954214,26954214,26954414,0,0,0,200
29989,26954214,26954214,26954414,0,0,0,200
29990,26954215,26954215,26954415,0,0,0,200
29991,26954215,26954215,26954415,0,0,0,200
29992,26954215,26954215,26954415,0,0,0,200
29993,26954215,26954215,26954415,0,0,0,200
29994,26954215,26954215,26954415,0,0,0,200
29995,26954215,26954215,26954415,0,0,0,200
29996,26954215,26954215,26954415,0,0,0,200
29997,26954215,26954215,26954415,0,0,0,200
29998,26954216,26954216,26954416,0,0,0,200
29999,26954216,26954216,26954428,0,0,0,212
30000,26954216,26954216,26954439,0,0,0,223
30001,26954216,26954216,26954439,0,0,0,223
30002,26954216,26954216,26954439,0,0,0,223
30004,26954217,26954217,26954451,0,0,0,234
30005,26954217,26954217,26954451,0,0,0,234
30003,26954216,26954216,26954461,0,0,0,245
30006,26954217,26954217,26954462,0,0,0,245
30007,26954217,26954217,26954473,0,0,0,256
30008,26954217,26954217,26954473,0,0,0,256
30009,26954217,26954217,26954484,0,0,0,267
30010,26954217,26954217,26954484,0,0,0,267
30018,26954361,26954361,26954540,0,0,0,179
29987,26954214,26954214,26954562,0,0,0,348
30042,26955394,26955394,26955533,0,0,0,139
30043,26955394,26955394,26955544,0,0,0,150
30044,26955394,26955394,26955555,0,0,0,161
30045,26955394,26955394,26955555,0,0,0,161
30046,26955394,26955394,26955555,0,0,0,161
30047,26955394,26955394,26955566,0,0,0,172
30048,26955394,26955394,26955566,0,0,0,172
30049,26955394,26955394,26955577,0,0,0,183
30050,26955394,26955394,26955577,0,0,0,183
30051,26955394,26955394,26955577,0,0,0,183
30019,26955394,26955394,26955609,0,0,0,215
30020,26955394,26955394,26955609,0,0,0,215
30021,26955394,26955394,26955609,0,0,0,215
30022,26955394,26955394,26955609,0,0,0,215
30023,26955394,26955394,26955609,0,0,0,215
30024,26955394,26955394,26955609,0,0,0,215
30025,26955394,26955394,26955609,0,0,0,215
30026,26955394,26955394,26955609,0,0,0,215
30027,26955394,26955394,26955609,0,0,0,215
30028,26955394,26955394,26955609,0,0,0,215
30029,26955394,26955394,26955620,0,0,0,226
30030,26955394,26955394,26955620,0,0,0,226
30031,26955394,26955394,26955620,0,0,0,226
30032,26955394,26955394,26955620,0,0,0,226
30033,26955394,26955394,26955620,0,0,0,226
30034,26955394,26955394,26955631,0,0,0,237
30035,26955394,26955394,26955642,0,0,0,248
30036,26955394,26955394,26955642,0,0,0,248
30037,26955394,26955394,26955642,0,0,0,248
30038,26955394,26955394,26955653,0,0,0,259
30039,26955394,26955394,26955653,0,0,0,259
30040,26955394,26955394,26955664,0,0,0,270
30041,26955394,26955394,26955664,0,0,0,270
30060,26957563,26957563,26957623,0,0,0,60
30061,26957563,26957563,26957623,0,0,0,60
30062,26957563,26957563,26957623,0,0,0,60
30063,26957563,26957563,26957623,0,0,0,60
30064,26957563,26957563,26957623,0,0,0,60
30065,26957563,26957563,26957623,0,0,0,60
30052,26956727,26956727,26957627,0,0,0,900
30053,26956727,26956727,26957627,0,0,0,900
30054,26956727,26956727,26957627,0,0,0,900
30055,26956727,26956727,26957627,0,0,0,900
30066,26957725,26957725,26957785,0,0,0,60
30067,26957725,26957725,26957785,0,0,0,60
30068,26957725,26957725,26957785,0,0,0,60
30069,26957725,26957725,26957785,0,0,0,60
30070,26957725,26957725,26957785,0,0,0,60
30071,26957725,26957725,26957785,0,0,0,60
30056,26957015,26957015,26957915,0,0,0,900
30057,26957015,26957015,26957915,0,0,0,900
30058,26957015,26957015,26957915,0,0,0,900
30059,26957015,26957015,26957915,0,0,0,900
30072,26957893,26957893,26957953,0,0,0,60
30073,26957893,26957893,26957953,0,0,0,60
30074,26957893,26957893,26957953,0,0,0,60
30075,26957893,26957893,26957953,0,0,0,60
30076,26957893,26957893,26957953,0,0,0,60
30077,26957893,26957893,26957953,0,0,0,60
30078,26957924,26957924,26957984,0,0,0,60
30079,26957925,26957925,26957985,0,0,0,60
30080,26957925,26957925,26957985,0,0,0,60
30081,26957925,26957925,26957985,0,0,0,60
30082,26957925,26957925,26957985,0,0,0,60
30083,26957925,26957925,26957985,0,0,0,60
30084,26957925,26957925,26957985,0,0,0,60
30085,26957925,26957925,26957985,0,0,0,60
30086,26957925,26957925,26957985,0,0,0,60
30087,26957925,26957925,26957985,0,0,0,60
30088,26957925,26957925,26957985,0,0,0,60
30089,26957925,26957925,26957985,0,0,0,60
30090,26957925,26957925,26957985,0,0,0,60
30091,26957925,26957925,26957985,0,0,0,60
30092,26958006,26958006,26958066,0,0,0,60
30093,26958006,26958006,26958066,0,0,0,60
30094,26958006,26958006,26958066,0,0,0,60
30095,26958006,26958006,26958066,0,0,0,60
30096,26958006,26958006,26958066,0,0,0,60
30097,26958006,26958006,26958066,0,0,0,60
30098,26958006,26958006,26958066,0,0,0,60
30099,26958006,26958006,26958066,0,0,0,60
30100,26958006,26958006,26958066,0,0,0,60
30101,26958006,26958006,26958066,0,0,0,60
30102,26958717,26958717,26958777,0,0,0,60
30103,26958717,26958717,26958777,0,0,0,60
30104,26958717,26958717,26958777,0,0,0,60
30105,26958717,26958717,26958777,0,0,0,60
30106,26958717,26958717,26958777,0,0,0,60
30107,26958717,26958717,26958777,0,0,0,60
30108,26958717,26958717,26958777,0,0,0,60
30109,26958717,26958717,26958777,0,0,0,60
30110,26958717,26958717,26958777,0,0,0,60
30111,26958717,26958717,26958777,0,0,0,60
30112,26958966,26958966,26959026,0,0,0,60
30113,26958966,26958966,26959026,0,0,0,60
30114,26958966,26958966,26959026,0,0,0,60
30115,26958966,26958966,26959026,0,0,0,60
30116,26958966,26958966,26959026,0,0,0,60
30117,26958966,26958966,26959026,0,0,0,60
30118,26958966,26958966,26959026,0,0,0,60
30119,26958966,26958966,26959026,0,0,0,60
30120,26958966,26958966,26959026,0,0,0,60
30121,26958966,26958966,26959026,0,0,0,60
30122,26959193,26959193,26959253,0,0,0,60
30123,26959193,26959193,26959253,0,0,0,60
30124,26959193,26959193,26959253,0,0,0,60
30125,26959354,26959354,26959414,0,0,0,60
30126,26959354,26959354,26959414,0,0,0,60
30127,26959354,26959354,26959414,0,0,0,60
30128,26959510,26959510,26959570,0,0,0,60
30129,26959510,26959510,26959570,0,0,0,60
30130,26959510,26959510,26959570,0,0,0,60
30131,26959663,26959663,26959723,0,0,0,60
30132,26959663,26959663,26959723,0,0,0,60
30133,26959663,26959663,26959723,0,0,0,60
30134,26959702,26959702,26959762,0,0,0,60
30135,26959702,26959702,26959762,0,0,0,60
30136,26959702,26959702,26959762,0,0,0,60
30137,26960149,26960149,26960209,0,0,0,60
30138,26960149,26960149,26960209,0,0,0,60
30139,26960149,26960149,26960209,0,0,0,60
30140,26960233,26960233,26960293,0,0,0,60
30141,26960233,26960233,26960293,0,0,0,60
30142,26960233,26960233,26960293,0,0,0,60
30143,26960609,26960609,26960669,0,0,0,60
30144,26960609,26960609,26960669,0,0,0,60
30145,26960609,26960609,26960669,0,0,0,60
30146,26960643,26960643,26960703,0,0,0,60
30147,26960643,26960643,26960703,0,0,0,60
30148,26960643,26960643,26960703,0,0,0,60
30149,26960689,26960689,26960749,0,0,0,60
30150,26960689,26960689,26960749,0,0,0,60
30151,26960689,26960689,26960749,0,0,0,60
29522,26909401,26909401,26992639,0,0,0,83238
29076,26741214,26741214,27000414,0,0,0,259200
29077,26741214,26741214,27000414,0,0,0,259200
29078,26741214,26741214,27000414,0,0,0,259200
29079,26741214,26741214,27000414,0,0,0,259200
29080,26741215,26741215,27000415,0,0,0,259200
29081,26741215,26741215,27000415,0,0,0,259200
30156,26999316,26999316,27000637,0,0,0,1321
30164,27004391,27004391,27004762,0,0,0,371
30165,27004435,27004435,27004766,0,0,0,331
30166,27004545,27004545,27004902,0,0,0,357
30167,27004598,27004598,27004950,0,0,0,352
30168,27004641,27004641,27004970,0,0,0,329
30158,27002875,27002875,27005195,0,0,0,2320
30170,27005089,27005089,27005448,0,0,0,359
30169,27005080,27005080,27005456,0,0,0,376
30171,27005138,27005138,27005514,0,0,0,376
30172,27005181,27005181,27005564,0,0,0,383
30173,27005253,27005253,27005627,0,0,0,374
29444,26831222,26833010,27005810,0,0,1788,174588
29445,26831235,26833010,27005810,0,0,1775,174575
29446,26831261,26833083,27005883,0,0,1822,174622
29155,26753281,26753281,27012481,0,0,0,259200
30152,26990786,26990786,27035806,0,0,0,45020
30153,26990936,26990936,27039719,0,0,0,48783
29431,26827850,26827850,27041721,0,0,0,213871
29443,26831118,26833373,27065049,0,0,2255,233931
30189,27067226,27067226,27067315,0,0,0,89
30154,26990998,26990998,27069618,0,0,0,78620
30191,27068868,27068868,27074036,0,0,0,5168
30192,27073996,27073996,27074069,0,0,0,73
30193,27074084,27074084,27074230,0,0,0,146
30194,27074241,27074241,27074319,0,0,0,78
30195,27074441,27074441,27074509,0,0,0,68
30196,27077401,27077401,27077485,0,0,0,84
30155,26992599,26992599,27077975,0,0,0,85376
30190,27067433,27067433,27082133,0,0,0,14700
30199,27082199,27082199,27083372,0,0,0,1173
30200,27083792,27083792,27084222,0,0,0,430
30437,27084566,27084566,27084944,0,0,0,378
30438,27086016,27086016,27086804,0,0,0,788
30441,27087698,27087698,27087745,0,0,0,47
30440,27087609,27087609,27087834,0,0,0,225
30439,27086757,27086804,27087851,0,0,47,1094
30443,27087835,27087835,27088805,0,0,0,970
30445,27088832,27088832,27088871,0,0,0,39
30447,27089681,27089681,27089734,0,0,0,53
30448,27089819,27089819,27090789,0,0,0,970
30442,27087803,27087851,27093264,0,0,48,5461
30455,27096581,27096581,27096624,0,0,0,43
30456,27096599,27096599,27096657,0,0,0,58
30457,27096758,27096758,27096803,0,0,0,45
28753,26579173,26579173,27097573,0,0,0,518400
30449,27089825,27093264,27097964,0,0,3439,8139
30459,27099500,27099500,27099593,0,0,0,93
30460,27099500,27099593,27099686,0,0,93,186
30452,27091729,27097964,27099800,0,0,6235,8071
30461,27099500,27099686,27099800,0,0,186,300
30462,27099500,27099800,27099914,0,0,300,414
30463,27099500,27099914,27100028,0,0,414,528
30464,27099500,27100028,27100168,0,0,528,668
30465,27099500,27100168,27100308,0,0,668,808
30466,27099500,27100308,27100469,0,0,808,969
30467,27099500,27100469,27100630,0,0,969,1130
30468,27099500,27100630,27100791,0,0,1130,1291
30469,27099500,27100791,27100978,0,0,1291,1478
30470,27099500,27100978,27101093,0,0,1478,1593
30471,27099500,27101093,27101208,0,0,1593,1708
30472,27099500,27101208,27101323,0,0,1708,1823
30473,27099500,27101323,27101438,0,0,1823,1938
30474,27099500,27101438,27101553,0,0,1938,2053
30475,27099500,27101553,27101668,0,0,2053,2168
30476,27099500,27101668,27101783,0,0,2168,2283
30477,27099500,27101783,27101898,0,0,2283,2398
30478,27099500,27101898,27102013,0,0,2398,2513
30479,27099500,27102013,27102128,0,0,2513,2628
30480,27099500,27102128,27102430,0,0,2628,2930
30481,27099500,27102430,27102545,0,0,2930,3045
30482,27099500,27102545,27102660,0,0,3045,3160
30483,27099500,27102660,27102780,0,0,3160,3280
30484,27099500,27102780,27102900,0,0,3280,3400
30485,27099500,27102900,27102999,0,0,3400,3499
30486,27099500,27102999,27103124,0,0,3499,3624
30487,27099500,27103124,27103249,0,0,3624,3749
30488,27099500,27103249,27103369,0,0,3749,3869
30489,27099500,27103369,27103489,0,0,3869,3989
30490,27099500,27103489,27103588,0,0,3989,4088
30491,27099500,27103588,27103713,0,0,4088,4213
30492,27099500,27103713,27103838,0,0,4213,4338
30493,27099500,27103838,27103937,0,0,4338,4437
30494,27099500,27103937,27104062,0,0,4437,4562
30495,27099500,27104062,27104161,0,0,4562,4661
30496,27099500,27104161,27104281,0,0,4661,4781
30497,27099500,27104281,27104401,0,0,4781,4901
30498,27099500,27104401,27104516,0,0,4901,5016
30499,27099500,27104516,27104647,0,0,5016,5147
30500,27099500,27104647,27104757,0,0,5147,5257
30501,27099500,27104757,27104867,0,0,5257,5367
30502,27099500,27104867,27104977,0,0,5367,5477
30503,27099500,27104977,27105092,0,0,5477,5592
30504,27099500,27105092,27105207,0,0,5592,5707
30505,27099500,27105207,27105442,0,0,5707,5942
30506,27099500,27105442,27105578,0,0,5942,6078
30507,27099500,27105578,27105688,0,0,6078,6188
30508,27099501,27105688,27105798,0,0,6187,6297
30509,27099501,27105798,27105918,0,0,6297,6417
30510,27099501,27105918,27106038,0,0,6417,6537
30511,27099501,27106038,27106158,0,0,6537,6657
30512,27099501,27106158,27106262,0,0,6657,6761
30513,27099501,27106262,27106366,0,0,6761,6865
30514,27099501,27106366,27106496,0,0,6865,6995
30515,27099501,27106496,27106626,0,0,6995,7125
30516,27099501,27106626,27106725,0,0,7125,7224
30517,27099501,27106725,27106850,0,0,7224,7349
30518,27099501,27106850,27106954,0,0,7349,7453
30519,27099501,27106954,27107058,0,0,7453,7557
30520,27099501,27107058,27107188,0,0,7557,7687
30521,27099501,27107188,27107287,0,0,7687,7786
30522,27099501,27107287,27107407,0,0,7786,7906
30523,27099501,27107407,27107506,0,0,7906,8005
30524,27099501,27107506,27107626,0,0,8005,8125
30525,27099501,27107626,27107746,0,0,8125,8245
30526,27099501,27107746,27107861,0,0,8245,8360
30527,27099501,27107861,27107976,0,0,8360,8475
30528,27099501,27107976,27108091,0,0,8475,8590
30529,27099501,27108091,27108206,0,0,8590,8705
30530,27099501,27108206,27108321,0,0,8705,8820
30531,27099501,27108321,27108436,0,0,8820,8935
30453,27095063,27099800,27108440,0,0,4737,13377
30532,27099501,27108436,27108681,0,0,8935,9180
30533,27099501,27108681,27108796,0,0,9180,9295
30534,27099501,27108796,27108911,0,0,9295,9410
30535,27099501,27108911,27109031,0,0,9410,9530
30536,27099501,27109031,27109151,0,0,9530,9650
30537,27099501,27109151,27109250,0,0,9650,9749
30538,27099501,27109250,27109375,0,0,9749,9874
30539,27099501,27109375,27109479,0,0,9874,9978
30540,27099501,27109479,27109604,0,0,9978,10103
30541,27099501,27109604,27109703,0,0,10103,10202
30542,27099501,27109703,27109849,0,0,10202,10348
30543,27099501,27109849,27109969,0,0,10348,10468
30544,27099501,27109969,27110089,0,0,10468,10588
30545,27099501,27110089,27110209,0,0,10588,10708
30546,27099501,27110209,27110329,0,0,10708,10828
30547,27099501,27110329,27110444,0,0,10828,10943
30548,27099501,27110444,27110559,0,0,10943,11058
30549,27099501,27110559,27110674,0,0,11058,11173
30550,27099501,27110674,27110789,0,0,11173,11288
30551,27099501,27110789,27110904,0,0,11288,11403
30552,27099501,27110904,27111019,0,0,11403,11518
30553,27099501,27111019,27111134,0,0,11518,11633
30554,27099501,27111134,27111249,0,0,11633,11748
30555,27099501,27111249,27111364,0,0,11748,11863
30187,27035935,27035935,27111405,0,0,0,75470
30556,27099501,27111364,27111479,0,0,11863,11978
30557,27099501,27111479,27111594,0,0,11978,12093
30558,27099501,27111594,27111850,0,0,12093,12349
30559,27099502,27111850,27111965,0,0,12348,12463
30560,27099502,27111965,27112080,0,0,12463,12578
30561,27099502,27112080,27112195,0,0,12578,12693
30562,27099502,27112195,27112310,0,0,12693,12808
30563,27099502,27112310,27112430,0,0,12808,12928
30564,27099502,27112430,27112550,0,0,12928,13048
30565,27099502,27112550,27112649,0,0,13048,13147
30566,27099502,27112649,27112753,0,0,13147,13251
30567,27099502,27112753,27112857,0,0,13251,13355
30568,27099502,27112857,27113003,0,0,13355,13501
30569,27099502,27113003,27113128,0,0,13501,13626
30570,27099502,27113128,27113227,0,0,13626,13725
30571,27099502,27113227,27113352,0,0,13725,13850
30572,27099502,27113352,27113456,0,0,13850,13954
30573,27099502,27113456,27113560,0,0,13954,14058
30574,27099502,27113560,27113690,0,0,14058,14188
30575,27099502,27113690,27113789,0,0,14188,14287
30576,27099502,27113789,27113909,0,0,14287,14407
30577,27099502,27113909,27114029,0,0,14407,14527
30578,27099502,27114029,27114144,0,0,14527,14642
30579,27099502,27114144,27114259,0,0,14642,14757
30580,27099502,27114259,27114353,0,0,14757,14851
30581,27099502,27114353,27114473,0,0,14851,14971
30582,27099502,27114473,27114593,0,0,14971,15091
30583,27099502,27114593,27114709,0,0,15091,15207
30584,27099502,27114709,27114825,0,0,15207,15323
30585,27099502,27114825,27114941,0,0,15323,15439
30586,27099502,27114941,27115187,0,0,15439,15685
30587,27099502,27115187,27115303,0,0,15685,15801
30588,27099502,27115303,27115419,0,0,15801,15917
30589,27099502,27115419,27115540,0,0,15917,16038
30590,27099502,27115540,27115661,0,0,16038,16159
29813,26942873,26942873,27115673,0,0,0,172800
29814,26942894,26942894,27115694,0,0,0,172800
30591,27099502,27115661,27115761,0,0,16159,16259
30592,27099502,27115761,27115877,0,0,16259,16375
30593,27099502,27115877,27115993,0,0,16375,16491
30594,27099502,27115993,27116094,0,0,16491,16592
30595,27099502,27116094,27116195,0,0,16592,16693
30596,27099502,27116195,27116296,0,0,16693,16794
30597,27099502,27116296,27116397,0,0,16794,16895
30598,27099502,27116397,27116509,0,0,16895,17007
30599,27099502,27116509,27116606,0,0,17007,17104
30600,27099502,27116606,27116714,0,0,17104,17212
30601,27099502,27116714,27116818,0,0,17212,17316
30602,27099502,27116818,27117058,0,0,17316,17556
30454,27095258,27108440,27117136,0,0,13182,21878
30603,27101382,27117058,27117185,0,0,15676,15803
30604,27101382,27117185,27117329,0,0,15803,15947
30605,27101382,27117329,27117473,0,0,15947,16091
30606,27101382,27117473,27117617,0,0,16091,16235
30607,27101382,27117617,27117787,0,0,16235,16405
30608,27101382,27117787,27117957,0,0,16405,16575
30609,27101382,27117957,27118127,0,0,16575,16745
30610,27101382,27118127,27118297,0,0,16745,16915
30611,27101382,27118297,27118467,0,0,16915,17085
30612,27101382,27118467,27118674,0,0,17085,17292
30613,27101382,27118674,27118881,0,0,17292,17499
30614,27101382,27118881,27119088,0,0,17499,17706
30615,27101382,27119088,27119214,0,0,17706,17832
30616,27101382,27119214,27119350,0,0,17832,17968
30617,27101444,27119350,27119486,0,0,17906,18042
30618,27101444,27119486,27119622,0,0,18042,18178
30619,27101444,27119622,27119758,0,0,18178,18314
30620,27101444,27119758,27119894,0,0,18314,18450
30621,27101444,27119894,27120030,0,0,18450,18586
30622,27101444,27120030,27120192,0,0,18586,18748
30623,27101444,27120192,27120354,0,0,18748,18910
30624,27101444,27120354,27120479,0,0,18910,19035
30625,27101444,27120479,27120630,0,0,19035,19186
30626,27101444,27120630,27120781,0,0,19186,19337
30627,27101444,27120781,27120911,0,0,19337,19467
30628,27101444,27120911,27121038,0,0,19467,19594
30629,27101444,27121038,27121182,0,0,19594,19738
30630,27101444,27121182,27121326,0,0,19738,19882
30631,27101444,27121326,27121465,0,0,19882,20021
30632,27101444,27121465,27121604,0,0,20021,20160
30633,27101444,27121604,27121743,0,0,20160,20299
30634,27101444,27121743,27121882,0,0,20299,20438
30635,27101444,27121882,27122021,0,0,20438,20577
30636,27101444,27122021,27122160,0,0,20577,20716
30637,27101444,27122160,27122299,0,0,20716,20855
30638,27101444,27122299,27122438,0,0,20855,20994
30639,27101444,27122438,27122573,0,0,20994,21129
30640,27101444,27122573,27122711,0,0,21129,21267
30641,27101444,27122711,27122848,0,0,21267,21404
30642,27101444,27122848,27122985,0,0,21404,21541
30643,27101444,27122985,27123122,0,0,21541,21678
30644,27101444,27123122,27123259,0,0,21678,21815
30645,27101444,27123259,27123417,0,0,21815,21973
30646,27101444,27123417,27123549,0,0,21973,22105
30647,27101444,27123549,27123681,0,0,22105,22237
30648,27101444,27123681,27123839,0,0,22237,22395
30649,27101444,27123839,27123987,0,0,22395,22543
30650,27101444,27123987,27124135,0,0,22543,22691
30651,27101444,27124135,27124283,0,0,22691,22839
30652,27101444,27124283,27124420,0,0,22839,22976
30653,27101444,27124420,27124557,0,0,22976,23113
30654,27101445,27124557,27124694,0,0,23112,23249
30655,27101445,27124694,27124831,0,0,23249,23386
30656,27101445,27124831,27124968,0,0,23386,23523
30657,27101445,27124968,27125105,0,0,23523,23660
30658,27101445,27125105,27125242,0,0,23660,23797
30659,27101445,27125242,27125379,0,0,23797,23934
30660,27101445,27125379,27125516,0,0,23934,24071
30661,27101445,27125516,27125653,0,0,24071,24208
30458,27096765,27117136,27125713,0,0,20371,28948
30662,27101445,27125653,27125774,0,0,24208,24329
30664,27101445,27125713,27125834,0,0,24268,24389
30665,27101445,27125713,27125850,0,0,24268,24405
30663,27101445,27125713,27125855,0,0,24268,24410
30666,27101445,27125774,27125911,0,0,24329,24466
30668,27101445,27125850,27125982,0,0,24405,24537
30667,27101445,27125834,27125987,0,0,24389,24542
30669,27101445,27125855,27126008,0,0,24410,24563
30670,27101445,27125911,27126043,0,0,24466,24598
30671,27101445,27125982,27126135,0,0,24537,24690
30673,27101445,27126008,27126135,0,0,24563,24690
30672,27101445,27125987,27126140,0,0,24542,24695
30674,27101445,27126043,27126196,0,0,24598,24751
30675,27101445,27126135,27126267,0,0,24690,24822
30676,27101445,27126135,27126267,0,0,24690,24822
30677,27101445,27126140,27126277,0,0,24695,24832
30678,27101445,27126196,27126333,0,0,24751,24888
30679,27101445,27126267,27126404,0,0,24822,24959
30681,27101445,27126277,27126409,0,0,24832,24964
30680,27101445,27126267,27126420,0,0,24822,24975
30682,27101445,27126333,27126465,0,0,24888,25020
30683,27101445,27126404,27126541,0,0,24959,25096
30684,27101445,27126409,27126546,0,0,24964,25101
30685,27101445,27126420,27126557,0,0,24975,25112
30686,27101445,27126465,27126602,0,0,25020,25157
30687,27101445,27126541,27126694,0,0,25096,25249
30689,27101445,27126557,27126694,0,0,25112,25249
30688,27101445,27126546,27126699,0,0,25101,25254
30690,27101445,27126602,27126739,0,0,25157,25294
30691,27101445,27126694,27126831,0,0,25249,25386
30692,27101445,27126694,27126831,0,0,25249,25386
30693,27101445,27126699,27126836,0,0,25254,25391
30694,27101445,27126739,27126897,0,0,25294,25452
30695,27101445,27126831,27126963,0,0,25386,25518
30696,27101445,27126831,27126984,0,0,25386,25539
30697,27101445,27126836,27126989,0,0,25391,25544
30698,27101445,27126897,27127045,0,0,25452,25600
30699,27101445,27126963,27127095,0,0,25518,25650
30701,27101445,27126989,27127121,0,0,25544,25676
30700,27101445,27126984,27127137,0,0,25539,25692
30702,27101445,27127045,27127182,0,0,25600,25737
30703,27101445,27127095,27127232,0,0,25650,25787
30704,27101445,27127121,27127258,0,0,25676,25813
30705,27101445,27127137,27127274,0,0,25692,25829
30706,27101445,27127182,27127319,0,0,25737,25874
30707,27101446,27127232,27127369,0,0,25786,25923
30708,27101446,27127258,27127395,0,0,25812,25949
30709,27101446,27127274,27127411,0,0,25828,25965
30710,27101446,27127319,27127456,0,0,25873,26010
30711,27101446,27127369,27127506,0,0,25923,26060
30712,27101446,27127395,27127532,0,0,25949,26086
30713,27101446,27127411,27127548,0,0,25965,26102
30714,27101446,27127456,27127593,0,0,26010,26147
30715,27101446,27127506,27127643,0,0,26060,26197
30716,27101446,27127532,27127669,0,0,26086,26223
30717,27101446,27127548,27127685,0,0,26102,26239
30718,27101446,27127593,27127730,0,0,26147,26284
30719,27101446,27127643,27127780,0,0,26197,26334
30720,27101446,27127669,27127806,0,0,26223,26360
30721,27101446,27127685,27127838,0,0,26239,26392
30722,27101446,27127730,27127862,0,0,26284,26416
30723,27101446,27127780,27127933,0,0,26334,26487
30724,27101446,27127806,27127938,0,0,26360,26492
30725,27101446,27127838,27127991,0,0,26392,26545
30726,27101446,27127862,27127994,0,0,26416,26548
30727,27101446,27127933,27128070,0,0,26487,26624
30728,27101446,27127938,27128075,0,0,26492,26629
30729,27101446,27127991,27128128,0,0,26545,26682
30730,27101446,27127994,27128131,0,0,26548,26685
30731,27101446,27128070,27128207,0,0,26624,26761
30732,27101446,27128075,27128212,0,0,26629,26766
30733,27101446,27128128,27128265,0,0,26682,26819
30734,27101446,27128131,27128268,0,0,26685,26822
30735,27101446,27128207,27128345,0,0,26761,26899
30736,27101446,27128212,27128350,0,0,26766,26904
30737,27101446,27128265,27128404,0,0,26819,26958
30738,27101446,27128268,27128407,0,0,26822,26961
30739,27101446,27128345,27128485,0,0,26899,27039
30740,27101446,27128350,27128485,0,0,26904,27039
30741,27101446,27128404,27128539,0,0,26958,27093
30742,27101446,27128407,27128543,0,0,26961,27097
30743,27101446,27128485,27128621,0,0,27039,27175
30745,27103445,27128485,27128751,0,0,25040,25306
30746,27103445,27128539,27128821,0,0,25094,25376
30747,27103445,27128543,27128825,0,0,25098,25380
30748,27103461,27128621,27128898,0,0,25160,25437
30749,27103468,27128751,27129028,0,0,25283,25560
30750,27103468,27128821,27129098,0,0,25353,25630
30751,27103469,27128825,27129102,0,0,25356,25633
30752,27103469,27128898,27129206,0,0,25429,25737
30753,27103469,27129028,27129336,0,0,25559,25867
30754,27103469,27129098,27129406,0,0,25629,25937
30755,27103469,27129102,27129410,0,0,25633,25941
30756,27103469,27129206,27129545,0,0,25737,26076
30757,27103469,27129336,27129611,0,0,25867,26142
30758,27103470,27129406,27129681,0,0,25936,26211
30759,27103470,27129410,27129685,0,0,25940,26215
30760,27103470,27129545,27129820,0,0,26075,26350
30761,27103470,27129611,27129886,0,0,26141,26416
30763,27103470,27129685,27129950,0,0,26215,26480
30762,27103470,27129681,27129977,0,0,26211,26507
30764,27103470,27129820,27130116,0,0,26350,26646
30765,27103471,27129886,27130151,0,0,26415,26680
30766,27103471,27129950,27130215,0,0,26479,26744
30767,27103471,27129977,27130274,0,0,26506,26803
30768,27103471,27130116,27130382,0,0,26645,26911
30770,27103471,27130215,27130481,0,0,26744,27010
30771,27103471,27130274,27130545,0,0,26803,27074
30769,27103471,27130151,27130577,0,0,26680,27106
30772,27103518,27130382,27130653,0,0,26864,27135
30773,27103675,27130481,27131081,0,0,26806,27406
30774,27103675,27130545,27131145,0,0,26870,27470
30775,27103700,27130577,27131177,0,0,26877,27477
30776,27103701,27130653,27131253,0,0,26952,27552
30203,27084244,27084244,27131397,0,0,0,47153
30777,27104034,27131081,27131681,0,0,27047,27647
30778,27104034,27131145,27131745,0,0,27111,27711
30779,27104066,27131177,27131777,0,0,27111,27711
30207,27084245,27084245,27131836,0,0,0,47591
30780,27104082,27131253,27131853,0,0,27171,27771
30236,27084251,27084251,27131902,0,0,0,47651
30201,27084243,27084243,27131939,0,0,0,47696
30210,27084246,27084246,27131964,0,0,0,47718
30251,27084293,27084293,27132037,0,0,0,47744
30208,27084245,27084245,27132057,0,0,0,47812
30204,27084244,27084244,27132079,0,0,0,47835
30252,27084293,27084293,27132096,0,0,0,47803
30781,27104083,27131681,27132281,0,0,27598,28198
30253,27084294,27084294,27132284,0,0,0,47990
30782,27104135,27131745,27132345,0,0,27610,28210
30211,27084246,27084246,27132373,0,0,0,48127
30783,27104135,27131777,27132377,0,0,27642,28242
30249,27084293,27084293,27132429,0,0,0,48136
30784,27104154,27131853,27132453,0,0,27699,28299
30205,27084244,27084244,27132468,0,0,0,48224
30209,27084245,27084245,27132483,0,0,0,48238
30206,27084244,27084244,27132524,0,0,0,48280
30212,27084246,27084246,27132557,0,0,0,48311
30250,27084293,27084293,27132619,0,0,0,48326
30229,27084250,27084250,27132841,0,0,0,48591
30230,27084250,27084250,27132849,0,0,0,48599
30785,27104154,27132281,27132881,0,0,28127,28727
30786,27104171,27132345,27132945,0,0,28174,28774
30787,27104172,27132377,27132977,0,0,28205,28805
30214,27084247,27084247,27132987,0,0,0,48740
30788,27104207,27132453,27133053,0,0,28246,28846
30231,27084250,27084250,27133063,0,0,0,48813
30202,27084243,27084243,27133132,0,0,0,48889
30234,27084251,27084251,27133173,0,0,0,48922
30221,27084248,27084248,27133255,0,0,0,49007
30235,27084251,27084251,27133257,0,0,0,49006
30213,27084246,27084246,27133373,0,0,0,49127
30218,27084248,27084248,27133418,0,0,0,49170
30789,27104207,27132881,27133481,0,0,28674,29274
30790,27104250,27132945,27133545,0,0,28695,29295
30215,27084247,27084247,27133567,0,0,0,49320
30791,27104251,27132977,27133577,0,0,28726,29326
30792,27104267,27133053,27133653,0,0,28786,29386
30232,27084250,27084250,27133676,0,0,0,49426
30223,27084249,27084249,27133962,0,0,0,49713
30233,27084250,27084250,27133976,0,0,0,49726
30793,27104268,27133481,27134081,0,0,29213,29813
30225,27084249,27084249,27134099,0,0,0,49850
30794,27104303,27133545,27134145,0,0,29242,29842
30795,27104303,27133577,27134177,0,0,29274,29874
30796,27104323,27133653,27134253,0,0,29330,29930
30216,27084247,27084247,27134638,0,0,0,50391
30797,27104323,27134081,27134681,0,0,29758,30358
30798,27104334,27134145,27134745,0,0,29811,30411
30799,27104334,27134177,27134777,0,0,29843,30443
30800,27104345,27134253,27134853,0,0,29908,30508
30801,27104345,27134681,27135281,0,0,30336,30936
30802,27104375,27134745,27135345,0,0,30370,30970
30803,27104375,27134777,27135377,0,0,30402,31002
30804,27105146,27134853,27135453,0,0,29707,30307
30217,27084247,27084247,27135482,0,0,0,51235
30237,27084251,27084251,27135559,0,0,0,51308
30246,27084253,27084253,27135766,0,0,0,51513
30805,27105147,27135281,27135881,0,0,30134,30734
30226,27084249,27084249,27136231,0,0,0,51982
30227,27084249,27084249,27136731,0,0,0,52482
30239,27084252,27084252,27137034,0,0,0,52782
30228,27084249,27084249,27137743,0,0,0,53494
30240,27084252,27084252,27137756,0,0,0,53504
30241,27084252,27084252,27138690,0,0,0,54438
30245,27084253,27084253,27138768,0,0,0,54515
30222,27084248,27084248,27140047,0,0,0,55799
30248,27084253,27084253,27141453,0,0,0,57200
30224,27084249,27084249,27141568,0,0,0,57319
30238,27084252,27084252,27142323,0,0,0,58071
30244,27084253,27084253,27142434,0,0,0,58181
30219,27084248,27084248,27142539,0,0,0,58291
30242,27084252,27084252,27143675,0,0,0,59423
30243,27084252,27084252,27144041,0,0,0,59789
30247,27084253,27084253,27144138,0,0,0,59885
30220,27084248,27084248,27145379,0,0,0,61131
30254,27084294,27097573,27145951,0,0,13279,61657
30811,27147259,27147259,27147670,0,0,0,411
30812,27147826,27147826,27147931,0,0,0,105
30813,27148003,27148003,27148222,0,0,0,219
30814,27148111,27148222,27148423,0,0,111,312
30815,27149146,27149146,27149365,0,0,0,219
30816,27149350,27149365,27149564,0,0,15,214
30818,27150886,27150886,27151048,0,0,0,162
30819,27151018,27151048,27151203,0,0,30,185
30820,27151371,27151371,27151529,0,0,0,158
30821,27151701,27151701,27151852,0,0,0,151
30822,27151942,27151942,27152093,0,0,0,151
30823,27152236,27152236,27152388,0,0,0,152
30824,27152249,27152388,27152540,0,0,139,291
30825,27152686,27152686,27152994,0,0,0,308
30826,27152697,27152994,27153320,0,0,297,623
30828,27155434,27155434,27155757,0,0,0,323
30829,27155739,27155739,27155808,0,0,0,69
30830,27155830,27155830,27155891,0,0,0,61
30832,27155963,27155963,27155997,0,0,0,34
30833,27156014,27156014,27156076,0,0,0,62
30834,27156438,27156438,27156494,0,0,0,56
30835,27156460,27156460,27156521,0,0,0,61
30836,27156526,27156526,27156594,0,0,0,68
30837,27156548,27156548,27156607,0,0,0,59
30831,27155901,27155901,27156884,0,0,0,983
30838,27156873,27156873,27157112,0,0,0,239
30839,27157222,27157222,27157548,0,0,0,326
30840,27157246,27157548,27157867,0,0,302,621
30841,27157798,27157798,27158776,0,0,0,978
30842,27158682,27158682,27158998,0,0,0,316
30843,27158784,27158998,27159319,0,0,214,535
30255,27084294,27111405,27159333,0,0,27111,75039
30256,27084294,27111405,27159351,0,0,27111,75057
30266,27084296,27111405,27159536,0,0,27109,75240
30257,27084294,27111405,27159549,0,0,27111,75255
30258,27084294,27111405,27159612,0,0,27111,75318
30844,27158847,27159319,27159635,0,0,472,788
30267,27084296,27111405,27159685,0,0,27109,75389
30259,27084295,27111405,27159837,0,0,27110,75542
30260,27084295,27111405,27159864,0,0,27110,75569
30847,27159677,27159677,27159909,0,0,0,232
30845,27158909,27159635,27159986,0,0,726,1077
30848,27159677,27159909,27160141,0,0,232,464
30849,27159681,27160141,27160276,0,0,460,595
30846,27158969,27159986,27160317,0,0,1017,1348
30853,27159682,27160317,27160410,0,0,635,728
30850,27159681,27160276,27160411,0,0,595,730
30852,27159681,27160317,27160498,0,0,636,817
30854,27159682,27160410,27160503,0,0,728,821
30855,27159682,27160411,27160504,0,0,729,822
30851,27159681,27160317,27160519,0,0,636,838
30261,27084295,27111405,27160585,0,0,27110,76290
30856,27159682,27160498,27160591,0,0,816,909
30857,27159686,27160503,27160596,0,0,817,910
30858,27159686,27160504,27160623,0,0,818,937
30859,27159686,27160519,27160638,0,0,833,952
30860,27159686,27160591,27160731,0,0,905,1045
30862,27159774,27160623,27160742,0,0,849,968
30863,27159774,27160638,27160757,0,0,864,983
30861,27159773,27160596,27160758,0,0,823,985
30262,27084295,27111405,27160779,0,0,27110,76484
30864,27159774,27160731,27160798,0,0,957,1024
30867,27159929,27160758,27160830,0,0,829,901
30868,27159929,27160798,27160881,0,0,869,952
30869,27159929,27160830,27160935,0,0,901,1006
30865,27159774,27160742,27160937,0,0,968,1163
30866,27159774,27160757,27160952,0,0,983,1178
30870,27159930,27160881,27160964,0,0,951,1034
30872,27159930,27160937,27161002,0,0,1007,1072
30871,27159930,27160935,27161029,0,0,1005,1099
30873,27159930,27160952,27161090,0,0,1022,1160
30876,27159931,27161029,27161094,0,0,1098,1163
30263,27084295,27111405,27161128,0,0,27110,76833
30874,27159930,27160964,27161135,0,0,1034,1205
30875,27159930,27161002,27161195,0,0,1072,1265
30879,27160458,27161094,27161243,0,0,636,785
30880,27160459,27161135,27161284,0,0,676,825
30881,27160460,27161195,27161344,0,0,735,884
30882,27160460,27161243,27161392,0,0,783,932
30883,27160460,27161284,27161433,0,0,824,973
30878,27160457,27161090,27161449,0,0,633,992
30264,27084296,27111405,27161469,0,0,27109,77173
30884,27160460,27161344,27161493,0,0,884,1033
30197,27077935,27077935,27161528,0,0,0,83593
30885,27160460,27161392,27161541,0,0,932,1081
30888,27160461,27161493,27161555,0,0,1032,1094
30886,27160460,27161433,27161594,0,0,973,1134
30889,27160461,27161541,27161603,0,0,1080,1142
30887,27160460,27161449,27161632,0,0,989,1172
30890,27160583,27161555,27161640,0,0,972,1057
30891,27160583,27161594,27161701,0,0,1011,1118
30894,27160584,27161640,27161714,0,0,1056,1130
30892,27160583,27161603,27161743,0,0,1020,1160
30895,27160584,27161701,27161786,0,0,1117,1202
30893,27160583,27161632,27161794,0,0,1049,1211
30896,27160584,27161714,27161799,0,0,1130,1215
30897,27160584,27161743,27161839,0,0,1159,1255
30265,27084296,27111405,27162320,0,0,27109,78024
30902,27165017,27165017,27165178,0,0,0,161
30903,27165017,27165017,27165178,0,0,0,161
30904,27165018,27165018,27165179,0,0,0,161
30907,27165021,27165179,27165319,0,0,158,298
30905,27165018,27165178,27165339,0,0,160,321
30906,27165020,27165178,27165479,0,0,158,459
30908,27165021,27165319,27165480,0,0,298,459
30909,27165021,27165339,27165500,0,0,318,479
30268,27084296,27115673,27165580,0,0,31377,81284
30911,27165021,27165480,27165636,0,0,459,615
30910,27165021,27165479,27165640,0,0,458,619
30912,27165021,27165500,27165656,0,0,479,635
30913,27165021,27165636,27165792,0,0,615,771
30914,27165139,27165640,27165796,0,0,501,657
30915,27165140,27165656,27165812,0,0,516,672
30918,27165144,27165812,27165963,0,0,668,819
30916,27165143,27165792,27165964,0,0,649,821
30917,27165144,27165796,27165968,0,0,652,824
30919,27165144,27165963,27166114,0,0,819,970
30920,27165144,27165964,27166115,0,0,820,971
30921,27165144,27165968,27166130,0,0,824,986
30270,27084297,27115694,27166247,0,0,31397,81950
30922,27165144,27166114,27166276,0,0,970,1132
30923,27165145,27166115,27166277,0,0,970,1132
30924,27165145,27166130,27166292,0,0,985,1147
30925,27165145,27166276,27166438,0,0,1131,1293
30926,27165145,27166277,27166440,0,0,1132,1295
30927,27165145,27166292,27166455,0,0,1147,1310
30928,27165145,27166438,27166601,0,0,1293,1456
30929,27165146,27166440,27166603,0,0,1294,1457
30930,27165146,27166455,27166618,0,0,1309,1472
30931,27165146,27166601,27166759,0,0,1455,1613
30932,27165147,27166603,27166761,0,0,1456,1614
30933,27165147,27166618,27166776,0,0,1471,1629
30934,27165147,27166759,27166917,0,0,1612,1770
30936,27165148,27166776,27166928,0,0,1628,1780
30935,27165148,27166761,27166950,0,0,1613,1802
30937,27165149,27166917,27167069,0,0,1768,1920
30938,27165149,27166928,27167080,0,0,1779,1931
30939,27165149,27166950,27167102,0,0,1801,1953
30941,27165151,27167080,27167242,0,0,1929,2091
30942,27165151,27167102,27167264,0,0,1951,2113
30940,27165151,27167069,27167268,0,0,1918,2117
30943,27165151,27167242,27167404,0,0,2091,2253
30944,27165152,27167264,27167426,0,0,2112,2274
30945,27165154,27167268,27167436,0,0,2114,2282
30946,27165154,27167404,27167572,0,0,2250,2418
30947,27165154,27167426,27167594,0,0,2272,2440
30948,27165155,27167436,27167604,0,0,2281,2449
30949,27165155,27167572,27167740,0,0,2417,2585
30950,27165155,27167594,27167761,0,0,2439,2606
30951,27165156,27167604,27167771,0,0,2448,2615
30952,27165156,27167740,27167907,0,0,2584,2751
30953,27165156,27167761,27167928,0,0,2605,2772
30954,27165156,27167771,27167938,0,0,2615,2782
30956,27165157,27167928,27168084,0,0,2771,2927
30957,27165157,27167938,27168094,0,0,2781,2937
30955,27165156,27167907,27168209,0,0,2751,3053
30958,27165157,27168084,27168240,0,0,2927,3083
30959,27165157,27168094,27168276,0,0,2937,3119
30961,27165158,27168240,27168385,0,0,3082,3227
30960,27165157,27168209,27168391,0,0,3052,3234
30962,27165158,27168276,27168421,0,0,3118,3263
30963,27165159,27168385,27168556,0,0,3226,3397
30964,27165159,27168391,27168562,0,0,3232,3403
30965,27165159,27168421,27168592,0,0,3262,3433
30966,27165159,27168556,27168727,0,0,3397,3568
30967,27165159,27168562,27168733,0,0,3403,3574
30968,27165160,27168592,27168759,0,0,3432,3599
30969,27165160,27168727,27168894,0,0,3567,3734
30970,27165160,27168733,27168900,0,0,3573,3740
30971,27165160,27168759,27168926,0,0,3599,3766
30972,27165160,27168894,27169036,0,0,3734,3876
30973,27165160,27168900,27169053,0,0,3740,3893
30974,27165161,27168926,27169079,0,0,3765,3918
30975,27165161,27169036,27169174,0,0,3875,4013
30976,27165162,27169053,27169191,0,0,3891,4029
30977,27165162,27169079,27169228,0,0,3917,4066
30978,27165162,27169174,27169323,0,0,4012,4161
30979,27165162,27169191,27169331,0,0,4029,4169
30980,27165163,27169228,27169368,0,0,4065,4205
30981,27165163,27169323,27169474,0,0,4160,4311
30982,27165163,27169331,27169482,0,0,4168,4319
30983,27165163,27169368,27169530,0,0,4205,4367
30985,27165164,27169482,27169613,0,0,4318,4449
30984,27165164,27169474,27169636,0,0,4310,4472
30986,27165164,27169530,27169672,0,0,4366,4508
31000,27169237,27169672,27169723,0,0,435,486
30987,27165165,27169613,27169755,0,0,4448,4590
31001,27169243,27169723,27169772,0,0,480,529
30988,27165165,27169636,27169789,0,0,4471,4624
31002,27169243,27169755,27169815,0,0,512,572
30198,27078594,27078594,27171228,0,0,0,92634
31003,27171198,27171198,27171281,0,0,0,83
31004,27171204,27171204,27171287,0,0,0,83
31005,27171205,27171205,27171299,0,0,0,94
31006,27171458,27171458,27171594,0,0,0,136
31007,27171458,27171458,27171606,0,0,0,148
31008,27171458,27171458,27171606,0,0,0,148
31013,27173776,27173776,27173856,0,0,0,80
31014,27173776,27173776,27173856,0,0,0,80
31015,27173777,27173777,27173878,0,0,0,101
31016,27173777,27173856,27173957,0,0,79,180
31017,27173777,27173856,27173978,0,0,79,201
31018,27173777,27173878,27174000,0,0,101,223
31019,27173777,27173957,27174037,0,0,180,260
31021,27173778,27174000,27174075,0,0,222,297
31022,27173778,27174037,27174112,0,0,259,334
31020,27173777,27173978,27174196,0,0,201,419
31023,27173815,27174075,27174213,0,0,260,398
31024,27173815,27174112,27174250,0,0,297,435
31025,27173815,27174196,27174275,0,0,381,460
31027,27173815,27174250,27174334,0,0,435,519
31026,27173815,27174213,27174356,0,0,398,541
31028,27173815,27174275,27174359,0,0,460,544
31029,27173815,27174334,27174434,0,0,519,619
31030,27173815,27174356,27174451,0,0,541,636
31031,27173816,27174359,27174470,0,0,543,654
31032,27173816,27174434,27174519,0,0,618,703
31033,27173816,27174451,27174536,0,0,635,720
31035,27173817,27174519,27174609,0,0,702,792
31036,27173830,27174536,27174610,0,0,706,780
31034,27173816,27174470,27174661,0,0,654,845
31037,27173830,27174609,27174689,0,0,779,859
31038,27173831,27174610,27174711,0,0,779,880
31039,27173831,27174661,27174757,0,0,830,926
31040,27173831,27174689,27174806,0,0,858,975
31041,27173831,27174711,27174806,0,0,880,975
31042,27173831,27174757,27174847,0,0,926,1016
31043,27173831,27174806,27174896,0,0,975,1065
31045,27173832,27174847,27174937,0,0,1015,1105
31047,27174033,27174896,27174986,0,0,863,953
31044,27173831,27174806,27174991,0,0,975,1160
31048,27174033,27174937,27175027,0,0,904,994
31049,27174034,27174986,27175076,0,0,952,1042
31050,27174034,27174991,27175081,0,0,957,1047
31051,27174034,27175027,27175122,0,0,993,1088
31053,27174035,27175081,27175155,0,0,1046,1120
31052,27174034,27175076,27175192,0,0,1042,1158
31071,27174438,27174438,27175206,0,0,0,768
31054,27174035,27175122,27175217,0,0,1087,1182
31055,27174035,27175155,27175229,0,0,1120,1194
31056,27174035,27175192,27175292,0,0,1157,1257
31057,27174037,27175217,27175301,0,0,1180,1264
31058,27174037,27175229,27175308,0,0,1192,1271
31060,27174038,27175301,27175396,0,0,1263,1358
31061,27174038,27175308,27175398,0,0,1270,1360
31059,27174037,27175292,27175484,0,0,1255,1447
31062,27174038,27175396,27175502,0,0,1358,1464
31063,27174038,27175398,27175504,0,0,1360,1466
31064,27174038,27175484,27175564,0,0,1446,1526
31066,27174038,27175504,27175585,0,0,1466,1547
31065,27174038,27175502,27175588,0,0,1464,1550
31067,27174065,27175564,27175697,0,0,1499,1632
31068,27174065,27175585,27175723,0,0,1520,1658
31069,27174066,27175588,27175731,0,0,1522,1665
30188,27066909,27066909,27175823,0,0,0,108914
31072,27174479,27175697,27175833,0,0,1218,1354
31073,27174479,27175723,27175854,0,0,1244,1375
31074,27174480,27175731,27175868,0,0,1251,1388
31076,27174992,27175833,27175959,0,0,841,967
31077,27174992,27175854,27175992,0,0,862,1000
31078,27174992,27175868,27176006,0,0,876,1014
31079,27175513,27175959,27176101,0,0,446,588
31080,27175513,27175992,27176134,0,0,479,621
31081,27175514,27176006,27176148,0,0,492,634
31082,27175614,27176101,27176174,0,0,487,560
31083,27175620,27176134,27176207,0,0,514,587
31084,27175620,27176148,27176237,0,0,528,617
31085,27175621,27176174,27176263,0,0,553,642
31086,27175621,27176207,27176280,0,0,586,659
31087,27175621,27176237,27176322,0,0,616,701
31089,27175622,27176280,27176365,0,0,658,743
31090,27175622,27176322,27176392,0,0,700,770
31091,27175773,27176365,27176439,0,0,592,666
31088,27175621,27176263,27176458,0,0,642,837
31092,27175773,27176392,27176482,0,0,619,709
31093,27175773,27176439,27176529,0,0,666,756
31094,27175774,27176458,27176548,0,0,684,774
31095,27175774,27176482,27176598,0,0,708,824
31096,27175774,27176529,27176645,0,0,755,871
31097,27175774,27176548,27176664,0,0,774,890
31098,27175774,27176598,27176669,0,0,824,895
31099,27175774,27176645,27176717,0,0,871,943
31101,27175776,27176669,27176741,0,0,893,965
31102,27175776,27176717,27176810,0,0,941,1034
31103,27175776,27176741,27176824,0,0,965,1048
31100,27175774,27176664,27176859,0,0,890,1085
31104,27175776,27176810,27176893,0,0,1034,1117
31105,27175776,27176824,27176907,0,0,1048,1131
31106,27175777,27176859,27176939,0,0,1082,1162
31107,27175777,27176893,27176972,0,0,1116,1195
31108,27175777,27176907,27176986,0,0,1130,1209
31109,27175777,27176939,27177023,0,0,1162,1246
31110,27175777,27176972,27177056,0,0,1195,1279
31111,27175815,27176986,27177070,0,0,1171,1255
31112,27175816,27177023,27177107,0,0,1207,1291
31114,27175816,27177070,27177138,0,0,1254,1322
31113,27175816,27177056,27177140,0,0,1240,1324
31115,27175816,27177107,27177196,0,0,1291,1380
31116,27175817,27177138,27177217,0,0,1321,1400
31117,27175817,27177140,27177219,0,0,1323,1402
31118,27175817,27177196,27177275,0,0,1379,1458
31120,27175818,27177219,27177319,0,0,1401,1501
31121,27175885,27177275,27177349,0,0,1390,1464
31122,27175886,27177319,27177393,0,0,1433,1507
31119,27175817,27177217,27177412,0,0,1400,1595
31123,27175886,27177349,27177444,0,0,1463,1558
31124,27175886,27177393,27177472,0,0,1507,1586
31125,27175886,27177412,27177486,0,0,1526,1600
31126,27175887,27177444,27177529,0,0,1557,1642
31127,27175887,27177472,27177547,0,0,1585,1660
30269,27084296,27115673,27177554,0,0,31377,93258
31128,27175887,27177486,27177572,0,0,1599,1685
31129,27175887,27177529,27177605,0,0,1642,1718
31130,27175887,27177547,27177623,0,0,1660,1736
31131,27176320,27177572,27177701,0,0,1252,1381
31132,27176321,27177605,27177750,0,0,1284,1429
31133,27176321,27177623,27177768,0,0,1302,1447
31134,27176321,27177701,27177846,0,0,1380,1525
31135,27176321,27177750,27177921,0,0,1429,1600
31136,27176321,27177768,27177939,0,0,1447,1618
31137,27176321,27177846,27178017,0,0,1525,1696
31139,27176322,27177939,27178063,0,0,1617,1741
31140,27176322,27178017,27178141,0,0,1695,1819
31141,27176322,27178063,27178203,0,0,1741,1881
31138,27176321,27177921,27178248,0,0,1600,1927
31142,27176322,27178141,27178297,0,0,1819,1975
31143,27176322,27178203,27178333,0,0,1881,2011
31144,27176322,27178248,27178378,0,0,1926,2056
31145,27176322,27178297,27178453,0,0,1975,2131
31146,27176323,27178333,27178470,0,0,2010,2147
31147,27176323,27178378,27178510,0,0,2055,2187
31148,27176323,27178453,27178581,0,0,2130,2258
31149,27176323,27178470,27178598,0,0,2147,2275
31150,27176323,27178510,27178654,0,0,2187,2331
31151,27176323,27178581,27178725,0,0,2258,2402
31152,27176324,27178598,27178737,0,0,2274,2413
31153,27176324,27178654,27178791,0,0,2330,2467
31154,27176324,27178725,27178877,0,0,2401,2553
31155,27176324,27178737,27178889,0,0,2413,2565
31156,27176324,27178791,27178922,0,0,2467,2598
31161,27176781,27178922,27178979,0,0,2141,2198
31158,27176324,27178889,27179021,0,0,2565,2697
31162,27176782,27178979,27179057,0,0,2197,2275
31163,27176782,27179021,27179099,0,0,2239,2317
31164,27176782,27179057,27179136,0,0,2275,2354
31157,27176324,27178877,27179173,0,0,2553,2849
31166,27176783,27179136,27179178,0,0,2353,2395
31165,27176782,27179099,27179200,0,0,2317,2418
31167,27176783,27179173,27179227,0,0,2390,2444
31168,27176783,27179178,27179301,0,0,2395,2518
31169,27176783,27179200,27179302,0,0,2417,2519
31172,27177037,27179301,27179354,0,0,2264,2317
31173,27177037,27179302,27179366,0,0,2265,2329
31170,27176783,27179227,27179388,0,0,2444,2605
31174,27177037,27179354,27179434,0,0,2317,2397
31175,27177038,27179366,27179438,0,0,2328,2400
31178,27177039,27179438,27179476,0,0,2399,2437
31176,27177038,27179388,27179505,0,0,2350,2467
31179,27177039,27179476,27179540,0,0,2437,2501
31180,27177039,27179505,27179563,0,0,2466,2524
31181,27177039,27179540,27179619,0,0,2501,2580
31182,27177041,27179563,27179621,0,0,2522,2580
31177,27177038,27179434,27179669,0,0,2396,2631
31183,27177041,27179619,27179672,0,0,2578,2631
31184,27177041,27179621,27179696,0,0,2580,2655
31185,27177041,27179669,27179723,0,0,2628,2682
31186,27177041,27179672,27179768,0,0,2631,2727
31187,27177041,27179696,27179814,0,0,2655,2773
31189,27177042,27179768,27179816,0,0,2726,2774
30280,27084300,27132096,27179854,0,0,47796,95554
31190,27177042,27179814,27179878,0,0,2772,2836
31191,27177042,27179816,27179896,0,0,2774,2854
31188,27177041,27179723,27179915,0,0,2682,2874
31192,27177043,27179878,27179931,0,0,2835,2888
31193,27177043,27179896,27179954,0,0,2853,2911
31194,27177043,27179915,27179989,0,0,2872,2946
31195,27177043,27179931,27180016,0,0,2888,2973
31197,27177044,27179989,27180037,0,0,2945,2993
31198,27177044,27180016,27180064,0,0,2972,3020
31200,27177044,27180064,27180128,0,0,3020,3084
31196,27177043,27179954,27180151,0,0,2911,3108
31199,27177044,27180037,27180154,0,0,2993,3110
31201,27177044,27180128,27180208,0,0,3084,3164
31202,27177045,27180151,27180215,0,0,3106,3170
31203,27177045,27180154,27180218,0,0,3109,3173
31204,27177045,27180208,27180277,0,0,3163,3232
31205,27177061,27180215,27180290,0,0,3154,3229
31206,27177062,27180218,27180309,0,0,3156,3247
30276,27084299,27131964,27180317,0,0,47665,96018
31207,27177062,27180277,27180336,0,0,3215,3274
31210,27177063,27180336,27180390,0,0,3273,3327
31208,27177062,27180290,27180408,0,0,3228,3346
31209,27177062,27180309,27180461,0,0,3247,3399
31211,27177063,27180390,27180477,0,0,3327,3414
31215,27177648,27180408,27180545,0,0,2760,2897
30900,27162948,27162948,27180556,0,0,0,17608
31216,27177649,27180461,27180598,0,0,2812,2949
30283,27084301,27132429,27180601,0,0,48128,96300
31217,27177649,27180477,27180614,0,0,2828,2965
30287,27084302,27132557,27180640,0,0,48255,96338
31218,27177649,27180545,27180682,0,0,2896,3033
30298,27084350,27133418,27180707,0,0,49068,96357
31219,27177649,27180598,27180735,0,0,2949,3086
31220,27177650,27180614,27180751,0,0,2964,3101
31221,27177650,27180682,27180840,0,0,3032,3190
31222,27177650,27180735,27180875,0,0,3085,3225
30299,27084351,27133567,27180907,0,0,49216,96556
31224,27177651,27180840,27180980,0,0,3189,3329
31223,27177650,27180751,27181040,0,0,3101,3390
31225,27177651,27180875,27181075,0,0,3224,3424
30300,27084351,27133676,27181090,0,0,49325,96739
31226,27177651,27180980,27181164,0,0,3329,3513
31227,27177651,27181040,27181208,0,0,3389,3557
31228,27177652,27181075,27181243,0,0,3423,3591
31229,27177652,27181164,27181329,0,0,3512,3677
31230,27177652,27181208,27181357,0,0,3556,3705
30277,27084299,27132037,27181446,0,0,47738,97147
31232,27177653,27181329,27181461,0,0,3676,3808
31231,27177652,27181243,27181484,0,0,3591,3832
31233,27177653,27181357,27181489,0,0,3704,3836
31234,27177653,27181461,27181614,0,0,3808,3961
31236,27177653,27181489,27181621,0,0,3836,3968
31235,27177653,27181484,27181637,0,0,3831,3984
30278,27084299,27132057,27181697,0,0,47758,97398
30281,27084300,27132284,27181706,0,0,47984,97406
31238,27177654,27181621,27181753,0,0,3967,4099
31239,27177654,27181637,27181769,0,0,3983,4115
31237,27177653,27181614,27181872,0,0,3961,4219
31240,27177654,27181753,27181879,0,0,4099,4225
31241,27177654,27181769,27181912,0,0,4115,4258
30286,27084301,27132524,27181937,0,0,48223,97636
30303,27084352,27134099,27181960,0,0,49747,97608
31242,27177654,27181872,27181994,0,0,4218,4340
31243,27177654,27181879,27182022,0,0,4225,4368
31244,27177655,27181912,27182037,0,0,4257,4382
30282,27084300,27132373,27182057,0,0,48073,97757
31245,27177655,27181994,27182136,0,0,4339,4481
31246,27177655,27182022,27182159,0,0,4367,4504
31247,27177655,27182037,27182169,0,0,4382,4514
31248,27177655,27182136,27182267,0,0,4481,4612
31249,27177655,27182159,27182290,0,0,4504,4635
31251,27177656,27182267,27182398,0,0,4611,4742
31252,27177656,27182290,27182416,0,0,4634,4760
30284,27084301,27132468,27182430,0,0,48167,98129
31250,27177655,27182169,27182432,0,0,4514,4777
30272,27084298,27131397,27182489,0,0,47099,98191
31253,27177656,27182398,27182524,0,0,4742,4868
31254,27177656,27182416,27182542,0,0,4760,4886
31255,27177656,27182432,27182563,0,0,4776,4907
30301,27084351,27133962,27182599,0,0,49611,98248
30304,27084352,27134638,27182645,0,0,50286,98293
31256,27177656,27182524,27182655,0,0,4868,4999
31257,27177656,27182542,27182673,0,0,4886,5017
31258,27177657,27182563,27182694,0,0,4906,5037
31259,27177657,27182655,27182784,0,0,4998,5127
31260,27177657,27182673,27182801,0,0,5016,5144
31261,27177657,27182694,27182822,0,0,5037,5165
30285,27084301,27132483,27182851,0,0,48182,98550
31262,27177657,27182784,27182907,0,0,5127,5250
31263,27177657,27182801,27182924,0,0,5144,5267
31265,27177658,27182907,27183046,0,0,5249,5388
31266,27177658,27182924,27183058,0,0,5266,5400
31264,27177657,27182822,27183084,0,0,5165,5427
31267,27177658,27183046,27183180,0,0,5388,5522
31268,27177658,27183058,27183192,0,0,5400,5534
31269,27177658,27183084,27183218,0,0,5426,5560
31270,27177658,27183180,27183303,0,0,5522,5645
31271,27177659,27183192,27183320,0,0,5533,5661
31272,27177659,27183218,27183346,0,0,5559,5687
31273,27177660,27183303,27183431,0,0,5643,5771
31274,27177660,27183320,27183459,0,0,5660,5799
30302,27084351,27133976,27183470,0,0,49625,99119
31275,27177660,27183346,27183504,0,0,5686,5844
31277,27177661,27183459,27183585,0,0,5798,5924
31276,27177660,27183431,27183599,0,0,5771,5939
31278,27177661,27183504,27183609,0,0,5843,5948
31279,27177661,27183585,27183700,0,0,5924,6039
31281,27177662,27183609,27183708,0,0,5947,6046
31282,27177662,27183700,27183761,0,0,6038,6099
31283,27177662,27183708,27183765,0,0,6046,6103
31284,27177662,27183761,27183818,0,0,6099,6156
31285,27177663,27183765,27183843,0,0,6102,6180
31280,27177661,27183599,27183871,0,0,5938,6210
31286,27177663,27183818,27183886,0,0,6155,6223
30307,27084353,27135766,27183898,0,0,51413,99545
30305,27084352,27135482,27183900,0,0,51130,99548
31287,27177663,27183843,27183911,0,0,6180,6248
31288,27177663,27183871,27183939,0,0,6208,6276
31289,27177664,27183886,27183954,0,0,6222,6290
31290,27177664,27183911,27183974,0,0,6247,6310
31291,27177664,27183939,27184002,0,0,6275,6338
31292,27177664,27183954,27184022,0,0,6290,6358
31293,27177664,27183974,27184047,0,0,6310,6383
30306,27084352,27135559,27184050,0,0,51207,99698
31294,27177664,27184002,27184075,0,0,6338,6411
31295,27177665,27184022,27184095,0,0,6357,6430
31296,27177665,27184047,27184120,0,0,6382,6455
31297,27177665,27184075,27184148,0,0,6410,6483
31298,27177665,27184095,27184168,0,0,6430,6503
31299,27177665,27184120,27184193,0,0,6455,6528
31300,27177665,27184148,27184216,0,0,6483,6551
31302,27177666,27184193,27184261,0,0,6527,6595
31303,27177666,27184216,27184284,0,0,6550,6618
30288,27084302,27132619,27184316,0,0,48317,100014
31304,27177666,27184261,27184329,0,0,6595,6663
31301,27177665,27184168,27184351,0,0,6503,6686
31305,27177666,27184284,27184352,0,0,6618,6686
31306,27177666,27184329,27184397,0,0,6663,6731
31307,27177666,27184351,27184419,0,0,6685,6753
31308,27177667,27184352,27184420,0,0,6685,6753
31309,27177667,27184397,27184465,0,0,6730,6798
31310,27177667,27184419,27184487,0,0,6752,6820
31311,27177667,27184420,27184488,0,0,6753,6821
31312,27177667,27184465,27184533,0,0,6798,6866
30308,27084353,27136231,27184544,0,0,51878,100191
31313,27177667,27184487,27184555,0,0,6820,6888
31314,27177667,27184488,27184561,0,0,6821,6894
31315,27177667,27184533,27184590,0,0,6866,6923
31316,27177668,27184555,27184633,0,0,6887,6965
31317,27177668,27184561,27184639,0,0,6893,6971
31318,27177668,27184590,27184642,0,0,6922,6974
31319,27177668,27184633,27184711,0,0,6965,7043
31320,27177668,27184639,27184717,0,0,6971,7049
31322,27177669,27184711,27184779,0,0,7042,7110
31323,27177669,27184717,27184785,0,0,7048,7116
31321,27177668,27184642,27184830,0,0,6974,7162
31324,27177669,27184779,27184847,0,0,7110,7178
31325,27177669,27184785,27184853,0,0,7116,7184
31326,27177669,27184830,27184898,0,0,7161,7229
31328,27177676,27184847,27184915,0,0,7171,7239
31329,27177676,27184853,27184921,0,0,7177,7245
31330,27177676,27184898,27184966,0,0,7222,7290
31331,27177677,27184915,27184983,0,0,7238,7306
31332,27177677,27184921,27184989,0,0,7244,7312
31333,27177677,27184966,27185034,0,0,7289,7357
31334,27177678,27184983,27185051,0,0,7305,7373
31335,27177678,27184989,27185062,0,0,7311,7384
31336,27177678,27185034,27185107,0,0,7356,7429
31338,27177679,27185062,27185114,0,0,7383,7435
31337,27177678,27185051,27185129,0,0,7373,7451
30184,27012359,27012359,27185159,0,0,0,172800
31339,27177679,27185107,27185164,0,0,7428,7485
31340,27177680,27185114,27185171,0,0,7434,7491
30185,27012373,27012373,27185173,0,0,0,172800
31341,27177680,27185129,27185212,0,0,7449,7532
31342,27177680,27185164,27185216,0,0,7484,7536
31343,27177680,27185171,27185244,0,0,7491,7564
31345,27177681,27185216,27185289,0,0,7535,7608
30309,27084353,27136731,27185311,0,0,52378,100958
31346,27177681,27185244,27185312,0,0,7563,7631
31347,27177681,27185289,27185357,0,0,7608,7676
31348,27177681,27185312,27185380,0,0,7631,7699
31344,27177680,27185212,27185401,0,0,7532,7721
31349,27177681,27185357,27185410,0,0,7676,7729
31350,27177681,27185380,27185449,0,0,7699,7768
31351,27177681,27185401,27185465,0,0,7720,7784
31352,27180119,27185410,27185466,0,0,5291,5347
31353,27180119,27185449,27185521,0,0,5330,5402
31354,27180119,27185465,27185537,0,0,5346,5418
31355,27180120,27185466,27185538,0,0,5346,5418
31356,27180120,27185521,27185579,0,0,5401,5459
31357,27180120,27185537,27185590,0,0,5417,5470
31359,27180121,27185579,27185643,0,0,5458,5522
31360,27180121,27185590,27185654,0,0,5469,5533
31362,27180345,27185654,27185708,0,0,5309,5363
31358,27180120,27185538,27185723,0,0,5418,5603
31361,27180121,27185643,27185746,0,0,5522,5625
31363,27180351,27185708,27185762,0,0,5357,5411
31364,27180351,27185723,27185793,0,0,5372,5442
31365,27180352,27185746,27185816,0,0,5394,5464
31366,27180352,27185762,27185827,0,0,5410,5475
31367,27180352,27185793,27185857,0,0,5441,5505
31369,27180353,27185827,27185886,0,0,5474,5533
31370,27180353,27185857,27185927,0,0,5504,5574
31371,27180353,27185886,27185946,0,0,5533,5593
31372,27180585,27185927,27185979,0,0,5342,5394
31368,27180352,27185816,27186000,0,0,5464,5648
31373,27180585,27185946,27186014,0,0,5361,5429
31374,27180586,27185979,27186047,0,0,5393,5461
31375,27180586,27186000,27186089,0,0,5414,5503
31376,27180586,27186014,27186103,0,0,5428,5517
31377,27180586,27186047,27186103,0,0,5461,5517
30310,27084353,27137034,27186130,0,0,52681,101777
31378,27180586,27186089,27186151,0,0,5503,5565
31380,27180587,27186103,27186165,0,0,5516,5578
31381,27180587,27186151,27186203,0,0,5564,5616
31382,27181562,27186165,27186219,0,0,4603,4657
31383,27181562,27186203,27186274,0,0,4641,4712
31384,27181562,27186219,27186290,0,0,4657,4728
31379,27180586,27186103,27186295,0,0,5517,5709
31385,27181562,27186274,27186345,0,0,4712,4783
31387,27181562,27186295,27186349,0,0,4733,4787
31386,27181562,27186290,27186387,0,0,4728,4825
30311,27084354,27137743,27186396,0,0,53389,102042
31389,27181593,27186349,27186403,0,0,4756,4810
31390,27181594,27186387,27186452,0,0,4793,4858
31391,27181594,27186403,27186468,0,0,4809,4874
31392,27181766,27186452,27186508,0,0,4686,4742
31388,27181562,27186345,27186537,0,0,4783,4975
31393,27181766,27186468,27186540,0,0,4702,4774
31394,27181766,27186508,27186580,0,0,4742,4814
31395,27181766,27186537,27186609,0,0,4771,4843
31396,27181766,27186540,27186638,0,0,4774,4872
31398,27181797,27186609,27186663,0,0,4812,4866
31399,27181798,27186638,27186692,0,0,4840,4894
30274,27084298,27131902,27186695,0,0,47604,102397
31400,27181798,27186663,27186729,0,0,4865,4931
31401,27181798,27186692,27186758,0,0,4894,4960
31402,27181948,27186729,27186782,0,0,4781,4834
31397,27181766,27186580,27186793,0,0,4814,5027
31403,27181948,27186758,27186822,0,0,4810,4874
31404,27181948,27186782,27186857,0,0,4834,4909
31405,27181948,27186793,27186868,0,0,4845,4920
31406,27182094,27186822,27186886,0,0,4728,4792
31407,27182094,27186857,27186921,0,0,4763,4827
31408,27182094,27186868,27186932,0,0,4774,4838
30312,27084354,27137756,27186961,0,0,53402,102607
31409,27182094,27186886,27186961,0,0,4792,4867
31410,27182215,27186921,27186977,0,0,4706,4762
31411,27182215,27186932,27187000,0,0,4717,4785
31412,27182215,27186961,27187029,0,0,4746,4814
31414,27182311,27187000,27187045,0,0,4689,4734
31413,27182215,27186977,27187056,0,0,4762,4841
31415,27182311,27187029,27187074,0,0,4718,4763
31416,27182311,27187045,27187090,0,0,4734,4779
31417,27182311,27187056,27187113,0,0,4745,4802
31418,27182429,27187074,27187139,0,0,4645,4710
31419,27182435,27187090,27187149,0,0,4655,4714
31420,27182435,27187113,27187172,0,0,4678,4737
31421,27182435,27187139,27187209,0,0,4704,4774
31422,27182537,27187149,27187214,0,0,4612,4677
31423,27182543,27187172,27187231,0,0,4629,4688
31424,27182543,27187209,27187268,0,0,4666,4725
31425,27182543,27187214,27187284,0,0,4671,4741
31426,27182646,27187231,27187285,0,0,4585,4639
31427,27182652,27187268,27187316,0,0,4616,4664
31428,27182652,27187284,27187332,0,0,4632,4680
31429,27182652,27187285,27187350,0,0,4633,4698
31430,27182728,27187316,27187379,0,0,4588,4651
31431,27182729,27187332,27187395,0,0,4603,4666
30289,27084302,27132841,27187430,0,0,48539,103128
30315,27084355,27140047,27187434,0,0,55692,103079
31432,27182729,27187350,27187434,0,0,4621,4705
31433,27182729,27187379,27187463,0,0,4650,4734
31434,27182729,27187395,27187479,0,0,4666,4750
31435,27182730,27187434,27187481,0,0,4704,4751
31436,27182730,27187463,27187526,0,0,4733,4796
31437,27182730,27187479,27187537,0,0,4749,4807
31439,27182731,27187526,27187584,0,0,4795,4853
31440,27182731,27187537,27187616,0,0,4806,4885
31441,27182731,27187584,27187653,0,0,4853,4922
31438,27182730,27187481,27187691,0,0,4751,4961
30295,27084303,27133255,27187697,0,0,48952,103394
31442,27182731,27187616,27187700,0,0,4885,4969
31443,27182732,27187653,27187721,0,0,4921,4989
31444,27182732,27187691,27187759,0,0,4959,5027
31445,27182732,27187700,27187762,0,0,4968,5030
31446,27182732,27187721,27187799,0,0,4989,5067
31447,27182733,27187759,27187821,0,0,5026,5088
31448,27182733,27187762,27187852,0,0,5029,5119
31450,27182733,27187821,27187880,0,0,5088,5147
31449,27182733,27187799,27187889,0,0,5066,5156
31451,27182733,27187852,27187911,0,0,5119,5178
31452,27182733,27187880,27187939,0,0,5147,5206
31454,27182770,27187911,27187963,0,0,5141,5193
31455,27182770,27187939,27187991,0,0,5169,5221
31456,27182770,27187963,27188015,0,0,5193,5245
31458,27183368,27187991,27188056,0,0,4623,4688
31453,27182734,27187889,27188069,0,0,5155,5335
31459,27183374,27188015,27188079,0,0,4641,4705
31460,27183374,27188056,27188120,0,0,4682,4746
31461,27183375,27188069,27188133,0,0,4694,4758
30313,27084354,27138690,27188134,0,0,54336,103780
31462,27183375,27188079,27188169,0,0,4704,4794
31463,27183375,27188120,27188174,0,0,4745,4799
30273,27084298,27131836,27188175,0,0,47538,103877
31465,27183376,27188169,27188222,0,0,4793,4846
31466,27183376,27188174,27188239,0,0,4798,4863
31467,27183376,27188222,27188287,0,0,4846,4911
31464,27183375,27188133,27188326,0,0,4758,4951
31472,27183885,27188239,27188328,0,0,4354,4443
31473,27183885,27188287,27188392,0,0,4402,4507
31475,27183886,27188328,27188433,0,0,4442,4547
31474,27183885,27188326,27188442,0,0,4441,4557
31476,27183886,27188392,27188483,0,0,4506,4597
31477,27183886,27188433,27188545,0,0,4547,4659
31478,27183886,27188442,27188554,0,0,4556,4668
31479,27183886,27188483,27188595,0,0,4597,4709
31482,27183958,27188595,27188670,0,0,4637,4712
31481,27183887,27188554,27188678,0,0,4667,4791
31494,27184013,27188678,27188751,0,0,4665,4738
30314,27084354,27138768,27188753,0,0,54414,104399
31485,27183959,27188670,27188765,0,0,4711,4806
31480,27183886,27188545,27188768,0,0,4659,4882
31506,27184042,27188765,27188837,0,0,4723,4795
31498,27184014,27188751,27188858,0,0,4737,4844
31509,27184043,27188768,27188866,0,0,4725,4823
31522,27184941,27188837,27188947,0,0,3896,4006
31523,27184941,27188858,27188987,0,0,3917,4046
31524,27184942,27188866,27188995,0,0,3924,4053
31525,27184942,27188947,27189076,0,0,4005,4134
31528,27184975,27189076,27189110,0,0,4101,4135
31526,27184942,27188987,27189116,0,0,4045,4174
31529,27185183,27189110,27189175,0,0,3927,3992
31530,27185210,27189116,27189218,0,0,3906,4008
31527,27184942,27188995,27189224,0,0,4053,4282
31531,27185330,27189175,27189288,0,0,3845,3958
30294,27084303,27133173,27189524,0,0,48870,105221
31534,27185852,27189224,27190053,0,0,3372,4201
31535,27185960,27189288,27190118,0,0,3328,4158
31532,27185563,27189218,27190337,0,0,3655,4774
31537,27187157,27190118,27190352,0,0,2961,3195
31536,27186693,27190053,27190530,0,0,3360,3837
31539,27187211,27190352,27190531,0,0,3141,3320
31538,27187195,27190337,27190532,0,0,3142,3337
31542,27187372,27190532,27190655,0,0,3160,3283
31541,27187253,27190531,27190667,0,0,3278,3414
31540,27187228,27190530,27190682,0,0,3302,3454
30316,27084355,27141453,27190720,0,0,57098,106365
31544,27187440,27190667,27190725,0,0,3227,3285
31543,27187402,27190655,27190740,0,0,3253,3338
31545,27187479,27190682,27190740,0,0,3203,3261
30291,27084302,27132987,27191077,0,0,48685,106775
31551,27190879,27190879,27191112,0,0,0,233
30290,27084302,27132849,27191168,0,0,48547,106866
30296,27084303,27133257,27192054,0,0,48954,107751
30275,27084298,27131939,27192164,0,0,47641,107866
30317,27084355,27141568,27192315,0,0,57213,107960
30279,27084299,27132079,27192426,0,0,47780,108127
30293,27084303,27133132,27193150,0,0,48829,108847
30292,27084302,27133063,27193437,0,0,48761,109135
30325,27084357,27145951,27194187,0,0,61594,109830
30318,27084355,27142323,27194292,0,0,57968,109937
30321,27084356,27143675,27194925,0,0,59319,110569
30320,27084356,27142539,27195015,0,0,58183,110659
30322,27084356,27144041,27198504,0,0,59685,114148
30319,27084355,27142434,27199646,0,0,58079,115291
31546,27187635,27190725,27199725,0,0,3090,12090
31547,27187699,27190740,27199740,0,0,3041,12041
31548,27187708,27190740,27199740,0,0,3032,12032
30323,27084356,27144138,27199815,0,0,59782,115459
31553,27196885,27199740,27199860,0,0,2855,2975
31554,27197097,27199860,27200017,0,0,2763,2920
31555,27197098,27200017,27200136,0,0,2919,3038
31556,27197098,27200136,27200272,0,0,3038,3174
31557,27197098,27200272,27200408,0,0,3174,3310
31558,27197098,27200408,27200565,0,0,3310,3467
31559,27197098,27200565,27200679,0,0,3467,3581
31560,27197098,27200679,27200961,0,0,3581,3863
31561,27197099,27200961,27201086,0,0,3862,3987
31562,27197099,27201086,27201211,0,0,3987,4112
31563,27197099,27201211,27201336,0,0,4112,4237
31564,27197099,27201336,27201461,0,0,4237,4362
31565,27197099,27201461,27201576,0,0,4362,4477
30324,27084356,27145379,27201647,0,0,61023,117291
31566,27197099,27201576,27201690,0,0,4477,4591
31567,27197099,27201690,27201821,0,0,4591,4722
31568,27197100,27201821,27201947,0,0,4721,4847
31569,27197100,27201947,27202073,0,0,4847,4973
30271,27084297,27115694,27202094,0,0,31397,117797
31570,27197100,27202073,27202198,0,0,4973,5098
31571,27197100,27202198,27202312,0,0,5098,5212
31572,27197100,27202312,27202426,0,0,5212,5326
31573,27197100,27202426,27202682,0,0,5326,5582
31574,27197101,27202682,27202796,0,0,5581,5695
31575,27197101,27202796,27202926,0,0,5695,5825
31576,27197101,27202926,27203045,0,0,5825,5944
31577,27197101,27203045,27203164,0,0,5944,6063
31578,27197101,27203164,27203282,0,0,6063,6181
31579,27197101,27203282,27203400,0,0,6181,6299
31580,27197101,27203400,27203518,0,0,6299,6417
31581,27197102,27203518,27203634,0,0,6416,6532
31582,27197102,27203634,27203750,0,0,6532,6648
31583,27197102,27203750,27203867,0,0,6648,6765
31584,27197102,27203867,27203985,0,0,6765,6883
31585,27197102,27203985,27204103,0,0,6883,7001
31586,27197102,27204103,27204355,0,0,7001,7253
31587,27197103,27204355,27204475,0,0,7252,7372
31588,27197103,27204475,27204595,0,0,7372,7492
31589,27197103,27204595,27204714,0,0,7492,7611
31590,27197103,27204714,27204843,0,0,7611,7740
31591,27197103,27204843,27204972,0,0,7740,7869
31592,27197103,27204972,27205096,0,0,7869,7993
31593,27197103,27205096,27205341,0,0,7993,8238
31594,27197135,27205341,27205465,0,0,8206,8330
31595,27197135,27205465,27205589,0,0,8330,8454
31596,27197135,27205589,27205704,0,0,8454,8569
31597,27197135,27205704,27205820,0,0,8569,8685
31598,27197135,27205820,27205941,0,0,8685,8806
31599,27197136,27205941,27206062,0,0,8805,8926
31600,27197136,27206062,27206183,0,0,8926,9047
31601,27197136,27206183,27206302,0,0,9047,9166
31602,27197136,27206302,27206420,0,0,9166,9284
31603,27197137,27206420,27206540,0,0,9283,9403
31604,27197137,27206540,27206660,0,0,9403,9523
31605,27197137,27206660,27206780,0,0,9523,9643
31606,27197137,27206780,27207029,0,0,9643,9892
31607,27197138,27207029,27207149,0,0,9891,10011
31608,27197138,27207149,27207269,0,0,10011,10131
30326,27084357,27159333,27207343,0,0,74976,122986
31609,27197138,27207269,27207387,0,0,10131,10249
31610,27197139,27207387,27207505,0,0,10248,10366
31611,27197139,27207505,27207623,0,0,10366,10484
31612,27197139,27207623,27207741,0,0,10484,10602
30328,27084357,27159536,27207755,0,0,75179,123398
31613,27197139,27207741,27207859,0,0,10602,10720
31614,27197140,27207859,27207976,0,0,10719,10836
31615,27197140,27207976,27208089,0,0,10836,10949
30327,27084357,27159351,27208156,0,0,74994,123799
31616,27197140,27208089,27208235,0,0,10949,11095
31617,27197140,27208235,27208349,0,0,11095,11209
30331,27084358,27159685,27208409,0,0,75327,124051
30334,27084358,27160585,27208443,0,0,76227,124085
31618,27197140,27208349,27208468,0,0,11209,11328
31619,27197140,27208468,27208716,0,0,11328,11576
31549,27187715,27199725,27208725,0,0,12010,21010
31550,27187729,27199740,27208740,0,0,12011,21011
31620,27197141,27208716,27208836,0,0,11575,11695
31621,27197141,27208725,27208844,0,0,11584,11703
30332,27084358,27159837,27208850,0,0,75479,124492
31622,27197141,27208740,27208879,0,0,11599,11738
31624,27197141,27208844,27208962,0,0,11703,11821
31623,27197141,27208836,27208975,0,0,11695,11834
31625,27197141,27208879,27209002,0,0,11738,11861
31627,27197142,27208975,27209098,0,0,11833,11956
31628,27197142,27209002,27209141,0,0,11860,11999
31626,27197141,27208962,27209212,0,0,11821,12071
31629,27197142,27209098,27209237,0,0,11956,12095
31630,27197142,27209141,27209280,0,0,11999,12138
30335,27084359,27160779,27209292,0,0,76420,124933
31631,27197142,27209212,27209351,0,0,12070,12209
30333,27084358,27159864,27209359,0,0,75506,125001
31632,27197142,27209237,27209370,0,0,12095,12228
31633,27197143,27209280,27209413,0,0,12137,12270
31634,27197143,27209351,27209484,0,0,12208,12341
31635,27197143,27209370,27209497,0,0,12227,12354
31636,27197143,27209413,27209530,0,0,12270,12387
31637,27197143,27209484,27209602,0,0,12341,12459
31638,27197143,27209497,27209631,0,0,12354,12488
31639,27197144,27209530,27209664,0,0,12386,12520
31640,27197144,27209602,27209736,0,0,12458,12592
31641,27197144,27209631,27209760,0,0,12487,12616
31642,27197144,27209664,27209793,0,0,12520,12649
31643,27197144,27209736,27209865,0,0,12592,12721
31645,27197145,27209793,27209907,0,0,12648,12762
31646,27197145,27209865,27209982,0,0,12720,12837
31644,27197144,27209760,27210005,0,0,12616,12861
31647,27197145,27209907,27210023,0,0,12762,12878
31648,27197145,27209982,27210109,0,0,12837,12964
31649,27197145,27210005,27210132,0,0,12860,12987
31650,27197145,27210023,27210150,0,0,12878,13005
31651,27197146,27210109,27210236,0,0,12963,13090
31652,27197147,27210132,27210259,0,0,12985,13112
31653,27197147,27210150,27210277,0,0,13003,13130
31654,27197147,27210236,27210351,0,0,13089,13204
31655,27197147,27210259,27210375,0,0,13112,13228
31656,27197147,27210277,27210393,0,0,13130,13246
31657,27197148,27210351,27210467,0,0,13203,13319
30336,27084359,27161128,27210470,0,0,76769,126111
31658,27197148,27210375,27210507,0,0,13227,13359
31659,27197148,27210393,27210525,0,0,13245,13377
31660,27197149,27210467,27210610,0,0,13318,13461
31661,27197149,27210507,27210650,0,0,13358,13501
31662,27197149,27210525,27210668,0,0,13376,13519
31663,27197149,27210610,27210727,0,0,13461,13578
31664,27197150,27210650,27210777,0,0,13500,13627
31665,27197150,27210668,27210784,0,0,13518,13634
31666,27197150,27210727,27210843,0,0,13577,13693
31668,27197151,27210784,27210900,0,0,13633,13749
31669,27197151,27210843,27210975,0,0,13692,13824
31670,27197151,27210900,27211032,0,0,13749,13881
31667,27197150,27210777,27211036,0,0,13627,13886
31671,27197151,27210975,27211128,0,0,13824,13977
31673,27197151,27211036,27211152,0,0,13885,14001
31672,27197151,27211032,27211185,0,0,13881,14034
31674,27197152,27211128,27211270,0,0,13976,14118
31675,27197152,27211152,27211294,0,0,14000,14142
31676,27197152,27211185,27211327,0,0,14033,14175
31677,27197152,27211270,27211412,0,0,14118,14260
31678,27197152,27211294,27211420,0,0,14142,14268
31679,27197152,27211327,27211485,0,0,14175,14333
31680,27197153,27211412,27211538,0,0,14259,14385
31681,27197153,27211420,27211551,0,0,14267,14398
31682,27197153,27211485,27211616,0,0,14332,14463
31683,27197153,27211538,27211648,0,0,14385,14495
31684,27197153,27211551,27211687,0,0,14398,14534
31685,27197153,27211616,27211752,0,0,14463,14599
31686,27197153,27211648,27211774,0,0,14495,14621
31687,27197154,27211687,27211813,0,0,14533,14659
31688,27197154,27211752,27211889,0,0,14598,14735
31689,27197154,27211774,27211891,0,0,14620,14737
31690,27197154,27211813,27211936,0,0,14659,14782
31691,27197154,27211889,27212007,0,0,14735,14853
31693,27197155,27211936,27212054,0,0,14781,14899
31694,27197155,27212007,27212126,0,0,14852,14971
31692,27197154,27211891,27212160,0,0,14737,15006
31695,27197155,27212054,27212173,0,0,14899,15018
31696,27197155,27212126,27212256,0,0,14971,15101
31697,27197155,27212160,27212286,0,0,15005,15131
31698,27200130,27212173,27212362,0,0,12043,12232
30329,27084357,27159549,27212409,0,0,75192,128052
31699,27200131,27212256,27212445,0,0,12125,12314
31702,27200436,27212362,27212556,0,0,11926,12120
31700,27200131,27212286,27212581,0,0,12155,12450
31703,27200436,27212445,27212655,0,0,12009,12219
30337,27084359,27161469,27212751,0,0,77110,128392
31704,27200436,27212556,27212766,0,0,12120,12330
31705,27200437,27212581,27212791,0,0,12144,12354
31706,27200437,27212655,27212891,0,0,12218,12454
31707,27200437,27212766,27213002,0,0,12329,12565
31708,27200437,27212791,27213027,0,0,12354,12590
31709,27200437,27212891,27213127,0,0,12454,12690
31710,27200437,27213002,27213238,0,0,12565,12801
31711,27200484,27213027,27213243,0,0,12543,12759
31712,27200484,27213127,27213343,0,0,12643,12859
31713,27200484,27213238,27213454,0,0,12754,12970
31714,27200485,27213243,27213459,0,0,12758,12974
31715,27200485,27213343,27213559,0,0,12858,13074
31716,27200485,27213454,27213645,0,0,12969,13160
31718,27200486,27213559,27213761,0,0,13073,13275
31717,27200485,27213459,27213840,0,0,12974,13355
31719,27200486,27213645,27213847,0,0,13159,13361
31720,27200486,27213761,27213963,0,0,13275,13477
31722,27200487,27213847,27214049,0,0,13360,13562
31721,27200486,27213840,27214063,0,0,13354,13577
31723,27200487,27213963,27214186,0,0,13476,13699
31724,27200487,27214049,27214272,0,0,13562,13785
31725,27200487,27214063,27214286,0,0,13576,13799
31726,27200488,27214186,27214403,0,0,13698,13915
31727,27200488,27214272,27214489,0,0,13784,14001
31728,27200488,27214286,27214503,0,0,13798,14015
31729,27200488,27214403,27214620,0,0,13915,14132
31731,27200489,27214503,27214700,0,0,14014,14211
31730,27200489,27214489,27214706,0,0,14000,14217
31732,27200489,27214620,27214808,0,0,14131,14319
31733,27200489,27214700,27214904,0,0,14211,14415
31734,27200489,27214706,27214926,0,0,14217,14437
31735,27200489,27214808,27215002,0,0,14319,14513
31736,27200490,27214904,27215098,0,0,14414,14608
31737,27200490,27214926,27215136,0,0,14436,14646
31738,27200490,27215002,27215212,0,0,14512,14722
31739,27200490,27215098,27215308,0,0,14608,14818
31740,27200490,27215136,27215341,0,0,14646,14851
31742,27200491,27215308,27215513,0,0,14817,15022
31743,27200491,27215341,27215546,0,0,14850,15055
31741,27200490,27215212,27215566,0,0,14722,15076
31744,27200491,27215513,27215745,0,0,15022,15254
31746,27200491,27215566,27215760,0,0,15075,15269
31745,27200491,27215546,27215778,0,0,15055,15287
31748,27200492,27215760,27215952,0,0,15268,15460
31747,27200491,27215745,27215953,0,0,15254,15462
31749,27200492,27215778,27215975,0,0,15286,15483
30330,27084357,27159612,27216099,0,0,75255,131742
31751,27200492,27215953,27216145,0,0,15461,15653
31750,27200492,27215952,27216165,0,0,15460,15673
31752,27200492,27215975,27216172,0,0,15483,15680
31753,27200492,27216145,27216342,0,0,15653,15850
31754,27200493,27216165,27216362,0,0,15672,15869
31755,27200493,27216172,27216369,0,0,15679,15876
31756,27200493,27216342,27216539,0,0,15849,16046
31758,27200493,27216369,27216560,0,0,15876,16067
31757,27200493,27216362,27216580,0,0,15869,16087
31759,27200493,27216539,27216751,0,0,16046,16258
31760,27200494,27216560,27216764,0,0,16066,16270
31761,27200494,27216580,27216774,0,0,16086,16280
31762,27200494,27216751,27216945,0,0,16257,16451
31763,27200494,27216764,27216969,0,0,16270,16475
31764,27200494,27216774,27216974,0,0,16280,16480
31766,27200526,27216969,27217169,0,0,16443,16643
31767,27200526,27216974,27217175,0,0,16448,16649
31765,27200494,27216945,27217286,0,0,16451,16792
31768,27200526,27217169,27217370,0,0,16643,16844
31769,27200526,27217175,27217387,0,0,16649,16861
31770,27200527,27217286,27217483,0,0,16759,16956
31771,27200527,27217370,27217578,0,0,16843,17051
31772,27200527,27217387,27217585,0,0,16860,17058
31773,27200527,27217483,27217681,0,0,16956,17154
31775,27202001,27217578,27217769,0,0,15577,15768
31776,27202001,27217585,27217776,0,0,15584,15775
31777,27202001,27217681,27217893,0,0,15680,15892
31778,27202001,27217769,27217981,0,0,15768,15980
31779,27202001,27217776,27217988,0,0,15775,15987
31780,27202002,27217893,27218193,0,0,15891,16191
31781,27202002,27217981,27218281,0,0,15979,16279
31782,27202003,27217988,27218288,0,0,15985,16285
30340,27084360,27161528,27218353,0,0,77168,133993
30341,27084360,27161528,27218449,0,0,77168,134089
31784,27202003,27218281,27218465,0,0,16278,16462
31785,27202003,27218288,27218488,0,0,16285,16485
31783,27202003,27218193,27218493,0,0,16190,16490
31786,27202003,27218465,27218660,0,0,16462,16657
31788,27202004,27218493,27218688,0,0,16489,16684
30346,27084413,27171228,27218766,0,0,86815,134353
31787,27202003,27218488,27218788,0,0,16485,16785
30348,27084415,27171228,27218818,0,0,86813,134403
31789,27202004,27218660,27218876,0,0,16656,16872
31790,27202004,27218688,27218878,0,0,16684,16874
31791,27202004,27218788,27219004,0,0,16784,17000
30347,27084414,27171228,27219089,0,0,86814,134675
31792,27202004,27218876,27219092,0,0,16872,17088
31793,27202004,27218878,27219094,0,0,16874,17090
31794,27202004,27219004,27219220,0,0,17000,17216
31795,27202005,27219092,27219288,0,0,17087,17283
31796,27202005,27219094,27219394,0,0,17089,17389
31797,27202082,27219220,27219432,0,0,17138,17350
31798,27202082,27219288,27219500,0,0,17206,17418
30338,27084359,27161528,27219552,0,0,77169,135193
31800,27202083,27219432,27219644,0,0,17349,17561
31799,27202082,27219394,27219694,0,0,17312,17612
31801,27202083,27219500,27219696,0,0,17417,17613
30297,27084303,27133373,27219773,0,0,49070,135470
31802,27202083,27219644,27219840,0,0,17561,17757
31803,27202083,27219694,27219890,0,0,17611,17807
31804,27202084,27219696,27219892,0,0,17612,17808
31806,27202085,27219890,27220102,0,0,17805,18017
31807,27202085,27219892,27220104,0,0,17807,18019
31805,27202084,27219840,27220140,0,0,17756,18056
31808,27202085,27220102,27220314,0,0,18017,18229
31809,27202085,27220104,27220316,0,0,18019,18231
30345,27084361,27171228,27220320,0,0,86867,135959
31810,27202086,27220140,27220346,0,0,18054,18260
31811,27202086,27220314,27220504,0,0,18228,18418
31812,27202086,27220316,27220527,0,0,18230,18441
31813,27202087,27220346,27220557,0,0,18259,18470
31814,27202087,27220504,27220699,0,0,18417,18612
31815,27202087,27220527,27220722,0,0,18440,18635
31816,27202087,27220557,27220752,0,0,18470,18665
31817,27202087,27220699,27220915,0,0,18612,18828
31818,27202087,27220722,27220917,0,0,18635,18830
31819,27202088,27220752,27220958,0,0,18664,18870
31820,27202088,27220915,27221121,0,0,18827,19033
31821,27202088,27220917,27221217,0,0,18829,19129
31822,27202088,27220958,27221258,0,0,18870,19170
31823,27202088,27221121,27221421,0,0,19033,19333
31825,27202089,27221258,27221452,0,0,19169,19363
30342,27084360,27162320,27221471,0,0,77960,137111
31824,27202088,27221217,27221517,0,0,19129,19429
31826,27202089,27221421,27221627,0,0,19332,19538
31827,27202089,27221452,27221669,0,0,19363,19580
31828,27202089,27221517,27221709,0,0,19428,19620
31829,27202089,27221627,27221830,0,0,19538,19741
31831,27202090,27221709,27221902,0,0,19619,19812
31830,27202089,27221669,27221969,0,0,19580,19880
31832,27202090,27221830,27222034,0,0,19740,19944
31833,27202090,27221902,27222096,0,0,19812,20006
30339,27084359,27161528,27222122,0,0,77169,137763
31834,27202090,27221969,27222169,0,0,19879,20079
31835,27202090,27222034,27222229,0,0,19944,20139
31836,27203295,27222096,27222286,0,0,18801,18991
31837,27203296,27222169,27222375,0,0,18873,19079
31838,27203296,27222229,27222435,0,0,18933,19139
31839,27203296,27222286,27222513,0,0,18990,19217
31840,27203296,27222375,27222602,0,0,19079,19306
31841,27203297,27222435,27222662,0,0,19138,19365
31842,27203297,27222513,27222740,0,0,19216,19443
31843,27203298,27222602,27222902,0,0,19304,19604
31844,27203299,27222662,27222962,0,0,19363,19663
30349,27084415,27175823,27223034,0,0,91408,138619
31845,27203299,27222740,27223040,0,0,19441,19741
31847,27203301,27222962,27223172,0,0,19661,19871
31846,27203299,27222902,27223202,0,0,19603,19903
31848,27203301,27223040,27223250,0,0,19739,19949
30350,27084415,27175823,27223323,0,0,91408,138908
31849,27203302,27223172,27223382,0,0,19870,20080
31850,27203302,27223202,27223423,0,0,19900,20121
31851,27203302,27223250,27223482,0,0,19948,20180
30351,27084415,27175823,27223557,0,0,91408,139142
31852,27203302,27223382,27223614,0,0,20080,20312
31853,27203302,27223423,27223655,0,0,20121,20353
31854,27203302,27223482,27223725,0,0,20180,20423
31855,27203384,27223614,27223857,0,0,20230,20473
31856,27203384,27223655,27223898,0,0,20271,20514
31857,27203384,27223725,27223989,0,0,20341,20605
31858,27203385,27223857,27224111,0,0,20472,20726
31859,27203385,27223898,27224163,0,0,20513,20778
31860,27203385,27223989,27224254,0,0,20604,20869
31861,27203385,27224111,27224376,0,0,20726,20991
31862,27203386,27224163,27224439,0,0,20777,21053
31863,27203386,27224254,27224530,0,0,20868,21144
30352,27084416,27177554,27224603,0,0,93138,140187
31864,27203386,27224376,27224663,0,0,20990,21277
31865,27203387,27224439,27224726,0,0,21052,21339
31866,27203387,27224530,27224828,0,0,21143,21441
31867,27203387,27224663,27224961,0,0,21276,21574
31868,27203387,27224726,27225024,0,0,21339,21637
31869,27203388,27224828,27225128,0,0,21440,21740
31870,27203388,27224961,27225261,0,0,21573,21873
31871,27203388,27225024,27225324,0,0,21636,21936
31872,27203388,27225128,27225337,0,0,21740,21949
31873,27203389,27225261,27225470,0,0,21872,22081
31874,27203389,27225324,27225533,0,0,21935,22144
31875,27203389,27225337,27225557,0,0,21948,22168
31876,27203389,27225470,27225690,0,0,22081,22301
31877,27203389,27225533,27225775,0,0,22144,22386
31878,27203389,27225557,27225799,0,0,22168,22410
31879,27203390,27225690,27225932,0,0,22300,22542
31880,27203390,27225775,27226017,0,0,22385,22627
31881,27203390,27225799,27226052,0,0,22409,22662
31884,27204353,27226052,27226102,0,0,21699,21749
31885,27204353,27226102,27226163,0,0,21749,21810
31882,27203390,27225932,27226185,0,0,22542,22795
31886,27204353,27226163,27226224,0,0,21810,21871
31883,27203390,27226017,27226270,0,0,22627,22880
31887,27204353,27226185,27226342,0,0,21832,21989
31889,27204440,27226270,27226382,0,0,21830,21942
31888,27204353,27226224,27226411,0,0,21871,22058
31890,27204440,27226342,27226470,0,0,21902,22030
31891,27204440,27226382,27226510,0,0,21942,22070
31893,27204441,27226470,27226583,0,0,22029,22142
31894,27204441,27226510,27226624,0,0,22069,22183
31892,27204440,27226411,27226662,0,0,21971,22222
31895,27204441,27226583,27226713,0,0,22142,22272
31896,27204441,27226624,27226732,0,0,22183,22291
31898,27204441,27226713,27226836,0,0,22272,22395
31899,27204442,27226732,27226855,0,0,22290,22413
31897,27204441,27226662,27226916,0,0,22221,22475
31900,27204442,27226836,27226949,0,0,22394,22507
30353,27084416,27179854,27226973,0,0,95438,142557
31901,27204442,27226855,27226973,0,0,22413,22531
30901,27163023,27226973,27227040,0,0,63950,64017
31902,27204442,27226916,27227045,0,0,22474,22603
31905,27204443,27226973,27227089,0,0,22530,22646
30989,27166225,27227040,27227117,0,0,60815,60892
31906,27204443,27227045,27227172,0,0,22602,22729
30990,27166295,27227117,27227194,0,0,60822,60899
31903,27204442,27226949,27227195,0,0,22507,22753
31907,27204443,27227089,27227205,0,0,22646,22762
31904,27204442,27226973,27227218,0,0,22531,22776
31909,27204443,27227195,27227252,0,0,22752,22809
30991,27166372,27227194,27227260,0,0,60822,60888
31908,27204443,27227172,27227277,0,0,22729,22834
31912,27204444,27227252,27227293,0,0,22808,22849
30992,27166446,27227260,27227330,0,0,60814,60884
30993,27166515,27227330,27227394,0,0,60815,60879
31911,27204443,27227218,27227399,0,0,22775,22956
31910,27204443,27227205,27227418,0,0,22762,22975
30994,27166581,27227394,27227469,0,0,60813,60888
30995,27166649,27227469,27227541,0,0,60820,60892
30996,27166727,27227541,27227609,0,0,60814,60882
30997,27166797,27227609,27227685,0,0,60812,60888
30998,27166865,27227685,27227754,0,0,60820,60889
30999,27167003,27227754,27227827,0,0,60751,60824
31075,27174918,27227827,27227901,0,0,52909,52983
31160,27176693,27227901,27228054,0,0,51208,51361
31171,27176914,27228054,27228604,0,0,51140,51690
31212,27177096,27228604,27228779,0,0,51508,51683
30356,27084417,27180640,27228960,0,0,96223,144543
30359,27084418,27181090,27229036,0,0,96672,144618
31327,27177675,27229036,27229109,0,0,51361,51434
31214,27177563,27228960,27229120,0,0,51397,51557
30355,27084417,27180601,27229287,0,0,96184,144870
31483,27183958,27228960,27229300,0,0,45002,45342
30357,27084417,27180707,27229322,0,0,96290,144905
31495,27184013,27229300,27229642,0,0,45287,45629
31486,27183959,27229322,27229936,0,0,45363,45977
31489,27183960,27229287,27230171,0,0,45327,46211
30358,27084417,27180907,27230405,0,0,96490,145988
31499,27184014,27229642,27230519,0,0,45628,46505
31507,27184042,27230171,27230522,0,0,46129,46480
31914,27212482,27230522,27230590,0,0,18040,18108
31915,27212597,27230590,27230663,0,0,17993,18066
30363,27084419,27181937,27230880,0,0,97518,146461
31490,27183960,27229936,27230912,0,0,45976,46952
31919,27222357,27227418,27230979,0,0,5061,8622
31500,27184014,27230405,27231024,0,0,46391,47010
31916,27214278,27230663,27231263,0,0,16385,16985
31514,27184044,27230519,27231402,0,0,46475,47358
30365,27084419,27182057,27231474,0,0,97638,147055
31920,27222357,27227901,27231493,0,0,5544,9136
31510,27184043,27230912,27231516,0,0,46869,47473
31469,27183510,27231474,27231571,0,0,47964,48061
30360,27084418,27181446,27231600,0,0,97028,147182
31471,27183854,27231571,27231633,0,0,47717,47779
31518,27184474,27231600,27231670,0,0,47126,47196
31519,27184543,27231633,27231705,0,0,47090,47162
31520,27184588,27231670,27231743,0,0,47082,47155
30369,27084420,27182645,27231750,0,0,98225,147330
31521,27184744,27231705,27231769,0,0,46961,47025
30366,27084419,27182430,27231779,0,0,98011,147360
31923,27227305,27229109,27231804,0,0,1804,4499
31503,27184026,27230880,27231845,0,0,46854,47819
30364,27084419,27181960,27231890,0,0,97541,147471
30374,27084421,27184050,27231970,0,0,99629,147549
31515,27184044,27231024,27231998,0,0,46980,47954
31924,27227306,27229322,27232005,0,0,2016,4699
30361,27084418,27181697,27232098,0,0,97279,147680
31213,27177513,27228779,27232123,0,0,51266,54610
30368,27084420,27182599,27232365,0,0,98179,147945
31921,27222358,27229036,27232657,0,0,6678,10299
31917,27216862,27227293,27232667,0,0,10431,15805
31487,27183959,27232098,27232712,0,0,48139,48753
31918,27216868,27227399,27232778,0,0,10531,15910
30379,27084422,27185173,27232906,0,0,100751,148484
31925,27227306,27230405,27233100,0,0,3099,5794
30375,27084421,27184316,27233280,0,0,99895,148859
31501,27184014,27232712,27233322,0,0,48698,49308
30362,27084418,27181706,27233364,0,0,97288,148946
31493,27183966,27232365,27233364,0,0,48399,49398
31926,27227306,27230880,27233659,0,0,3574,6353
30370,27084420,27182851,27233729,0,0,98431,149309
30377,27084421,27185159,27233896,0,0,100738,149475
31511,27184043,27233280,27233897,0,0,49237,49854
31504,27184026,27232906,27233903,0,0,48880,49877
31159,27176413,27233903,27233976,0,0,57490,57563
31009,27171604,27233896,27234011,0,0,62292,62407
30380,27084422,27185173,27234032,0,0,100751,149610
31516,27184044,27233322,27234308,0,0,49278,50264
30354,27084416,27180317,27234539,0,0,95901,150123
30382,27084422,27186130,27234552,0,0,101708,150130
31484,27183958,27233976,27234589,0,0,50018,50631
30383,27084422,27186396,27234616,0,0,101974,150194
30381,27084422,27185311,27234683,0,0,100889,150261
31496,27184013,27234589,27235211,0,0,50576,51198
30376,27084421,27184544,27235431,0,0,100123,151010
31491,27183960,27234552,27235559,0,0,50592,51599
30384,27084423,27186695,27236122,0,0,102272,151699
30367,27084419,27182489,27236393,0,0,98070,151974
30371,27084420,27183470,27237129,0,0,99050,152709
30394,27084457,27191077,27237761,0,0,106620,153304
31470,27183564,27229287,27237820,0,0,45723,54256
31502,27184014,27237129,27238137,0,0,53115,54123
30395,27084458,27191168,27238160,0,0,106710,153702
31913,27205183,27227277,27238409,0,0,22094,33226
30396,27084459,27192054,27239150,0,0,107595,154691
30372,27084420,27183898,27239423,0,0,99478,155003
31929,27239496,27239496,27239570,0,0,0,74
31508,27184042,27239150,27239769,0,0,55108,55727
30398,27084459,27192315,27239989,0,0,107856,155530
30399,27084459,27192426,27240033,0,0,107967,155574
30397,27084459,27192164,27240089,0,0,107705,155630
31930,27239931,27239931,27240165,0,0,0,234
30386,27084423,27187430,27240490,0,0,103007,156067
30400,27084460,27193150,27240498,0,0,108690,156038
30390,27084424,27188175,27240544,0,0,103751,156120
31512,27184043,27239769,27240774,0,0,55726,56731
30401,27084460,27193437,27240916,0,0,108977,156456
31931,27240883,27240883,27240956,0,0,0,73
30402,27084460,27194187,27242046,0,0,109727,157586
30373,27084420,27183900,27242395,0,0,99480,157975
30403,27084460,27194292,27242525,0,0,109832,158065
31932,27242655,27242655,27242957,0,0,0,302
30404,27084461,27194925,27243151,0,0,110464,158690
30385,27084423,27186961,27243197,0,0,102538,158774
30391,27084424,27188753,27243687,0,0,104329,159263
30405,27084461,27195015,27243958,0,0,110554,159497
30451,27091354,27243958,27244031,0,0,152604,152677
30817,27149520,27244031,27244105,0,0,94511,94585
30827,27153309,27244105,27244207,0,0,90796,90898
30392,27084424,27189524,27245956,0,0,105100,161532
30387,27084423,27187434,27246398,0,0,103011,161975
30389,27084424,27188134,27246437,0,0,103710,162013
31943,27246421,27246421,27246530,0,0,0,109
31944,27246561,27246561,27246620,0,0,0,59
31945,27246611,27246611,27246720,0,0,0,109
30406,27084461,27198504,27247542,0,0,114043,163081
31922,27223138,27231516,27247837,0,0,8378,24699
31946,27248428,27248428,27248537,0,0,0,109
31947,27248550,27248550,27248929,0,0,0,379
30899,27162611,27162611,27249011,0,0,0,86400
30408,27084462,27199815,27250427,0,0,115353,165965
31948,27248928,27248929,27250647,0,0,1,1719
30393,27084424,27190720,27250719,0,0,106296,166295
31950,27248929,27250427,27251601,0,0,1498,2672
31701,27200279,27231402,27251785,0,0,31123,51506
30343,27084360,27165580,27251980,0,0,81220,167620
31949,27248929,27250427,27251990,0,0,1498,3061
31951,27250021,27251980,27252047,0,0,1959,2026
31774,27201122,27233364,27252364,0,0,32242,51242
30409,27084462,27201647,27252631,0,0,117185,168169
30344,27084360,27166247,27252647,0,0,81887,168287
31952,27250682,27250682,27253348,0,0,0,2666
31953,27250688,27250688,27253372,0,0,0,2684
31954,27250689,27250689,27253384,0,0,0,2695
31955,27250689,27250689,27253399,0,0,0,2710
29812,26942818,26942818,27253843,0,0,0,311025
30411,27084463,27207343,27254893,0,0,122880,170430
31942,27246067,27246067,27254958,0,0,0,8891
31928,27239419,27239423,27255713,0,0,4,16294
31933,27243440,27243440,27255778,0,0,0,12338
30413,27084463,27208156,27255785,0,0,123693,171322
31961,27255653,27255713,27255817,0,0,60,164
31962,27255757,27255785,27255880,0,0,28,123
30412,27084463,27207755,27256902,0,0,123292,172439
31963,27255948,27256902,27256987,0,0,954,1039
31964,27256190,27256987,27257071,0,0,797,881
31965,27256562,27257071,27257271,0,0,509,709
31966,27256964,27257271,27257363,0,0,307,399
31967,27257312,27257363,27257458,0,0,51,146
30417,27084464,27209292,27257694,0,0,124828,173230
30414,27084463,27208409,27257730,0,0,123946,173267
31936,27244696,27244696,27257782,0,0,0,13086
31968,27258004,27258004,27258036,0,0,0,32
31937,27245007,27245007,27258079,0,0,0,13072
31969,27258004,27258036,27258079,0,0,32,75
30407,27084461,27199646,27258186,0,0,115185,173725
30415,27084463,27208443,27258409,0,0,123980,173946
31972,27258553,27258553,27259153,0,0,0,600
30418,27084464,27209359,27259214,0,0,124895,174750
31941,27246064,27246064,27259484,0,0,0,13420
30416,27084463,27208850,27259820,0,0,124387,175357
31959,27254801,27255880,27259841,0,0,1079,5040
31934,27243686,27243686,27259963,0,0,0,16277
30421,27084465,27212751,27260155,0,0,128286,175690
31973,27259904,27260155,27260254,0,0,251,350
31457,27182862,27229109,27260268,0,0,46247,77406
31974,27260029,27260254,27260558,0,0,225,529
30157,27001927,27001927,27261127,0,0,0,259200
31976,27260609,27261127,27261204,0,0,518,595
31978,27261281,27261281,27261355,0,0,0,74
31468,27183411,27229120,27261520,0,0,45709,78109
31979,27261622,27261622,27261682,0,0,0,60
31488,27183959,27261127,27261745,0,0,77168,77786
31533,27185847,27231743,27262032,0,0,45896,76185
30159,27002875,27002875,27262075,0,0,0,259200
30160,27002875,27002875,27262075,0,0,0,259200
30161,27002875,27002875,27262075,0,0,0,259200
30162,27002875,27002875,27262075,0,0,0,259200
30163,27002875,27002875,27262075,0,0,0,259200
31552,27191412,27240498,27262466,0,0,49086,71054
31497,27184013,27262032,27262656,0,0,78019,78643
31492,27183960,27261745,27262768,0,0,77785,78808
31505,27184026,27262075,27263103,0,0,78049,79077
31513,27184043,27262656,27263289,0,0,78613,79246
31987,27262903,27263103,27263335,0,0,200,432
31985,27262477,27263335,27263408,0,0,858,931
31970,27258054,27258079,27263434,0,0,25,5380
31971,27258054,27258186,27263558,0,0,132,5504
31991,27263464,27263558,27263596,0,0,94,132
31993,27263582,27263582,27263612,0,0,0,30
31992,27263519,27263596,27263629,0,0,77,110
31994,27263609,27263629,27263689,0,0,20,80
31517,27184044,27262768,27263775,0,0,78724,79731
31995,27263672,27263689,27263776,0,0,17,104
31997,27263830,27263830,27263899,0,0,0,69
31984,27262474,27263775,27264041,0,0,1301,1567
31998,27264002,27264002,27264088,0,0,0,86
31999,27264091,27264091,27264138,0,0,0,47
32000,27264136,27264136,27264172,0,0,0,36
30419,27084464,27210470,27264232,0,0,126006,179768
30422,27084465,27216099,27264258,0,0,131634,179793
32001,27264226,27264226,27264265,0,0,0,39
32002,27264299,27264299,27264346,0,0,0,47
32003,27264372,27264372,27264410,0,0,0,38
32004,27264445,27264445,27264485,0,0,0,40
30174,27005296,27005296,27264496,0,0,0,259200
30175,27005314,27005314,27264514,0,0,0,259200
30176,27005328,27005328,27264528,0,0,0,259200
30177,27005340,27005340,27264540,0,0,0,259200
30178,27005351,27005351,27264551,0,0,0,259200
32006,27264506,27264506,27264588,0,0,0,82
30179,27005517,27005517,27264717,0,0,0,259200
30180,27005529,27005529,27264729,0,0,0,259200
30181,27005541,27005541,27264741,0,0,0,259200
30182,27005554,27005554,27264754,0,0,0,259200
32008,27264732,27264732,27264804,0,0,0,72
30183,27005613,27005613,27264813,0,0,0,259200
32010,27264842,27264842,27264909,0,0,0,67
32011,27264900,27264900,27264949,0,0,0,49
32013,27264954,27264954,27265078,0,0,0,124
32009,27264832,27264832,27265158,0,0,0,326
32014,27264973,27264973,27265198,0,0,0,225
32017,27265203,27265203,27265242,0,0,0,39
32015,27265003,27265003,27265352,0,0,0,349
32018,27265304,27265304,27265352,0,0,0,48
31986,27262622,27262622,27265427,0,0,0,2805
32019,27265401,27265401,27265744,0,0,0,343
32022,27265699,27265699,27265896,0,0,0,197
32027,27265861,27265861,27265904,0,0,0,43
32020,27265580,27265580,27265915,0,0,0,335
32021,27265604,27265604,27265945,0,0,0,341
32029,27265942,27265942,27265981,0,0,0,39
32026,27265803,27265803,27265993,0,0,0,190
32025,27265785,27265785,27266032,0,0,0,247
32033,27266328,27266328,27266366,0,0,0,38
32032,27266216,27266216,27266422,0,0,0,206
32034,27266376,27266376,27266426,0,0,0,50
32035,27266461,27266461,27266492,0,0,0,31
32036,27266542,27266542,27266716,0,0,0,174
32051,27266662,27266662,27266716,0,0,0,54
32037,27266542,27266542,27266754,0,0,0,212
30423,27084465,27218353,27266830,0,0,133888,182365
32040,27266549,27266549,27266851,0,0,0,302
32038,27266542,27266542,27266875,0,0,0,333
32039,27266548,27266548,27266889,0,0,0,341
32041,27266549,27266549,27266890,0,0,0,341
32052,27266831,27266831,27266900,0,0,0,69
30427,27084466,27219089,27267013,0,0,134623,182547
32045,27266551,27266551,27267122,0,0,0,571
32043,27266550,27266550,27267144,0,0,0,594
32042,27266549,27266549,27267153,0,0,0,604
32046,27266551,27266551,27267154,0,0,0,603
32044,27266550,27266550,27267366,0,0,0,816
32053,27267441,27267441,27267509,0,0,0,68
32048,27266552,27266552,27267621,0,0,0,1069
32047,27266551,27266551,27267671,0,0,0,1120
32050,27266553,27266553,27267673,0,0,0,1120
32054,27267606,27267606,27267685,0,0,0,79
32007,27264612,27264612,27267704,0,0,0,3092
32056,27267607,27267607,27267721,0,0,0,114
32049,27266552,27266552,27267752,0,0,0,1200
32055,27267606,27267606,27267762,0,0,0,156
32057,27267607,27267607,27267763,0,0,0,156
32058,27267607,27267607,27267774,0,0,0,167
30420,27084464,27212409,27267928,0,0,127945,183464
30425,27084465,27218766,27268110,0,0,134301,183645
32063,27268317,27268317,27268464,0,0,0,147
30430,27084466,27220320,27268563,0,0,135854,184097
30424,27084465,27218449,27268634,0,0,133984,184169
30429,27084466,27219773,27268693,0,0,135307,184227
30428,27084466,27219552,27268711,0,0,135086,184245
32064,27269005,27269005,27269127,0,0,0,122
32065,27269087,27269087,27269152,0,0,0,65
32066,27269106,27269106,27269166,0,0,0,60
32069,27269199,27269199,27269354,0,0,0,155
32067,27269143,27269143,27269380,0,0,0,237
32070,27269447,27269447,27269497,0,0,0,50
30431,27084466,27221471,27269560,0,0,137005,185094
32072,27269649,27269649,27269692,0,0,0,43
32068,27269162,27269162,27269762,0,0,0,600
32073,27269671,27269671,27269837,0,0,0,166
32075,27269890,27269890,27269944,0,0,0,54
30426,27084465,27218818,27270073,0,0,134353,185608
32077,27269926,27269926,27270216,0,0,0,290
32062,27268282,27268282,27270592,0,0,0,2310
32059,27267905,27267905,27270622,0,0,0,2717
30744,27101852,27235211,27271057,0,0,133359,169205
30432,27084467,27222122,27271200,0,0,137655,186733
32082,27271215,27271215,27271366,0,0,0,151
32081,27271203,27271203,27271428,0,0,0,225
30378,27084421,27185159,27271559,0,0,100738,187138
32083,27271616,27271616,27271689,0,0,0,73
32060,27268019,27268019,27271705,0,0,0,3686
32084,27271757,27271757,27271819,0,0,0,62
31975,27260059,27260558,27272023,0,0,499,11964
32061,27268121,27268121,27272143,0,0,0,4022
32085,27272191,27272191,27272282,0,0,0,91
31990,27263100,27263775,27272608,0,0,675,9508
30186,27013688,27013688,27272888,0,0,0,259200
32087,27273450,27273450,27273504,0,0,0,54
30444,27088618,27261127,27273507,0,0,172509,184889
31957,27254718,27254718,27273683,0,0,0,18965
30388,27084423,27187697,27274097,0,0,103274,189674
31996,27263734,27263775,27274446,0,0,41,10712
32088,27274839,27274839,27274892,0,0,0,53
32089,27275191,27275191,27275243,0,0,0,52
31958,27254748,27254958,27275283,0,0,210,20535
32090,27275771,27275771,27275824,0,0,0,53
32091,27275811,27275811,27275876,0,0,0,65
31977,27260894,27261127,27277519,0,0,233,16625
30433,27084467,27223034,27277799,0,0,138567,193332
30434,27084467,27223323,27279541,0,0,138856,195074
30436,27084468,27224603,27281570,0,0,140135,197102
32093,27279190,27279190,27282755,0,0,0,3565
32094,27279190,27279190,27282804,0,0,0,3614
32095,27279190,27279190,27282970,0,0,0,3780
30435,27084467,27223557,27283971,0,0,139090,199504
31956,27254108,27254108,27284544,0,0,0,30436
32096,27284539,27284539,27284696,0,0,0,157
32098,27286777,27286777,27287141,0,0,0,364
31989,27262938,27263434,27288163,0,0,496,25225
30410,27084462,27202094,27288494,0,0,117632,204032
32099,27290982,27290982,27291066,0,0,0,84
32101,27291825,27291825,27292166,0,0,0,341
30807,27115813,27231845,27292445,0,0,116032,176632
32092,27277283,27277283,27293674,0,0,0,16391
32080,27270334,27270334,27294274,0,0,0,23940
32100,27291811,27291811,27294571,0,0,0,2760
31988,27262914,27263408,27295647,0,0,494,32733
32012,27264949,27264949,27295902,0,0,0,30953
30810,27117546,27264514,27296394,0,0,146968,178848
31938,27245294,27245294,27297218,0,0,0,51924
31940,27245612,27245612,27297554,0,0,0,51942
30809,27117516,27264496,27299744,0,0,146980,182228
32102,27293535,27293535,27300802,0,0,0,7267
32074,27269825,27269825,27308624,0,0,0,38799
32078,27269962,27269962,27308730,0,0,0,38768
32103,27293636,27293636,27309944,0,0,0,16308
32028,27265934,27265934,27311493,0,0,0,45559
32097,27284654,27284654,27315015,0,0,0,30361
32076,27269894,27269894,27317648,0,0,0,47754
30898,27161489,27234032,27318064,0,0,72543,156575
32079,27270178,27270178,27318097,0,0,0,47919
31012,27173421,27238137,27321982,0,0,64716,148561
30446,27089094,27242046,27321993,0,0,152952,232899
32110,27324179,27324179,27324274,0,0,0,95
32111,27324253,27324253,27324380,0,0,0,127
31011,27173382,27235559,27324443,0,0,62177,151061
32108,27323956,27323956,27324909,0,0,0,953
32109,27323992,27323992,27324963,0,0,0,971
32106,27309912,27309912,27326280,0,0,0,16368
32115,27326743,27326743,27326832,0,0,0,89
32116,27326832,27326832,27326924,0,0,0,92
32117,27326983,27326983,27327053,0,0,0,70
32118,27327119,27327119,27327338,0,0,0,219
32119,27327577,27327577,27327695,0,0,0,118
32120,27327752,27327752,27327859,0,0,0,107
32121,27327958,27327958,27328070,0,0,0,112
32005,27264477,27264477,27328902,0,0,0,64425
32122,27329013,27329013,27329118,0,0,0,105
32123,27329198,27329198,27329271,0,0,0,73
32125,27329396,27329396,27329471,0,0,0,75
32127,27329551,27329551,27329621,0,0,0,70
32128,27329654,27329654,27329727,0,0,0,73
32129,27329743,27329743,27329818,0,0,0,75
32126,27329488,27329488,27330088,0,0,0,600
32132,27330065,27330065,27330169,0,0,0,104
32133,27330095,27330095,27330212,0,0,0,117
32134,27330162,27330162,27330235,0,0,0,73
32135,27330207,27330207,27330274,0,0,0,67
32137,27330297,27330297,27330417,0,0,0,120
32130,27329843,27329843,27330443,0,0,0,600
32140,27330556,27330556,27330661,0,0,0,105
32139,27330552,27330552,27330680,0,0,0,128
32141,27330627,27330627,27330685,0,0,0,58
32142,27330663,27330663,27330771,0,0,0,108
32136,27330248,27330248,27330848,0,0,0,600
32143,27330762,27330762,27330879,0,0,0,117
32144,27331013,27331013,27331131,0,0,0,118
32147,27331252,27331252,27331307,0,0,0,55
32149,27331290,27331290,27331357,0,0,0,67
32148,27331287,27331287,27331388,0,0,0,101
32145,27331179,27331179,27331449,0,0,0,270
32152,27331504,27331504,27331559,0,0,0,55
32150,27331439,27331439,27331601,0,0,0,162
32153,27331541,27331541,27331617,0,0,0,76
32154,27331609,27331609,27331838,0,0,0,229
32151,27331458,27331458,27332058,0,0,0,600
32156,27332102,27332102,27332188,0,0,0,86
32159,27332306,27332306,27332418,0,0,0,112
32157,27332208,27332208,27332437,0,0,0,229
31939,27245521,27247837,27332671,0,0,2316,87150
32124,27329347,27329347,27332947,0,0,0,3600
32161,27333451,27333451,27333560,0,0,0,109
32162,27333642,27333642,27333729,0,0,0,87
32163,27334534,27334534,27334629,0,0,0,95
32174,27334714,27334714,27334772,0,0,0,58
32175,27334990,27334990,27335072,0,0,0,82
32176,27336160,27336160,27336252,0,0,0,92
32177,27336592,27336592,27336831,0,0,0,239
32178,27336978,27336978,27337064,0,0,0,86
32179,27337743,27337743,27337830,0,0,0,87
32181,27337905,27337905,27338109,0,0,0,204
32183,27338179,27338179,27338517,0,0,0,338
31960,27255336,27257730,27339529,0,0,2394,84193
32023,27265709,27265709,27341765,0,0,0,76056
32114,27326238,27326238,27342626,0,0,0,16388
32155,27331854,27331854,27342708,0,0,0,10854
32186,27339608,27339608,27342721,0,0,0,3113
32198,27341585,27341585,27343021,0,0,0,1436
32187,27340041,27340041,27343135,0,0,0,3094
32188,27340209,27340209,27343290,0,0,0,3081
32189,27340352,27340352,27343423,0,0,0,3071
32190,27340475,27340475,27343558,0,0,0,3083
32191,27340658,27340658,27343743,0,0,0,3085
32192,27341158,27341158,27344290,0,0,0,3132
32193,27341221,27341221,27344362,0,0,0,3141
32194,27341289,27341289,27344394,0,0,0,3105
32195,27341361,27341361,27344515,0,0,0,3154
32107,27314978,27314978,27344543,0,0,0,29565
32196,27341432,27341432,27344556,0,0,0,3124
32197,27341500,27341500,27344639,0,0,0,3139
32219,27344964,27344964,27345038,0,0,0,74
32225,27345455,27345455,27345575,0,0,0,120
32199,27342019,27342019,27346185,0,0,0,4166
32180,27337892,27337892,27346832,0,0,0,8940
32201,27343087,27343087,27347122,0,0,0,4035
32206,27343727,27343727,27347897,0,0,0,4170
32209,27343940,27343940,27348050,0,0,0,4110
32212,27344073,27344073,27348188,0,0,0,4115
32213,27344173,27344173,27348251,0,0,0,4078
32214,27344227,27344227,27348361,0,0,0,4134
32215,27344410,27344410,27348548,0,0,0,4138
32216,27344482,27344482,27348616,0,0,0,4134
32184,27339061,27339061,27350055,0,0,0,10994
30877,27160285,27244207,27351262,0,0,83922,190977
32232,27349111,27349111,27351279,0,0,0,2168
32235,27349112,27349112,27351307,0,0,0,2195
32233,27349111,27349111,27351317,0,0,0,2206
32236,27349112,27349112,27351329,0,0,0,2217
32234,27349111,27349111,27351348,0,0,0,2237
30808,27115847,27231970,27352418,0,0,116123,236571
32245,27351097,27351262,27353590,0,0,165,2493
32247,27353637,27353637,27353794,0,0,0,157
32244,27350965,27351262,27354029,0,0,297,3064
32238,27350047,27350047,27355151,0,0,0,5104
32239,27350166,27350166,27355234,0,0,0,5068
32202,27343181,27351262,27355363,0,0,8081,12182
32241,27350317,27351262,27356222,0,0,945,5905
32240,27350258,27351262,27356250,0,0,1004,5992
32258,27355796,27355796,27356755,0,0,0,959
32261,27355934,27355934,27357710,0,0,0,1776
32260,27355928,27355928,27357771,0,0,0,1843
32262,27355935,27355935,27357806,0,0,0,1871
32263,27355935,27355935,27358314,0,0,0,2379
32264,27355935,27355935,27358337,0,0,0,2402
32265,27355935,27355935,27358370,0,0,0,2435
31010,27172144,27252631,27358918,0,0,80487,186774
32275,27359541,27359541,27359766,0,0,0,225
32269,27358432,27358432,27359983,0,0,0,1551
32270,27358432,27358432,27359983,0,0,0,1551
32271,27358432,27358432,27359994,0,0,0,1562
32268,27358426,27358426,27360005,0,0,0,1579
32272,27358432,27358432,27360005,0,0,0,1573
32273,27358433,27358433,27360030,0,0,0,1597
32274,27358433,27358433,27360065,0,0,0,1632
32185,27339088,27339529,27361129,0,0,441,22041
32248,27353693,27353693,27362919,0,0,0,9226
32200,27342579,27342579,27363086,0,0,0,20507
32277,27362276,27362276,27363633,0,0,0,1357
32278,27362281,27362281,27363633,0,0,0,1352
32282,27362283,27362283,27363666,0,0,0,1383
32279,27362282,27362282,27363676,0,0,0,1394
32280,27362282,27362282,27363687,0,0,0,1405
32281,27362282,27362282,27363687,0,0,0,1405
32283,27362283,27362283,27363688,0,0,0,1405
32284,27362283,27362283,27363710,0,0,0,1427
32250,27354721,27354721,27363912,0,0,0,9191
32246,27353321,27358918,27363965,0,0,5597,10644
32249,27353836,27353836,27363986,0,0,0,10150
32251,27354802,27354802,27363992,0,0,0,9190
32252,27354878,27354878,27364099,0,0,0,9221
32253,27354941,27354941,27364147,0,0,0,9206
32254,27355072,27355072,27364254,0,0,0,9182
32286,27364441,27364441,27364667,0,0,0,226
32255,27355517,27355517,27365830,0,0,0,10313
32256,27355594,27355594,27365890,0,0,0,10296
32257,27355697,27355697,27365978,0,0,0,10281
32276,27359761,27363965,27366010,0,0,4204,6249
32131,27329863,27329863,27366217,0,0,0,36354
32259,27355893,27355893,27366218,0,0,0,10325
32138,27330360,27330360,27366623,0,0,0,36263
32146,27331201,27331201,27367458,0,0,0,36257
32287,27365246,27366010,27368057,0,0,764,2811
32266,27355971,27355971,27368060,0,0,0,12089
32158,27332216,27332216,27368228,0,0,0,36012
32290,27367595,27367595,27368799,0,0,0,1204
32291,27367595,27367595,27368811,0,0,0,1216
32289,27367594,27367594,27368821,0,0,0,1227
32292,27367595,27367595,27368822,0,0,0,1227
32294,27367596,27367596,27368823,0,0,0,1227
32288,27367588,27367588,27368831,0,0,0,1243
32295,27367596,27367596,27368834,0,0,0,1238
32296,27367596,27367596,27368845,0,0,0,1249
32293,27367595,27367595,27368855,0,0,0,1260
32160,27333319,27333319,27369748,0,0,0,36429
32297,27369271,27369271,27370398,0,0,0,1127
32299,27369278,27369278,27370400,0,0,0,1122
32307,27370185,27370185,27370410,0,0,0,225
32300,27369278,27369278,27370411,0,0,0,1133
32301,27369278,27369278,27370433,0,0,0,1155
32303,27369279,27369279,27370434,0,0,0,1155
32304,27369279,27369279,27370434,0,0,0,1155
32298,27369277,27369277,27370443,0,0,0,1166
32305,27369279,27369279,27370445,0,0,0,1166
32302,27369278,27369278,27370470,0,0,0,1192
32306,27369279,27369279,27370513,0,0,0,1234
31927,27238984,27263103,27370578,0,0,24119,131594
32310,27370637,27370637,27371660,0,0,0,1023
32308,27370630,27370630,27371669,0,0,0,1039
32309,27370636,27370636,27371670,0,0,0,1034
32311,27370637,27370637,27371671,0,0,0,1034
32314,27370638,27370638,27371694,0,0,0,1056
32312,27370637,27370637,27371705,0,0,0,1068
32315,27370638,27370638,27371706,0,0,0,1068
32316,27370638,27370638,27371706,0,0,0,1068
32313,27370637,27370637,27371716,0,0,0,1079
32318,27370639,27370639,27371718,0,0,0,1079
32317,27370638,27370638,27371770,0,0,0,1132
32320,27372417,27372417,27373319,0,0,0,902
32321,27372417,27372417,27373331,0,0,0,914
32324,27372418,27372418,27373350,0,0,0,932
32322,27372417,27372417,27373361,0,0,0,944
32325,27372418,27372418,27373362,0,0,0,944
32323,27372417,27372417,27373372,0,0,0,955
32326,27372418,27372418,27373373,0,0,0,955
32330,27372419,27372419,27373385,0,0,0,966
32331,27372419,27372419,27373385,0,0,0,966
32327,27372418,27372418,27373395,0,0,0,977
32328,27372418,27372418,27373406,0,0,0,988
32329,27372418,27372418,27373406,0,0,0,988
32217,27344501,27344501,27373704,0,0,0,29203
32332,27373774,27373774,27373919,0,0,0,145
32333,27373798,27373798,27374282,0,0,0,484
32337,27373799,27373799,27374294,0,0,0,495
32334,27373798,27373798,27374304,0,0,0,506
32335,27373798,27373798,27374304,0,0,0,506
32338,27373799,27373799,27374305,0,0,0,506
32182,27337972,27337972,27374308,0,0,0,36336
32336,27373798,27373798,27374315,0,0,0,517
32339,27373799,27373799,27374316,0,0,0,517
32340,27373799,27373799,27374327,0,0,0,528
32341,27373799,27373799,27374327,0,0,0,528
32343,27373800,27373800,27374328,0,0,0,528
32342,27373799,27373799,27374338,0,0,0,539
32344,27373800,27373800,27374350,0,0,0,550
32345,27373800,27373800,27374350,0,0,0,550
32346,27373800,27373800,27374361,0,0,0,561
32347,27373800,27373800,27374361,0,0,0,561
32348,27373800,27373800,27374361,0,0,0,561
32349,27373800,27373800,27374361,0,0,0,561
32350,27373801,27373801,27374362,0,0,0,561
32351,27373801,27373801,27374362,0,0,0,561
32352,27373801,27373801,27374362,0,0,0,561
32353,27373801,27373801,27374362,0,0,0,561
32354,27373801,27373919,27374363,0,0,118,562
32356,27374609,27374609,27374732,0,0,0,123
32357,27374609,27374609,27374732,0,0,0,123
32360,27374610,27374610,27374733,0,0,0,123
32361,27374610,27374610,27374733,0,0,0,123
32362,27374610,27374610,27374733,0,0,0,123
32366,27374611,27374611,27374734,0,0,0,123
32367,27374611,27374611,27374734,0,0,0,123
32355,27374608,27374608,27374742,0,0,0,134
32358,27374609,27374609,27374743,0,0,0,134
32359,27374609,27374609,27374743,0,0,0,134
32363,27374610,27374610,27374744,0,0,0,134
32364,27374610,27374610,27374744,0,0,0,134
32365,27374610,27374610,27374744,0,0,0,134
32368,27374611,27374611,27374745,0,0,0,134
32369,27374611,27374611,27374745,0,0,0,134
32370,27374611,27374611,27374745,0,0,0,134
32371,27374611,27374611,27374745,0,0,0,134
32372,27374612,27374612,27374746,0,0,0,134
32373,27374612,27374612,27374746,0,0,0,134
32243,27350565,27351262,27374834,0,0,697,24269
32374,27374612,27374612,27374876,0,0,0,264
32376,27375007,27375007,27375469,0,0,0,462
32377,27375013,27375013,27375501,0,0,0,488
32378,27375013,27375013,27375512,0,0,0,499
32379,27375013,27375013,27375512,0,0,0,499
32380,27375013,27375013,27375523,0,0,0,510
32381,27375014,27375014,27375524,0,0,0,510
32382,27375014,27375014,27375524,0,0,0,510
32383,27375014,27375014,27375535,0,0,0,521
32384,27375015,27375015,27375536,0,0,0,521
32385,27375015,27375015,27375547,0,0,0,532
32386,27375015,27375015,27375547,0,0,0,532
32387,27375015,27375015,27375558,0,0,0,543
32388,27375016,27375016,27375559,0,0,0,543
32400,27375551,27375559,27375634,0,0,8,83
32389,27375016,27375016,27375791,0,0,0,775
32390,27375016,27375016,27375813,0,0,0,797
32391,27375016,27375016,27375813,0,0,0,797
32392,27375017,27375469,27375959,0,0,452,942
32393,27375017,27375501,27376002,0,0,484,985
32396,27375018,27375523,27376024,0,0,505,1006
32397,27375018,27375524,27376025,0,0,506,1007
32398,27375018,27375524,27376036,0,0,506,1018
32399,27375018,27375535,27376047,0,0,517,1029
32242,27350478,27351262,27376219,0,0,784,25741
32394,27375017,27375512,27376298,0,0,495,1281
32395,27375017,27375512,27376298,0,0,495,1281
32403,27376619,27376619,27376943,0,0,0,324
32404,27376619,27376619,27376959,0,0,0,340
32402,27376613,27376613,27376970,0,0,0,357
32405,27376619,27376619,27376980,0,0,0,361
32406,27376620,27376620,27376981,0,0,0,361
32407,27376620,27376620,27376981,0,0,0,361
32408,27376621,27376621,27377050,0,0,0,429
32409,27376622,27376622,27377051,0,0,0,429
32410,27376622,27376622,27377051,0,0,0,429
32411,27376622,27376622,27377051,0,0,0,429
32412,27376623,27376623,27377052,0,0,0,429
32413,27376623,27376943,27377372,0,0,320,749
32421,27376625,27377051,27377383,0,0,426,758
32414,27376623,27376959,27377388,0,0,336,765
32422,27376625,27377051,27377394,0,0,426,769
32423,27376625,27377052,27377396,0,0,427,771
32415,27376623,27376970,27377587,0,0,347,964
32416,27376624,27376980,27377597,0,0,356,973
32417,27376624,27376981,27377609,0,0,357,985
32418,27376624,27376981,27377609,0,0,357,985
32419,27376624,27377050,27377689,0,0,426,1065
32420,27376624,27377051,27377690,0,0,427,1066
32424,27376625,27377372,27377716,0,0,747,1091
32425,27376625,27377383,27377727,0,0,758,1102
32426,27376625,27377388,27377728,0,0,763,1103
32427,27376625,27377394,27377734,0,0,769,1109
32428,27376626,27377396,27377747,0,0,770,1121
32429,27376626,27377587,27377949,0,0,961,1323
32430,27376626,27377597,27377959,0,0,971,1333
32431,27376626,27377609,27377971,0,0,983,1345
32285,27362836,27363086,27379390,0,0,250,16554
32433,27379218,27379218,27379476,0,0,0,258
32435,27379219,27379219,27379493,0,0,0,274
32434,27379218,27379218,27379508,0,0,0,290
32436,27379219,27379219,27379509,0,0,0,290
32437,27379219,27379219,27379509,0,0,0,290
32438,27379219,27379219,27379509,0,0,0,290
32439,27379219,27379219,27379540,0,0,0,321
32440,27379219,27379390,27379711,0,0,171,492
32441,27379219,27379390,27379711,0,0,171,492
32442,27379220,27379390,27379711,0,0,170,491
32443,27379220,27379390,27379711,0,0,170,491
32449,27379222,27379509,27379779,0,0,287,557
32444,27379220,27379476,27379797,0,0,256,577
32224,27345280,27345280,27379840,0,0,0,34560
32453,27379222,27379711,27379975,0,0,489,753
32452,27379222,27379711,27379991,0,0,489,769
32454,27379222,27379711,27380001,0,0,489,779
32445,27379221,27379493,27380021,0,0,272,800
32446,27379221,27379508,27380036,0,0,287,815
32447,27379221,27379509,27380063,0,0,288,842
32448,27379221,27379509,27380063,0,0,288,842
32455,27379222,27379779,27380069,0,0,557,847
32456,27379223,27379797,27380087,0,0,574,864
32450,27379222,27379540,27380094,0,0,318,872
32457,27379223,27379975,27380245,0,0,752,1022
32458,27379223,27379991,27380261,0,0,768,1038
32451,27379222,27379711,27380265,0,0,489,1043
32459,27379223,27380001,27380282,0,0,778,1059
31070,27174404,27264540,27380304,0,0,90136,205900
32460,27379223,27380021,27380313,0,0,798,1090
32461,27379223,27380036,27380328,0,0,813,1105
32463,27379346,27380063,27380330,0,0,717,984
32464,27379346,27380069,27380347,0,0,723,1001
32465,27379346,27380087,27380376,0,0,741,1030
32466,27379346,27380094,27380394,0,0,748,1048
32462,27379345,27380063,27380511,0,0,718,1166
32467,27379347,27380245,27380534,0,0,898,1187
32470,27379347,27380282,27380546,0,0,935,1199
32468,27379347,27380261,27380561,0,0,914,1214
32469,27379347,27380265,27380565,0,0,918,1218
32471,27379348,27380304,27380565,0,0,956,1217
32474,27379349,27380304,27380576,0,0,955,1227
32472,27379348,27380304,27380745,0,0,956,1397
32473,27379348,27380304,27380745,0,0,956,1397
32475,27380684,27380684,27380961,0,0,0,277
32476,27380685,27380685,27380962,0,0,0,277
32477,27380685,27380685,27380962,0,0,0,277
32478,27380685,27380685,27380962,0,0,0,277
32479,27380686,27380686,27381036,0,0,0,350
32480,27380686,27380686,27381036,0,0,0,350
32481,27380686,27380686,27381036,0,0,0,350
32482,27380687,27380687,27381037,0,0,0,350
32483,27380687,27380687,27381037,0,0,0,350
32484,27380687,27380687,27381037,0,0,0,350
32485,27380687,27380687,27381048,0,0,0,361
32486,27380687,27380687,27381048,0,0,0,361
32487,27380687,27380687,27381048,0,0,0,361
32488,27380687,27380687,27381059,0,0,0,372
32489,27380688,27380688,27381060,0,0,0,372
32223,27345229,27345229,27381063,0,0,0,35834
32490,27380688,27380688,27381071,0,0,0,383
32491,27380688,27380688,27381071,0,0,0,383
32492,27380688,27380688,27381082,0,0,0,394
32493,27380688,27380688,27381082,0,0,0,394
32494,27380688,27380688,27381093,0,0,0,405
32495,27380689,27380689,27381105,0,0,0,416
32496,27380689,27380689,27381105,0,0,0,416
32497,27380689,27380689,27381105,0,0,0,416
32498,27380689,27380689,27381116,0,0,0,427
32499,27380689,27380745,27381172,0,0,56,483
32500,27380689,27380745,27381183,0,0,56,494
32515,27380891,27381060,27381201,0,0,169,310
32508,27380889,27381037,27381321,0,0,148,432
32509,27380889,27381037,27381321,0,0,148,432
32510,27380889,27381037,27381332,0,0,148,443
32511,27380890,27381048,27381343,0,0,158,453
32512,27380890,27381048,27381354,0,0,158,464
32513,27380890,27381048,27381354,0,0,158,464
32518,27380892,27381082,27381360,0,0,190,468
32519,27380892,27381082,27381360,0,0,190,468
32520,27380892,27381093,27381371,0,0,201,479
32523,27380893,27381105,27381374,0,0,212,481
32514,27380890,27381059,27381376,0,0,169,486
32516,27380891,27381071,27381388,0,0,180,497
32522,27380893,27381105,27381394,0,0,212,501
32524,27380893,27381116,27381396,0,0,223,503
32502,27380690,27380962,27381400,0,0,272,710
32501,27380689,27380961,27381410,0,0,272,721
32503,27380690,27380962,27381411,0,0,272,721
32504,27380690,27380962,27381422,0,0,272,732
32525,27380893,27381172,27381452,0,0,279,559
32526,27380894,27381183,27381474,0,0,289,580
32527,27380894,27381201,27381492,0,0,307,598
32505,27380690,27381036,27381496,0,0,346,806
32506,27380690,27381036,27381507,0,0,346,817
32507,27380690,27381036,27381507,0,0,346,817
32517,27380891,27381071,27381560,0,0,180,669
32521,27380892,27381105,27381605,0,0,213,713
32528,27380894,27381321,27381623,0,0,427,729
32530,27381626,27381626,27381892,0,0,0,266
32531,27381632,27381632,27381898,0,0,0,266
32532,27381633,27381633,27381915,0,0,0,282
32533,27381633,27381633,27381915,0,0,0,282
32534,27381633,27381633,27381915,0,0,0,282
32535,27381633,27381633,27381941,0,0,0,308
32536,27381634,27381634,27381942,0,0,0,308
32537,27381634,27381634,27381942,0,0,0,308
32538,27381634,27381634,27381942,0,0,0,308
32539,27381634,27381634,27381942,0,0,0,308
32540,27381637,27381637,27382029,0,0,0,392
32541,27381637,27381892,27382284,0,0,255,647
32542,27381637,27381898,27382290,0,0,261,653
32543,27381637,27381915,27382307,0,0,278,670
32544,27381637,27381915,27382307,0,0,278,670
32545,27381637,27381915,27382307,0,0,278,670
32546,27381638,27381941,27382333,0,0,303,695
32547,27381638,27381942,27382334,0,0,304,696
32548,27381638,27381942,27382334,0,0,304,696
32549,27381638,27381942,27382334,0,0,304,696
32550,27381638,27381942,27382361,0,0,304,723
32551,27381638,27382029,27382448,0,0,391,810
32222,27345192,27345192,27382488,0,0,0,37296
32560,27381640,27382334,27382598,0,0,694,958
32561,27381640,27382361,27382626,0,0,721,986
32552,27381638,27382284,27382703,0,0,646,1065
32553,27381639,27382290,27382709,0,0,651,1070
32562,27381640,27382448,27382723,0,0,808,1083
32554,27381639,27382307,27382737,0,0,668,1098
32555,27381639,27382307,27382737,0,0,668,1098
32556,27381639,27382307,27382737,0,0,668,1098
32557,27381639,27382333,27382945,0,0,694,1306
32558,27381639,27382334,27382946,0,0,695,1307
32559,27381639,27382334,27382957,0,0,695,1318
32566,27381641,27382709,27382984,0,0,1068,1343
32568,27381641,27382737,27383008,0,0,1096,1367
32569,27381641,27382737,27383008,0,0,1096,1367
32567,27381641,27382723,27383009,0,0,1082,1368
32570,27381641,27382737,27383019,0,0,1096,1378
32221,27345085,27345085,27383115,0,0,0,38030
32563,27381640,27382598,27383221,0,0,958,1581
32573,27381642,27382957,27383235,0,0,1315,1593
32571,27381641,27382945,27383238,0,0,1304,1597
32572,27381642,27382946,27383239,0,0,1304,1597
32564,27381640,27382626,27383249,0,0,986,1609
32574,27381642,27382984,27383262,0,0,1342,1620
32575,27381642,27383008,27383286,0,0,1366,1644
32576,27381642,27383008,27383297,0,0,1366,1655
32577,27381642,27383009,27383309,0,0,1367,1667
32578,27381642,27383019,27383319,0,0,1377,1677
32565,27381640,27382703,27383326,0,0,1063,1686
32579,27381840,27383115,27383415,0,0,1275,1575
32580,27381840,27383221,27383496,0,0,1381,1656
32581,27381841,27383235,27383510,0,0,1394,1669
32587,27382647,27383297,27383518,0,0,650,871
32582,27381841,27383238,27383524,0,0,1397,1683
32588,27382647,27383309,27383530,0,0,662,883
32583,27382646,27383239,27383603,0,0,593,957
32584,27382646,27383249,27383613,0,0,603,967
32401,27376245,27376245,27383705,0,0,0,7460
32585,27382646,27383262,27383725,0,0,616,1079
32593,27382648,27383510,27383731,0,0,862,1083
32594,27382648,27383518,27383739,0,0,870,1091
32595,27382648,27383524,27383745,0,0,876,1097
32586,27382646,27383286,27383749,0,0,640,1103
32596,27382648,27383530,27383762,0,0,882,1114
32589,27382647,27383319,27383782,0,0,672,1135
32590,27382647,27383326,27383800,0,0,679,1153
32597,27382648,27383603,27383846,0,0,955,1198
32598,27382648,27383613,27383856,0,0,965,1208
32591,27382647,27383415,27383889,0,0,768,1242
32604,27382649,27383725,27383924,0,0,1076,1275
32605,27382650,27383731,27383941,0,0,1081,1291
32599,27382649,27383705,27383948,0,0,1056,1299
32606,27382650,27383739,27383949,0,0,1089,1299
32600,27382649,27383705,27383959,0,0,1056,1310
32601,27382649,27383705,27383959,0,0,1056,1310
32602,27382649,27383705,27383959,0,0,1056,1310
32607,27382650,27383745,27383966,0,0,1095,1316
32592,27382647,27383496,27383970,0,0,849,1323
32603,27382649,27383705,27383970,0,0,1056,1321
32608,27382650,27383749,27383970,0,0,1099,1320
32609,27382650,27383762,27383983,0,0,1112,1333
32610,27382650,27383782,27384003,0,0,1132,1353
32611,27382650,27383800,27384043,0,0,1150,1393
32612,27382651,27383846,27384089,0,0,1195,1438
32613,27382651,27383856,27384099,0,0,1205,1448
32614,27382651,27383889,27384143,0,0,1238,1492
32616,27382651,27383941,27384156,0,0,1290,1505
32617,27382651,27383948,27384163,0,0,1297,1512
32618,27382784,27383949,27384164,0,0,1165,1380
32615,27382651,27383924,27384178,0,0,1273,1527
32619,27382784,27383959,27384185,0,0,1175,1401
32622,27382785,27383966,27384203,0,0,1181,1418
32620,27382784,27383959,27384207,0,0,1175,1423
32623,27382785,27383970,27384207,0,0,1185,1422
32621,27382784,27383959,27384218,0,0,1175,1434
32624,27382785,27383970,27384218,0,0,1185,1433
32625,27382786,27383970,27384218,0,0,1184,1432
32626,27382786,27383983,27384231,0,0,1197,1445
32627,27382786,27384003,27384251,0,0,1217,1465
32220,27345017,27345017,27385836,0,0,0,40819
32529,27381345,27381410,27391493,0,0,65,10148
32218,27344897,27344897,27391644,0,0,0,46747
32432,27379100,27379100,27395446,0,0,0,16346
29815,26943147,26943147,27405262,0,0,0,462115
32375,27374806,27374806,27405367,0,0,0,30561
30450,27090291,27261127,27407440,0,0,170836,317149
32104,27295621,27295621,27411388,0,0,0,115767
32105,27295712,27295712,27411497,0,0,0,115785
32628,27395407,27395407,27411738,0,0,0,16331
32319,27370698,27391493,27412026,0,0,20795,41328
32031,27266034,27266034,27416620,0,0,0,150586
31046,27173929,27259841,27416944,0,0,85912,243015
32630,27413889,27413889,27418303,0,0,0,4414
32632,27418321,27418321,27418380,0,0,0,59
32634,27418399,27418399,27418476,0,0,0,77
32633,27418363,27418363,27418549,0,0,0,186
32636,27418553,27418553,27418872,0,0,0,319
32638,27418833,27418833,27418966,0,0,0,133
32635,27418446,27418446,27419356,0,0,0,910
32637,27418666,27418666,27419954,0,0,0,1288
32640,27420855,27420855,27420982,0,0,0,127
32641,27421155,27421155,27421290,0,0,0,135
32642,27421585,27421585,27421715,0,0,0,130
32643,27422152,27422152,27422280,0,0,0,128
32644,27422340,27422340,27422463,0,0,0,123
32645,27422780,27422780,27422908,0,0,0,128
32639,27419965,27419965,27423260,0,0,0,3295
32646,27423202,27423202,27423329,0,0,0,127
32647,27423322,27423322,27423449,0,0,0,127
32024,27265724,27265724,27424124,0,0,0,158400
32030,27265992,27265992,27424392,0,0,0,158400
32648,27425448,27425448,27425573,0,0,0,125
32629,27411697,27411697,27428012,0,0,0,16315
32652,27428258,27428258,27428473,0,0,0,215
32653,27428258,27428258,27428473,0,0,0,215
32654,27428258,27428258,27428473,0,0,0,215
32655,27428259,27428259,27428474,0,0,0,215
32674,27428268,27428268,27428481,0,0,0,213
32675,27428268,27428268,27428481,0,0,0,213
32676,27428268,27428268,27428481,0,0,0,213
32677,27428268,27428268,27428481,0,0,0,213
32651,27428252,27428252,27428484,0,0,0,232
32668,27428267,27428267,27428501,0,0,0,234
32669,27428267,27428267,27428501,0,0,0,234
32670,27428267,27428267,27428501,0,0,0,234
32671,27428267,27428267,27428501,0,0,0,234
32672,27428268,27428268,27428502,0,0,0,234
32673,27428268,27428268,27428528,0,0,0,260
32689,27428476,27428476,27428554,0,0,0,78
32656,27428263,27428263,27428671,0,0,0,408
32657,27428264,27428264,27428672,0,0,0,408
32658,27428264,27428264,27428672,0,0,0,408
32659,27428265,27428265,27428673,0,0,0,408
32660,27428265,27428265,27428673,0,0,0,408
32682,27428474,27428474,27428673,0,0,0,199
32697,27428478,27428478,27428678,0,0,0,200
32692,27428476,27428476,27428679,0,0,0,203
32702,27428479,27428479,27428681,0,0,0,202
32703,27428479,27428479,27428681,0,0,0,202
32681,27428473,27428473,27428683,0,0,0,210
32696,27428477,27428477,27428688,0,0,0,211
32698,27428478,27428478,27428689,0,0,0,211
32693,27428477,27428477,27428691,0,0,0,214
32694,27428477,27428477,27428691,0,0,0,214
32704,27428479,27428479,27428692,0,0,0,213
32683,27428474,27428474,27428695,0,0,0,221
32685,27428475,27428475,27428696,0,0,0,221
32678,27428473,27428473,27428697,0,0,0,224
32679,27428473,27428473,27428697,0,0,0,224
32699,27428478,27428478,27428700,0,0,0,222
32700,27428478,27428478,27428700,0,0,0,222
32701,27428478,27428478,27428700,0,0,0,222
32695,27428477,27428477,27428702,0,0,0,225
32684,27428474,27428474,27428706,0,0,0,232
32686,27428475,27428475,27428707,0,0,0,232
32687,27428475,27428475,27428707,0,0,0,232
32680,27428473,27428473,27428708,0,0,0,235
32688,27428475,27428475,27428718,0,0,0,243
32690,27428476,27428476,27428719,0,0,0,243
32691,27428476,27428476,27428730,0,0,0,254
32661,27428265,27428265,27428788,0,0,0,523
32662,27428265,27428265,27428799,0,0,0,534
32663,27428265,27428265,27428799,0,0,0,534
32664,27428266,27428266,27428800,0,0,0,534
32665,27428266,27428266,27428811,0,0,0,545
32666,27428266,27428266,27428822,0,0,0,556
32667,27428266,27428266,27428822,0,0,0,556
32721,27429095,27429095,27429308,0,0,0,213
32722,27429095,27429095,27429319,0,0,0,224
32711,27429094,27429094,27429320,0,0,0,226
32712,27429094,27429094,27429320,0,0,0,226
32713,27429094,27429094,27429320,0,0,0,226
32714,27429094,27429094,27429320,0,0,0,226
32715,27429094,27429094,27429320,0,0,0,226
32717,27429095,27429095,27429321,0,0,0,226
32723,27429095,27429095,27429330,0,0,0,235
32718,27429095,27429095,27429332,0,0,0,237
32719,27429095,27429095,27429343,0,0,0,248
32720,27429095,27429095,27429343,0,0,0,248
32736,27429327,27429327,27429536,0,0,0,209
32724,27429323,27429323,27429547,0,0,0,224
32737,27429327,27429327,27429547,0,0,0,220
32738,27429327,27429327,27429547,0,0,0,220
32725,27429324,27429324,27429548,0,0,0,224
32726,27429324,27429324,27429548,0,0,0,224
32739,27429328,27429328,27429548,0,0,0,220
32727,27429324,27429324,27429559,0,0,0,235
32740,27429328,27429328,27429559,0,0,0,231
32741,27429328,27429328,27429559,0,0,0,231
32742,27429328,27429328,27429570,0,0,0,242
32743,27429328,27429328,27429570,0,0,0,242
32744,27429328,27429328,27429570,0,0,0,242
32728,27429325,27429325,27429571,0,0,0,246
32729,27429325,27429325,27429571,0,0,0,246
32730,27429325,27429325,27429582,0,0,0,257
32731,27429325,27429325,27429582,0,0,0,257
32745,27429329,27429329,27429582,0,0,0,253
32746,27429329,27429329,27429582,0,0,0,253
32747,27429329,27429329,27429593,0,0,0,264
32732,27429326,27429326,27429594,0,0,0,268
32733,27429326,27429326,27429594,0,0,0,268
32748,27429329,27429329,27429604,0,0,0,275
32734,27429326,27429326,27429605,0,0,0,279
32735,27429326,27429326,27429605,0,0,0,279
32705,27429093,27429093,27429634,0,0,0,541
32706,27429093,27429093,27429645,0,0,0,552
32707,27429093,27429093,27429656,0,0,0,563
32708,27429093,27429093,27429656,0,0,0,563
32709,27429093,27429093,27429656,0,0,0,563
32710,27429093,27429093,27429667,0,0,0,574
32716,27429094,27429094,27429679,0,0,0,585
32749,27429985,27429985,27430115,0,0,0,130
32750,27430542,27430542,27430670,0,0,0,128
32112,27325220,27325220,27431036,0,0,0,105816
32751,27430918,27430918,27431049,0,0,0,131
32753,27431274,27431274,27431413,0,0,0,139
32754,27432217,27432217,27432383,0,0,0,166
32113,27325252,27325252,27432900,0,0,0,107648
32755,27433081,27433081,27433210,0,0,0,129
32756,27433518,27433518,27433684,0,0,0,166
32757,27433849,27433849,27434069,0,0,0,220
32231,27346009,27350055,27435068,0,0,4046,89059
32631,27418204,27418204,27436867,0,0,0,18663
32758,27435185,27435185,27438409,0,0,0,3224
32649,27426794,27426794,27441626,0,0,0,14832
32764,27445513,27445513,27446497,0,0,0,984
32765,27445946,27445946,27446925,0,0,0,979
32650,27427974,27427974,27448279,0,0,0,20305
32774,27450731,27450731,27450915,0,0,0,184
32775,27450731,27450731,27450915,0,0,0,184
32776,27450731,27450731,27450915,0,0,0,184
32777,27450731,27450731,27450915,0,0,0,184
32778,27450731,27450731,27450915,0,0,0,184
32779,27450731,27450731,27450915,0,0,0,184
32780,27450986,27450986,27451170,0,0,0,184
32781,27450986,27450986,27451170,0,0,0,184
32782,27450987,27450987,27451171,0,0,0,184
32783,27450987,27450987,27451171,0,0,0,184
32784,27450987,27450987,27451171,0,0,0,184
32785,27450987,27450987,27451171,0,0,0,184
32786,27450988,27450988,27451172,0,0,0,184
32787,27450988,27450988,27451172,0,0,0,184
32788,27450988,27450988,27451172,0,0,0,184
32789,27450988,27450988,27451172,0,0,0,184
32790,27450989,27450989,27451173,0,0,0,184
32791,27450989,27450989,27451173,0,0,0,184
32792,27450989,27450989,27451173,0,0,0,184
32793,27450989,27450989,27451173,0,0,0,184
32794,27450990,27450990,27451174,0,0,0,184
32795,27450990,27450990,27451174,0,0,0,184
32796,27450990,27450990,27451174,0,0,0,184
32797,27450990,27450990,27451174,0,0,0,184
32798,27450991,27450991,27451175,0,0,0,184
32799,27450991,27450991,27451175,0,0,0,184
32800,27450991,27450991,27451175,0,0,0,184
32801,27450991,27450991,27451175,0,0,0,184
32802,27450991,27450991,27451175,0,0,0,184
32769,27450730,27450730,27451179,0,0,0,449
32770,27450730,27450730,27451179,0,0,0,449
32771,27450730,27450730,27451179,0,0,0,449
32772,27450730,27450730,27451179,0,0,0,449
32773,27450731,27450731,27451180,0,0,0,449
32803,27450992,27450992,27451188,0,0,0,196
32804,27450992,27450992,27451188,0,0,0,196
32805,27450992,27450992,27451188,0,0,0,196
32806,27450992,27450992,27451199,0,0,0,207
32807,27450992,27450992,27451199,0,0,0,207
32840,27451408,27451408,27451495,0,0,0,87
32838,27451408,27451408,27451587,0,0,0,179
32839,27451408,27451408,27451587,0,0,0,179
32827,27451406,27451406,27451612,0,0,0,206
32828,27451406,27451406,27451612,0,0,0,206
32829,27451406,27451406,27451623,0,0,0,217
32830,27451406,27451406,27451623,0,0,0,217
32831,27451407,27451407,27451635,0,0,0,228
32832,27451407,27451407,27451635,0,0,0,228
32833,27451407,27451407,27451635,0,0,0,228
32834,27451407,27451407,27451646,0,0,0,239
32835,27451407,27451407,27451657,0,0,0,250
32836,27451407,27451407,27451657,0,0,0,250
32837,27451407,27451407,27451657,0,0,0,250
32841,27451408,27451408,27451669,0,0,0,261
32842,27451408,27451408,27451680,0,0,0,272
32843,27451408,27451408,27451680,0,0,0,272
32844,27451611,27451611,27451725,0,0,0,114
32808,27451403,27451403,27451795,0,0,0,392
32809,27451403,27451403,27451795,0,0,0,392
32810,27451403,27451403,27451795,0,0,0,392
32811,27451403,27451403,27451795,0,0,0,392
32812,27451404,27451404,27451796,0,0,0,392
32813,27451404,27451404,27451796,0,0,0,392
32814,27451404,27451404,27451796,0,0,0,392
32815,27451404,27451404,27451796,0,0,0,392
32816,27451404,27451404,27451796,0,0,0,392
32817,27451404,27451404,27451796,0,0,0,392
32818,27451404,27451404,27451796,0,0,0,392
32819,27451405,27451405,27451797,0,0,0,392
32820,27451405,27451405,27451797,0,0,0,392
32821,27451405,27451405,27451797,0,0,0,392
32822,27451405,27451405,27451797,0,0,0,392
32823,27451405,27451405,27451797,0,0,0,392
32858,27451615,27451615,27451818,0,0,0,203
32859,27451615,27451615,27451818,0,0,0,203
32824,27451405,27451405,27451824,0,0,0,419
32845,27451611,27451611,27451824,0,0,0,213
32846,27451611,27451611,27451824,0,0,0,213
32825,27451406,27451406,27451825,0,0,0,419
32826,27451406,27451406,27451825,0,0,0,419
32860,27451615,27451615,27451829,0,0,0,214
32847,27451612,27451612,27451836,0,0,0,224
32848,27451612,27451612,27451847,0,0,0,235
32849,27451612,27451612,27451847,0,0,0,235
32850,27451612,27451612,27451847,0,0,0,235
32851,27451613,27451613,27451859,0,0,0,246
32852,27451613,27451613,27451859,0,0,0,246
32853,27451613,27451613,27451870,0,0,0,257
32854,27451614,27451614,27451882,0,0,0,268
32855,27451614,27451614,27451882,0,0,0,268
32856,27451614,27451614,27451882,0,0,0,268
32857,27451614,27451614,27451882,0,0,0,268
32878,27452564,27452564,27452770,0,0,0,206
32879,27452564,27452564,27452781,0,0,0,217
32893,27452816,27452816,27452913,0,0,0,97
32894,27452816,27452816,27452913,0,0,0,97
32885,27452814,27452814,27453008,0,0,0,194
32861,27452561,27452561,27453013,0,0,0,452
32862,27452561,27452561,27453013,0,0,0,452
32863,27452562,27452562,27453014,0,0,0,452
32864,27452562,27452562,27453014,0,0,0,452
32865,27452562,27452562,27453014,0,0,0,452
32866,27452562,27452562,27453014,0,0,0,452
32867,27452562,27452562,27453014,0,0,0,452
32868,27452562,27452562,27453014,0,0,0,452
32869,27452562,27452562,27453014,0,0,0,452
32870,27452563,27452563,27453015,0,0,0,452
32871,27452563,27452563,27453015,0,0,0,452
32872,27452563,27452563,27453015,0,0,0,452
32873,27452563,27452563,27453015,0,0,0,452
32874,27452563,27452563,27453015,0,0,0,452
32875,27452563,27452563,27453015,0,0,0,452
32876,27452564,27452564,27453016,0,0,0,452
32877,27452564,27452564,27453016,0,0,0,452
32895,27452816,27452816,27453024,0,0,0,208
32896,27452817,27452817,27453036,0,0,0,219
32897,27452817,27452817,27453036,0,0,0,219
32880,27452812,27452812,27453040,0,0,0,228
32881,27452812,27452812,27453040,0,0,0,228
32898,27452817,27452817,27453047,0,0,0,230
32899,27452817,27452817,27453047,0,0,0,230
32900,27452817,27452817,27453047,0,0,0,230
32882,27452813,27452813,27453052,0,0,0,239
32883,27452813,27452813,27453052,0,0,0,239
32884,27452813,27452813,27453052,0,0,0,239
32886,27452814,27452814,27453053,0,0,0,239
32901,27452817,27452817,27453058,0,0,0,241
32902,27452818,27452818,27453059,0,0,0,241
32887,27452814,27452814,27453064,0,0,0,250
32888,27452814,27452814,27453064,0,0,0,250
32903,27452818,27452818,27453070,0,0,0,252
32904,27452818,27452818,27453070,0,0,0,252
32889,27452815,27452815,27453076,0,0,0,261
32905,27452818,27452818,27453081,0,0,0,263
32890,27452815,27452815,27453087,0,0,0,272
32906,27452819,27452819,27453093,0,0,0,274
32907,27452819,27452819,27453093,0,0,0,274
32908,27452819,27452819,27453093,0,0,0,274
32891,27452815,27452815,27453098,0,0,0,283
32892,27452815,27452815,27453098,0,0,0,283
32909,27452819,27452819,27453104,0,0,0,285
32928,27453823,27453823,27454029,0,0,0,206
32929,27453823,27453823,27454029,0,0,0,206
32930,27453823,27453823,27454040,0,0,0,217
32931,27453823,27453823,27454040,0,0,0,217
32932,27453823,27453823,27454051,0,0,0,228
32937,27454074,27454074,27454166,0,0,0,92
32938,27454076,27454076,27454190,0,0,0,114
32939,27454076,27454076,27454190,0,0,0,114
32940,27454076,27454076,27454190,0,0,0,114
32941,27454076,27454076,27454190,0,0,0,114
32935,27454074,27454074,27454258,0,0,0,184
32936,27454074,27454074,27454258,0,0,0,184
32910,27453820,27453820,27454262,0,0,0,442
32911,27453820,27453820,27454262,0,0,0,442
32912,27453820,27453820,27454262,0,0,0,442
32913,27453820,27453820,27454262,0,0,0,442
32914,27453821,27453821,27454263,0,0,0,442
32915,27453821,27453821,27454263,0,0,0,442
32916,27453821,27453821,27454263,0,0,0,442
32917,27453821,27453821,27454263,0,0,0,442
32918,27453821,27453821,27454263,0,0,0,442
32919,27453821,27453821,27454263,0,0,0,442
32920,27453822,27453822,27454264,0,0,0,442
32921,27453822,27453822,27454264,0,0,0,442
32922,27453822,27453822,27454264,0,0,0,442
32923,27453822,27453822,27454264,0,0,0,442
32924,27453822,27453822,27454264,0,0,0,442
32925,27453822,27453822,27454264,0,0,0,442
32926,27453822,27453822,27454264,0,0,0,442
32927,27453823,27453823,27454265,0,0,0,442
32933,27454071,27454071,27454299,0,0,0,228
32934,27454071,27454071,27454299,0,0,0,228
32961,27454320,27454320,27454526,0,0,0,206
32990,27454581,27454581,27454663,0,0,0,82
32991,27454581,27454581,27454663,0,0,0,82
32976,27454578,27454578,27454675,0,0,0,97
32979,27454579,27454579,27454676,0,0,0,97
32985,27454580,27454580,27454704,0,0,0,124
32986,27454580,27454580,27454704,0,0,0,124
32962,27454574,27454574,27454753,0,0,0,179
32963,27454574,27454574,27454753,0,0,0,179
32969,27454576,27454576,27454755,0,0,0,179
32942,27454317,27454317,27454760,0,0,0,443
32943,27454317,27454317,27454760,0,0,0,443
32944,27454317,27454317,27454760,0,0,0,443
32945,27454318,27454318,27454761,0,0,0,443
32946,27454318,27454318,27454761,0,0,0,443
32947,27454318,27454318,27454761,0,0,0,443
32948,27454318,27454318,27454761,0,0,0,443
32949,27454318,27454318,27454761,0,0,0,443
32950,27454318,27454318,27454761,0,0,0,443
32951,27454319,27454319,27454762,0,0,0,443
32952,27454319,27454319,27454762,0,0,0,443
32953,27454319,27454319,27454762,0,0,0,443
32954,27454319,27454319,27454762,0,0,0,443
32955,27454319,27454319,27454762,0,0,0,443
32956,27454319,27454319,27454762,0,0,0,443
32957,27454320,27454320,27454763,0,0,0,443
32958,27454320,27454320,27454763,0,0,0,443
32959,27454320,27454320,27454763,0,0,0,443
32960,27454320,27454320,27454763,0,0,0,443
32975,27454577,27454577,27454778,0,0,0,201
32977,27454578,27454578,27454779,0,0,0,201
32964,27454574,27454574,27454780,0,0,0,206
32994,27454581,27454581,27454784,0,0,0,203
32978,27454578,27454578,27454790,0,0,0,212
32965,27454575,27454575,27454792,0,0,0,217
32980,27454579,27454579,27454802,0,0,0,223
32981,27454579,27454579,27454802,0,0,0,223
32982,27454579,27454579,27454802,0,0,0,223
32966,27454575,27454575,27454803,0,0,0,228
32983,27454579,27454579,27454813,0,0,0,234
32967,27454575,27454575,27454814,0,0,0,239
32968,27454575,27454575,27454814,0,0,0,239
32970,27454576,27454576,27454815,0,0,0,239
32984,27454579,27454579,27454824,0,0,0,245
32971,27454576,27454576,27454826,0,0,0,250
32972,27454577,27454577,27454827,0,0,0,250
32973,27454577,27454577,27454827,0,0,0,250
32987,27454580,27454580,27454836,0,0,0,256
32974,27454577,27454577,27454838,0,0,0,261
32988,27454580,27454580,27454847,0,0,0,267
32989,27454580,27454580,27454847,0,0,0,267
32992,27454581,27454581,27454859,0,0,0,278
32993,27454581,27454581,27454859,0,0,0,278
33010,27455300,27455300,27455496,0,0,0,196
33011,27455300,27455300,27455508,0,0,0,208
33012,27455300,27455300,27455508,0,0,0,208
33013,27455300,27455300,27455519,0,0,0,219
33040,27455555,27455555,27455708,0,0,0,153
33025,27455552,27455552,27455749,0,0,0,197
32995,27455297,27455297,27455751,0,0,0,454
32996,27455297,27455297,27455751,0,0,0,454
32997,27455297,27455297,27455751,0,0,0,454
32998,27455298,27455298,27455752,0,0,0,454
32999,27455298,27455298,27455752,0,0,0,454
33000,27455298,27455298,27455752,0,0,0,454
33001,27455298,27455298,27455752,0,0,0,454
33002,27455298,27455298,27455752,0,0,0,454
33003,27455298,27455298,27455752,0,0,0,454
33004,27455299,27455299,27455753,0,0,0,454
33005,27455299,27455299,27455753,0,0,0,454
33006,27455299,27455299,27455753,0,0,0,454
33007,27455299,27455299,27455753,0,0,0,454
33008,27455300,27455300,27455754,0,0,0,454
33009,27455300,27455300,27455754,0,0,0,454
33026,27455552,27455552,27455760,0,0,0,208
33027,27455552,27455552,27455760,0,0,0,208
33014,27455548,27455548,27455767,0,0,0,219
33028,27455552,27455552,27455771,0,0,0,219
33029,27455553,27455553,27455772,0,0,0,219
33015,27455549,27455549,27455779,0,0,0,230
33016,27455549,27455549,27455779,0,0,0,230
33017,27455549,27455549,27455779,0,0,0,230
33030,27455553,27455553,27455783,0,0,0,230
33031,27455553,27455553,27455783,0,0,0,230
33018,27455550,27455550,27455791,0,0,0,241
33019,27455550,27455550,27455791,0,0,0,241
33032,27455553,27455553,27455794,0,0,0,241
33033,27455553,27455553,27455794,0,0,0,241
33034,27455554,27455554,27455795,0,0,0,241
33020,27455550,27455550,27455802,0,0,0,252
33021,27455550,27455550,27455802,0,0,0,252
33035,27455554,27455554,27455806,0,0,0,252
33036,27455554,27455554,27455806,0,0,0,252
33037,27455554,27455554,27455806,0,0,0,252
33022,27455551,27455551,27455814,0,0,0,263
33038,27455554,27455554,27455817,0,0,0,263
33039,27455554,27455554,27455817,0,0,0,263
33023,27455551,27455551,27455825,0,0,0,274
33024,27455551,27455551,27455825,0,0,0,274
33041,27455555,27455555,27455829,0,0,0,274
33042,27455555,27455555,27455840,0,0,0,285
33043,27455555,27455555,27455840,0,0,0,285
32763,27436882,27436882,27456090,0,0,0,19208
33060,27456535,27456535,27456736,0,0,0,201
33061,27456535,27456535,27456736,0,0,0,201
33062,27456535,27456535,27456747,0,0,0,212
33063,27456535,27456535,27456747,0,0,0,212
33064,27456536,27456536,27456759,0,0,0,223
33065,27456536,27456536,27456770,0,0,0,234
33066,27456536,27456536,27456770,0,0,0,234
33044,27456531,27456531,27456877,0,0,0,346
33045,27456531,27456531,27456877,0,0,0,346
33046,27456532,27456532,27456878,0,0,0,346
33047,27456532,27456532,27456878,0,0,0,346
33048,27456533,27456533,27456879,0,0,0,346
33049,27456533,27456533,27456879,0,0,0,346
33050,27456533,27456533,27456879,0,0,0,346
33051,27456533,27456533,27456879,0,0,0,346
33052,27456533,27456533,27456879,0,0,0,346
33053,27456534,27456534,27456880,0,0,0,346
33054,27456534,27456534,27456880,0,0,0,346
33055,27456534,27456534,27456880,0,0,0,346
33056,27456534,27456534,27456880,0,0,0,346
33057,27456534,27456534,27456880,0,0,0,346
33058,27456534,27456534,27456880,0,0,0,346
33059,27456535,27456535,27456881,0,0,0,346
33100,27457087,27457087,27457189,0,0,0,102
33101,27457087,27457087,27457189,0,0,0,102
33102,27457087,27457087,27457201,0,0,0,114
33103,27457087,27457087,27457201,0,0,0,114
33093,27457086,27457086,27457236,0,0,0,150
33094,27457086,27457086,27457236,0,0,0,150
33082,27457084,27457084,27457289,0,0,0,205
33083,27457084,27457084,27457289,0,0,0,205
33084,27457084,27457084,27457289,0,0,0,205
33085,27457084,27457084,27457289,0,0,0,205
33086,27457084,27457084,27457289,0,0,0,205
33087,27457084,27457084,27457289,0,0,0,205
33088,27457085,27457085,27457290,0,0,0,205
33089,27457085,27457085,27457290,0,0,0,205
33090,27457085,27457085,27457290,0,0,0,205
33091,27457085,27457085,27457290,0,0,0,205
33095,27457086,27457086,27457291,0,0,0,205
33096,27457086,27457086,27457291,0,0,0,205
33097,27457086,27457086,27457291,0,0,0,205
33098,27457087,27457087,27457292,0,0,0,205
33099,27457087,27457087,27457292,0,0,0,205
33092,27457085,27457085,27457302,0,0,0,217
33104,27457251,27457251,27457353,0,0,0,102
33105,27457251,27457251,27457353,0,0,0,102
33106,27457251,27457251,27457365,0,0,0,114
33067,27457081,27457081,27457405,0,0,0,324
33068,27457081,27457081,27457405,0,0,0,324
33069,27457081,27457081,27457405,0,0,0,324
33070,27457082,27457082,27457406,0,0,0,324
33071,27457082,27457082,27457406,0,0,0,324
33072,27457082,27457082,27457406,0,0,0,324
33073,27457082,27457082,27457406,0,0,0,324
33074,27457082,27457082,27457406,0,0,0,324
33075,27457082,27457082,27457406,0,0,0,324
33076,27457083,27457083,27457418,0,0,0,335
33077,27457083,27457083,27457418,0,0,0,335
33078,27457083,27457083,27457418,0,0,0,335
33079,27457083,27457083,27457429,0,0,0,346
33080,27457083,27457083,27457440,0,0,0,357
33081,27457083,27457083,27457440,0,0,0,357
33114,27457819,27457819,27458003,0,0,0,184
33115,27457820,27457820,27458004,0,0,0,184
33116,27457820,27457820,27458004,0,0,0,184
33117,27457820,27457820,27458004,0,0,0,184
33118,27457820,27457820,27458004,0,0,0,184
33119,27457821,27457821,27458005,0,0,0,184
33120,27457821,27457821,27458005,0,0,0,184
33121,27457821,27457821,27458005,0,0,0,184
33122,27457822,27457822,27458006,0,0,0,184
33123,27457822,27457822,27458006,0,0,0,184
33124,27457822,27457822,27458006,0,0,0,184
33125,27457822,27457822,27458006,0,0,0,184
33126,27457823,27457823,27458007,0,0,0,184
33127,27457823,27457823,27458007,0,0,0,184
33128,27457823,27457823,27458007,0,0,0,184
33129,27457823,27457823,27458007,0,0,0,184
33130,27457824,27457824,27458008,0,0,0,184
33131,27457824,27457824,27458008,0,0,0,184
33132,27457824,27457824,27458008,0,0,0,184
33133,27457824,27457824,27458008,0,0,0,184
33134,27457824,27457824,27458008,0,0,0,184
33135,27457824,27457824,27458008,0,0,0,184
33136,27457825,27457825,27458009,0,0,0,184
33137,27457825,27457825,27458009,0,0,0,184
33138,27457825,27457825,27458009,0,0,0,184
33139,27457825,27457825,27458009,0,0,0,184
33140,27457825,27457825,27458009,0,0,0,184
33107,27457566,27457566,27458013,0,0,0,447
33108,27457566,27457566,27458013,0,0,0,447
33109,27457566,27457566,27458013,0,0,0,447
33110,27457566,27457566,27458013,0,0,0,447
33111,27457566,27457566,27458013,0,0,0,447
33112,27457566,27457566,27458013,0,0,0,447
33113,27457566,27457566,27458013,0,0,0,447
33141,27457825,27457825,27458021,0,0,0,196
33142,27457826,27457826,27458022,0,0,0,196
33143,27457826,27457826,27458033,0,0,0,207
33144,27457826,27457826,27458033,0,0,0,207
33145,27457826,27457826,27458044,0,0,0,218
33146,27457826,27457826,27458044,0,0,0,218
33147,27457826,27457826,27458044,0,0,0,218
33154,27460885,27460885,27461114,0,0,0,229
33155,27460886,27460886,27461115,0,0,0,229
33156,27460886,27460886,27461115,0,0,0,229
33157,27460886,27460886,27461115,0,0,0,229
33158,27460886,27460886,27461115,0,0,0,229
33159,27460887,27460887,27461116,0,0,0,229
33160,27460887,27460887,27461116,0,0,0,229
33161,27460887,27460887,27461116,0,0,0,229
33162,27460887,27460887,27461116,0,0,0,229
33163,27460888,27460888,27461117,0,0,0,229
33164,27460888,27460888,27461117,0,0,0,229
33165,27460888,27460888,27461117,0,0,0,229
33166,27460888,27460888,27461117,0,0,0,229
33167,27460889,27460889,27461118,0,0,0,229
33168,27460889,27460889,27461118,0,0,0,229
33169,27460889,27460889,27461118,0,0,0,229
33170,27460889,27460889,27461118,0,0,0,229
33171,27460890,27460890,27461119,0,0,0,229
33172,27460890,27460890,27461119,0,0,0,229
33173,27460890,27460890,27461119,0,0,0,229
33174,27460890,27460890,27461119,0,0,0,229
33175,27460890,27460890,27461119,0,0,0,229
33176,27460891,27460891,27461120,0,0,0,229
33177,27460891,27460891,27461120,0,0,0,229
33178,27460891,27460891,27461120,0,0,0,229
33179,27460891,27460891,27461120,0,0,0,229
33180,27460891,27460891,27461120,0,0,0,229
33181,27460891,27460891,27461120,0,0,0,229
33182,27460892,27460892,27461121,0,0,0,229
33183,27460892,27460892,27461121,0,0,0,229
33184,27460892,27460892,27461121,0,0,0,229
33185,27460892,27460892,27461121,0,0,0,229
33186,27460892,27460892,27461121,0,0,0,229
33187,27460892,27460892,27461121,0,0,0,229
33188,27460893,27460893,27461122,0,0,0,229
33189,27460893,27460893,27461122,0,0,0,229
33148,27460677,27460677,27461124,0,0,0,447
33149,27460677,27460677,27461124,0,0,0,447
33150,27460677,27460677,27461124,0,0,0,447
33151,27460677,27460677,27461124,0,0,0,447
33152,27460677,27460677,27461124,0,0,0,447
33153,27460677,27460677,27461124,0,0,0,447
33190,27460893,27460893,27461134,0,0,0,241
33191,27460893,27460893,27461134,0,0,0,241
33192,27460893,27460893,27461145,0,0,0,252
33193,27460893,27460893,27461145,0,0,0,252
33194,27460893,27460893,27461156,0,0,0,263
33195,27460894,27460894,27461157,0,0,0,263
33196,27460894,27460894,27461168,0,0,0,274
33197,27462029,27462029,27462151,0,0,0,122
33198,27462029,27462029,27462151,0,0,0,122
33199,27462029,27462029,27462151,0,0,0,122
33200,27462029,27462029,27462151,0,0,0,122
33201,27462030,27462030,27462152,0,0,0,122
33202,27462030,27462030,27462168,0,0,0,138
33203,27462030,27462030,27462168,0,0,0,138
33204,27462030,27462030,27462168,0,0,0,138
33205,27462030,27462030,27462168,0,0,0,138
33206,27462030,27462030,27462168,0,0,0,138
33207,27462031,27462031,27462169,0,0,0,138
33208,27462031,27462031,27462169,0,0,0,138
33209,27462031,27462031,27462169,0,0,0,138
33210,27462031,27462031,27462169,0,0,0,138
33211,27462031,27462031,27462169,0,0,0,138
33212,27462031,27462031,27462169,0,0,0,138
33213,27462032,27462032,27462170,0,0,0,138
33214,27462032,27462032,27462170,0,0,0,138
33215,27462032,27462032,27462170,0,0,0,138
33216,27462032,27462032,27462170,0,0,0,138
33217,27462032,27462032,27462170,0,0,0,138
33218,27462032,27462032,27462196,0,0,0,164
33235,27462327,27462327,27462523,0,0,0,196
33236,27462327,27462327,27462523,0,0,0,196
33237,27462327,27462327,27462535,0,0,0,208
33238,27462327,27462327,27462546,0,0,0,219
33239,27462327,27462327,27462546,0,0,0,219
33240,27462327,27462327,27462557,0,0,0,230
33257,27462580,27462580,27462683,0,0,0,103
33258,27462580,27462580,27462683,0,0,0,103
33219,27462324,27462324,27462778,0,0,0,454
33220,27462324,27462324,27462778,0,0,0,454
33221,27462324,27462324,27462778,0,0,0,454
33222,27462324,27462324,27462778,0,0,0,454
33223,27462325,27462325,27462779,0,0,0,454
33224,27462325,27462325,27462779,0,0,0,454
33225,27462325,27462325,27462779,0,0,0,454
33226,27462325,27462325,27462779,0,0,0,454
33227,27462325,27462325,27462779,0,0,0,454
33228,27462325,27462325,27462779,0,0,0,454
33229,27462326,27462326,27462780,0,0,0,454
33230,27462326,27462326,27462780,0,0,0,454
33231,27462326,27462326,27462780,0,0,0,454
33232,27462326,27462326,27462780,0,0,0,454
33233,27462326,27462326,27462780,0,0,0,454
33234,27462326,27462326,27462780,0,0,0,454
33251,27462578,27462578,27462781,0,0,0,203
33252,27462578,27462578,27462792,0,0,0,214
33253,27462579,27462579,27462793,0,0,0,214
33254,27462579,27462579,27462793,0,0,0,214
33255,27462579,27462579,27462793,0,0,0,214
33256,27462579,27462579,27462804,0,0,0,225
33259,27462580,27462580,27462805,0,0,0,225
33241,27462575,27462575,27462816,0,0,0,241
33242,27462576,27462576,27462817,0,0,0,241
33243,27462576,27462576,27462817,0,0,0,241
33244,27462576,27462576,27462828,0,0,0,252
33245,27462577,27462577,27462829,0,0,0,252
33246,27462577,27462577,27462829,0,0,0,252
33260,27462580,27462580,27462838,0,0,0,258
33261,27462581,27462581,27462839,0,0,0,258
33262,27462581,27462581,27462839,0,0,0,258
33247,27462577,27462577,27462840,0,0,0,263
33249,27462578,27462578,27462841,0,0,0,263
33250,27462578,27462578,27462841,0,0,0,263
33263,27462581,27462581,27462850,0,0,0,269
33264,27462581,27462581,27462850,0,0,0,269
33265,27462581,27462581,27462850,0,0,0,269
33248,27462577,27462577,27462851,0,0,0,274
33266,27462582,27462582,27462862,0,0,0,280
33285,27462974,27462974,27463181,0,0,0,207
33286,27462974,27462974,27463192,0,0,0,218
33287,27462974,27462974,27463203,0,0,0,229
33301,27463227,27463227,27463335,0,0,0,108
33302,27463227,27463227,27463335,0,0,0,108
33305,27463228,27463228,27463336,0,0,0,108
33310,27463229,27463229,27463360,0,0,0,131
33311,27463229,27463229,27463360,0,0,0,131
33315,27463230,27463230,27463383,0,0,0,153
33288,27463223,27463223,27463418,0,0,0,195
33294,27463225,27463225,27463420,0,0,0,195
33295,27463225,27463225,27463420,0,0,0,195
33298,27463226,27463226,27463423,0,0,0,197
33267,27462971,27462971,27463425,0,0,0,454
33268,27462971,27462971,27463425,0,0,0,454
33269,27462971,27462971,27463425,0,0,0,454
33270,27462971,27462971,27463425,0,0,0,454
33271,27462971,27462971,27463425,0,0,0,454
33272,27462972,27462972,27463426,0,0,0,454
33273,27462972,27462972,27463426,0,0,0,454
33274,27462972,27462972,27463426,0,0,0,454
33275,27462972,27462972,27463426,0,0,0,454
33276,27462972,27462972,27463426,0,0,0,454
33277,27462972,27462972,27463426,0,0,0,454
33278,27462973,27462973,27463427,0,0,0,454
33279,27462973,27462973,27463427,0,0,0,454
33280,27462973,27462973,27463427,0,0,0,454
33281,27462973,27462973,27463427,0,0,0,454
33282,27462974,27462974,27463428,0,0,0,454
33283,27462974,27462974,27463428,0,0,0,454
33299,27463226,27463226,27463434,0,0,0,208
33300,27463226,27463226,27463434,0,0,0,208
33284,27462974,27462974,27463440,0,0,0,466
33303,27463227,27463227,27463446,0,0,0,219
33289,27463223,27463223,27463452,0,0,0,229
33304,27463227,27463227,27463457,0,0,0,230
33290,27463224,27463224,27463464,0,0,0,240
33306,27463228,27463228,27463469,0,0,0,241
33291,27463224,27463224,27463475,0,0,0,251
33292,27463224,27463224,27463475,0,0,0,251
33293,27463224,27463224,27463475,0,0,0,251
33307,27463228,27463228,27463480,0,0,0,252
33308,27463228,27463228,27463480,0,0,0,252
33309,27463228,27463228,27463480,0,0,0,252
33296,27463225,27463225,27463487,0,0,0,262
33297,27463226,27463226,27463499,0,0,0,273
33312,27463229,27463229,27463503,0,0,0,274
33313,27463229,27463229,27463514,0,0,0,285
33314,27463229,27463229,27463514,0,0,0,285
33316,27463230,27463230,27463515,0,0,0,285
33349,27463863,27463863,27463955,0,0,0,92
33350,27463863,27463863,27463955,0,0,0,92
33355,27463864,27463864,27463956,0,0,0,92
33356,27463864,27463864,27463956,0,0,0,92
33357,27463864,27463864,27463956,0,0,0,92
33351,27463863,27463863,27463977,0,0,0,114
33352,27463863,27463863,27463977,0,0,0,114
33358,27463864,27463864,27463978,0,0,0,114
33359,27463864,27463864,27463978,0,0,0,114
33360,27463864,27463864,27463989,0,0,0,125
33367,27464003,27464003,27464058,0,0,0,55
33368,27464003,27464003,27464069,0,0,0,66
33353,27463863,27463863,27464102,0,0,0,239
33361,27464001,27464001,27464115,0,0,0,114
33362,27464002,27464002,27464116,0,0,0,114
33363,27464002,27464002,27464116,0,0,0,114
33364,27464002,27464002,27464127,0,0,0,125
33365,27464002,27464002,27464127,0,0,0,125
33366,27464003,27464003,27464139,0,0,0,136
33317,27463857,27463857,27464188,0,0,0,331
33318,27463857,27463857,27464188,0,0,0,331
33319,27463857,27463857,27464188,0,0,0,331
33320,27463857,27463857,27464188,0,0,0,331
33321,27463858,27463858,27464189,0,0,0,331
33322,27463858,27463858,27464189,0,0,0,331
33323,27463858,27463858,27464189,0,0,0,331
33324,27463858,27463858,27464189,0,0,0,331
33325,27463859,27463859,27464190,0,0,0,331
33326,27463859,27463859,27464190,0,0,0,331
33327,27463859,27463859,27464190,0,0,0,331
33328,27463859,27463859,27464190,0,0,0,331
33329,27463859,27463859,27464190,0,0,0,331
33330,27463860,27463860,27464191,0,0,0,331
33331,27463860,27463860,27464191,0,0,0,331
33332,27463860,27463860,27464191,0,0,0,331
33333,27463860,27463860,27464191,0,0,0,331
33334,27463860,27463860,27464213,0,0,0,353
32768,27448016,27448016,27464226,0,0,0,16210
33335,27463860,27463860,27464460,0,0,0,600
33336,27463861,27463861,27464461,0,0,0,600
33337,27463861,27463861,27464461,0,0,0,600
33338,27463861,27463861,27464461,0,0,0,600
33339,27463861,27463861,27464461,0,0,0,600
33340,27463861,27463861,27464461,0,0,0,600
33341,27463861,27463861,27464461,0,0,0,600
33342,27463862,27463862,27464462,0,0,0,600
33343,27463862,27463862,27464462,0,0,0,600
33344,27463862,27463862,27464462,0,0,0,600
33345,27463862,27463862,27464462,0,0,0,600
33346,27463862,27463862,27464462,0,0,0,600
33347,27463862,27463862,27464462,0,0,0,600
33348,27463862,27463862,27464462,0,0,0,600
33354,27463863,27463863,27464463,0,0,0,600
33389,27464686,27464686,27464893,0,0,0,207
33390,27464686,27464686,27464893,0,0,0,207
33391,27464686,27464686,27464904,0,0,0,218
33392,27464687,27464687,27464905,0,0,0,218
33393,27464687,27464687,27464916,0,0,0,229
33394,27464687,27464687,27464916,0,0,0,229
33395,27464687,27464687,27464916,0,0,0,229
33396,27464687,27464687,27464916,0,0,0,229
33397,27464687,27464687,27464927,0,0,0,240
33398,27464687,27464687,27464938,0,0,0,251
33411,27464914,27464914,27465045,0,0,0,131
33370,27464683,27464683,27465096,0,0,0,413
33371,27464683,27464683,27465096,0,0,0,413
33372,27464683,27464683,27465096,0,0,0,413
33373,27464683,27464683,27465096,0,0,0,413
33374,27464684,27464684,27465097,0,0,0,413
33375,27464684,27464684,27465097,0,0,0,413
33376,27464684,27464684,27465097,0,0,0,413
33377,27464684,27464684,27465097,0,0,0,413
33378,27464684,27464684,27465097,0,0,0,413
33379,27464684,27464684,27465097,0,0,0,413
33380,27464685,27464685,27465098,0,0,0,413
33381,27464685,27464685,27465098,0,0,0,413
33382,27464685,27464685,27465098,0,0,0,413
33383,27464685,27464685,27465098,0,0,0,413
33384,27464685,27464685,27465098,0,0,0,413
33385,27464685,27464685,27465098,0,0,0,413
33386,27464686,27464686,27465099,0,0,0,413
33387,27464686,27464686,27465099,0,0,0,413
33388,27464686,27464686,27465099,0,0,0,413
33420,27464916,27464916,27465108,0,0,0,192
33421,27464916,27464916,27465119,0,0,0,203
33404,27464912,27464912,27465120,0,0,0,208
33405,27464912,27464912,27465120,0,0,0,208
33406,27464912,27464912,27465120,0,0,0,208
33422,27464916,27464916,27465130,0,0,0,214
33407,27464913,27464913,27465132,0,0,0,219
33408,27464913,27464913,27465132,0,0,0,219
33409,27464913,27464913,27465143,0,0,0,230
33410,27464913,27464913,27465143,0,0,0,230
33412,27464914,27464914,27465155,0,0,0,241
33399,27464910,27464910,27465161,0,0,0,251
33413,27464914,27464914,27465166,0,0,0,252
33414,27464915,27464915,27465167,0,0,0,252
33415,27464915,27464915,27465167,0,0,0,252
33400,27464911,27464911,27465173,0,0,0,262
33401,27464911,27464911,27465173,0,0,0,262
33402,27464911,27464911,27465173,0,0,0,262
33403,27464912,27464912,27465174,0,0,0,262
33416,27464915,27464915,27465178,0,0,0,263
33417,27464915,27464915,27465178,0,0,0,263
33418,27464915,27464915,27465189,0,0,0,274
33419,27464916,27464916,27465190,0,0,0,274
32267,27356817,27361129,27466110,0,0,4312,109293
33447,27466666,27466666,27466782,0,0,0,116
33433,27466663,27466663,27466843,0,0,0,180
33430,27466662,27466662,27466864,0,0,0,202
33448,27466666,27466666,27466870,0,0,0,204
33449,27466666,27466666,27466870,0,0,0,204
33431,27466662,27466662,27466875,0,0,0,213
33432,27466662,27466662,27466875,0,0,0,213
33450,27466666,27466666,27466881,0,0,0,215
33434,27466663,27466663,27466887,0,0,0,224
33451,27466666,27466666,27466892,0,0,0,226
33452,27466667,27466667,27466893,0,0,0,226
33435,27466663,27466663,27466898,0,0,0,235
33453,27466667,27466667,27466904,0,0,0,237
33454,27466667,27466667,27466904,0,0,0,237
33436,27466664,27466664,27466910,0,0,0,246
33437,27466664,27466664,27466910,0,0,0,246
33455,27466667,27466667,27466915,0,0,0,248
33456,27466667,27466667,27466915,0,0,0,248
33438,27466664,27466664,27466921,0,0,0,257
33439,27466664,27466664,27466921,0,0,0,257
33440,27466664,27466664,27466932,0,0,0,268
33441,27466664,27466664,27466932,0,0,0,268
33442,27466665,27466665,27466933,0,0,0,268
33443,27466665,27466665,27466944,0,0,0,279
33444,27466665,27466665,27466955,0,0,0,290
33445,27466665,27466665,27466955,0,0,0,290
33446,27466665,27466665,27466955,0,0,0,290
33423,27466658,27466658,27466956,0,0,0,298
33424,27466659,27466659,27466957,0,0,0,298
33425,27466659,27466659,27466957,0,0,0,298
33426,27466660,27466660,27466958,0,0,0,298
33427,27466661,27466661,27466959,0,0,0,298
33428,27466662,27466662,27466960,0,0,0,298
33429,27466662,27466662,27466971,0,0,0,309
33457,27466775,27466775,27467023,0,0,0,248
33458,27466775,27466775,27467034,0,0,0,259
32016,27265082,27265082,27479708,0,0,0,214626
33369,27464185,27464185,27480228,0,0,0,16043
33459,27480194,27480194,27496154,0,0,0,15960
32230,27345723,27345723,27497814,0,0,0,152091
33461,27497724,27497724,27498671,0,0,0,947
32210,27343958,27343958,27502358,0,0,0,158400
32211,27344014,27344014,27502414,0,0,0,158400
33460,27496112,27496112,27512110,0,0,0,15998
32203,27343615,27343615,27516415,0,0,0,172800
32204,27343657,27343657,27516457,0,0,0,172800
32205,27343721,27343721,27516521,0,0,0,172800
32207,27343754,27343754,27516554,0,0,0,172800
32208,27343833,27343833,27516633,0,0,0,172800
32226,27345528,27345528,27518328,0,0,0,172800
32227,27345566,27345566,27518366,0,0,0,172800
32228,27345621,27345621,27518421,0,0,0,172800
32229,27345676,27345676,27518476,0,0,0,172800
32752,27430976,27430976,27520152,0,0,0,89176
31980,27262458,27262466,27521666,0,0,8,259208
31981,27262458,27262466,27521666,0,0,8,259208
31982,27262458,27262466,27521666,0,0,8,259208
31983,27262473,27262473,27521673,0,0,0,259200
31935,27243875,27263289,27522489,0,0,19414,278614
33465,27522286,27522286,27523116,0,0,0,830
33463,27512067,27512067,27527979,0,0,0,15912
32237,27349618,27355363,27528163,0,0,5745,178545
32071,27269516,27269516,27528716,0,0,0,259200
30806,27111570,27231769,27529548,0,0,120199,417978
32086,27273075,27273075,27532275,0,0,0,259200
32759,27435264,27435264,27541075,0,0,0,105811
33470,27527219,27527219,27543394,0,0,0,16175
33471,27527937,27527937,27543788,0,0,0,15851
32761,27435293,27435293,27551081,0,0,0,115788
32760,27435286,27435286,27551094,0,0,0,115808
32762,27435301,27435301,27551105,0,0,0,115804
32766,27447233,27447233,27554174,0,0,0,106941
32767,27447263,27447263,27554388,0,0,0,107125
33476,27558209,27558209,27558416,0,0,0,207
33477,27558216,27558216,27558429,0,0,0,213
33474,27543350,27543350,27559413,0,0,0,16063
33475,27543785,27543785,27559640,0,0,0,15855
33478,27558444,27558444,27560623,0,0,0,2179
33479,27558464,27558464,27560702,0,0,0,2238
33480,27559366,27559366,27575237,0,0,0,15871
33481,27559597,27559597,27575588,0,0,0,15991
33482,27575203,27575203,27591201,0,0,0,15998
32164,27334566,27334566,27593766,0,0,0,259200
32165,27334581,27334581,27593781,0,0,0,259200
32166,27334587,27334587,27593787,0,0,0,259200
32167,27334599,27334599,27593799,0,0,0,259200
32168,27334606,27334606,27593806,0,0,0,259200
32169,27334614,27334614,27593814,0,0,0,259200
32170,27334619,27334619,27593819,0,0,0,259200
32171,27334625,27334625,27593825,0,0,0,259200
33464,27520117,27520117,27605728,0,0,0,85611
33462,27499075,27499075,27606794,0,0,0,107719
33486,27591157,27591157,27607103,0,0,0,15946
33490,27622954,27622954,27623038,0,0,0,84
33489,27607061,27607061,27623205,0,0,0,16144
32172,27334631,27370578,27629778,0,0,35947,295147
33493,27630525,27630525,27630589,0,0,0,64
33494,27632159,27632159,27632233,0,0,0,74
33495,27632529,27632529,27633153,0,0,0,624
33496,27633298,27633298,27633935,0,0,0,637
33492,27624275,27624275,27634447,0,0,0,10172
33497,27633888,27633888,27634515,0,0,0,627
33498,27634475,27634475,27635124,0,0,0,649
33499,27635076,27635076,27635371,0,0,0,295
33501,27635734,27635734,27636397,0,0,0,663
33487,27601778,27601778,27637778,0,0,0,36000
33491,27623165,27623165,27639365,0,0,0,16200
32173,27334644,27380304,27639504,0,0,45660,304860
33500,27635104,27635104,27644825,0,0,0,9721
33503,27639333,27639333,27655596,0,0,0,16263
33504,27655554,27655554,27671823,0,0,0,16269
33507,27682097,27682097,27682460,0,0,0,363
33508,27683024,27683024,27683657,0,0,0,633
33509,27683803,27683803,27683848,0,0,0,45
33505,27671781,27671781,27688161,0,0,0,16380
33522,27688295,27688295,27688941,0,0,0,646
33484,27590981,27590981,27689493,0,0,0,98512
33523,27688891,27688891,27689537,0,0,0,646
33524,27689626,27689626,27690274,0,0,0,648
33488,27605683,27605683,27690788,0,0,0,85105
33525,27690231,27690231,27690877,0,0,0,646
33510,27683812,27683812,27691057,0,0,0,7245
33512,27683882,27683882,27691070,0,0,0,7188
33511,27683871,27683871,27691076,0,0,0,7205
33513,27683893,27683893,27691076,0,0,0,7183
33516,27683930,27683930,27691076,0,0,0,7146
33517,27683935,27683935,27691081,0,0,0,7146
33518,27683951,27683951,27691087,0,0,0,7136
33520,27683972,27683972,27691087,0,0,0,7115
33515,27683914,27683914,27691109,0,0,0,7195
33519,27683955,27683955,27691113,0,0,0,7158
33514,27683901,27683901,27691128,0,0,0,7227
33529,27691194,27691194,27693327,0,0,0,2133
33527,27691130,27691130,27693409,0,0,0,2279
33532,27691251,27691251,27693468,0,0,0,2217
33535,27691299,27691299,27693521,0,0,0,2222
33528,27691168,27691168,27693525,0,0,0,2357
33531,27691235,27691235,27693543,0,0,0,2308
33533,27691268,27691268,27693567,0,0,0,2299
33534,27691283,27691283,27693577,0,0,0,2294
33530,27691215,27691215,27693584,0,0,0,2369
33536,27691317,27691317,27693632,0,0,0,2315
33537,27691339,27691339,27697929,0,0,0,6590
33539,27697271,27697271,27702575,0,0,0,5304
33521,27688127,27688127,27704482,0,0,0,16355
33543,27705074,27705074,27705480,0,0,0,406
33538,27697253,27697253,27705820,0,0,0,8567
33544,27705433,27705433,27705832,0,0,0,399
33485,27591082,27591082,27706845,0,0,0,115763
33541,27697841,27697841,27708052,0,0,0,10211
33540,27697835,27697835,27708973,0,0,0,11138
33542,27704439,27704439,27720801,0,0,0,16362
33545,27720761,27720761,27737022,0,0,0,16261
33546,27736980,27736980,27753344,0,0,0,16364
33502,27638901,27638901,27754651,0,0,0,115750
33548,27761031,27761031,27762334,0,0,0,1303
33549,27763089,27763089,27763689,0,0,0,600
33551,27765614,27765614,27765710,0,0,0,96
33552,27765693,27765693,27765813,0,0,0,120
33554,27766493,27766493,27766613,0,0,0,120
33556,27768031,27768031,27768092,0,0,0,61
33557,27768071,27768071,27768140,0,0,0,69
33555,27766600,27766600,27768400,0,0,0,1800
33547,27753303,27753303,27769663,0,0,0,16360
33560,27770668,27770668,27770876,0,0,0,208
33561,27770908,27770908,27771048,0,0,0,140
33506,27674371,27674371,27771174,0,0,0,96803
33562,27771095,27771095,27772206,0,0,0,1111
33563,27772313,27772313,27772502,0,0,0,189
33567,27772622,27772622,27772758,0,0,0,136
33571,27773216,27773216,27773362,0,0,0,146
33572,27773220,27773220,27773377,0,0,0,157
33574,27773228,27773228,27773498,0,0,0,270
33570,27773199,27773199,27773529,0,0,0,330
33573,27773224,27773224,27773605,0,0,0,381
33569,27773193,27773193,27773652,0,0,0,459
33568,27773189,27773189,27773958,0,0,0,769
33576,27774851,27774851,27775585,0,0,0,734
33575,27773669,27773669,27776189,0,0,0,2520
33526,27690751,27690751,27776366,0,0,0,85615
33581,27776534,27776534,27776634,0,0,0,100
33582,27776624,27776624,27776700,0,0,0,76
33577,27775716,27775716,27777005,0,0,0,1289
33580,27776531,27776531,27777471,0,0,0,940
33579,27776491,27776491,27778261,0,0,0,1770
33583,27777066,27777066,27778866,0,0,0,1800
33584,27778265,27778265,27779050,0,0,0,785
33587,27779235,27779235,27779344,0,0,0,109
33585,27778968,27778968,27779473,0,0,0,505
33588,27779513,27779513,27779826,0,0,0,313
33590,27779662,27779662,27779837,0,0,0,175
33586,27779191,27779191,27779905,0,0,0,714
33591,27779843,27779843,27780449,0,0,0,606
33592,27779855,27779855,27780450,0,0,0,595
33595,27780430,27780430,27780573,0,0,0,143
33596,27780450,27780450,27780740,0,0,0,290
33598,27780719,27780719,27780857,0,0,0,138
33594,27780356,27780356,27781079,0,0,0,723
33593,27780305,27780305,27781092,0,0,0,787
33599,27780870,27780870,27781279,0,0,0,409
33600,27781303,27781303,27781441,0,0,0,138
33601,27781313,27781313,27781451,0,0,0,138
33602,27781323,27781323,27781461,0,0,0,138
33604,27781432,27781432,27781574,0,0,0,142
33603,27781323,27781323,27781624,0,0,0,301
33466,27522614,27522614,27781814,0,0,0,259200
33467,27522614,27522614,27781814,0,0,0,259200
33468,27522614,27522614,27781814,0,0,0,259200
33605,27781799,27781799,27781924,0,0,0,125
33469,27522811,27522811,27782011,0,0,0,259200
33606,27782206,27782206,27782348,0,0,0,142
33609,27782927,27782927,27783084,0,0,0,157
33610,27783071,27783071,27783146,0,0,0,75
33615,27783308,27783308,27783391,0,0,0,83
33616,27783367,27783367,27784078,0,0,0,711
33619,27784575,27784575,27784721,0,0,0,146
33618,27783838,27783838,27784889,0,0,0,1051
33620,27784972,27784972,27785079,0,0,0,107
33621,27785061,27785061,27785195,0,0,0,134
33622,27785288,27785288,27785668,0,0,0,380
33623,27785617,27785617,27785680,0,0,0,63
33624,27785646,27785646,27785722,0,0,0,76
33625,27785812,27785812,27785927,0,0,0,115
33558,27769616,27769616,27785969,0,0,0,16353
33627,27786119,27786119,27786244,0,0,0,125
33628,27786473,27786473,27786610,0,0,0,137
33629,27786583,27786583,27786729,0,0,0,146
33472,27530104,27530104,27789304,0,0,0,259200
33631,27789755,27789755,27789813,0,0,0,58
33632,27789925,27789925,27789965,0,0,0,40
33473,27532409,27532409,27791609,0,0,0,259200
33607,27782604,27782604,27793390,0,0,0,10786
33626,27785925,27785925,27802238,0,0,0,16313
33483,27588882,27588882,27804300,0,0,0,215418
33550,27764100,27764100,27818450,0,0,0,54350
33634,27802201,27802201,27818550,0,0,0,16349
33642,27824624,27824624,27825641,0,0,0,1017
33641,27824602,27824602,27825653,0,0,0,1051
33636,27824327,27824327,27826094,0,0,0,1767
33637,27824514,27824514,27827793,0,0,0,3279
33638,27824543,27824543,27827928,0,0,0,3385
33640,27824562,27824562,27828944,0,0,0,4382
33639,27824554,27824554,27829050,0,0,0,4496
33635,27818507,27818507,27834880,0,0,0,16373
33644,27839962,27839962,27840071,0,0,0,109
33608,27782607,27782607,27841193,0,0,0,58586
33647,27845567,27845567,27845690,0,0,0,123
33646,27844445,27844445,27845826,0,0,0,1381
33650,27847449,27847449,27847583,0,0,0,134
33651,27847823,27847823,27847959,0,0,0,136
33652,27848324,27848324,27848459,0,0,0,135
33654,27848857,27848857,27849003,0,0,0,146
33655,27849190,27849190,27849325,0,0,0,135
33643,27834837,27834837,27851045,0,0,0,16208
33565,27772374,27772374,27852226,0,0,0,79852
33653,27848429,27848429,27852254,0,0,0,3825
33564,27772364,27772364,27855205,0,0,0,82841
33661,27855268,27855268,27856190,0,0,0,922
33660,27855260,27855260,27856287,0,0,0,1027
33662,27856480,27856480,27856593,0,0,0,113
33659,27854327,27854327,27856738,0,0,0,2411
33663,27856627,27856627,27856987,0,0,0,360
33664,27856874,27856874,27857105,0,0,0,231
33665,27856971,27856971,27857134,0,0,0,163
33658,27854313,27854313,27857735,0,0,0,3422
33657,27854304,27854304,27857811,0,0,0,3507
33666,27857287,27857287,27858314,0,0,0,1027
33667,27857845,27857845,27858523,0,0,0,678
33668,27857922,27857922,27858700,0,0,0,778
33566,27772385,27772385,27858785,0,0,0,86400
33672,27859996,27859996,27860159,0,0,0,163
33559,27769648,27769648,27860400,0,0,0,90752
33673,27860319,27860319,27860481,0,0,0,162
33674,27860526,27860526,27860635,0,0,0,109
33675,27860797,27860797,27860878,0,0,0,81
33649,27845833,27845833,27861238,0,0,0,15405
33677,27861600,27861600,27861855,0,0,0,255
33578,27776320,27776320,27862717,0,0,0,86397
33678,27861921,27861921,27863686,0,0,0,1765
33682,27862969,27862969,27865096,0,0,0,2127
33681,27862960,27862960,27865202,0,0,0,2242
33684,27862978,27862978,27865488,0,0,0,2510
33648,27845716,27845716,27865672,0,0,0,19956
33685,27863215,27863215,27866204,0,0,0,2989
33680,27862953,27862953,27866247,0,0,0,3294
33617,27783537,27783537,27866337,0,0,0,82800
33656,27850995,27850995,27867253,0,0,0,16258
33686,27863734,27863734,27867501,0,0,0,3767
33683,27862975,27862975,27868950,0,0,0,5975
33692,27870948,27870948,27871021,0,0,0,73
33676,27860888,27860888,27871688,0,0,0,10800
33695,27871890,27871890,27871975,0,0,0,85
33691,27870803,27870803,27872522,0,0,0,1719
33696,27872096,27872096,27874181,0,0,0,2085
33697,27874171,27874171,27874295,0,0,0,124
33669,27859927,27859927,27876080,0,0,0,16153
33671,27859972,27859972,27876083,0,0,0,16111
33670,27859937,27859937,27876085,0,0,0,16148
33589,27779588,27779588,27877474,0,0,0,97886
33704,27882083,27882083,27882200,0,0,0,117
33701,27876985,27876985,27882929,0,0,0,5944
33694,27871582,27871582,27883200,0,0,0,11618
33705,27883088,27883088,27883248,0,0,0,160
33687,27867216,27867216,27883431,0,0,0,16215
33709,27885730,27885730,27885852,0,0,0,122
33710,27885815,27885815,27885932,0,0,0,117
33713,27885833,27885833,27886604,0,0,0,771
33712,27885824,27885824,27886733,0,0,0,909
33711,27885820,27885820,27887547,0,0,0,1727
33703,27881586,27881586,27889908,0,0,0,8322
33700,27876050,27876050,27892106,0,0,0,16056
33698,27876043,27876043,27892122,0,0,0,16079
33699,27876043,27876043,27892133,0,0,0,16090
33708,27883726,27883726,27899292,0,0,0,15566
33707,27883391,27883391,27899420,0,0,0,16029
33645,27841155,27841155,27899849,0,0,0,58694
33693,27871015,27871015,27904229,0,0,0,33214
33714,27892068,27892068,27907887,0,0,0,15819
33716,27892087,27892087,27907913,0,0,0,15826
33715,27892080,27892080,27908011,0,0,0,15931
33717,27899379,27899379,27915342,0,0,0,15963
33553,27765828,27765828,27920807,0,0,0,154979
33719,27907851,27907851,27923806,0,0,0,15955
33720,27907873,27907873,27923859,0,0,0,15986
33721,27907977,27907977,27924037,0,0,0,16060
33690,27869663,27869663,27927799,0,0,0,58136
33722,27915296,27915296,27931342,0,0,0,16046
33728,27934084,27934084,27934193,0,0,0,109
33633,27789968,27789968,27936101,0,0,0,146133
33731,27937708,27937708,27937823,0,0,0,115
33732,27937878,27937878,27937994,0,0,0,116
33689,27868990,27868990,27939106,0,0,0,70116
33734,27939303,27939303,27939469,0,0,0,166
33735,27939398,27939398,27939552,0,0,0,154
33724,27923809,27923809,27939745,0,0,0,15936
33723,27923759,27923759,27939778,0,0,0,16019
33736,27939453,27939453,27939953,0,0,0,500
33725,27923991,27923991,27939969,0,0,0,15978
33741,27940253,27940253,27940384,0,0,0,131
33740,27940145,27940145,27940675,0,0,0,530
33729,27936076,27936076,27941104,0,0,0,5028
33743,27941015,27941015,27941114,0,0,0,99
33742,27940707,27940707,27941820,0,0,0,1113
33744,27942267,27942267,27942352,0,0,0,85
33745,27942318,27942318,27942398,0,0,0,80
33748,27942319,27942319,27942433,0,0,0,114
33746,27942318,27942318,27942445,0,0,0,127
33747,27942318,27942318,27942445,0,0,0,127
33749,27942319,27942319,27942446,0,0,0,127
33768,27942439,27942439,27942508,0,0,0,69
33766,27942439,27942439,27942525,0,0,0,86
33767,27942439,27942439,27942536,0,0,0,97
33760,27942429,27942429,27942552,0,0,0,123
33763,27942434,27942434,27942568,0,0,0,134
33770,27942442,27942508,27942597,0,0,66,155
33769,27942439,27942508,27942600,0,0,69,161
33771,27942442,27942536,27942625,0,0,94,183
33773,27943304,27943304,27943433,0,0,0,129
33750,27942319,27942319,27943519,0,0,0,1200
33751,27942319,27942319,27943519,0,0,0,1200
33752,27942320,27942320,27943520,0,0,0,1200
33753,27942320,27942320,27943520,0,0,0,1200
33754,27942320,27942320,27943520,0,0,0,1200
33755,27942320,27942320,27943520,0,0,0,1200
33756,27942320,27942320,27943520,0,0,0,1200
33757,27942320,27942320,27943520,0,0,0,1200
33758,27942321,27942321,27943521,0,0,0,1200
33759,27942321,27942321,27943521,0,0,0,1200
33772,27942828,27942828,27943578,0,0,0,750
33761,27942429,27942429,27943629,0,0,0,1200
33762,27942430,27942430,27943630,0,0,0,1200
33764,27942435,27942435,27943635,0,0,0,1200
33765,27942435,27942435,27943635,0,0,0,1200
33730,27936133,27936133,27945192,0,0,0,9059
33774,27946916,27946916,27947063,0,0,0,147
33775,27947091,27947091,27947179,0,0,0,88
33726,27931309,27931309,27947296,0,0,0,15987
33679,27862678,27862678,27947394,0,0,0,84716
33778,27947545,27947545,27947722,0,0,0,177
33781,27947553,27947553,27948164,0,0,0,611
33780,27947550,27947550,27948420,0,0,0,870
33779,27947548,27947548,27948978,0,0,0,1430
33792,27950832,27950832,27950906,0,0,0,74
33782,27950825,27950825,27950913,0,0,0,88
33785,27950827,27950827,27950925,0,0,0,98
33791,27950831,27950831,27950929,0,0,0,98
33783,27950826,27950826,27951407,0,0,0,581
33793,27950832,27950832,27951413,0,0,0,581
33784,27950826,27950826,27951430,0,0,0,604
33786,27950827,27950827,27951431,0,0,0,604
33787,27950827,27950827,27951431,0,0,0,604
33788,27950827,27950827,27951431,0,0,0,604
33789,27950828,27950828,27951432,0,0,0,604
33790,27950828,27950828,27951432,0,0,0,604
33794,27950832,27950832,27951436,0,0,0,604
33795,27950832,27950832,27951436,0,0,0,604
33796,27950832,27950832,27951436,0,0,0,604
33797,27950832,27950832,27951436,0,0,0,604
33798,27950832,27950832,27951436,0,0,0,604
33799,27950833,27950833,27951437,0,0,0,604
33810,27951615,27951615,27951680,0,0,0,65
33801,27951607,27951607,27951695,0,0,0,88
33800,27951483,27951483,27951696,0,0,0,213
33802,27951608,27951608,27951707,0,0,0,99
33812,27951615,27951615,27951713,0,0,0,98
33811,27951615,27951615,27951714,0,0,0,99
33814,27951616,27951616,27951886,0,0,0,270
33815,27951616,27951616,27951917,0,0,0,301
33813,27951615,27951615,27951927,0,0,0,312
33816,27951616,27951616,27951928,0,0,0,312
33817,27951616,27951616,27951928,0,0,0,312
33818,27951616,27951616,27951939,0,0,0,323
33819,27951962,27951962,27952022,0,0,0,60
33803,27951608,27951608,27952055,0,0,0,447
33805,27951609,27951609,27952090,0,0,0,481
33806,27951609,27951609,27952143,0,0,0,534
33807,27951609,27951609,27952156,0,0,0,547
33804,27951608,27951608,27952166,0,0,0,558
33808,27951609,27951609,27952167,0,0,0,558
33809,27951609,27951609,27952167,0,0,0,558
33820,27953265,27953265,27953345,0,0,0,80
33821,27953265,27953265,27953388,0,0,0,123
33822,27953265,27953265,27953388,0,0,0,123
33825,27953266,27953266,27953389,0,0,0,123
33826,27953266,27953266,27953389,0,0,0,123
33827,27953266,27953266,27953400,0,0,0,134
33823,27953265,27953265,27953410,0,0,0,145
33828,27953266,27953266,27953411,0,0,0,145
33835,27953279,27953279,27953411,0,0,0,132
33824,27953265,27953265,27953433,0,0,0,168
33840,27953281,27953281,27953531,0,0,0,250
33829,27953266,27953266,27953539,0,0,0,273
33832,27953279,27953279,27953544,0,0,0,265
33833,27953279,27953279,27953544,0,0,0,265
33834,27953279,27953279,27953544,0,0,0,265
33836,27953280,27953280,27953545,0,0,0,265
33837,27953280,27953280,27953545,0,0,0,265
33841,27953281,27953281,27953546,0,0,0,265
33842,27953282,27953282,27953547,0,0,0,265
33843,27953282,27953282,27953547,0,0,0,265
33830,27953266,27953266,27953554,0,0,0,288
33831,27953266,27953266,27953554,0,0,0,288
33844,27953282,27953282,27953559,0,0,0,277
33839,27953280,27953410,27953565,0,0,130,285
33845,27953282,27953410,27953565,0,0,128,283
33838,27953280,27953400,27953677,0,0,120,397
33848,27953914,27953914,27954218,0,0,0,304
33847,27953913,27953913,27954259,0,0,0,346
33849,27953914,27953914,27954260,0,0,0,346
33852,27953915,27953915,27954261,0,0,0,346
33853,27953915,27953915,27954261,0,0,0,346
33850,27953914,27953914,27954271,0,0,0,357
33851,27953914,27953914,27954271,0,0,0,357
33854,27953915,27953915,27954284,0,0,0,369
33846,27953912,27953912,27954292,0,0,0,380
33864,27954130,27954260,27954336,0,0,130,206
33865,27954332,27954332,27954405,0,0,0,73
33856,27953964,27953964,27954537,0,0,0,573
33860,27953965,27953965,27954572,0,0,0,607
33857,27953964,27953964,27954582,0,0,0,618
33858,27953964,27953964,27954582,0,0,0,618
33861,27953965,27953965,27954583,0,0,0,618
33859,27953964,27953964,27954594,0,0,0,630
33862,27953965,27953965,27954594,0,0,0,629
33863,27953965,27953965,27954605,0,0,0,640
33855,27953963,27953963,27954619,0,0,0,656
33727,27933539,27933539,27954843,0,0,0,21304
33866,27955231,27955231,27955303,0,0,0,72
33867,27955245,27955245,27955400,0,0,0,155
33869,27955328,27955328,27955473,0,0,0,145
33870,27955328,27955328,27955516,0,0,0,188
33873,27955329,27955329,27955517,0,0,0,188
33874,27955329,27955329,27955517,0,0,0,188
33871,27955328,27955328,27955527,0,0,0,199
33875,27955329,27955329,27955528,0,0,0,199
33872,27955328,27955328,27955538,0,0,0,210
33876,27955329,27955329,27955539,0,0,0,210
33868,27955327,27955327,27955561,0,0,0,234
33877,27955333,27955333,27955597,0,0,0,264
33878,27955333,27955333,27955628,0,0,0,295
33881,27955334,27955334,27955629,0,0,0,295
33880,27955333,27955333,27955638,0,0,0,305
33882,27955334,27955334,27955641,0,0,0,307
33883,27955334,27955334,27955641,0,0,0,307
33884,27955334,27955334,27955652,0,0,0,318
33885,27955334,27955334,27955652,0,0,0,318
33879,27955333,27955333,27955674,0,0,0,341
33887,27955351,27955351,27955821,0,0,0,470
33737,27939704,27939704,27955849,0,0,0,16145
33889,27955351,27955351,27955865,0,0,0,514
33738,27939743,27939743,27955886,0,0,0,16143
33891,27955352,27955473,27955987,0,0,121,635
33888,27955351,27955516,27956030,0,0,165,679
33892,27955352,27955517,27956031,0,0,165,679
33898,27955967,27955967,27956047,0,0,0,80
33893,27955352,27955528,27956053,0,0,176,701
33894,27955352,27955538,27956064,0,0,186,712
33890,27955351,27955561,27956081,0,0,210,730
33739,27939931,27939931,27956083,0,0,0,16152
33886,27955338,27955538,27956083,0,0,200,745
33899,27956029,27956029,27956176,0,0,0,147
33901,27956162,27956162,27956218,0,0,0,56
33910,27956173,27956173,27956222,0,0,0,49
33919,27956189,27956189,27956233,0,0,0,44
33923,27956191,27956191,27956235,0,0,0,44
33902,27956162,27956162,27956240,0,0,0,78
33903,27956162,27956162,27956240,0,0,0,78
33904,27956162,27956162,27956240,0,0,0,78
33905,27956162,27956162,27956240,0,0,0,78
33906,27956162,27956162,27956240,0,0,0,78
33908,27956163,27956163,27956241,0,0,0,78
33909,27956163,27956163,27956241,0,0,0,78
33917,27956174,27956174,27956248,0,0,0,74
33907,27956162,27956162,27956252,0,0,0,90
33911,27956173,27956173,27956257,0,0,0,84
33914,27956174,27956174,27956258,0,0,0,84
33915,27956174,27956174,27956258,0,0,0,84
33918,27956175,27956175,27956259,0,0,0,84
33913,27956173,27956173,27956264,0,0,0,91
33916,27956174,27956174,27956265,0,0,0,91
33912,27956173,27956173,27956269,0,0,0,96
33920,27956190,27956190,27956270,0,0,0,80
33924,27956191,27956191,27956271,0,0,0,80
33921,27956190,27956235,27956315,0,0,45,125
33931,27956195,27956240,27956315,0,0,45,120
33930,27956194,27956240,27956315,0,0,46,121
33932,27956195,27956241,27956316,0,0,46,121
33925,27956191,27956240,27956320,0,0,49,129
33927,27956194,27956240,27956320,0,0,46,126
33933,27956197,27956248,27956322,0,0,51,125
33935,27956197,27956248,27956328,0,0,51,131
33922,27956190,27956240,27956331,0,0,50,141
33926,27956191,27956240,27956331,0,0,49,140
33928,27956194,27956240,27956331,0,0,46,137
33929,27956194,27956240,27956331,0,0,46,137
33934,27956197,27956252,27956336,0,0,55,139
33936,27956197,27956269,27956349,0,0,72,152
33938,27957657,27957657,27957735,0,0,0,78
33939,27957754,27957754,27957861,0,0,0,107
33943,27957761,27957761,27957876,0,0,0,115
33940,27957760,27957760,27957898,0,0,0,138
33944,27957761,27957761,27957899,0,0,0,138
33941,27957760,27957760,27957909,0,0,0,149
33946,27957762,27957762,27957911,0,0,0,149
33970,27957767,27957861,27957930,0,0,94,163
33964,27957766,27957766,27957932,0,0,0,166
33945,27957761,27957761,27957939,0,0,0,178
33947,27957762,27957762,27957940,0,0,0,178
33948,27957762,27957762,27957951,0,0,0,189
33942,27957760,27957760,27957973,0,0,0,213
33950,27957763,27957763,27957976,0,0,0,213
33954,27957764,27957764,27957977,0,0,0,213
33953,27957763,27957763,27957985,0,0,0,222
33951,27957763,27957763,27957988,0,0,0,225
33955,27957764,27957764,27957989,0,0,0,225
33957,27957764,27957764,27957992,0,0,0,228
33952,27957763,27957763,27958002,0,0,0,239
33978,27957768,27957876,27958003,0,0,108,235
33979,27957768,27957876,27958003,0,0,108,235
33977,27957768,27957909,27958036,0,0,141,268
33983,27957769,27957899,27958037,0,0,130,268
33949,27957762,27957762,27958043,0,0,0,281
33980,27957768,27957939,27958054,0,0,171,286
33973,27957767,27957876,27958075,0,0,109,308
33965,27957766,27957876,27958077,0,0,110,311
33956,27957764,27957764,27958079,0,0,0,315
33966,27957766,27957876,27958089,0,0,110,323
33971,27957767,27957876,27958089,0,0,109,322
33972,27957767,27957876,27958089,0,0,109,322
33959,27957765,27957765,27958126,0,0,0,361
33981,27957768,27958002,27958137,0,0,234,369
33976,27957767,27958043,27958192,0,0,276,425
33974,27957767,27957992,27958204,0,0,225,437
33968,27957766,27957973,27958208,0,0,207,442
33967,27957766,27957876,27958225,0,0,110,459
33958,27957765,27957876,27958237,0,0,111,472
33960,27957765,27957876,27958248,0,0,111,483
33961,27957765,27957876,27958259,0,0,111,494
33962,27957765,27957876,27958273,0,0,111,508
33975,27957767,27958192,27958297,0,0,425,530
33982,27957768,27958208,27958299,0,0,440,531
33969,27957766,27957951,27958326,0,0,185,560
33963,27957765,27957985,27958347,0,0,220,582
33718,27899806,27899806,27958369,0,0,0,58563
33986,27958746,27958746,27958890,0,0,0,144
33688,27868987,27868987,27958932,0,0,0,89945
33984,27957815,27958299,27959499,0,0,484,1684
33895,27955699,27955699,27960849,0,0,0,5150
34002,27962765,27962765,27963025,0,0,0,260
34003,27962766,27962766,27963026,0,0,0,260
34004,27962768,27962768,27963028,0,0,0,260
34001,27962763,27962763,27963034,0,0,0,271
33776,27947245,27947245,27963140,0,0,0,15895
34010,27963235,27963235,27963980,0,0,0,745
33987,27960839,27960839,27966011,0,0,0,5172
33988,27961041,27961041,27966095,0,0,0,5054
33989,27961118,27961118,27966251,0,0,0,5133
33990,27961173,27961173,27966271,0,0,0,5098
33991,27961652,27961652,27966773,0,0,0,5121
34012,27966883,27966883,27966941,0,0,0,58
34028,27968791,27968791,27968855,0,0,0,64
34038,27971208,27971208,27971542,0,0,0,334
34039,27971713,27971713,27971848,0,0,0,135
33896,27955809,27955809,27972023,0,0,0,16214
33897,27955836,27955836,27972027,0,0,0,16191
34042,27971987,27971987,27972112,0,0,0,125
33900,27956042,27956042,27972254,0,0,0,16212
33702,27877432,27877432,27974892,0,0,0,97460
34005,27963000,27963000,27977184,0,0,0,14184
34007,27963031,27963031,27977204,0,0,0,14173
34008,27963048,27963048,27977399,0,0,0,14351
34006,27963012,27963012,27977519,0,0,0,14507
34011,27963238,27963238,27978401,0,0,0,15163
33937,27956292,27956292,27978591,0,0,0,22299
34009,27963107,27963107,27978937,0,0,0,15830
33597,27780631,27780631,27980029,0,0,0,199398
33992,27961749,27961749,27980443,0,0,0,18694
33993,27961939,27961939,27980723,0,0,0,18784
33999,27962561,27962561,27981117,0,0,0,18556
33998,27962501,27962501,27981202,0,0,0,18701
34000,27962722,27962722,27981401,0,0,0,18679
34014,27967195,27967195,27985137,0,0,0,17942
34013,27967150,27967150,27985140,0,0,0,17990
34015,27967257,27967257,27985234,0,0,0,17977
34016,27967598,27967598,27985525,0,0,0,17927
34017,27967717,27967717,27985814,0,0,0,18097
34018,27967911,27967911,27985962,0,0,0,18051
34026,27968739,27968739,27986730,0,0,0,17991
34031,27968853,27968853,27986876,0,0,0,18023
34033,27968924,27968924,27986937,0,0,0,18013
34040,27971981,27971981,27988291,0,0,0,16310
34041,27971984,27971984,27988296,0,0,0,16312
34043,27972222,27972222,27988489,0,0,0,16267
34034,27968987,27968987,27991632,0,0,0,22645
34030,27968826,27968826,27991876,0,0,0,23050
34035,27969012,27969012,27992300,0,0,0,23288
34025,27968730,27968730,27992704,0,0,0,23974
34036,27969038,27969038,27992795,0,0,0,23757
34023,27968688,27968688,27993308,0,0,0,24620
34019,27968566,27968566,27993868,0,0,0,25302
34021,27968625,27968625,27994084,0,0,0,25459
34027,27968765,27968765,27994181,0,0,0,25416
34020,27968609,27968609,27994316,0,0,0,25707
34022,27968649,27968649,27994654,0,0,0,26005
33996,27962396,27962396,27994774,0,0,0,32378
33994,27962374,27962374,27994838,0,0,0,32464
34046,27978891,27978891,27994907,0,0,0,16016
33995,27962386,27962386,27995077,0,0,0,32691
33997,27962405,27962405,27996297,0,0,0,33892
34047,27988250,27988250,28004483,0,0,0,16233
34048,27988262,27988262,28004548,0,0,0,16286
34024,27968715,27968715,28004715,0,0,0,36000
34049,27988447,27988447,28004737,0,0,0,16290
34029,27968816,27968816,28004816,0,0,0,36000
34032,27968859,27968859,28004859,0,0,0,36000
34037,27969070,27969070,28005070,0,0,0,36000
34050,27990343,27990343,28016638,0,0,0,26295
33985,27958322,27958322,28016938,0,0,0,58616
34064,28004440,28004440,28020764,0,0,0,16324
34065,28004499,28004499,28020812,0,0,0,16313
34066,28004694,28004694,28021041,0,0,0,16347
34071,28021080,28021080,28021150,0,0,0,70
34070,28021067,28021067,28021169,0,0,0,102
33706,27883360,27883360,28021821,0,0,0,138461
34072,28021976,28021976,28022030,0,0,0,54
34073,28022262,28022262,28022378,0,0,0,116
34074,28022629,28022629,28022675,0,0,0,46
34075,28022663,28022663,28022717,0,0,0,54
34076,28022690,28022690,28022722,0,0,0,32
34077,28022773,28022773,28022811,0,0,0,38
34078,28022852,28022852,28022911,0,0,0,59
34080,28022894,28022894,28022980,0,0,0,86
34079,28022875,28022875,28022988,0,0,0,113
34083,28023914,28023914,28024202,0,0,0,288
34084,28024029,28024029,28024202,0,0,0,173
34082,28023770,28023770,28024205,0,0,0,435
34085,28024067,28024067,28024205,0,0,0,138
34092,28025087,28025087,28025187,0,0,0,100
34088,28024295,28024295,28025201,0,0,0,906
34091,28025072,28025072,28025205,0,0,0,133
34089,28024311,28024311,28025206,0,0,0,895
34093,28025107,28025107,28025207,0,0,0,100
34090,28025064,28025064,28025208,0,0,0,144
34086,28024246,28024246,28025210,0,0,0,964
34087,28024283,28024283,28025212,0,0,0,929
34094,28025142,28025142,28025222,0,0,0,80
34100,28025316,28025316,28025390,0,0,0,74
34105,28026137,28026137,28026197,0,0,0,60
34106,28026493,28026493,28026553,0,0,0,60
34126,28027279,28027279,28027485,0,0,0,206
34127,28027279,28027279,28027485,0,0,0,206
34128,28027279,28027279,28027496,0,0,0,217
34129,28027279,28027279,28027507,0,0,0,228
34130,28027279,28027279,28027518,0,0,0,239
34151,28027535,28027535,28027676,0,0,0,141
34152,28027535,28027535,28027676,0,0,0,141
34131,28027529,28027529,28027718,0,0,0,189
34107,28027276,28027276,28027725,0,0,0,449
34108,28027276,28027276,28027725,0,0,0,449
34109,28027276,28027276,28027725,0,0,0,449
34110,28027276,28027276,28027725,0,0,0,449
34111,28027276,28027276,28027725,0,0,0,449
34112,28027276,28027276,28027725,0,0,0,449
34113,28027277,28027277,28027726,0,0,0,449
34114,28027277,28027277,28027726,0,0,0,449
34115,28027277,28027277,28027726,0,0,0,449
34116,28027277,28027277,28027726,0,0,0,449
34117,28027277,28027277,28027726,0,0,0,449
34118,28027277,28027277,28027726,0,0,0,449
34119,28027277,28027277,28027726,0,0,0,449
34120,28027278,28027278,28027727,0,0,0,449
34121,28027278,28027278,28027727,0,0,0,449
34122,28027278,28027278,28027727,0,0,0,449
34123,28027278,28027278,28027727,0,0,0,449
34124,28027278,28027278,28027727,0,0,0,449
34125,28027278,28027278,28027727,0,0,0,449
34139,28027531,28027531,28027738,0,0,0,207
34140,28027532,28027532,28027739,0,0,0,207
34157,28027536,28027536,28027740,0,0,0,204
34142,28027533,28027533,28027751,0,0,0,218
34143,28027533,28027533,28027751,0,0,0,218
34141,28027532,28027532,28027761,0,0,0,229
34144,28027533,28027533,28027762,0,0,0,229
34145,28027533,28027533,28027762,0,0,0,229
34146,28027534,28027534,28027774,0,0,0,240
34147,28027534,28027534,28027774,0,0,0,240
34148,28027534,28027534,28027774,0,0,0,240
34132,28027529,28027529,28027779,0,0,0,250
34133,28027530,28027530,28027780,0,0,0,250
34134,28027530,28027530,28027780,0,0,0,250
34135,28027530,28027530,28027791,0,0,0,261
34136,28027530,28027530,28027791,0,0,0,261
34149,28027534,28027534,28027796,0,0,0,262
34150,28027534,28027534,28027796,0,0,0,262
34153,28027535,28027535,28027797,0,0,0,262
34154,28027535,28027535,28027797,0,0,0,262
34137,28027531,28027531,28027803,0,0,0,272
34138,28027531,28027531,28027803,0,0,0,272
34155,28027535,28027535,28027819,0,0,0,284
34156,28027535,28027535,28027830,0,0,0,295
34158,28028565,28028565,28028604,0,0,0,39
34051,27990405,27990405,28028988,0,0,0,38583
34160,28029167,28029167,28029214,0,0,0,47
34095,28025178,28025178,28029637,0,0,0,4459
34097,28025183,28025183,28029663,0,0,0,4480
34165,28029943,28029943,28030035,0,0,0,92
34166,28030102,28030102,28030173,0,0,0,71
34169,28030270,28030270,28030365,0,0,0,95
34202,28030425,28030425,28030529,0,0,0,104
34203,28030425,28030425,28030529,0,0,0,104
34204,28030425,28030425,28030529,0,0,0,104
34171,28030419,28030419,28030776,0,0,0,357
34172,28030420,28030420,28030777,0,0,0,357
34173,28030420,28030420,28030777,0,0,0,357
34174,28030420,28030420,28030777,0,0,0,357
34175,28030420,28030420,28030777,0,0,0,357
34176,28030420,28030420,28030777,0,0,0,357
34177,28030420,28030420,28030777,0,0,0,357
34178,28030421,28030421,28030778,0,0,0,357
34179,28030421,28030421,28030778,0,0,0,357
34180,28030421,28030421,28030778,0,0,0,357
34181,28030421,28030421,28030778,0,0,0,357
34182,28030421,28030421,28030778,0,0,0,357
34183,28030421,28030421,28030778,0,0,0,357
34184,28030422,28030422,28030779,0,0,0,357
34185,28030422,28030422,28030779,0,0,0,357
34186,28030422,28030422,28030779,0,0,0,357
34187,28030422,28030422,28030779,0,0,0,357
34188,28030422,28030422,28030779,0,0,0,357
34209,28030680,28030680,28030784,0,0,0,104
34210,28030680,28030680,28030784,0,0,0,104
34211,28030680,28030680,28030784,0,0,0,104
34213,28030681,28030681,28030785,0,0,0,104
34214,28030681,28030681,28030785,0,0,0,104
34215,28030681,28030681,28030785,0,0,0,104
34216,28030681,28030681,28030785,0,0,0,104
34217,28030682,28030682,28030786,0,0,0,104
34189,28030422,28030422,28030791,0,0,0,369
34190,28030422,28030422,28030791,0,0,0,369
34195,28030424,28030424,28030793,0,0,0,369
34218,28030682,28030682,28030797,0,0,0,115
34219,28030682,28030682,28030797,0,0,0,115
34220,28030682,28030682,28030797,0,0,0,115
34221,28030683,28030683,28030798,0,0,0,115
34191,28030423,28030423,28030803,0,0,0,380
34192,28030423,28030423,28030803,0,0,0,380
34193,28030423,28030423,28030803,0,0,0,380
34194,28030423,28030423,28030803,0,0,0,380
34196,28030424,28030424,28030804,0,0,0,380
34197,28030424,28030424,28030804,0,0,0,380
34198,28030424,28030424,28030804,0,0,0,380
34199,28030424,28030424,28030804,0,0,0,380
34200,28030424,28030424,28030804,0,0,0,380
34201,28030424,28030424,28030804,0,0,0,380
34205,28030425,28030425,28030805,0,0,0,380
34206,28030425,28030425,28030805,0,0,0,380
34207,28030425,28030425,28030805,0,0,0,380
34208,28030425,28030425,28030805,0,0,0,380
34212,28030680,28030680,28030982,0,0,0,302
34222,28030772,28030772,28031165,0,0,0,393
34224,28030965,28030965,28031290,0,0,0,325
34225,28031170,28031170,28031332,0,0,0,162
34227,28031415,28031415,28031857,0,0,0,442
34228,28031415,28031415,28031857,0,0,0,442
34229,28031415,28031415,28031857,0,0,0,442
34230,28031415,28031415,28031857,0,0,0,442
34231,28031415,28031415,28031857,0,0,0,442
34232,28031415,28031415,28031857,0,0,0,442
34233,28031416,28031416,28031858,0,0,0,442
34234,28031416,28031416,28031858,0,0,0,442
34235,28031416,28031416,28031858,0,0,0,442
34236,28031416,28031416,28031858,0,0,0,442
34237,28031666,28031666,28032047,0,0,0,381
34238,28032094,28032094,28032345,0,0,0,251
34239,28032094,28032094,28032345,0,0,0,251
34240,28032094,28032094,28032345,0,0,0,251
34241,28032094,28032094,28032345,0,0,0,251
34242,28032094,28032094,28032345,0,0,0,251
34243,28032116,28032116,28032367,0,0,0,251
34245,28032239,28032239,28032367,0,0,0,128
34244,28032117,28032117,28032368,0,0,0,251
34246,28032240,28032240,28032368,0,0,0,128
34247,28032240,28032240,28032368,0,0,0,128
34248,28032240,28032240,28032368,0,0,0,128
34249,28032245,28032245,28032373,0,0,0,128
34250,28032246,28032246,28032374,0,0,0,128
34251,28032246,28032246,28032374,0,0,0,128
34252,28032246,28032246,28032374,0,0,0,128
34253,28032246,28032246,28032374,0,0,0,128
34254,28032246,28032246,28032374,0,0,0,128
34255,28032246,28032246,28032374,0,0,0,128
34256,28032247,28032247,28032375,0,0,0,128
34257,28032247,28032247,28032375,0,0,0,128
34258,28032247,28032247,28032375,0,0,0,128
34259,28032247,28032247,28032375,0,0,0,128
34260,28032247,28032247,28032375,0,0,0,128
34261,28032247,28032247,28032392,0,0,0,145
34262,28032248,28032248,28032393,0,0,0,145
34263,28032248,28032248,28032393,0,0,0,145
34264,28032248,28032248,28032404,0,0,0,156
34265,28032248,28032248,28032404,0,0,0,156
34266,28032248,28032248,28032415,0,0,0,167
34267,28032248,28032248,28032415,0,0,0,167
34268,28032367,28032367,28032417,0,0,0,50
34272,28032624,28032624,28032684,0,0,0,60
34271,28032590,28032590,28032752,0,0,0,162
34281,28033665,28033665,28033798,0,0,0,133
34282,28033665,28033665,28033798,0,0,0,133
34283,28033666,28033666,28033799,0,0,0,133
34284,28033666,28033666,28033799,0,0,0,133
34285,28033666,28033666,28033799,0,0,0,133
34286,28033666,28033666,28033799,0,0,0,133
34287,28033667,28033667,28033800,0,0,0,133
34288,28033667,28033667,28033800,0,0,0,133
34289,28033667,28033667,28033800,0,0,0,133
34290,28033667,28033667,28033800,0,0,0,133
34291,28033668,28033668,28033801,0,0,0,133
34292,28033668,28033668,28033801,0,0,0,133
34293,28033668,28033668,28033801,0,0,0,133
34294,28033668,28033668,28033801,0,0,0,133
34295,28033669,28033669,28033802,0,0,0,133
34296,28033669,28033669,28033802,0,0,0,133
34273,28033517,28033517,28033803,0,0,0,286
34274,28033517,28033517,28033803,0,0,0,286
34275,28033517,28033517,28033803,0,0,0,286
34276,28033517,28033517,28033803,0,0,0,286
34277,28033518,28033518,28033804,0,0,0,286
34278,28033518,28033518,28033804,0,0,0,286
34279,28033518,28033518,28033804,0,0,0,286
34280,28033518,28033518,28033804,0,0,0,286
34297,28033669,28033669,28033819,0,0,0,150
34298,28033670,28033670,28033820,0,0,0,150
34299,28033670,28033670,28033820,0,0,0,150
34300,28033670,28033670,28033820,0,0,0,150
34301,28033670,28033670,28033820,0,0,0,150
34302,28033670,28033670,28033820,0,0,0,150
34303,28033670,28033670,28033820,0,0,0,150
34304,28033671,28033671,28033821,0,0,0,150
34305,28033798,28033798,28033859,0,0,0,61
34321,28034231,28034231,28034443,0,0,0,212
34322,28034231,28034231,28034443,0,0,0,212
34323,28034231,28034231,28034443,0,0,0,212
34324,28034231,28034231,28034454,0,0,0,223
34325,28034231,28034231,28034454,0,0,0,223
34326,28034232,28034232,28034466,0,0,0,234
34327,28034232,28034232,28034466,0,0,0,234
34328,28034232,28034232,28034466,0,0,0,234
34329,28034232,28034232,28034477,0,0,0,245
34330,28034232,28034232,28034488,0,0,0,256
34331,28034232,28034232,28034488,0,0,0,256
34336,28034451,28034451,28034559,0,0,0,108
34337,28034451,28034451,28034559,0,0,0,108
34343,28034453,28034453,28034573,0,0,0,120
34347,28034454,28034454,28034607,0,0,0,153
34348,28034454,28034454,28034607,0,0,0,153
34332,28034450,28034450,28034650,0,0,0,200
34335,28034451,28034451,28034651,0,0,0,200
34306,28034228,28034228,28034656,0,0,0,428
34307,28034228,28034228,28034656,0,0,0,428
34308,28034228,28034228,28034656,0,0,0,428
34309,28034229,28034229,28034657,0,0,0,428
34310,28034229,28034229,28034657,0,0,0,428
34311,28034229,28034229,28034657,0,0,0,428
34312,28034229,28034229,28034657,0,0,0,428
34313,28034229,28034229,28034657,0,0,0,428
34314,28034229,28034229,28034657,0,0,0,428
34315,28034230,28034230,28034658,0,0,0,428
34316,28034230,28034230,28034658,0,0,0,428
34317,28034230,28034230,28034658,0,0,0,428
34318,28034230,28034230,28034658,0,0,0,428
34319,28034231,28034231,28034659,0,0,0,428
34320,28034231,28034231,28034659,0,0,0,428
34339,28034452,28034452,28034671,0,0,0,219
34340,28034452,28034452,28034671,0,0,0,219
34341,28034452,28034452,28034671,0,0,0,219
34342,28034452,28034452,28034682,0,0,0,230
34344,28034453,28034453,28034683,0,0,0,230
34345,28034453,28034453,28034694,0,0,0,241
34346,28034453,28034453,28034705,0,0,0,252
34333,28034450,28034450,28034706,0,0,0,256
34349,28034454,28034454,28034706,0,0,0,252
34334,28034450,28034450,28034717,0,0,0,267
34338,28034451,28034451,28034718,0,0,0,267
34350,28034454,28034454,28034728,0,0,0,274
34351,28034455,28034455,28034729,0,0,0,274
34352,28034455,28034455,28034729,0,0,0,274
33777,27947353,27947353,28034766,0,0,0,87413
34354,28034893,28034893,28035166,0,0,0,273
34355,28034893,28034893,28035166,0,0,0,273
34356,28034893,28034893,28035166,0,0,0,273
34357,28034893,28034893,28035166,0,0,0,273
34358,28034893,28034893,28035166,0,0,0,273
34359,28034893,28034893,28035166,0,0,0,273
34360,28034894,28034894,28035167,0,0,0,273
34361,28034894,28034894,28035167,0,0,0,273
34362,28034894,28034894,28035167,0,0,0,273
34363,28034894,28034894,28035167,0,0,0,273
34364,28034894,28034894,28035167,0,0,0,273
34368,28035103,28035103,28035316,0,0,0,213
34369,28035104,28035104,28035317,0,0,0,213
34370,28035104,28035104,28035317,0,0,0,213
34371,28035104,28035104,28035317,0,0,0,213
34383,28035109,28035109,28035318,0,0,0,209
34384,28035112,28035112,28035321,0,0,0,209
34372,28035105,28035105,28035339,0,0,0,234
34373,28035105,28035105,28035339,0,0,0,234
34374,28035105,28035105,28035350,0,0,0,245
34375,28035106,28035106,28035351,0,0,0,245
34376,28035106,28035106,28035351,0,0,0,245
34377,28035106,28035106,28035373,0,0,0,267
34378,28035106,28035106,28035373,0,0,0,267
34379,28035107,28035107,28035374,0,0,0,267
34380,28035107,28035107,28035374,0,0,0,267
34365,28035102,28035102,28035375,0,0,0,273
34385,28035200,28035200,28035375,0,0,0,175
34386,28035200,28035200,28035375,0,0,0,175
34387,28035200,28035200,28035375,0,0,0,175
34381,28035107,28035107,28035385,0,0,0,278
34366,28035103,28035103,28035388,0,0,0,285
34367,28035103,28035103,28035388,0,0,0,285
34382,28035107,28035107,28035396,0,0,0,289
34389,28035202,28035202,28035411,0,0,0,209
34394,28035314,28035314,28035414,0,0,0,100
34390,28035204,28035204,28035424,0,0,0,220
34391,28035207,28035207,28035427,0,0,0,220
34388,28035200,28035200,28035431,0,0,0,231
34392,28035209,28035209,28035440,0,0,0,231
34393,28035313,28035313,28035555,0,0,0,242
34395,28035317,28035317,28035559,0,0,0,242
34396,28035392,28035392,28035593,0,0,0,201
34397,28035395,28035395,28035596,0,0,0,201
34398,28035397,28035397,28035609,0,0,0,212
34399,28035413,28035413,28035621,0,0,0,208
34400,28035416,28035416,28035624,0,0,0,208
34159,28029153,28029153,28035768,0,0,0,6615
34401,28035728,28035728,28035777,0,0,0,49
34269,28032367,28032367,28035802,0,0,0,3435
34402,28035822,28035822,28036122,0,0,0,300
34403,28035822,28035822,28036122,0,0,0,300
34404,28035822,28035822,28036122,0,0,0,300
34405,28035823,28035823,28036123,0,0,0,300
34406,28035823,28035823,28036123,0,0,0,300
34407,28035823,28035823,28036123,0,0,0,300
34408,28035823,28035823,28036123,0,0,0,300
34409,28035823,28035823,28036123,0,0,0,300
34410,28035823,28035823,28036123,0,0,0,300
34434,28036037,28036037,28036145,0,0,0,108
34439,28036038,28036038,28036146,0,0,0,108
34443,28036039,28036039,28036147,0,0,0,108
34436,28036037,28036037,28036162,0,0,0,125
34437,28036037,28036037,28036162,0,0,0,125
34438,28036037,28036037,28036162,0,0,0,125
34440,28036038,28036038,28036163,0,0,0,125
34441,28036038,28036038,28036163,0,0,0,125
34442,28036038,28036038,28036163,0,0,0,125
34444,28036039,28036039,28036164,0,0,0,125
34445,28036039,28036039,28036164,0,0,0,125
34446,28036039,28036039,28036164,0,0,0,125
34447,28036039,28036039,28036164,0,0,0,125
34448,28036040,28036040,28036165,0,0,0,125
34449,28036040,28036040,28036165,0,0,0,125
34450,28036040,28036040,28036165,0,0,0,125
34451,28036040,28036040,28036165,0,0,0,125
34452,28036040,28036040,28036165,0,0,0,125
34453,28036040,28036040,28036165,0,0,0,125
34411,28036031,28036031,28036272,0,0,0,241
34412,28036031,28036031,28036272,0,0,0,241
34413,28036031,28036031,28036272,0,0,0,241
34414,28036032,28036032,28036273,0,0,0,241
34415,28036032,28036032,28036273,0,0,0,241
34416,28036032,28036032,28036273,0,0,0,241
34417,28036032,28036032,28036273,0,0,0,241
34418,28036033,28036033,28036274,0,0,0,241
34419,28036033,28036033,28036274,0,0,0,241
34420,28036033,28036033,28036274,0,0,0,241
34422,28036034,28036034,28036275,0,0,0,241
34421,28036033,28036033,28036291,0,0,0,258
34423,28036034,28036034,28036292,0,0,0,258
34424,28036034,28036034,28036292,0,0,0,258
34425,28036035,28036035,28036293,0,0,0,258
34426,28036035,28036035,28036293,0,0,0,258
34427,28036035,28036035,28036293,0,0,0,258
34428,28036035,28036035,28036293,0,0,0,258
34429,28036036,28036036,28036294,0,0,0,258
34430,28036036,28036036,28036294,0,0,0,258
34431,28036036,28036036,28036294,0,0,0,258
34432,28036036,28036036,28036294,0,0,0,258
34433,28036036,28036036,28036294,0,0,0,258
34435,28036037,28036037,28036295,0,0,0,258
34062,27991576,27991576,28036326,0,0,0,44750
34454,28036344,28036344,28036587,0,0,0,243
34455,28036344,28036344,28036587,0,0,0,243
34456,28036344,28036344,28036587,0,0,0,243
34457,28036344,28036344,28036587,0,0,0,243
34475,28036598,28036598,28036749,0,0,0,151
34469,28036596,28036596,28036802,0,0,0,206
34470,28036596,28036596,28036802,0,0,0,206
34471,28036596,28036596,28036802,0,0,0,206
34483,28036599,28036599,28036805,0,0,0,206
34484,28036599,28036599,28036805,0,0,0,206
34472,28036596,28036596,28036813,0,0,0,217
34485,28036600,28036600,28036817,0,0,0,217
34486,28036600,28036600,28036817,0,0,0,217
34487,28036602,28036602,28036819,0,0,0,217
34473,28036597,28036597,28036825,0,0,0,228
34458,28036593,28036593,28036836,0,0,0,243
34459,28036593,28036593,28036836,0,0,0,243
34460,28036593,28036593,28036836,0,0,0,243
34461,28036593,28036593,28036836,0,0,0,243
34474,28036597,28036597,28036836,0,0,0,239
34463,28036594,28036594,28036837,0,0,0,243
34464,28036594,28036594,28036848,0,0,0,254
34476,28036598,28036598,28036848,0,0,0,250
34477,28036598,28036598,28036848,0,0,0,250
34478,28036598,28036598,28036848,0,0,0,250
34465,28036594,28036594,28036859,0,0,0,265
34466,28036595,28036595,28036860,0,0,0,265
34479,28036599,28036599,28036860,0,0,0,261
34467,28036595,28036595,28036871,0,0,0,276
34468,28036595,28036595,28036871,0,0,0,276
34480,28036599,28036599,28036871,0,0,0,272
34481,28036599,28036599,28036871,0,0,0,272
34482,28036599,28036599,28036882,0,0,0,283
34462,28036593,28036593,28036902,0,0,0,309
34488,28036685,28036685,28036913,0,0,0,228
34489,28036778,28036778,28037006,0,0,0,228
34490,28036780,28036780,28037019,0,0,0,239
34491,28036782,28036782,28037032,0,0,0,250
34492,28036971,28036971,28037053,0,0,0,82
34068,28020721,28020721,28037067,0,0,0,16346
34069,28020775,28020775,28037079,0,0,0,16304
34495,28037120,28037120,28037192,0,0,0,72
34517,28037504,28037504,28037674,0,0,0,170
34508,28037501,28037501,28037715,0,0,0,214
34509,28037502,28037502,28037716,0,0,0,214
34510,28037502,28037502,28037727,0,0,0,225
34511,28037502,28037502,28037727,0,0,0,225
34512,28037502,28037502,28037738,0,0,0,236
34513,28037503,28037503,28037739,0,0,0,236
34514,28037503,28037503,28037750,0,0,0,247
34515,28037503,28037503,28037750,0,0,0,247
34516,28037503,28037503,28037750,0,0,0,247
34518,28037504,28037504,28037762,0,0,0,258
34497,28037498,28037498,28037766,0,0,0,268
34498,28037499,28037499,28037767,0,0,0,268
34499,28037499,28037499,28037767,0,0,0,268
34500,28037499,28037499,28037767,0,0,0,268
34501,28037499,28037499,28037767,0,0,0,268
34502,28037500,28037500,28037768,0,0,0,268
34503,28037500,28037500,28037768,0,0,0,268
34504,28037500,28037500,28037768,0,0,0,268
34519,28037504,28037504,28037773,0,0,0,269
34520,28037504,28037504,28037773,0,0,0,269
34525,28037595,28037595,28037782,0,0,0,187
34521,28037504,28037504,28037784,0,0,0,280
34522,28037504,28037504,28037784,0,0,0,280
34505,28037501,28037501,28037786,0,0,0,285
34506,28037501,28037501,28037786,0,0,0,285
34523,28037505,28037505,28037796,0,0,0,291
34524,28037507,28037507,28037798,0,0,0,291
34507,28037501,28037501,28037801,0,0,0,300
34528,28037600,28037600,28037806,0,0,0,206
34529,28037602,28037602,28037819,0,0,0,217
34530,28037604,28037604,28037821,0,0,0,217
34526,28037595,28037595,28037895,0,0,0,300
34527,28037597,28037597,28037897,0,0,0,300
34531,28037713,28037713,28037930,0,0,0,217
34532,28037716,28037716,28037933,0,0,0,217
34533,28037718,28037718,28037946,0,0,0,228
34535,28037723,28037723,28037951,0,0,0,228
34534,28037721,28037721,28037960,0,0,0,239
34536,28037765,28037765,28037963,0,0,0,198
34537,28037784,28037784,28037997,0,0,0,213
34538,28037786,28037786,28037999,0,0,0,213
34539,28037789,28037789,28038002,0,0,0,213
34544,28038945,28038945,28038992,0,0,0,47
34567,28039168,28039168,28039337,0,0,0,169
34545,28039087,28039087,28039387,0,0,0,300
34546,28039087,28039087,28039387,0,0,0,300
34547,28039087,28039087,28039387,0,0,0,300
34548,28039088,28039088,28039388,0,0,0,300
34549,28039088,28039088,28039388,0,0,0,300
34550,28039088,28039088,28039388,0,0,0,300
34551,28039088,28039088,28039388,0,0,0,300
34552,28039089,28039089,28039389,0,0,0,300
34553,28039167,28039167,28039396,0,0,0,229
34554,28039167,28039167,28039396,0,0,0,229
34555,28039167,28039167,28039396,0,0,0,229
34559,28039168,28039168,28039397,0,0,0,229
34560,28039168,28039168,28039397,0,0,0,229
34561,28039168,28039168,28039397,0,0,0,229
34562,28039168,28039168,28039397,0,0,0,229
34563,28039168,28039168,28039397,0,0,0,229
34568,28039169,28039169,28039398,0,0,0,229
34569,28039169,28039169,28039398,0,0,0,229
34570,28039169,28039169,28039398,0,0,0,229
34571,28039169,28039169,28039398,0,0,0,229
34572,28039170,28039170,28039399,0,0,0,229
34573,28039170,28039170,28039399,0,0,0,229
34574,28039170,28039170,28039399,0,0,0,229
34575,28039170,28039170,28039399,0,0,0,229
34576,28039171,28039171,28039400,0,0,0,229
34577,28039171,28039171,28039400,0,0,0,229
34578,28039171,28039171,28039400,0,0,0,229
34579,28039171,28039171,28039400,0,0,0,229
34580,28039172,28039172,28039401,0,0,0,229
34581,28039172,28039172,28039401,0,0,0,229
34582,28039172,28039172,28039401,0,0,0,229
34583,28039172,28039172,28039401,0,0,0,229
34584,28039172,28039172,28039401,0,0,0,229
34585,28039172,28039172,28039401,0,0,0,229
34586,28039173,28039173,28039402,0,0,0,229
34587,28039173,28039173,28039402,0,0,0,229
34588,28039173,28039173,28039402,0,0,0,229
34589,28039173,28039173,28039402,0,0,0,229
34590,28039173,28039173,28039402,0,0,0,229
34591,28039173,28039173,28039425,0,0,0,252
34592,28039174,28039174,28039426,0,0,0,252
34593,28039174,28039174,28039426,0,0,0,252
34594,28039174,28039174,28039426,0,0,0,252
34595,28039174,28039174,28039426,0,0,0,252
34596,28039174,28039174,28039426,0,0,0,252
34597,28039174,28039174,28039426,0,0,0,252
34598,28039174,28039174,28039426,0,0,0,252
34599,28039175,28039175,28039427,0,0,0,252
34600,28039175,28039175,28039427,0,0,0,252
34601,28039175,28039175,28039427,0,0,0,252
34602,28039396,28039396,28039463,0,0,0,67
34564,28039168,28039168,28039497,0,0,0,329
34556,28039167,28039167,28039507,0,0,0,340
34565,28039168,28039168,28039519,0,0,0,351
34557,28039167,28039167,28039540,0,0,0,373
34603,28039396,28039396,28039596,0,0,0,200
34566,28039168,28039168,28039630,0,0,0,462
34604,28039645,28039645,28039778,0,0,0,133
34605,28039808,28039808,28040108,0,0,0,300
34606,28039808,28039808,28040108,0,0,0,300
34607,28039808,28039808,28040108,0,0,0,300
34608,28039808,28039808,28040108,0,0,0,300
34609,28039808,28039808,28040108,0,0,0,300
34610,28039808,28039808,28040108,0,0,0,300
34611,28039809,28039809,28040109,0,0,0,300
34612,28039809,28039809,28040109,0,0,0,300
34613,28039809,28039809,28040109,0,0,0,300
34614,28039809,28039809,28040109,0,0,0,300
34615,28039809,28039809,28040109,0,0,0,300
34616,28039810,28039810,28040110,0,0,0,300
34617,28039810,28039810,28040110,0,0,0,300
34618,28040064,28040064,28040265,0,0,0,201
34632,28040067,28040067,28040265,0,0,0,198
34621,28040065,28040065,28040266,0,0,0,201
34625,28040066,28040066,28040267,0,0,0,201
34633,28040068,28040068,28040277,0,0,0,209
34634,28040068,28040068,28040277,0,0,0,209
34635,28040068,28040068,28040288,0,0,0,220
34636,28040068,28040068,28040288,0,0,0,220
34622,28040065,28040065,28040294,0,0,0,229
34637,28040069,28040069,28040300,0,0,0,231
34638,28040069,28040069,28040300,0,0,0,231
34541,28037979,28037979,28040304,0,0,0,2325
34619,28040064,28040064,28040304,0,0,0,240
34639,28040069,28040069,28040311,0,0,0,242
34640,28040069,28040069,28040311,0,0,0,242
34641,28040069,28040069,28040311,0,0,0,242
34623,28040065,28040065,28040316,0,0,0,251
34642,28040070,28040070,28040323,0,0,0,253
34624,28040065,28040065,28040327,0,0,0,262
34626,28040066,28040066,28040328,0,0,0,262
34643,28040070,28040070,28040334,0,0,0,264
34644,28040070,28040070,28040334,0,0,0,264
34645,28040070,28040070,28040334,0,0,0,264
34627,28040066,28040066,28040339,0,0,0,273
34628,28040066,28040066,28040339,0,0,0,273
34646,28040070,28040070,28040345,0,0,0,275
34629,28040067,28040067,28040351,0,0,0,284
34630,28040067,28040067,28040351,0,0,0,284
34647,28040070,28040070,28040356,0,0,0,286
34631,28040067,28040067,28040362,0,0,0,295
34558,28039167,28039167,28040367,0,0,0,1200
34620,28040064,28040064,28040661,0,0,0,597
34649,28040513,28040513,28040661,0,0,0,148
34650,28040755,28040755,28040895,0,0,0,140
34651,28040960,28040960,28041010,0,0,0,50
34652,28040966,28040966,28041041,0,0,0,75
34653,28040966,28040966,28041041,0,0,0,75
34659,28040968,28040968,28041043,0,0,0,75
34658,28040967,28040967,28041051,0,0,0,84
34654,28040966,28040966,28041052,0,0,0,86
34655,28040967,28040967,28041053,0,0,0,86
34656,28040967,28040967,28041053,0,0,0,86
34657,28040967,28040967,28041053,0,0,0,86
34660,28041344,28041344,28041428,0,0,0,84
34661,28041642,28041642,28041720,0,0,0,78
34662,28041997,28041997,28042096,0,0,0,99
33611,27783094,27783094,28042294,0,0,0,259200
33612,27783094,27783094,28042294,0,0,0,259200
33613,27783094,27783094,28042294,0,0,0,259200
34664,28042230,28042230,28042323,0,0,0,93
34663,28042043,28042043,28042411,0,0,0,368
33614,27783233,27783233,28042433,0,0,0,259200
34665,28042490,28042490,28042745,0,0,0,255
34667,28042860,28042860,28043267,0,0,0,407
34668,28043260,28043260,28043474,0,0,0,214
34669,28043735,28043735,28043773,0,0,0,38
34164,28029671,28029671,28043977,0,0,0,14306
34670,28043953,28043953,28043998,0,0,0,45
34688,28044338,28044338,28044534,0,0,0,196
34689,28044338,28044338,28044557,0,0,0,219
34690,28044338,28044338,28044557,0,0,0,219
34691,28044338,28044338,28044568,0,0,0,230
34671,28044335,28044335,28044635,0,0,0,300
34672,28044335,28044335,28044635,0,0,0,300
34673,28044335,28044335,28044635,0,0,0,300
34674,28044335,28044335,28044635,0,0,0,300
34675,28044335,28044335,28044635,0,0,0,300
34676,28044335,28044335,28044635,0,0,0,300
34677,28044336,28044336,28044636,0,0,0,300
34678,28044336,28044336,28044636,0,0,0,300
34679,28044336,28044336,28044636,0,0,0,300
34680,28044336,28044336,28044636,0,0,0,300
34681,28044336,28044336,28044636,0,0,0,300
34683,28044337,28044337,28044637,0,0,0,300
34684,28044337,28044337,28044637,0,0,0,300
34685,28044337,28044337,28044637,0,0,0,300
34686,28044337,28044337,28044637,0,0,0,300
34687,28044338,28044338,28044638,0,0,0,300
34710,28044597,28044597,28044767,0,0,0,170
34715,28044598,28044598,28044768,0,0,0,170
34716,28044598,28044598,28044768,0,0,0,170
34717,28044598,28044598,28044768,0,0,0,170
34718,28044598,28044598,28044779,0,0,0,181
34719,28044598,28044598,28044779,0,0,0,181
34702,28044595,28044595,28044798,0,0,0,203
34703,28044595,28044595,28044798,0,0,0,203
34704,28044595,28044595,28044820,0,0,0,225
34705,28044595,28044595,28044820,0,0,0,225
34706,28044596,28044596,28044821,0,0,0,225
34707,28044596,28044596,28044821,0,0,0,225
34708,28044596,28044596,28044832,0,0,0,236
34709,28044596,28044596,28044832,0,0,0,236
34692,28044592,28044592,28044833,0,0,0,241
34693,28044592,28044592,28044833,0,0,0,241
34694,28044592,28044592,28044833,0,0,0,241
34711,28044597,28044597,28044844,0,0,0,247
34712,28044597,28044597,28044844,0,0,0,247
34695,28044593,28044593,28044845,0,0,0,252
34696,28044593,28044593,28044845,0,0,0,252
34713,28044597,28044597,28044855,0,0,0,258
34714,28044597,28044597,28044855,0,0,0,258
34697,28044593,28044593,28044856,0,0,0,263
34698,28044594,28044594,28044857,0,0,0,263
34699,28044594,28044594,28044868,0,0,0,274
34700,28044594,28044594,28044868,0,0,0,274
34701,28044594,28044594,28044879,0,0,0,285
34543,28038012,28038012,28044943,0,0,0,6931
34720,28044849,28044849,28044959,0,0,0,110
34052,27990463,27990463,28044976,0,0,0,54513
34721,28045057,28045057,28045357,0,0,0,300
34722,28045058,28045058,28045358,0,0,0,300
34723,28045058,28045058,28045358,0,0,0,300
34724,28045058,28045058,28045358,0,0,0,300
34725,28045058,28045058,28045358,0,0,0,300
34726,28045058,28045058,28045358,0,0,0,300
34727,28045058,28045058,28045358,0,0,0,300
34728,28045059,28045059,28045359,0,0,0,300
34729,28045059,28045059,28045359,0,0,0,300
34730,28045059,28045059,28045359,0,0,0,300
34731,28045059,28045059,28045359,0,0,0,300
34732,28045059,28045059,28045359,0,0,0,300
34733,28045059,28045059,28045359,0,0,0,300
34734,28045060,28045060,28045360,0,0,0,300
34735,28045060,28045060,28045360,0,0,0,300
34736,28045060,28045060,28045360,0,0,0,300
34737,28045060,28045060,28045360,0,0,0,300
34738,28045060,28045060,28045360,0,0,0,300
34739,28045060,28045060,28045360,0,0,0,300
34740,28045061,28045061,28045361,0,0,0,300
34741,28045061,28045061,28045361,0,0,0,300
34742,28045061,28045061,28045361,0,0,0,300
34743,28045061,28045061,28045361,0,0,0,300
34744,28045061,28045061,28045361,0,0,0,300
34745,28045061,28045061,28045361,0,0,0,300
34746,28045062,28045062,28045362,0,0,0,300
34747,28045062,28045062,28045362,0,0,0,300
34748,28045062,28045062,28045362,0,0,0,300
34749,28045062,28045062,28045362,0,0,0,300
34750,28045062,28045062,28045362,0,0,0,300
34751,28045062,28045062,28045362,0,0,0,300
34752,28045063,28045063,28045363,0,0,0,300
34753,28045063,28045063,28045363,0,0,0,300
34754,28045063,28045063,28045363,0,0,0,300
34755,28045063,28045063,28045363,0,0,0,300
34756,28045063,28045063,28045363,0,0,0,300
34757,28045063,28045063,28045363,0,0,0,300
34758,28045063,28045063,28045363,0,0,0,300
34759,28045256,28045256,28045556,0,0,0,300
34760,28045256,28045256,28045556,0,0,0,300
34761,28045257,28045257,28045557,0,0,0,300
34762,28045257,28045257,28045557,0,0,0,300
34763,28045257,28045257,28045557,0,0,0,300
34764,28045258,28045258,28045558,0,0,0,300
34765,28045258,28045258,28045558,0,0,0,300
34766,28045258,28045258,28045558,0,0,0,300
34767,28045258,28045258,28045558,0,0,0,300
34768,28045259,28045259,28045559,0,0,0,300
34769,28045259,28045259,28045559,0,0,0,300
34770,28045259,28045259,28045559,0,0,0,300
34771,28045259,28045259,28045559,0,0,0,300
34772,28045260,28045260,28045560,0,0,0,300
34773,28045260,28045260,28045560,0,0,0,300
34774,28045260,28045260,28045560,0,0,0,300
34775,28045694,28045694,28045809,0,0,0,115
34776,28045695,28045695,28045909,0,0,0,214
34777,28045697,28045697,28045911,0,0,0,214
34778,28045716,28045716,28045920,0,0,0,204
34779,28045938,28045938,28046111,0,0,0,173
34781,28046269,28046269,28046384,0,0,0,115
34648,28040286,28040286,28047098,0,0,0,6812
34783,28047619,28047619,28047672,0,0,0,53
34790,28047627,28047627,28047686,0,0,0,59
34786,28047626,28047626,28047707,0,0,0,81
34791,28047627,28047627,28047708,0,0,0,81
34789,28047626,28047626,28047712,0,0,0,86
34784,28047625,28047625,28047717,0,0,0,92
34785,28047625,28047625,28047717,0,0,0,92
34787,28047626,28047626,28047718,0,0,0,92
34788,28047626,28047626,28047718,0,0,0,92
34792,28047627,28047627,28047719,0,0,0,92
34794,28047628,28047628,28047720,0,0,0,92
34795,28047628,28047628,28047720,0,0,0,92
34796,28047628,28047628,28047720,0,0,0,92
34799,28047629,28047629,28047721,0,0,0,92
34800,28047629,28047629,28047734,0,0,0,105
34798,28047629,28047712,28047804,0,0,83,175
34793,28047627,28047712,28047810,0,0,85,183
34797,28047628,28047718,28047815,0,0,90,187
34801,28047718,28047815,28047904,0,0,97,186
34780,28046143,28046143,28048026,0,0,0,1883
34168,28030236,28030236,28048268,0,0,0,18032
34167,28030114,28030114,28048279,0,0,0,18165
33630,27789748,27789748,28048948,0,0,0,259200
34802,28048963,28048963,28049040,0,0,0,77
34804,28049011,28049011,28049102,0,0,0,91
34803,28048982,28048982,28049106,0,0,0,124
34807,28049696,28049696,28049811,0,0,0,115
34081,28023594,28023594,28049878,0,0,0,26284
34808,28050053,28050053,28050172,0,0,0,119
34809,28050234,28050234,28050349,0,0,0,115
34810,28050426,28050426,28050530,0,0,0,104
34811,28050670,28050670,28050785,0,0,0,115
34822,28050904,28050904,28051110,0,0,0,206
34823,28050905,28050905,28051111,0,0,0,206
34824,28050905,28050905,28051123,0,0,0,218
34825,28050905,28050905,28051134,0,0,0,229
34826,28050905,28050905,28051134,0,0,0,229
34827,28050905,28050905,28051134,0,0,0,229
34828,28050905,28050905,28051145,0,0,0,240
34829,28050905,28050905,28051145,0,0,0,240
34848,28051160,28051160,28051367,0,0,0,207
34849,28051160,28051160,28051367,0,0,0,207
34812,28050902,28050902,28051368,0,0,0,466
34834,28051156,28051156,28051368,0,0,0,212
34813,28050903,28050903,28051369,0,0,0,466
34814,28050903,28050903,28051369,0,0,0,466
34815,28050903,28050903,28051369,0,0,0,466
34816,28050903,28050903,28051369,0,0,0,466
34835,28051157,28051157,28051369,0,0,0,212
34817,28050904,28050904,28051370,0,0,0,466
34818,28050904,28050904,28051370,0,0,0,466
34819,28050904,28050904,28051370,0,0,0,466
34820,28050904,28050904,28051370,0,0,0,466
34821,28050904,28050904,28051370,0,0,0,466
34850,28051160,28051160,28051378,0,0,0,218
34851,28051160,28051160,28051378,0,0,0,218
34852,28051161,28051161,28051379,0,0,0,218
34836,28051157,28051157,28051380,0,0,0,223
34853,28051161,28051161,28051390,0,0,0,229
34854,28051161,28051161,28051390,0,0,0,229
34837,28051157,28051157,28051391,0,0,0,234
34838,28051157,28051157,28051391,0,0,0,234
34855,28051161,28051161,28051401,0,0,0,240
34839,28051158,28051158,28051403,0,0,0,245
34840,28051158,28051158,28051403,0,0,0,245
34841,28051158,28051158,28051403,0,0,0,245
34842,28051158,28051158,28051403,0,0,0,245
34830,28051155,28051155,28051406,0,0,0,251
34831,28051155,28051155,28051406,0,0,0,251
34843,28051159,28051159,28051415,0,0,0,256
34832,28051156,28051156,28051418,0,0,0,262
34833,28051156,28051156,28051418,0,0,0,262
34844,28051159,28051159,28051426,0,0,0,267
34845,28051159,28051159,28051426,0,0,0,267
34846,28051160,28051160,28051427,0,0,0,267
34847,28051160,28051160,28051438,0,0,0,278
34540,28037966,28037966,28051497,0,0,0,13531
34542,28037995,28037995,28051560,0,0,0,13565
34887,28051838,28051838,28051912,0,0,0,74
34874,28051835,28051835,28052039,0,0,0,204
34875,28051835,28051835,28052039,0,0,0,204
34892,28051838,28051838,28052049,0,0,0,211
34876,28051836,28051836,28052051,0,0,0,215
34877,28051836,28051836,28052051,0,0,0,215
34878,28051836,28051836,28052067,0,0,0,231
34879,28051836,28051836,28052067,0,0,0,231
34880,28051836,28051836,28052067,0,0,0,231
34881,28051837,28051837,28052079,0,0,0,242
34882,28051837,28051837,28052079,0,0,0,242
34857,28051832,28051832,28052084,0,0,0,252
34858,28051832,28051832,28052084,0,0,0,252
34859,28051832,28051832,28052084,0,0,0,252
34860,28051833,28051833,28052085,0,0,0,252
34861,28051833,28051833,28052085,0,0,0,252
34862,28051833,28051833,28052085,0,0,0,252
34863,28051833,28051833,28052085,0,0,0,252
34864,28051833,28051833,28052085,0,0,0,252
34865,28051834,28051834,28052086,0,0,0,252
34866,28051834,28051834,28052086,0,0,0,252
34867,28051834,28051834,28052086,0,0,0,252
34883,28051837,28051837,28052090,0,0,0,253
34884,28051837,28051837,28052101,0,0,0,264
34885,28051837,28051837,28052101,0,0,0,264
34886,28051837,28051837,28052101,0,0,0,264
34888,28051838,28051838,28052102,0,0,0,264
34868,28051834,28051834,28052103,0,0,0,269
34869,28051834,28051834,28052103,0,0,0,269
34870,28051834,28051834,28052103,0,0,0,269
34889,28051838,28051838,28052113,0,0,0,275
34871,28051835,28051835,28052115,0,0,0,280
34872,28051835,28051835,28052115,0,0,0,280
34890,28051838,28051838,28052124,0,0,0,286
34891,28051838,28051838,28052124,0,0,0,286
34873,28051835,28051835,28052126,0,0,0,291
34893,28051915,28051915,28052137,0,0,0,222
34895,28051916,28051916,28052138,0,0,0,222
34896,28051916,28051916,28052154,0,0,0,238
34897,28051916,28051916,28052154,0,0,0,238
34898,28051916,28051916,28052154,0,0,0,238
34894,28051915,28051915,28052164,0,0,0,249
34899,28052110,28052110,28052167,0,0,0,57
34901,28052229,28052229,28052278,0,0,0,49
34900,28052170,28052170,28052373,0,0,0,203
34902,28052336,28052336,28052374,0,0,0,38
34938,28052780,28052780,28052871,0,0,0,91
34918,28052776,28052776,28052975,0,0,0,199
34936,28052779,28052779,28052980,0,0,0,201
34919,28052776,28052776,28052986,0,0,0,210
34920,28052776,28052776,28052986,0,0,0,210
34937,28052779,28052779,28052991,0,0,0,212
34939,28052780,28052780,28052992,0,0,0,212
34921,28052776,28052776,28052997,0,0,0,221
34922,28052776,28052776,28053008,0,0,0,232
34923,28052777,28052777,28053009,0,0,0,232
34924,28052777,28052777,28053009,0,0,0,232
34940,28052780,28052780,28053014,0,0,0,234
34941,28052780,28052780,28053014,0,0,0,234
34925,28052777,28052777,28053020,0,0,0,243
34942,28052780,28052780,28053025,0,0,0,245
34943,28052781,28052781,28053026,0,0,0,245
34926,28052777,28052777,28053031,0,0,0,254
34927,28052778,28052778,28053032,0,0,0,254
34928,28052778,28052778,28053032,0,0,0,254
34903,28052771,28052771,28053033,0,0,0,262
34904,28052772,28052772,28053034,0,0,0,262
34905,28052772,28052772,28053034,0,0,0,262
34906,28052772,28052772,28053034,0,0,0,262
34907,28052773,28052773,28053035,0,0,0,262
34908,28052773,28052773,28053035,0,0,0,262
34909,28052773,28052773,28053035,0,0,0,262
34910,28052774,28052774,28053036,0,0,0,262
34911,28052774,28052774,28053036,0,0,0,262
34912,28052774,28052774,28053036,0,0,0,262
34913,28052774,28052774,28053036,0,0,0,262
34929,28052778,28052778,28053043,0,0,0,265
34914,28052775,28052775,28053049,0,0,0,274
34915,28052775,28052775,28053049,0,0,0,274
34930,28052778,28052778,28053054,0,0,0,276
34932,28052779,28052779,28053055,0,0,0,276
34916,28052775,28052775,28053060,0,0,0,285
34931,28052778,28052778,28053065,0,0,0,287
34933,28052779,28052779,28053066,0,0,0,287
34917,28052775,28052775,28053071,0,0,0,296
34934,28052779,28052779,28053077,0,0,0,298
34935,28052779,28052779,28053077,0,0,0,298
34944,28053063,28053063,28053120,0,0,0,57
34494,28037033,28037033,28053357,0,0,0,16324
34098,28025187,28025187,28053426,0,0,0,28239
34493,28037025,28037025,28053448,0,0,0,16423
34972,28053804,28053804,28053999,0,0,0,195
34962,28053802,28053802,28054014,0,0,0,212
34963,28053802,28053802,28054014,0,0,0,212
34964,28053802,28053802,28054025,0,0,0,223
34965,28053802,28053802,28054025,0,0,0,223
34966,28053802,28053802,28054036,0,0,0,234
34967,28053803,28053803,28054037,0,0,0,234
34968,28053803,28053803,28054037,0,0,0,234
34969,28053803,28053803,28054048,0,0,0,245
34970,28053803,28053803,28054048,0,0,0,245
34971,28053803,28053803,28054069,0,0,0,266
34973,28053804,28053804,28054070,0,0,0,266
34974,28053804,28053804,28054070,0,0,0,266
34982,28053882,28053882,28054073,0,0,0,191
34975,28053804,28053804,28054081,0,0,0,277
34976,28053804,28053804,28054081,0,0,0,277
34947,28053799,28053799,28054092,0,0,0,293
34948,28053799,28053799,28054092,0,0,0,293
34949,28053799,28053799,28054092,0,0,0,293
34950,28053799,28053799,28054092,0,0,0,293
34951,28053799,28053799,28054092,0,0,0,293
34952,28053800,28053800,28054093,0,0,0,293
34953,28053800,28053800,28054093,0,0,0,293
34954,28053800,28053800,28054093,0,0,0,293
34955,28053800,28053800,28054093,0,0,0,293
34956,28053801,28053801,28054094,0,0,0,293
34957,28053801,28053801,28054094,0,0,0,293
34958,28053801,28053801,28054094,0,0,0,293
34959,28053801,28053801,28054094,0,0,0,293
34960,28053801,28053801,28054094,0,0,0,293
34961,28053802,28053802,28054095,0,0,0,293
34983,28053883,28053883,28054096,0,0,0,213
34984,28053883,28053883,28054096,0,0,0,213
34985,28053883,28053883,28054096,0,0,0,213
34987,28053884,28053884,28054097,0,0,0,213
34986,28053883,28053883,28054107,0,0,0,224
34988,28053884,28053884,28054119,0,0,0,235
34989,28053884,28053884,28054119,0,0,0,235
34990,28053884,28053884,28054130,0,0,0,246
34991,28053885,28053885,28054131,0,0,0,246
34992,28053885,28053885,28054131,0,0,0,246
34993,28053885,28053885,28054142,0,0,0,257
34994,28053886,28053886,28054154,0,0,0,268
34995,28053886,28053886,28054154,0,0,0,268
34979,28053882,28053882,28054159,0,0,0,277
34977,28053881,28053881,28054160,0,0,0,279
34980,28053882,28053882,28054170,0,0,0,288
34981,28053882,28053882,28054181,0,0,0,299
34996,28054174,28054174,28054245,0,0,0,71
34997,28054230,28054230,28054328,0,0,0,98
34998,28054230,28054230,28054438,0,0,0,208
34999,28054727,28054727,28054984,0,0,0,257
35000,28054727,28054727,28054984,0,0,0,257
34162,28029625,28029625,28057964,0,0,0,28339
34496,28037497,28037497,28059180,0,0,0,21683
34163,28029647,28029647,28060708,0,0,0,31061
34782,28047525,28047525,28062759,0,0,0,15234
34806,28049301,28049301,28064223,0,0,0,14922
34682,28044336,28044336,28064629,0,0,0,20293
34945,28053320,28053320,28069566,0,0,0,16246
34946,28053401,28053401,28069696,0,0,0,16295
34226,28031292,28031292,28069734,0,0,0,38442
34978,28053881,28053881,28070269,0,0,0,16388
34099,28025272,28025272,28071591,0,0,0,46319
34101,28025382,28025382,28071945,0,0,0,46563
34045,27974860,27974860,28072098,0,0,0,97238
34102,28025413,28025413,28072765,0,0,0,47352
34103,28025455,28025455,28073055,0,0,0,47600
34067,28016898,28016898,28075348,0,0,0,58450
34104,28025477,28025477,28075650,0,0,0,50173
34096,28025180,28025180,28107623,0,0,0,82443
33733,27938451,27938451,28109556,0,0,0,171105
34161,28029592,28029592,28111900,0,0,0,82308
34353,28034730,28034730,28121781,0,0,0,87051
34059,27991088,27991088,28136478,0,0,0,145390
34053,27990720,27990720,28149120,0,0,0,158400
34054,27990760,27990760,28149160,0,0,0,158400
34055,27990868,27990868,28149268,0,0,0,158400
34056,27990894,27990894,28149294,0,0,0,158400
34057,27990945,27990945,28149345,0,0,0,158400
34058,27991029,27991029,28149429,0,0,0,158400
34060,27991158,27991158,28149558,0,0,0,158400
34061,27991335,27991335,28149735,0,0,0,158400
34063,27991722,27991722,28150122,0,0,0,158400
34170,28030414,28030414,28203214,0,0,0,172800
34666,28042632,28042632,28218365,0,0,0,175733
34044,27972626,27972626,28231826,0,0,0,259200
34223,28030901,28030901,28276412,0,0,0,245511
34270,28032392,28032392,28291592,0,0,0,259200
34805,28049231,28049231,28308431,0,0,0,259200
34856,28051454,28051454,28310654,0,0,0,259200
