id,Arrival,Start,Completion,No_of_expansion,No_of_shrinkage,Wait_time,Turn_around_time
1001,1249933,1249933,1250142,0,0,0,209
1004,1250171,1250171,1250305,0,0,0,134
1006,1251427,1251427,1251666,0,0,0,239
1007,1251676,1251676,1251904,0,0,0,228
1008,1252013,1252013,1252295,0,0,0,282
1009,1252739,1252739,1252960,0,0,0,221
1010,1253324,1253324,1253546,0,0,0,222
1011,1254067,1254067,1254283,0,0,0,216
1012,1254300,1254300,1254883,0,0,0,583
1013,1254848,1254848,1255176,0,0,0,328
1014,1255237,1255237,1255518,0,0,0,281
1016,1258266,1258266,1258349,0,0,0,83
1018,1258626,1258626,1258713,0,0,0,87
1019,1259252,1259252,1259345,0,0,0,93
1021,1260892,1260892,1260979,0,0,0,87
1022,1262655,1262655,1262739,0,0,0,84
1023,1262788,1262788,1262872,0,0,0,84
1024,1263062,1263062,1263178,0,0,0,116
1025,1263757,1263757,1264657,0,0,0,900
1027,1266055,1266055,1266235,0,0,0,180
1028,1266365,1266365,1268465,0,0,0,2100
1043,1278328,1278328,1278434,0,0,0,106
1044,1278328,1278328,1278498,0,0,0,170
1063,1278332,1278332,1278514,0,0,0,182
1057,1278331,1278331,1278524,0,0,0,193
1064,1278332,1278332,1278525,0,0,0,193
1045,1278328,1278328,1278687,0,0,0,359
1077,1279241,1279241,1279346,0,0,0,105
1065,1278332,1278332,1279386,0,0,0,1054
1020,1259446,1259446,1283833,0,0,0,24387
1015,1255499,1255499,1287479,0,0,0,31980
1026,1265971,1265971,1290286,0,0,0,24315
1017,1258471,1258471,1301187,0,0,0,42716
1082,1315914,1315914,1319247,0,0,0,3333
1081,1315886,1315886,1319256,0,0,0,3370
1066,1278332,1278332,1320929,0,0,0,42597
1068,1278333,1278333,1320961,0,0,0,42628
1067,1278332,1278332,1321033,0,0,0,42701
1069,1278333,1278333,1321394,0,0,0,43061
1070,1278333,1278333,1321473,0,0,0,43140
1071,1278333,1278333,1321938,0,0,0,43605
1072,1278333,1278333,1322031,0,0,0,43698
1073,1278334,1278334,1322147,0,0,0,43813
1075,1278334,1278334,1322152,0,0,0,43818
1076,1278334,1278334,1322232,0,0,0,43898
1074,1278334,1278334,1322302,0,0,0,43968
1029,1278324,1278324,1322746,0,0,0,44422
1031,1278325,1278325,1322933,0,0,0,44608
1030,1278324,1278324,1323110,0,0,0,44786
1032,1278325,1278325,1323772,0,0,0,45447
1033,1278325,1278325,1323834,0,0,0,45509
1034,1278325,1278325,1323983,0,0,0,45658
1078,1279268,1279268,1324142,0,0,0,44874
1035,1278326,1278326,1324224,0,0,0,45898
1036,1278326,1278326,1324494,0,0,0,46168
1037,1278326,1278326,1324680,0,0,0,46354
1038,1278326,1278326,1324691,0,0,0,46365
1039,1278327,1278327,1324716,0,0,0,46389
1040,1278327,1278327,1324925,0,0,0,46598
1052,1278330,1278330,1325966,0,0,0,47636
1053,1278330,1278330,1326028,0,0,0,47698
1041,1278327,1278327,1326047,0,0,0,47720
1054,1278330,1278330,1326353,0,0,0,48023
1055,1278330,1278330,1327502,0,0,0,49172
1058,1278331,1278331,1328443,0,0,0,50112
1042,1278327,1278327,1328656,0,0,0,50329
1046,1278329,1278329,1328742,0,0,0,50413
1059,1278331,1278331,1328860,0,0,0,50529
1047,1278329,1278329,1329241,0,0,0,50912
1060,1278331,1278331,1329347,0,0,0,51016
1061,1278331,1278331,1329836,0,0,0,51505
1048,1278329,1278329,1329945,0,0,0,51616
1049,1278329,1278329,1330514,0,0,0,52185
1062,1278331,1278331,1330686,0,0,0,52355
1050,1278329,1278329,1331260,0,0,0,52931
1088,1329524,1329524,1331861,0,0,0,2337
1051,1278329,1278329,1332006,0,0,0,53677
1079,1279304,1279304,1332107,0,0,0,52803
1056,1278330,1278330,1332380,0,0,0,54050
1090,1332446,1332446,1334629,0,0,0,2183
1005,1250435,1250435,1336835,0,0,0,86400
1086,1319247,1319247,1338123,0,0,0,18876
1085,1319243,1319243,1338239,0,0,0,18996
1092,1339534,1339534,1340434,0,0,0,900
1091,1335064,1335064,1340641,0,0,0,5577
1003,1250120,1250120,1340898,0,0,0,90778
1093,1340875,1340875,1341477,0,0,0,602
1002,1250028,1250028,1342942,0,0,0,92914
1106,1342971,1342971,1343041,0,0,0,70
1107,1342971,1342971,1343074,0,0,0,103
1142,1342995,1342995,1343107,0,0,0,112
1144,1350322,1350322,1350366,0,0,0,44
1143,1343085,1343085,1355625,0,0,0,12540
1148,1353465,1353465,1366198,0,0,0,12733
1084,1316037,1316037,1368391,0,0,0,52354
1083,1315982,1315982,1370227,0,0,0,54245
1150,1372668,1372668,1372784,0,0,0,116
1080,1313115,1313115,1377291,0,0,0,64176
1087,1319503,1319503,1379738,0,0,0,60235
1089,1332287,1332287,1382542,0,0,0,50255
1149,1372298,1372298,1383555,0,0,0,11257
1146,1350385,1350385,1394098,0,0,0,43713
1147,1353428,1353428,1394515,0,0,0,41087
1108,1342971,1342971,1398668,0,0,0,55697
1133,1342978,1342978,1400432,0,0,0,57454
1129,1342977,1342977,1400818,0,0,0,57841
1130,1342977,1342977,1400850,0,0,0,57873
1134,1342978,1342978,1401194,0,0,0,58216
1131,1342977,1342977,1401494,0,0,0,58517
1135,1342978,1342978,1402188,0,0,0,59210
1136,1342978,1342978,1402819,0,0,0,59841
1137,1342979,1342979,1402978,0,0,0,59999
1138,1342979,1342979,1403716,0,0,0,60737
1139,1342979,1342979,1403913,0,0,0,60934
1140,1342979,1342979,1404482,0,0,0,61503
1141,1342980,1342980,1404562,0,0,0,61582
1156,1406266,1406266,1406333,0,0,0,67
1158,1406414,1406414,1406664,0,0,0,250
1159,1406581,1406581,1406676,0,0,0,95
1160,1406781,1406781,1406876,0,0,0,95
1161,1407000,1407000,1407089,0,0,0,89
1123,1342974,1342974,1407154,0,0,0,64180
1162,1407559,1407559,1407652,0,0,0,93
1132,1342977,1342977,1407786,0,0,0,64809
1163,1411257,1411257,1411352,0,0,0,95
1166,1411565,1411565,1411653,0,0,0,88
1170,1411826,1411826,1411942,0,0,0,116
1145,1350342,1350342,1411984,0,0,0,61642
1171,1411989,1411989,1412095,0,0,0,106
1094,1342969,1342969,1413321,0,0,0,70352
1174,1413574,1413574,1413684,0,0,0,110
1175,1414061,1414061,1414167,0,0,0,106
1176,1414377,1414377,1414482,0,0,0,105
1177,1414811,1414811,1414915,0,0,0,104
1095,1342969,1342969,1415275,0,0,0,72306
1180,1415416,1415416,1415520,0,0,0,104
1173,1412126,1412126,1415550,0,0,0,3424
1181,1415570,1415570,1415666,0,0,0,96
1178,1415144,1415144,1415721,0,0,0,577
1096,1342969,1342969,1415779,0,0,0,72810
1182,1415695,1415695,1416159,0,0,0,464
1183,1416236,1416236,1416667,0,0,0,431
1185,1416720,1416720,1417214,0,0,0,494
1099,1342970,1342970,1417498,0,0,0,74528
1186,1417261,1417261,1417693,0,0,0,432
1151,1376893,1376893,1418547,0,0,0,41654
1188,1418443,1418443,1418548,0,0,0,105
1100,1342970,1342970,1418661,0,0,0,75691
1187,1418328,1418328,1418772,0,0,0,444
1189,1418688,1418688,1418789,0,0,0,101
1101,1342970,1342970,1419172,0,0,0,76202
1102,1342970,1342970,1419283,0,0,0,76313
1190,1418896,1418896,1420260,0,0,0,1364
1097,1342969,1342969,1420669,0,0,0,77700
1103,1342970,1342970,1421126,0,0,0,78156
1104,1342970,1342970,1421188,0,0,0,78218
1105,1342970,1342970,1421571,0,0,0,78601
1098,1342969,1342969,1424125,0,0,0,81156
1192,1421643,1421643,1424736,0,0,0,3093
1117,1342973,1342973,1426013,0,0,0,83040
1172,1412047,1412047,1426683,0,0,0,14636
1194,1426895,1426895,1426993,0,0,0,98
1195,1427022,1427022,1427113,0,0,0,91
1196,1427214,1427214,1427318,0,0,0,104
1193,1424722,1424722,1427690,0,0,0,2968
1191,1419118,1419118,1431603,0,0,0,12485
1118,1342973,1342973,1435034,0,0,0,92061
1112,1342972,1342972,1436246,0,0,0,93274
1124,1342974,1342974,1436291,0,0,0,93317
1125,1342974,1342974,1436291,0,0,0,93317
1126,1342974,1342974,1436302,0,0,0,93328
1127,1342974,1342974,1436302,0,0,0,93328
1128,1342974,1342974,1436302,0,0,0,93328
1109,1342971,1342971,1436310,0,0,0,93339
1113,1342972,1342972,1436322,0,0,0,93350
1114,1342972,1342972,1436322,0,0,0,93350
1115,1342972,1342972,1436333,0,0,0,93361
1184,1416602,1416602,1437263,0,0,0,20661
1116,1342972,1342972,1441033,0,0,0,98061
1119,1342973,1342973,1449209,0,0,0,106236
1120,1342973,1342973,1449319,0,0,0,106346
1110,1342971,1342971,1449452,0,0,0,106481
1121,1342973,1342973,1449688,0,0,0,106715
1111,1342971,1342971,1452102,0,0,0,109131
1122,1342973,1342973,1464142,0,0,0,121169
1157,1406342,1406342,1466439,0,0,0,60097
1152,1379063,1379063,1470778,0,0,0,91715
1153,1379081,1379081,1471787,0,0,0,92706
1179,1415305,1415305,1472381,0,0,0,57076
1214,1436505,1436505,1487542,0,0,0,51037
1154,1392087,1392087,1488496,0,0,0,96409
1211,1436504,1436504,1490281,0,0,0,53777
1212,1436504,1436504,1492279,0,0,0,55775
1239,1493484,1493484,1494436,0,0,0,952
1201,1436501,1436501,1496094,0,0,0,59593
1169,1411795,1411795,1498396,0,0,0,86601
1197,1427385,1427385,1498645,0,0,0,71260
1202,1436501,1436501,1501505,0,0,0,65004
1241,1501168,1501168,1501976,0,0,0,808
1240,1501131,1501131,1504534,0,0,0,3403
1227,1459323,1459323,1504649,0,0,0,45326
1228,1459323,1459323,1504691,0,0,0,45368
1203,1436501,1436501,1507452,0,0,0,70951
1204,1436501,1436501,1509345,0,0,0,72844
1198,1427785,1427785,1514185,0,0,0,86400
1243,1515194,1515194,1515317,0,0,0,123
1246,1519032,1519032,1519074,0,0,0,42
1215,1436505,1436505,1520830,0,0,0,84325
1200,1436118,1436118,1524132,0,0,0,88014
1205,1436502,1436502,1525376,0,0,0,88874
1222,1436507,1436507,1525454,0,0,0,88947
1223,1436507,1436507,1527333,0,0,0,90826
1224,1436507,1436507,1527603,0,0,0,91096
1218,1436506,1436506,1531930,0,0,0,95424
1207,1436503,1436503,1532404,0,0,0,95901
1229,1459323,1459323,1533053,0,0,0,73730
1225,1439432,1439432,1534182,0,0,0,94750
1206,1436502,1436502,1534588,0,0,0,98086
1219,1436506,1436506,1535462,0,0,0,98956
1258,1535625,1535625,1535719,0,0,0,94
1259,1536062,1536062,1536162,0,0,0,100
1261,1536290,1536290,1536394,0,0,0,104
1226,1456168,1456168,1536520,0,0,0,80352
1220,1436506,1436506,1536796,0,0,0,100290
1221,1436506,1436506,1537846,0,0,0,101340
1208,1436503,1436503,1539530,0,0,0,103027
1216,1436505,1436505,1540112,0,0,0,103607
1209,1436503,1436503,1540121,0,0,0,103618
1210,1436503,1436503,1541600,0,0,0,105097
1230,1459323,1459323,1547741,0,0,0,88418
1217,1436505,1436505,1549205,0,0,0,112700
1213,1436504,1436504,1549433,0,0,0,112929
1251,1519649,1519649,1551004,0,0,0,31355
1270,1551514,1551514,1551616,0,0,0,102
1271,1551605,1551605,1551646,0,0,0,41
1272,1551698,1551698,1551740,0,0,0,42
1273,1552042,1552042,1552084,0,0,0,42
1274,1553055,1553055,1553148,0,0,0,93
1167,1411603,1411603,1553183,0,0,0,141580
1264,1551137,1551137,1553675,0,0,0,2538
1263,1551136,1551136,1554578,0,0,0,3442
1164,1411489,1411489,1554876,0,0,0,143387
1265,1551137,1551137,1556408,0,0,0,5271
1266,1551137,1551137,1556484,0,0,0,5347
1168,1411633,1411633,1556604,0,0,0,144971
1267,1551137,1551137,1556679,0,0,0,5542
1165,1411547,1411547,1557035,0,0,0,145488
1237,1459325,1459325,1559835,0,0,0,100510
1232,1459324,1459324,1568783,0,0,0,109459
1233,1459324,1459324,1569299,0,0,0,109975
1231,1459323,1459323,1569351,0,0,0,110028
1234,1459324,1459324,1569642,0,0,0,110318
1155,1406229,1406229,1572187,0,0,0,165958
1235,1459324,1459324,1577275,0,0,0,117951
1250,1519387,1519387,1577634,0,0,0,58247
1236,1459324,1459324,1581910,0,0,0,122586
1238,1459325,1459325,1587497,0,0,0,128172
1242,1503874,1503874,1587714,0,0,0,83840
1244,1515331,1515331,1588425,0,0,0,73094
1249,1519365,1519365,1588729,0,0,0,69364
1253,1519676,1519676,1597982,0,0,0,78306
1282,1599511,1599511,1599602,0,0,0,91
1283,1599807,1599807,1599895,0,0,0,88
1199,1431560,1431560,1604360,0,0,0,172800
1286,1607468,1607468,1607578,0,0,0,110
1287,1607712,1607712,1607754,0,0,0,42
1252,1519670,1519670,1612053,0,0,0,92383
1248,1519216,1519216,1617695,0,0,0,98479
1256,1529394,1529394,1618132,0,0,0,88738
1247,1519116,1519116,1621333,0,0,0,102217
1289,1629762,1629762,1629908,0,0,0,146
1280,1588546,1588546,1635867,0,0,0,47321
1275,1553291,1553291,1638065,0,0,0,84774
1254,1519682,1519682,1640515,0,0,0,120833
1255,1519690,1519690,1642803,0,0,0,123113
1268,1551137,1551137,1647040,0,0,0,95903
1309,1647019,1647019,1647126,0,0,0,107
1310,1647019,1647019,1647148,0,0,0,129
1276,1553303,1553303,1648558,0,0,0,95255
1277,1553316,1553316,1650386,0,0,0,97070
1269,1551137,1551137,1650833,0,0,0,99696
1279,1587769,1587769,1658950,0,0,0,71181
1327,1675745,1675745,1675837,0,0,0,92
1328,1676024,1676024,1676108,0,0,0,84
1245,1515447,1515447,1688247,0,0,0,172800
1329,1691544,1691544,1691661,0,0,0,117
1330,1695111,1695111,1695226,0,0,0,115
1331,1695404,1695404,1695529,0,0,0,125
1332,1695643,1695643,1695789,0,0,0,146
1333,1696283,1696283,1698083,0,0,0,1800
1257,1534447,1534447,1698089,0,0,0,163642
1288,1612322,1612322,1698124,0,0,0,85802
1291,1647014,1647014,1698434,0,0,0,51420
1294,1647015,1647015,1698477,0,0,0,51462
1285,1603988,1603988,1698714,0,0,0,94726
1334,1699123,1699123,1699216,0,0,0,93
1295,1647015,1647015,1702525,0,0,0,55510
1292,1647014,1647014,1703063,0,0,0,56049
1290,1630247,1630247,1703650,0,0,0,73403
1335,1703916,1703916,1704066,0,0,0,150
1336,1703951,1703951,1704097,0,0,0,146
1284,1603842,1603842,1704368,0,0,0,100526
1337,1704056,1704056,1705138,0,0,0,1082
1338,1704085,1704085,1706630,0,0,0,2545
1262,1536643,1536643,1706763,0,0,0,170120
1260,1536150,1536150,1707798,0,0,0,171648
1313,1647161,1647161,1724598,0,0,0,77437
1296,1647015,1647015,1729137,0,0,0,82122
1293,1647014,1647014,1729365,0,0,0,82351
1278,1569641,1569641,1742441,0,0,0,172800
1314,1649816,1649816,1742788,0,0,0,92972
1323,1650850,1650850,1746987,0,0,0,96137
1322,1650722,1650722,1748320,0,0,0,97598
1317,1650129,1650129,1748737,0,0,0,98608
1321,1650594,1650594,1749915,0,0,0,99321
1315,1649870,1649870,1750550,0,0,0,100680
1316,1650001,1650001,1751808,0,0,0,101807
1342,1748076,1748076,1752558,0,0,0,4482
1343,1752541,1752541,1752637,0,0,0,96
1299,1647016,1647016,1753864,0,0,0,106848
1300,1647016,1647016,1753882,0,0,0,106866
1301,1647016,1647016,1754085,0,0,0,107069
1304,1647017,1647017,1754749,0,0,0,107732
1305,1647017,1647017,1754802,0,0,0,107785
1297,1647015,1647015,1755378,0,0,0,108363
1318,1650241,1650241,1756012,0,0,0,105771
1345,1755958,1755958,1756161,0,0,0,203
1306,1647017,1647017,1757206,0,0,0,110189
1319,1650352,1650352,1758074,0,0,0,107722
1320,1650465,1650465,1758263,0,0,0,107798
1302,1647016,1647016,1759212,0,0,0,112196
1307,1647017,1647017,1764025,0,0,0,117008
1281,1598147,1598147,1764216,0,0,0,166069
1298,1647015,1647015,1764316,0,0,0,117301
1303,1647016,1647016,1765173,0,0,0,118157
1311,1647125,1647125,1769080,0,0,0,121955
1312,1647130,1647130,1769716,0,0,0,122586
1348,1772993,1772993,1773093,0,0,0,100
1350,1773080,1773080,1773231,0,0,0,151
1351,1773828,1773828,1773919,0,0,0,91
1352,1773886,1773886,1774026,0,0,0,140
1349,1773075,1773075,1774074,0,0,0,999
1308,1647017,1647017,1774155,0,0,0,127138
1359,1774587,1774587,1774736,0,0,0,149
1325,1665246,1698089,1783376,0,0,32843,118130
1339,1705409,1705409,1791809,0,0,0,86400
1340,1706864,1706864,1792104,0,0,0,85240
1324,1665215,1665215,1793572,0,0,0,128357
1387,1792039,1792039,1797447,0,0,0,5408
1391,1811354,1811354,1812082,0,0,0,728
1371,1786930,1786930,1813005,0,0,0,26075
1388,1792185,1792185,1821561,0,0,0,29376
1379,1788228,1788228,1831097,0,0,0,42869
1375,1788227,1788227,1831189,0,0,0,42962
1376,1788227,1788227,1831280,0,0,0,43053
1380,1788228,1788228,1831292,0,0,0,43064
1382,1788229,1788229,1831675,0,0,0,43446
1381,1788228,1788228,1831716,0,0,0,43488
1385,1788230,1788230,1831860,0,0,0,43630
1383,1788229,1788229,1831880,0,0,0,43651
1386,1788230,1788230,1832024,0,0,0,43794
1384,1788229,1788229,1832128,0,0,0,43899
1377,1788227,1788227,1843200,0,0,0,54973
1341,1748058,1748058,1843437,0,0,0,95379
1394,1849966,1849966,1852854,0,0,0,2888
1344,1752613,1752613,1853042,0,0,0,100429
1395,1850618,1850618,1853468,0,0,0,2850
1396,1850889,1850889,1853667,0,0,0,2778
1397,1851126,1851126,1853893,0,0,0,2767
1362,1786927,1786927,1872974,0,0,0,86047
1363,1786927,1786927,1876469,0,0,0,89542
1326,1668360,1706763,1879563,0,0,38403,211203
1361,1786926,1786926,1881103,0,0,0,94177
1378,1788227,1788227,1881834,0,0,0,93607
1398,1883498,1883498,1884079,0,0,0,581
1401,1886781,1886781,1886960,0,0,0,179
1402,1886816,1886816,1886963,0,0,0,147
1364,1786928,1786928,1892556,0,0,0,105628
1365,1786928,1786928,1892665,0,0,0,105737
1367,1786929,1786929,1894119,0,0,0,107190
1368,1786929,1786929,1895634,0,0,0,108705
1372,1786930,1786930,1897157,0,0,0,110227
1366,1786928,1786928,1897259,0,0,0,110331
1373,1786930,1786930,1908162,0,0,0,121232
1389,1811049,1811049,1909600,0,0,0,98551
1390,1811093,1811093,1911959,0,0,0,100866
1347,1756119,1756119,1919742,0,0,0,163623
1369,1786929,1786929,1920551,0,0,0,133622
1404,1887284,1887284,1920607,0,0,0,33323
1346,1756052,1756052,1926188,0,0,0,170136
1429,1939495,1939495,1939611,0,0,0,116
1355,1774260,1774260,1940295,0,0,0,166035
1430,1940380,1940380,1940606,0,0,0,226
1410,1899582,1899582,1941103,0,0,0,41521
1431,1940581,1940581,1941532,0,0,0,951
1411,1899598,1899598,1941750,0,0,0,42152
1356,1774480,1774480,1943660,0,0,0,169180
1419,1899799,1899799,1946071,0,0,0,46272
1415,1899798,1899798,1946237,0,0,0,46439
1423,1899800,1899800,1946250,0,0,0,46450
1416,1899798,1899798,1946294,0,0,0,46496
1420,1899799,1899799,1946338,0,0,0,46539
1421,1899799,1899799,1946537,0,0,0,46738
1417,1899798,1899798,1946555,0,0,0,46757
1424,1899800,1899800,1946726,0,0,0,46926
1422,1899799,1899799,1946740,0,0,0,46941
1418,1899798,1899798,1946763,0,0,0,46965
1370,1786929,1786929,1949807,0,0,0,162878
1353,1774118,1774118,1951178,0,0,0,177060
1354,1774131,1774131,1952275,0,0,0,178144
1358,1774564,1774564,1953880,0,0,0,179316
1413,1899797,1899797,1953893,0,0,0,54096
1435,1956805,1956805,1956891,0,0,0,86
1409,1899517,1899517,1958779,0,0,0,59262
1408,1899499,1899499,1959283,0,0,0,59784
1399,1883963,1883963,1969846,0,0,0,85883
1400,1884104,1884104,1973405,0,0,0,89301
1360,1774587,1774587,1978298,0,0,0,203711
1357,1774540,1774540,1979887,0,0,0,205347
1414,1899797,1899797,1990400,0,0,0,90603
1407,1899459,1899459,1995943,0,0,0,96484
1406,1899455,1899455,1998857,0,0,0,99402
1438,1957217,1957217,2000436,0,0,0,43219
1405,1899441,1899441,2000697,0,0,0,101256
1436,1956920,1956920,2002015,0,0,0,45095
1437,1957109,1957109,2004019,0,0,0,46910
1412,1899721,1899721,2010295,0,0,0,110574
1392,1831073,1831073,2012975,0,0,0,181902
1393,1832604,1832604,2020498,0,0,0,187894
1374,1786930,1786930,2027897,0,0,0,240967
1467,2027878,2027878,2027982,0,0,0,104
1468,2027881,2027881,2027985,0,0,0,104
1466,2027864,2027864,2028557,0,0,0,693
1460,2027862,2027862,2028766,0,0,0,904
1461,2027862,2027862,2029604,0,0,0,1742
1469,2030236,2030236,2030285,0,0,0,49
1470,2030253,2030253,2030307,0,0,0,54
1463,2027863,2027863,2030527,0,0,0,2664
1471,2030733,2030733,2030791,0,0,0,58
1472,2030845,2030845,2030892,0,0,0,47
1443,1968028,1978298,2030916,0,0,10270,62888
1473,2030896,2030896,2030945,0,0,0,49
1474,2031017,2031017,2031060,0,0,0,43
1475,2031036,2031036,2031090,0,0,0,54
1476,2031063,2031063,2031105,0,0,0,42
1477,2031949,2031949,2032007,0,0,0,58
1462,2027862,2027862,2032985,0,0,0,5123
1478,2034612,2034612,2034670,0,0,0,58
1464,2027863,2027863,2035171,0,0,0,7308
1439,1957347,2000436,2043537,0,0,43089,86190
1444,1968029,1978298,2050688,0,0,10269,82659
1446,1968030,1979887,2054264,0,0,11857,86234
1445,1968029,1979887,2056978,0,0,11858,88949
1447,1968030,1990400,2066690,0,0,22370,98660
1448,1968030,1995943,2072423,0,0,27913,104393
1449,1968030,1998857,2077295,0,0,30827,109265
1450,1968031,2000697,2079738,0,0,32666,111707
1452,1968031,2002015,2080208,0,0,33984,112177
1451,1968031,2002015,2082146,0,0,33984,114115
1426,1921599,1921599,2085201,0,0,0,163602
1453,1968031,2002015,2087482,0,0,33984,119451
1403,1886970,1886970,2091745,0,0,0,204775
1428,1933476,1933476,2099914,0,0,0,166438
1454,2017690,2017690,2101251,0,0,0,83561
1427,1928950,1928950,2101750,0,0,0,172800
1441,1967045,1969846,2110850,0,0,2801,143805
1442,1967096,1973405,2111870,0,0,6309,144774
1425,1920585,1920585,2119334,0,0,0,198749
1434,1956072,1956072,2122129,0,0,0,166057
1433,1953113,1953113,2122205,0,0,0,169092
1479,2122380,2122380,2122423,0,0,0,43
1482,2123843,2123843,2124114,0,0,0,271
1432,1952842,1952842,2125310,0,0,0,172468
1483,2124117,2124117,2125670,0,0,0,1553
1484,2125708,2125708,2126411,0,0,0,703
1485,2126400,2126400,2126566,0,0,0,166
1480,2122399,2122399,2127029,0,0,0,4630
1481,2123564,2123564,2127033,0,0,0,3469
1486,2126609,2126609,2127118,0,0,0,509
1487,2127022,2127022,2127118,0,0,0,96
1488,2127035,2127035,2127131,0,0,0,96
1489,2127118,2127118,2127213,0,0,0,95
1490,2127377,2127377,2127558,0,0,0,181
1492,2127606,2127606,2127761,0,0,0,155
1493,2127834,2127834,2128036,0,0,0,202
1495,2128024,2128024,2129224,0,0,0,1200
1497,2133132,2133132,2133361,0,0,0,229
1496,2131546,2131546,2135502,0,0,0,3956
1440,1959138,1959283,2135822,0,0,145,176684
1458,2027861,2027861,2135991,0,0,0,108130
1459,2027861,2027861,2136425,0,0,0,108564
1498,2136430,2136430,2136731,0,0,0,301
1499,2138201,2138201,2139401,0,0,0,1200
1457,2027860,2027860,2139478,0,0,0,111618
1500,2139501,2139501,2139892,0,0,0,391
1465,2027863,2027863,2140973,0,0,0,113110
1504,2149364,2149364,2149411,0,0,0,47
1524,2149434,2149434,2149807,0,0,0,373
1519,2149433,2149433,2150343,0,0,0,910
1520,2149433,2149433,2151192,0,0,0,1759
1521,2149433,2149433,2152138,0,0,0,2705
1456,2019252,2019252,2153357,0,0,0,134105
1522,2149433,2149433,2154539,0,0,0,5106
1455,2019226,2019226,2158340,0,0,0,139114
1532,2168250,2168250,2168293,0,0,0,43
1494,2127970,2127970,2183060,0,0,0,55090
1491,2127571,2127571,2184827,0,0,0,57256
1513,2149432,2149432,2185277,0,0,0,35845
1540,2189238,2189238,2189365,0,0,0,127
1542,2191369,2191369,2191419,0,0,0,50
1543,2191480,2191480,2191539,0,0,0,59
1501,2139925,2139925,2194110,0,0,0,54185
1502,2141429,2141429,2194589,0,0,0,53160
1503,2141451,2141451,2194598,0,0,0,53147
1508,2149431,2149431,2202503,0,0,0,53072
1544,2205495,2205495,2205630,0,0,0,135
1545,2207666,2207666,2207781,0,0,0,115
1546,2207934,2207934,2208049,0,0,0,115
1547,2208126,2208126,2208230,0,0,0,104
1548,2210483,2210483,2211382,0,0,0,899
1549,2211359,2211359,2211488,0,0,0,129
1552,2213298,2213298,2213445,0,0,0,147
1551,2212938,2212938,2213730,0,0,0,792
1553,2216952,2216952,2217166,0,0,0,214
1555,2217587,2217587,2217753,0,0,0,166
1554,2217531,2217531,2219000,0,0,0,1469
1556,2217999,2217999,2220024,0,0,0,2025
1538,2188186,2188186,2230139,0,0,0,41953
1557,2218820,2218820,2230444,0,0,0,11624
1550,2211658,2211658,2232424,0,0,0,20766
1509,2149431,2149431,2232627,0,0,0,83196
1510,2149431,2149431,2233900,0,0,0,84469
1511,2149431,2149431,2238987,0,0,0,89556
1514,2149432,2149432,2242507,0,0,0,93075
1515,2149432,2149432,2245396,0,0,0,95964
1516,2149432,2149432,2245959,0,0,0,96527
1523,2149433,2149433,2246642,0,0,0,97209
1565,2245744,2245744,2246750,0,0,0,1006
1566,2245830,2245830,2246959,0,0,0,1129
1567,2245905,2245905,2246976,0,0,0,1071
1568,2246086,2246642,2247276,0,0,556,1190
1517,2149432,2149432,2247452,0,0,0,98020
1512,2149431,2149431,2249306,0,0,0,99875
1518,2149432,2149432,2249443,0,0,0,100011
1570,2246313,2246959,2251761,0,0,646,5448
1563,2230365,2230444,2255523,0,0,79,25158
1569,2246179,2246750,2256328,0,0,571,10149
1527,2152658,2152658,2259830,0,0,0,107172
1564,2231206,2255523,2259897,0,0,24317,28691
1534,2168556,2168556,2261999,0,0,0,93443
1531,2157008,2157008,2264294,0,0,0,107286
1533,2168551,2168551,2264305,0,0,0,95754
1529,2155573,2155573,2266476,0,0,0,110903
1525,2149434,2149434,2266931,0,0,0,117497
1535,2168650,2168650,2268129,0,0,0,99479
1530,2155588,2155588,2268991,0,0,0,113403
1536,2168666,2168666,2269607,0,0,0,100941
1505,2149430,2149430,2270325,0,0,0,120895
1506,2149430,2149430,2270529,0,0,0,121099
1507,2149430,2149430,2273860,0,0,0,124430
1571,2274174,2274174,2274396,0,0,0,222
1572,2274174,2274174,2274408,0,0,0,234
1576,2274175,2274175,2274409,0,0,0,234
1573,2274174,2274174,2274430,0,0,0,256
1577,2274175,2274175,2274442,0,0,0,267
1579,2274176,2274176,2274454,0,0,0,278
1580,2274176,2274176,2274454,0,0,0,278
1581,2274176,2274176,2274454,0,0,0,278
1574,2274174,2274174,2274463,0,0,0,289
1578,2274175,2274175,2274464,0,0,0,289
1575,2274174,2274174,2274503,0,0,0,329
1558,2219402,2219402,2275153,0,0,0,55751
1528,2155560,2155560,2282029,0,0,0,126469
1594,2292343,2292343,2292540,0,0,0,197
1595,2292553,2292553,2292731,0,0,0,178
1596,2292782,2292782,2292918,0,0,0,136
1597,2293508,2293508,2293642,0,0,0,134
1598,2293631,2293631,2293882,0,0,0,251
1599,2293849,2293849,2293974,0,0,0,125
1601,2294939,2294939,2295204,0,0,0,265
1600,2294432,2294432,2295672,0,0,0,1240
1602,2295551,2295551,2295824,0,0,0,273
1603,2295594,2295594,2295878,0,0,0,284
1604,2295783,2295783,2295888,0,0,0,105
1605,2296125,2296125,2296221,0,0,0,96
1606,2296391,2296391,2296487,0,0,0,96
1607,2296531,2296531,2296636,0,0,0,105
1608,2296735,2296735,2296825,0,0,0,90
1609,2297451,2297451,2297557,0,0,0,106
1610,2297855,2297855,2297950,0,0,0,95
1611,2298151,2298151,2298248,0,0,0,97
1612,2298268,2298268,2298436,0,0,0,168
1613,2298384,2298384,2298634,0,0,0,250
1614,2299103,2299103,2299195,0,0,0,92
1615,2299249,2299249,2299353,0,0,0,104
1616,2299407,2299407,2299569,0,0,0,162
1617,2299545,2299545,2299645,0,0,0,100
1620,2302579,2302579,2302637,0,0,0,58
1621,2302760,2302760,2302819,0,0,0,59
1622,2303065,2303065,2303123,0,0,0,58
1582,2274495,2274495,2303502,0,0,0,29007
1623,2303512,2303512,2303559,0,0,0,47
1625,2303707,2303707,2303758,0,0,0,51
1628,2309145,2309145,2309406,0,0,0,261
1629,2309182,2309182,2309439,0,0,0,257
1618,2299633,2299633,2312150,0,0,0,12517
1541,2189341,2189341,2314499,0,0,0,125158
1619,2302233,2302233,2316839,0,0,0,14606
1539,2189105,2189105,2318930,0,0,0,129825
1583,2274496,2274496,2345659,0,0,0,71163
1584,2274497,2274497,2347955,0,0,0,73458
1537,2182042,2182042,2354842,0,0,0,172800
1585,2274497,2274497,2357404,0,0,0,82907
1586,2274497,2274497,2383578,0,0,0,109081
1591,2274499,2274499,2385423,0,0,0,110924
1588,2274498,2274498,2386332,0,0,0,111834
1589,2274498,2274498,2386344,0,0,0,111846
1559,2220340,2220340,2386386,0,0,0,166046
1633,2385284,2385284,2386414,0,0,0,1130
1634,2387700,2387700,2388095,0,0,0,395
1592,2274499,2274499,2388162,0,0,0,113663
1627,2306507,2312150,2390025,0,0,5643,83518
1562,2220444,2230139,2393820,0,0,9695,173376
1561,2220416,2230139,2399282,0,0,9723,178866
1590,2274498,2274498,2399391,0,0,0,124893
1560,2220367,2230139,2400273,0,0,9772,179906
1593,2274499,2274499,2404193,0,0,0,129694
1526,2149434,2149434,2408634,0,0,0,259200
1587,2274497,2274497,2409755,0,0,0,135258
1624,2303571,2303571,2435421,0,0,0,131850
1626,2303964,2303964,2439726,0,0,0,135762
1641,2444289,2444289,2444558,0,0,0,269
1631,2321155,2321155,2445416,0,0,0,124261
1630,2321121,2321121,2448122,0,0,0,127001
1642,2452508,2452508,2452902,0,0,0,394
1643,2452930,2452930,2453082,0,0,0,152
1644,2453173,2453173,2453573,0,0,0,400
1645,2453633,2453633,2453923,0,0,0,290
1647,2454041,2454041,2454281,0,0,0,240
1646,2454025,2454025,2454518,0,0,0,493
1648,2456103,2456103,2457454,0,0,0,1351
1649,2457662,2457662,2457821,0,0,0,159
1650,2457827,2457827,2459394,0,0,0,1567
1651,2459432,2459432,2459703,0,0,0,271
1652,2459703,2459703,2460703,0,0,0,1000
1653,2460702,2460702,2460935,0,0,0,233
1654,2461674,2461674,2461798,0,0,0,124
1656,2466068,2466068,2466332,0,0,0,264
1657,2469587,2469587,2469851,0,0,0,264
1658,2473226,2473226,2473316,0,0,0,90
1659,2473410,2473410,2473503,0,0,0,93
1660,2474113,2474113,2474199,0,0,0,86
1661,2474275,2474275,2474368,0,0,0,93
1662,2474420,2474420,2474555,0,0,0,135
1663,2474669,2474669,2474761,0,0,0,92
1664,2475069,2475069,2475195,0,0,0,126
1665,2475174,2475174,2475458,0,0,0,284
1667,2475605,2475605,2475697,0,0,0,92
1666,2475438,2475438,2476499,0,0,0,1061
1668,2477491,2477491,2477618,0,0,0,127
1669,2477607,2477607,2477734,0,0,0,127
1670,2477792,2477792,2477922,0,0,0,130
1671,2477910,2477910,2478417,0,0,0,507
1672,2478506,2478506,2480035,0,0,0,1529
1673,2480450,2480450,2480782,0,0,0,332
1675,2481068,2481068,2482709,0,0,0,1641
1676,2482944,2482944,2483223,0,0,0,279
1677,2483192,2483192,2483492,0,0,0,300
1674,2480946,2480946,2483776,0,0,0,2830
1678,2483708,2483708,2484239,0,0,0,531
1679,2484355,2484355,2484508,0,0,0,153
1680,2484518,2484518,2485034,0,0,0,516
1681,2485008,2485008,2485367,0,0,0,359
1682,2485773,2485773,2486311,0,0,0,538
1683,2487463,2487463,2487550,0,0,0,87
1684,2487731,2487731,2487815,0,0,0,84
1685,2487829,2487829,2488236,0,0,0,407
1686,2488206,2488206,2488719,0,0,0,513
1687,2489518,2489518,2489665,0,0,0,147
1688,2490634,2490634,2490883,0,0,0,249
1689,2492056,2492056,2492194,0,0,0,138
1690,2492787,2492787,2492933,0,0,0,146
1691,2493257,2493257,2493403,0,0,0,146
1692,2493772,2493772,2493918,0,0,0,146
1693,2494414,2494414,2494560,0,0,0,146
1695,2494644,2494644,2494790,0,0,0,146
1697,2494898,2494898,2495044,0,0,0,146
1694,2494639,2494639,2495106,0,0,0,467
1698,2495042,2495042,2495188,0,0,0,146
1700,2498153,2498153,2498247,0,0,0,94
1696,2494699,2494699,2498400,0,0,0,3701
1699,2496725,2496725,2499074,0,0,0,2349
1636,2400587,2400587,2502567,0,0,0,101980
1701,2499025,2499025,2506039,0,0,0,7014
1635,2400122,2400122,2521091,0,0,0,120969
1705,2525115,2525115,2525199,0,0,0,84
1706,2525500,2525500,2525678,0,0,0,178
1702,2524385,2524385,2525747,0,0,0,1362
1707,2526110,2526110,2528014,0,0,0,1904
1655,2463695,2463695,2528495,0,0,0,64800
1632,2355810,2355810,2528610,0,0,0,172800
1709,2527878,2528610,2528870,0,0,732,992
1714,2541870,2541870,2542145,0,0,0,275
1715,2542280,2542280,2542542,0,0,0,262
1716,2542490,2542490,2542762,0,0,0,272
1718,2550421,2550421,2550479,0,0,0,58
1719,2552426,2552426,2552516,0,0,0,90
1720,2552556,2552556,2552649,0,0,0,93
1721,2552786,2552786,2552878,0,0,0,92
1722,2554698,2554698,2554786,0,0,0,88
1717,2543104,2543104,2555009,0,0,0,11905
1723,2556310,2556310,2556501,0,0,0,191
1724,2556486,2556486,2556573,0,0,0,87
1725,2556963,2556963,2557109,0,0,0,146
1726,2562365,2562365,2562450,0,0,0,85
1727,2562862,2562862,2562949,0,0,0,87
1728,2580613,2580613,2580702,0,0,0,89
1729,2581992,2581992,2582084,0,0,0,92
1730,2582233,2582233,2582326,0,0,0,93
1731,2582380,2582380,2582476,0,0,0,96
1732,2582731,2582731,2582821,0,0,0,90
1733,2583291,2583291,2583379,0,0,0,88
1734,2583840,2583840,2584326,0,0,0,486
1735,2584161,2584161,2584551,0,0,0,390
1736,2585390,2585390,2585649,0,0,0,259
1638,2443422,2443422,2606958,0,0,0,163536
1637,2443389,2443389,2609440,0,0,0,166051
1737,2609890,2609890,2611090,0,0,0,1200
1708,2526162,2526162,2612562,0,0,0,86400
1639,2443456,2443456,2613488,0,0,0,170032
1640,2443518,2443518,2614350,0,0,0,170832
1738,2616920,2616920,2617014,0,0,0,94
1739,2617460,2617460,2617557,0,0,0,97
1741,2625638,2625638,2625728,0,0,0,90
1742,2625738,2625738,2625853,0,0,0,115
1743,2626640,2626640,2627199,0,0,0,559
1745,2627147,2627147,2627615,0,0,0,468
1746,2627845,2627845,2628194,0,0,0,349
1747,2627933,2627933,2628412,0,0,0,479
1748,2628385,2628385,2629007,0,0,0,622
1750,2630279,2630279,2630507,0,0,0,228
1749,2629036,2629036,2631393,0,0,0,2357
1751,2631753,2631753,2633287,0,0,0,1534
1752,2634411,2634411,2635530,0,0,0,1119
1710,2540857,2540857,2636095,0,0,0,95238
1754,2637943,2637943,2638035,0,0,0,92
1753,2635546,2635546,2638549,0,0,0,3003
1712,2540955,2540955,2639498,0,0,0,98543
1756,2638533,2638533,2639573,0,0,0,1040
1711,2540937,2540937,2639590,0,0,0,98653
1758,2640001,2640001,2640023,0,0,0,22
1713,2540970,2540970,2640488,0,0,0,99518
1759,2640416,2640416,2640531,0,0,0,115
1757,2639670,2639670,2640758,0,0,0,1088
1755,2638050,2638050,2641652,0,0,0,3602
1763,2642723,2642723,2642824,0,0,0,101
1764,2642754,2642754,2642848,0,0,0,94
1767,2643060,2643060,2643289,0,0,0,229
1761,2641565,2641565,2643945,0,0,0,2380
1769,2647338,2647338,2647453,0,0,0,115
1762,2641915,2641915,2651244,0,0,0,9329
1704,2524430,2524430,2658108,0,0,0,133678
1770,2652802,2652802,2660467,0,0,0,7665
1768,2643922,2643922,2662862,0,0,0,18940
1773,2664257,2664257,2664314,0,0,0,57
1774,2664290,2664290,2664345,0,0,0,55
1775,2664319,2664319,2664375,0,0,0,56
1776,2664358,2664358,2664410,0,0,0,52
1777,2665935,2665935,2665993,0,0,0,58
1778,2666075,2666075,2666086,0,0,0,11
1779,2666285,2666285,2666297,0,0,0,12
1780,2666356,2666356,2666366,0,0,0,10
1781,2666503,2666503,2666561,0,0,0,58
1782,2667175,2667175,2667228,0,0,0,53
1783,2667455,2667455,2667672,0,0,0,217
1703,2524407,2524407,2678699,0,0,0,154292
1772,2662837,2662837,2719968,0,0,0,57131
1744,2626804,2626804,2723364,0,0,0,96560
1786,2717232,2717232,2723492,0,0,0,6260
1788,2723718,2723718,2724101,0,0,0,383
1787,2723710,2723710,2724132,0,0,0,422
1789,2724097,2724097,2724674,0,0,0,577
1760,2640808,2640808,2727208,0,0,0,86400
1771,2662555,2662555,2737744,0,0,0,75189
1785,2714499,2714499,2783725,0,0,0,69226
1740,2618338,2618338,2790259,0,0,0,171921
1795,2788538,2788538,2803828,0,0,0,15290
1790,2724136,2724136,2803901,0,0,0,79765
1797,2803847,2803847,2805080,0,0,0,1233
1784,2667690,2667690,2812313,0,0,0,144623
1801,2812347,2812347,2812623,0,0,0,276
1791,2738623,2738623,2814007,0,0,0,75384
1766,2642937,2642937,2819530,0,0,0,176593
1765,2642910,2642910,2820487,0,0,0,177577
1807,2824286,2824286,2830751,0,0,0,6465
1799,2805328,2805328,2880757,0,0,0,75429
1814,2881936,2881936,2882030,0,0,0,94
1815,2882330,2882330,2882423,0,0,0,93
1816,2884238,2884238,2884717,0,0,0,479
1817,2884639,2884639,2884830,0,0,0,191
1806,2814107,2814107,2889331,0,0,0,75224
1819,2889237,2889237,2889381,0,0,0,144
1821,2889397,2889397,2889492,0,0,0,95
1820,2889265,2889265,2889631,0,0,0,366
1823,2889558,2889558,2889748,0,0,0,190
1818,2884806,2884806,2890806,0,0,0,6000
1824,2890802,2890802,2890901,0,0,0,99
1826,2892763,2892763,2892947,0,0,0,184
1828,2895476,2895476,2895573,0,0,0,97
1825,2890871,2890871,2896871,0,0,0,6000
1832,2905414,2905414,2905507,0,0,0,93
1833,2905571,2905571,2905749,0,0,0,178
1834,2905771,2905771,2905894,0,0,0,123
1835,2905912,2905912,2906000,0,0,0,88
1831,2900676,2900676,2906676,0,0,0,6000
1794,2740675,2740675,2907840,0,0,0,167165
1792,2739168,2739168,2908123,0,0,0,168955
1793,2740109,2740109,2908200,0,0,0,168091
1796,2788580,2788580,2920746,0,0,0,132166
1839,2924104,2924104,2924380,0,0,0,276
1840,2924411,2924411,2924663,0,0,0,252
1841,2924697,2924697,2924956,0,0,0,259
1842,2925216,2925216,2925517,0,0,0,301
1843,2925385,2925385,2925637,0,0,0,252
1798,2803897,2803897,2950914,0,0,0,147017
1844,2961619,2961619,2961735,0,0,0,116
1845,2962137,2962137,2962294,0,0,0,157
1847,2962651,2962651,2962736,0,0,0,85
1848,2962976,2962976,2963072,0,0,0,96
1850,2963277,2963277,2963506,0,0,0,229
1849,2962982,2962982,2964231,0,0,0,1249
1851,2966318,2966318,2967704,0,0,0,1386
1800,2812270,2812270,2969847,0,0,0,157577
1854,2970564,2970564,2970623,0,0,0,59
1856,2971810,2971810,2972088,0,0,0,278
1812,2862081,2880757,2974877,0,0,18676,112796
1852,2967991,2967991,2975039,0,0,0,7048
1804,2812548,2812548,2976182,0,0,0,163634
1860,2975730,2975730,2976217,0,0,0,487
1862,2976539,2976539,2978271,0,0,0,1732
1805,2812576,2812623,2978645,0,0,47,166069
1863,2978241,2978241,2978711,0,0,0,470
1864,2978810,2978810,2979069,0,0,0,259
1865,2979119,2979119,2979364,0,0,0,245
1813,2862114,2880757,2980326,0,0,18643,118212
1810,2862051,2880757,2980535,0,0,18706,118484
1827,2894330,2894330,2980730,0,0,0,86400
1866,2979395,2979395,2981654,0,0,0,2259
1811,2862061,2880757,2981886,0,0,18696,119825
1867,2982287,2982287,2982404,0,0,0,117
1802,2812376,2812376,2982518,0,0,0,170142
1869,2983072,2983072,2983218,0,0,0,146
1803,2812425,2812425,2983621,0,0,0,171196
1861,2976058,2983621,2983726,0,0,7563,7668
1870,2984878,2984878,2984965,0,0,0,87
1872,2985393,2985393,2985459,0,0,0,66
1871,2985326,2985326,2985503,0,0,0,177
1873,2985467,2985467,2985549,0,0,0,82
1875,2985792,2985792,2985882,0,0,0,90
1874,2985786,2985786,2985960,0,0,0,174
1876,2985917,2985917,2986012,0,0,0,95
1878,2986282,2986282,2986386,0,0,0,104
1877,2986275,2986275,2986463,0,0,0,188
1879,2986572,2986572,2986705,0,0,0,133
1880,2986658,2986658,2986760,0,0,0,102
1881,2986694,2986694,2986885,0,0,0,191
1883,2987274,2987274,2987400,0,0,0,126
1884,2987386,2987386,2987512,0,0,0,126
1885,2987510,2987510,2987625,0,0,0,115
1882,2987035,2987035,2987935,0,0,0,900
1887,2988236,2988236,2988371,0,0,0,135
1888,2988487,2988487,2988615,0,0,0,128
1889,2990665,2990665,2991565,0,0,0,900
1890,2993006,2993006,2993906,0,0,0,900
1829,2895496,2895573,2996657,0,0,77,101161
1891,2999757,2999757,3000657,0,0,0,900
1830,2895715,2907840,3009551,0,0,12125,113836
1809,2837738,2837738,3012280,0,0,0,174542
1808,2837709,2837709,3012961,0,0,0,175252
1868,2982433,2982433,3019033,0,0,0,36600
1855,2971584,2971584,3036384,0,0,0,64800
1892,3012672,3012672,3042078,0,0,0,29406
1893,3012952,3012952,3042078,0,0,0,29126
1894,3047143,3047143,3049357,0,0,0,2214
1895,3054575,3054575,3054827,0,0,0,252
1896,3055207,3055207,3055455,0,0,0,248
1897,3055720,3055720,3056177,0,0,0,457
1836,2907798,2908123,3075728,0,0,325,167930
1837,2908080,2908200,3078993,0,0,120,170913
1838,2908158,2920746,3090239,0,0,12588,182081
1853,2969802,2969802,3095399,0,0,0,125597
1859,2972279,2978645,3103085,0,0,6366,130806
1858,2972271,2974877,3103238,0,0,2606,130967
1846,2962284,2962284,3108520,0,0,0,146236
1822,2889451,2889451,3113190,0,0,0,223739
1903,3118053,3118053,3118159,0,0,0,106
1904,3118070,3118070,3118172,0,0,0,102
1857,2972261,2978645,3121136,0,0,6384,148875
1898,3056192,3056192,3122772,0,0,0,66580
1910,3135967,3135967,3136320,0,0,0,353
1911,3138830,3138830,3139133,0,0,0,303
1912,3139416,3139416,3139459,0,0,0,43
1913,3139432,3139432,3141025,0,0,0,1593
1915,3140559,3140559,3144209,0,0,0,3650
1916,3142781,3142781,3144468,0,0,0,1687
1917,3146543,3146543,3146966,0,0,0,423
1918,3146665,3146665,3149371,0,0,0,2706
1921,3158888,3158888,3158956,0,0,0,68
1922,3159404,3159404,3159452,0,0,0,48
1923,3159457,3159457,3159515,0,0,0,58
1924,3159645,3159645,3159692,0,0,0,47
1925,3160049,3160049,3160107,0,0,0,58
1926,3160173,3160173,3160220,0,0,0,47
1927,3160419,3160419,3160466,0,0,0,47
1930,3163976,3163976,3169122,0,0,0,5146
1933,3178307,3178307,3178372,0,0,0,65
1934,3182410,3182410,3182526,0,0,0,116
1935,3183476,3183476,3183540,0,0,0,64
1886,2987638,2987638,3190492,0,0,0,202854
1936,3191641,3191641,3205054,0,0,0,13413
1937,3191847,3191847,3207710,0,0,0,15863
1938,3192052,3192052,3209390,0,0,0,17338
1944,3218077,3218077,3218125,0,0,0,48
1950,3220567,3220567,3220625,0,0,0,58
1942,3217179,3217179,3221877,0,0,0,4698
1905,3118087,3118087,3223324,0,0,0,105237
1920,3148596,3148596,3224070,0,0,0,75474
1977,3226083,3226083,3226413,0,0,0,330
1906,3118100,3118100,3226893,0,0,0,108793
1902,3095400,3095400,3227648,0,0,0,132248
1980,3227180,3227180,3228574,0,0,0,1394
1987,3229468,3229468,3229583,0,0,0,115
1988,3229560,3229560,3229914,0,0,0,354
1941,3217071,3217071,3233118,0,0,0,16047
1939,3216816,3216816,3233691,0,0,0,16875
1957,3221529,3221529,3234282,0,0,0,12753
1952,3221182,3221182,3234287,0,0,0,13105
1955,3221397,3221397,3234298,0,0,0,12901
1958,3221597,3221597,3234299,0,0,0,12702
1948,3220407,3220407,3234302,0,0,0,13895
1951,3220657,3220657,3234307,0,0,0,13650
1956,3221487,3221487,3234310,0,0,0,12823
1959,3221641,3221641,3234317,0,0,0,12676
1954,3221325,3221325,3234327,0,0,0,13002
1953,3221239,3221239,3234372,0,0,0,13133
1940,3216918,3216918,3234405,0,0,0,17487
1949,3220486,3220486,3234409,0,0,0,13923
1947,3220354,3220354,3234448,0,0,0,14094
1968,3222724,3222724,3236576,0,0,0,13852
1945,3218219,3218219,3236588,0,0,0,18369
1961,3221774,3221774,3236592,0,0,0,14818
1963,3222071,3222071,3236598,0,0,0,14527
1966,3222663,3222663,3236599,0,0,0,13936
1965,3222621,3222621,3236608,0,0,0,13987
1943,3217674,3217674,3236611,0,0,0,18937
1976,3223090,3223090,3236631,0,0,0,13541
1960,3221727,3221727,3236636,0,0,0,14909
1962,3222024,3222024,3236656,0,0,0,14632
1964,3222565,3222565,3236763,0,0,0,14198
1967,3222697,3222697,3236773,0,0,0,14076
1946,3218331,3218331,3236853,0,0,0,18522
1970,3222827,3222827,3236857,0,0,0,14030
1972,3222882,3222882,3236858,0,0,0,13976
1971,3222856,3222856,3236859,0,0,0,14003
1973,3222933,3222933,3236862,0,0,0,13929
1975,3223050,3223050,3236883,0,0,0,13833
1969,3222784,3222784,3236895,0,0,0,14111
1974,3223023,3223023,3237050,0,0,0,14027
1978,3226116,3226116,3240939,0,0,0,14823
1983,3227721,3227721,3240979,0,0,0,13258
1984,3227772,3227772,3240997,0,0,0,13225
1979,3226156,3226156,3241078,0,0,0,14922
1986,3229443,3229443,3243155,0,0,0,13712
1899,3075406,3075406,3244571,0,0,0,169165
1990,3232235,3232235,3245279,0,0,0,13044
2010,3245719,3245719,3245856,0,0,0,137
2014,3245828,3245828,3246029,0,0,0,201
1989,3232188,3232188,3246086,0,0,0,13898
2017,3246043,3246043,3246169,0,0,0,126
1900,3077650,3077650,3246247,0,0,0,168597
1996,3237484,3237484,3247967,0,0,0,10483
1995,3236845,3236845,3248100,0,0,0,11255
1992,3236746,3236746,3248684,0,0,0,11938
1997,3237561,3237561,3248693,0,0,0,11132
1993,3236779,3236779,3248734,0,0,0,11955
1998,3237628,3237628,3248751,0,0,0,11123
2000,3237749,3237749,3248765,0,0,0,11016
1999,3237696,3237696,3248787,0,0,0,11091
1994,3236811,3236811,3248801,0,0,0,11990
1991,3236712,3236712,3248833,0,0,0,12121
1901,3078872,3078872,3249602,0,0,0,170730
2001,3237902,3237902,3249746,0,0,0,11844
2003,3238152,3238152,3249800,0,0,0,11648
2002,3238063,3238063,3250650,0,0,0,12587
2007,3241251,3241251,3253933,0,0,0,12682
2006,3241217,3241217,3254040,0,0,0,12823
2005,3241172,3241172,3254446,0,0,0,13274
2018,3246149,3246149,3255480,0,0,0,9331
2015,3245847,3245847,3259436,0,0,0,13589
2013,3245806,3245806,3259489,0,0,0,13683
2011,3245719,3245719,3259573,0,0,0,13854
2009,3245675,3245675,3259579,0,0,0,13904
2016,3245906,3245906,3259658,0,0,0,13752
2012,3245765,3245765,3259667,0,0,0,13902
1929,3163901,3163901,3262591,0,0,0,98690
2024,3248928,3248928,3263167,0,0,0,14239
2022,3248872,3248872,3263176,0,0,0,14304
2023,3248900,3248900,3263323,0,0,0,14423
1928,3163826,3163826,3263328,0,0,0,99502
1931,3164056,3164056,3263508,0,0,0,99452
1932,3164139,3164139,3264014,0,0,0,99875
2004,3238965,3238965,3264727,0,0,0,25762
2029,3251971,3251971,3265294,0,0,0,13323
2026,3250609,3250609,3265311,0,0,0,14702
2027,3251891,3251891,3265321,0,0,0,13430
2028,3251926,3251926,3265353,0,0,0,13427
2050,3267970,3267970,3268143,0,0,0,173
2031,3253912,3253912,3268404,0,0,0,14492
2030,3253839,3253839,3268575,0,0,0,14736
2056,3269300,3269300,3269635,0,0,0,335
2059,3271424,3271424,3271472,0,0,0,48
2045,3262491,3262491,3274299,0,0,0,11808
2042,3262323,3262323,3274302,0,0,0,11979
2043,3262375,3262375,3274307,0,0,0,11932
2041,3262273,3262273,3274310,0,0,0,12037
2038,3261977,3261977,3274311,0,0,0,12334
2046,3262533,3262533,3274316,0,0,0,11783
2040,3262177,3262177,3274321,0,0,0,12144
2047,3262648,3262648,3274336,0,0,0,11688
2039,3262105,3262105,3274344,0,0,0,12239
2044,3262450,3262450,3274355,0,0,0,11905
2048,3267883,3267883,3280078,0,0,0,12195
2049,3267928,3267928,3280088,0,0,0,12160
2051,3268155,3268155,3280094,0,0,0,11939
2053,3268260,3268260,3280116,0,0,0,11856
2052,3268212,3268212,3280255,0,0,0,12043
2054,3268346,3268346,3280264,0,0,0,11918
2057,3269356,3269356,3280310,0,0,0,10954
2020,3247877,3247877,3280488,0,0,0,32611
2060,3271485,3271485,3283430,0,0,0,11945
2058,3271364,3271364,3283450,0,0,0,12086
1909,3135612,3135612,3286214,0,0,0,150602
2034,3259361,3259361,3295687,0,0,0,36326
1908,3135570,3135570,3307255,0,0,0,171685
2072,3307230,3307255,3307350,0,0,25,120
2073,3307261,3307350,3307443,0,0,89,182
2064,3300602,3300602,3310297,0,0,0,9695
2067,3300780,3300780,3310309,0,0,0,9529
2062,3300519,3300519,3310361,0,0,0,9842
2063,3300559,3300559,3310372,0,0,0,9813
2065,3300685,3300685,3310373,0,0,0,9688
2068,3300827,3300827,3310485,0,0,0,9658
2066,3300728,3300728,3310564,0,0,0,9836
1907,3132847,3132847,3312779,0,0,0,179932
1985,3228957,3228957,3315357,0,0,0,86400
2061,3280590,3280590,3321620,0,0,0,41030
2075,3307561,3321620,3322002,0,0,14059,14441
2077,3322208,3322208,3329037,0,0,0,6829
2055,3268977,3268977,3329049,0,0,0,60072
2070,3301313,3301313,3329057,0,0,0,27744
2071,3301526,3301526,3329057,0,0,0,27531
2069,3301144,3301144,3329060,0,0,0,27916
2080,3329055,3329055,3340935,0,0,0,11880
2081,3329121,3329121,3342281,0,0,0,13160
2033,3258481,3258481,3361877,0,0,0,103396
2032,3258468,3258468,3367254,0,0,0,108786
2021,3247943,3247943,3367396,0,0,0,119453
1982,3227602,3227602,3371736,0,0,0,144134
2084,3349986,3349986,3375619,0,0,0,25633
2083,3349656,3349656,3385810,0,0,0,36154
1914,3139983,3139983,3399183,0,0,0,259200
2079,3323532,3361877,3405203,0,0,38345,81671
1919,3147476,3147476,3406676,0,0,0,259200
2093,3400668,3406676,3406948,0,0,6008,6280
2008,3244528,3244528,3412116,0,0,0,167588
2019,3246206,3246206,3415291,0,0,0,169085
2025,3249561,3249561,3417889,0,0,0,168328
2037,3260293,3260293,3423952,0,0,0,163659
2035,3260070,3260070,3426487,0,0,0,166417
2078,3322830,3426487,3426603,0,0,103657,103773
1981,3227430,3227430,3436445,0,0,0,209015
2094,3407353,3426603,3436952,0,0,19250,29599
2107,3433529,3433529,3451777,0,0,0,18248
2106,3433401,3433401,3453682,0,0,0,20281
2036,3260175,3286214,3457212,0,0,26039,197037
2101,3431661,3431661,3457319,0,0,0,25658
2105,3433284,3433284,3458887,0,0,0,25603
2100,3431608,3431608,3467681,0,0,0,36073
2108,3435787,3436952,3468610,0,0,1165,32823
2104,3432388,3432388,3474887,0,0,0,42499
2086,3370737,3371736,3475277,0,0,999,104540
2111,3477913,3477913,3478138,0,0,0,225
2087,3370755,3371736,3480666,0,0,981,109911
2114,3485222,3485222,3485746,0,0,0,524
2115,3485488,3485488,3486218,0,0,0,730
2116,3486281,3486281,3486685,0,0,0,404
2118,3487838,3487838,3488062,0,0,0,224
2119,3488293,3488293,3488554,0,0,0,261
2120,3488499,3488499,3488760,0,0,0,261
2121,3488502,3488502,3488774,0,0,0,272
2122,3488716,3488716,3489316,0,0,0,600
2117,3487797,3487797,3490695,0,0,0,2898
2123,3491991,3491991,3492231,0,0,0,240
2125,3493289,3493289,3493900,0,0,0,611
2127,3494557,3494557,3494776,0,0,0,219
2128,3495304,3495304,3495517,0,0,0,213
2130,3495882,3495882,3496220,0,0,0,338
2131,3496241,3496241,3496709,0,0,0,468
2088,3370794,3399183,3497998,0,0,28389,127204
2113,3478293,3478293,3498026,0,0,0,19733
2089,3370819,3399183,3498196,0,0,28364,127377
2132,3496771,3496771,3500096,0,0,0,3325
2090,3370856,3399183,3500415,0,0,28327,129559
2135,3500078,3500078,3500929,0,0,0,851
2137,3501233,3501233,3501367,0,0,0,134
2091,3370866,3399183,3501374,0,0,28317,130508
2085,3367400,3371736,3501498,0,0,4336,134098
2138,3501356,3501356,3501504,0,0,0,148
2139,3501480,3501480,3501614,0,0,0,134
2140,3501675,3501675,3501821,0,0,0,146
2145,3502211,3502211,3502479,0,0,0,268
2109,3476667,3476667,3502672,0,0,0,26005
2146,3502584,3502584,3502860,0,0,0,276
2147,3503296,3503296,3503436,0,0,0,140
2133,3497362,3497362,3503925,0,0,0,6563
2148,3504163,3504163,3504427,0,0,0,264
2136,3500929,3500929,3504460,0,0,0,3531
2149,3504831,3504831,3504967,0,0,0,136
2151,3505473,3505473,3505746,0,0,0,273
2150,3505438,3505438,3505822,0,0,0,384
2152,3505913,3505913,3506289,0,0,0,376
2153,3506772,3506772,3506957,0,0,0,185
2154,3506934,3506934,3507122,0,0,0,188
2157,3508196,3508196,3508285,0,0,0,89
2158,3508246,3508246,3508393,0,0,0,147
2159,3508854,3508854,3509001,0,0,0,147
2161,3511238,3511238,3511422,0,0,0,184
2110,3476690,3476690,3513199,0,0,0,36509
2092,3371694,3399183,3522935,0,0,27489,151241
2134,3497405,3497405,3532455,0,0,0,35050
2098,3421278,3421278,3559754,0,0,0,138476
2074,3307541,3307541,3566741,0,0,0,259200
2155,3507122,3507122,3571703,0,0,0,64581
2163,3570339,3570339,3572088,0,0,0,1749
2164,3572707,3572707,3572842,0,0,0,135
2167,3573292,3573292,3574173,0,0,0,881
2165,3573016,3573016,3574178,0,0,0,1162
2169,3573874,3573874,3574197,0,0,0,323
2172,3574530,3574530,3574707,0,0,0,177
2171,3574273,3574273,3574709,0,0,0,436
2168,3573865,3573865,3574811,0,0,0,946
2173,3574721,3574721,3574901,0,0,0,180
2174,3574831,3574831,3575061,0,0,0,230
2176,3575650,3575650,3575691,0,0,0,41
2175,3575002,3575002,3575803,0,0,0,801
2178,3575697,3575697,3575812,0,0,0,115
2177,3575666,3575666,3575823,0,0,0,157
2180,3575788,3575788,3576008,0,0,0,220
2179,3575786,3575786,3576148,0,0,0,362
2181,3575891,3575891,3576148,0,0,0,257
2182,3576126,3576126,3576656,0,0,0,530
2183,3576969,3576969,3577856,0,0,0,887
2170,3574075,3574075,3578233,0,0,0,4158
2166,3573247,3573247,3578381,0,0,0,5134
2095,3412084,3412084,3579613,0,0,0,167529
2185,3580440,3580440,3580802,0,0,0,362
2186,3580748,3580748,3580895,0,0,0,147
2187,3580894,3580894,3581137,0,0,0,243
2188,3581009,3581009,3581137,0,0,0,128
2076,3307975,3322002,3581173,0,0,14027,273198
2189,3581115,3581115,3581427,0,0,0,312
2190,3581314,3581314,3581436,0,0,0,122
2192,3584562,3584562,3584783,0,0,0,221
2096,3415249,3415249,3585449,0,0,0,170200
2097,3417847,3417847,3585461,0,0,0,167614
2191,3581533,3581533,3586589,0,0,0,5056
2195,3586555,3586555,3586647,0,0,0,92
2196,3586866,3586866,3586958,0,0,0,92
2197,3587943,3587943,3588337,0,0,0,394
2199,3589021,3589021,3589147,0,0,0,126
2198,3588845,3588845,3589149,0,0,0,304
2200,3589287,3589287,3589473,0,0,0,186
2082,3331853,3367396,3590774,0,0,35543,258921
2202,3593914,3593914,3594194,0,0,0,280
2201,3589545,3589545,3595545,0,0,0,6000
2160,3509591,3509591,3595991,0,0,0,86400
2203,3597372,3597372,3597764,0,0,0,392
2102,3432175,3432175,3604975,0,0,0,172800
2103,3432283,3432283,3605083,0,0,0,172800
2206,3614510,3614510,3614552,0,0,0,42
2207,3614701,3614701,3614945,0,0,0,244
2208,3615006,3615006,3615273,0,0,0,267
2209,3615122,3615122,3615368,0,0,0,246
2212,3618339,3618339,3618577,0,0,0,238
2129,3495450,3495450,3618618,0,0,0,123168
2213,3618399,3618399,3618694,0,0,0,295
2126,3493542,3493542,3637743,0,0,0,144201
2204,3612740,3612740,3638454,0,0,0,25714
2205,3612975,3612975,3649045,0,0,0,36070
2112,3478105,3478105,3650905,0,0,0,172800
2142,3502046,3502046,3651963,0,0,0,149917
2141,3502017,3502017,3651967,0,0,0,149950
2156,3508150,3508150,3653661,0,0,0,145511
2216,3653487,3653487,3654285,0,0,0,798
2144,3502194,3502194,3654786,0,0,0,152592
2143,3502189,3502189,3655252,0,0,0,153063
2218,3656255,3656255,3656555,0,0,0,300
2217,3655625,3655625,3657186,0,0,0,1561
2219,3656364,3656364,3657199,0,0,0,835
2220,3660486,3660486,3660746,0,0,0,260
2221,3660786,3660786,3661110,0,0,0,324
2222,3661090,3661090,3661320,0,0,0,230
2223,3661302,3661302,3661437,0,0,0,135
2224,3661599,3661599,3661830,0,0,0,231
2225,3661901,3661901,3662067,0,0,0,166
2226,3666208,3666208,3666830,0,0,0,622
2227,3667461,3667461,3668021,0,0,0,560
2228,3668042,3668042,3668252,0,0,0,210
2229,3668227,3668227,3668435,0,0,0,208
2230,3669341,3669341,3669585,0,0,0,244
2231,3669577,3669577,3669913,0,0,0,336
2232,3669923,3669923,3670100,0,0,0,177
2233,3670117,3670117,3670364,0,0,0,247
2234,3670353,3670353,3670542,0,0,0,189
2124,3492276,3492276,3672313,0,0,0,180037
2099,3421282,3436952,3674788,0,0,15670,253506
2236,3683872,3683872,3683984,0,0,0,112
2237,3683872,3683872,3683984,0,0,0,112
2238,3683873,3683873,3683985,0,0,0,112
2239,3683873,3683873,3683985,0,0,0,112
2240,3683873,3683873,3683985,0,0,0,112
2241,3683873,3683873,3683985,0,0,0,112
2242,3683873,3683873,3683985,0,0,0,112
2243,3683874,3683874,3683986,0,0,0,112
2244,3683874,3683874,3683986,0,0,0,112
2245,3683874,3683874,3683986,0,0,0,112
2246,3683874,3683874,3683997,0,0,0,123
2247,3683875,3683875,3683998,0,0,0,123
2248,3683875,3683875,3683998,0,0,0,123
2249,3683875,3683875,3684009,0,0,0,134
2250,3683875,3683875,3684020,0,0,0,145
2251,3683875,3683875,3684020,0,0,0,145
2252,3683876,3683876,3684021,0,0,0,145
2253,3683876,3683876,3684032,0,0,0,156
2254,3683876,3683876,3684032,0,0,0,156
2255,3683876,3683876,3684043,0,0,0,167
2256,3683979,3683979,3685515,0,0,0,1536
2257,3683979,3683979,3685515,0,0,0,1536
2258,3684495,3684495,3685581,0,0,0,1086
2263,3684496,3684496,3685582,0,0,0,1086
2268,3684497,3684497,3685583,0,0,0,1086
2269,3684497,3684497,3685583,0,0,0,1086
2272,3684498,3684498,3685584,0,0,0,1086
2259,3684495,3684495,3685592,0,0,0,1097
2260,3684495,3684495,3685592,0,0,0,1097
2261,3684495,3684495,3685592,0,0,0,1097
2264,3684496,3684496,3685593,0,0,0,1097
2265,3684496,3684496,3685593,0,0,0,1097
2266,3684496,3684496,3685593,0,0,0,1097
2270,3684497,3684497,3685594,0,0,0,1097
2273,3684498,3684498,3685595,0,0,0,1097
2274,3684498,3684498,3685595,0,0,0,1097
2275,3684498,3684498,3685595,0,0,0,1097
2276,3684498,3684498,3685595,0,0,0,1097
2262,3684495,3684495,3685603,0,0,0,1108
2267,3684496,3684496,3685604,0,0,0,1108
2271,3684497,3684497,3685605,0,0,0,1108
2277,3684499,3684499,3685607,0,0,0,1108
2278,3684499,3684499,3685607,0,0,0,1108
2280,3684989,3684989,3686077,0,0,0,1088
2281,3684990,3684990,3686078,0,0,0,1088
2288,3684992,3684992,3686080,0,0,0,1088
2292,3684993,3684993,3686081,0,0,0,1088
2296,3684994,3684994,3686082,0,0,0,1088
2297,3684994,3684994,3686082,0,0,0,1088
2279,3684989,3684989,3686088,0,0,0,1099
2282,3684990,3684990,3686089,0,0,0,1099
2283,3684990,3684990,3686089,0,0,0,1099
2284,3684991,3684991,3686090,0,0,0,1099
2285,3684991,3684991,3686090,0,0,0,1099
2286,3684991,3684991,3686090,0,0,0,1099
2289,3684992,3684992,3686091,0,0,0,1099
2290,3684992,3684992,3686091,0,0,0,1099
2293,3684993,3684993,3686092,0,0,0,1099
2294,3684993,3684993,3686092,0,0,0,1099
2295,3684993,3684993,3686092,0,0,0,1099
2298,3684994,3684994,3686093,0,0,0,1099
2299,3684994,3684994,3686093,0,0,0,1099
2287,3684991,3684991,3686101,0,0,0,1110
2291,3684992,3684992,3686102,0,0,0,1110
2314,3685703,3685703,3686791,0,0,0,1088
2315,3685703,3685703,3686791,0,0,0,1088
2301,3685699,3685699,3686798,0,0,0,1099
2303,3685700,3685700,3686799,0,0,0,1099
2304,3685700,3685700,3686799,0,0,0,1099
2305,3685700,3685700,3686799,0,0,0,1099
2306,3685700,3685700,3686799,0,0,0,1099
2307,3685701,3685701,3686800,0,0,0,1099
2308,3685701,3685701,3686800,0,0,0,1099
2309,3685701,3685701,3686800,0,0,0,1099
2310,3685702,3685702,3686801,0,0,0,1099
2311,3685702,3685702,3686801,0,0,0,1099
2312,3685702,3685702,3686801,0,0,0,1099
2319,3685704,3685704,3686803,0,0,0,1099
2320,3685704,3685704,3686803,0,0,0,1099
2321,3685704,3685704,3686803,0,0,0,1099
2313,3685702,3685702,3686812,0,0,0,1110
2316,3685703,3685703,3686813,0,0,0,1110
2317,3685703,3685703,3686813,0,0,0,1110
2318,3685703,3685703,3686813,0,0,0,1110
2302,3685699,3685699,3686820,0,0,0,1121
2322,3685961,3685961,3711671,0,0,0,25710
2214,3618569,3618569,3718993,0,0,0,100424
2323,3685968,3685968,3722275,0,0,0,36307
2326,3741250,3741250,3741511,0,0,0,261
2327,3741805,3741805,3742070,0,0,0,265
2328,3741836,3741836,3742099,0,0,0,263
2329,3744924,3744924,3745423,0,0,0,499
2330,3745606,3745606,3745875,0,0,0,269
2331,3746442,3746442,3746706,0,0,0,264
2184,3579569,3579569,3747687,0,0,0,168118
2334,3748033,3748033,3748294,0,0,0,261
2333,3748029,3748029,3748780,0,0,0,751
2349,3748051,3748051,3749083,0,0,0,1032
2350,3748051,3748051,3749094,0,0,0,1043
2351,3748051,3748051,3749110,0,0,0,1059
2354,3748052,3748052,3749111,0,0,0,1059
2347,3748050,3748050,3749162,0,0,0,1112
2348,3748050,3748050,3749174,0,0,0,1124
2355,3748052,3748052,3749176,0,0,0,1124
2352,3748051,3748051,3749385,0,0,0,1334
2353,3748051,3748051,3749396,0,0,0,1345
2335,3748047,3748047,3749397,0,0,0,1350
2337,3748048,3748048,3749398,0,0,0,1350
2338,3748048,3748048,3749398,0,0,0,1350
2341,3748049,3748049,3749399,0,0,0,1350
2342,3748049,3748049,3749399,0,0,0,1350
2345,3748050,3748050,3749400,0,0,0,1350
2346,3748050,3748050,3749400,0,0,0,1350
2336,3748047,3748047,3749408,0,0,0,1361
2339,3748048,3748048,3749409,0,0,0,1361
2343,3748049,3748049,3749421,0,0,0,1372
2340,3748048,3748048,3749431,0,0,0,1383
2344,3748049,3748049,3749432,0,0,0,1383
2374,3749664,3749664,3749765,0,0,0,101
2364,3749662,3749662,3749766,0,0,0,104
2373,3749664,3749664,3749768,0,0,0,104
2357,3749346,3749346,3749897,0,0,0,551
2368,3749663,3749663,3750005,0,0,0,342
2381,3751574,3751574,3751667,0,0,0,93
2382,3751574,3751574,3751671,0,0,0,97
2387,3751575,3751575,3753200,0,0,0,1625
2388,3751575,3751667,3753292,0,0,92,1717
2389,3751576,3751671,3753296,0,0,95,1720
2392,3751576,3753296,3753629,0,0,1720,2053
2393,3751577,3753629,3753745,0,0,2052,2168
2391,3751576,3753292,3753766,0,0,1716,2190
2390,3751576,3753200,3753842,0,0,1624,2266
2394,3751577,3753745,3753852,0,0,2168,2275
2397,3751578,3753852,3753894,0,0,2274,2316
2395,3751577,3753766,3753990,0,0,2189,2413
2396,3751577,3753842,3754013,0,0,2265,2436
2375,3749664,3749664,3754043,0,0,0,4379
2385,3751575,3751575,3754292,0,0,0,2717
2378,3749665,3749665,3754476,0,0,0,4811
2369,3749663,3749663,3754479,0,0,0,4816
2361,3749661,3749661,3754486,0,0,0,4825
2362,3749661,3749661,3754490,0,0,0,4829
2363,3749661,3749661,3754495,0,0,0,4834
2358,3749660,3749660,3754496,0,0,0,4836
2384,3751574,3751574,3754515,0,0,0,2941
2386,3751575,3751575,3754516,0,0,0,2941
2377,3749664,3749664,3754528,0,0,0,4864
2376,3749664,3749664,3754705,0,0,0,5041
2372,3749663,3749663,3754732,0,0,0,5069
2365,3749662,3749662,3754744,0,0,0,5082
2366,3749662,3749662,3754744,0,0,0,5082
2370,3749663,3749663,3754744,0,0,0,5081
2371,3749663,3749663,3754758,0,0,0,5095
2359,3749660,3749660,3754852,0,0,0,5192
2399,3754625,3754625,3754883,0,0,0,258
2360,3749660,3749660,3755006,0,0,0,5346
2367,3749662,3749662,3755053,0,0,0,5391
2194,3585411,3585411,3755206,0,0,0,169795
2383,3751574,3751574,3756226,0,0,0,4652
2380,3751573,3751573,3756415,0,0,0,4842
2235,3670606,3670606,3757006,0,0,0,86400
2398,3753122,3753122,3757135,0,0,0,4013
2379,3750030,3750030,3757230,0,0,0,7200
2402,3757479,3757479,3758079,0,0,0,600
2193,3585407,3585407,3758430,0,0,0,173023
2428,3763237,3763237,3763287,0,0,0,50
2404,3760578,3760578,3763356,0,0,0,2778
2405,3761020,3761020,3763965,0,0,0,2945
2412,3761284,3761284,3766278,0,0,0,4994
2401,3756575,3756575,3766285,0,0,0,9710
2407,3761282,3761282,3766288,0,0,0,5006
2409,3761283,3761283,3766289,0,0,0,5006
2416,3761285,3761285,3766297,0,0,0,5012
2410,3761283,3761283,3766311,0,0,0,5028
2411,3761283,3761283,3766373,0,0,0,5090
2422,3761287,3761287,3766542,0,0,0,5255
2417,3761285,3761285,3766548,0,0,0,5263
2408,3761282,3761282,3766549,0,0,0,5267
2413,3761284,3761284,3766551,0,0,0,5267
2418,3761286,3761286,3766551,0,0,0,5265
2423,3761287,3761287,3766553,0,0,0,5266
2419,3761286,3761286,3766563,0,0,0,5277
2420,3761286,3761286,3766583,0,0,0,5297
2421,3761286,3761286,3766645,0,0,0,5359
2414,3761284,3761284,3766786,0,0,0,5502
2406,3761281,3761281,3766806,0,0,0,5525
2415,3761285,3761285,3766810,0,0,0,5525
2459,3767155,3767155,3767253,0,0,0,98
2460,3767156,3767156,3767286,0,0,0,130
2424,3761287,3763965,3769215,0,0,2678,7928
2437,3764008,3766285,3769324,0,0,2277,5316
2427,3763103,3763103,3771008,0,0,0,7905
2434,3763456,3763456,3771025,0,0,0,7569
2435,3763539,3763539,3771031,0,0,0,7492
2429,3763271,3763271,3771173,0,0,0,7902
2433,3763423,3763423,3771247,0,0,0,7824
2430,3763306,3763306,3771264,0,0,0,7958
2431,3763339,3763339,3771295,0,0,0,7956
2432,3763381,3763381,3771338,0,0,0,7957
2425,3761287,3766278,3771547,0,0,4991,10260
2426,3761288,3766285,3771554,0,0,4997,10266
2436,3763795,3763795,3771670,0,0,0,7875
2450,3766971,3766971,3771961,0,0,0,4990
2451,3766971,3766971,3771966,0,0,0,4995
2452,3766971,3766971,3771967,0,0,0,4996
2441,3766969,3766969,3771971,0,0,0,5002
2453,3766971,3766971,3771981,0,0,0,5010
2449,3766970,3766970,3771995,0,0,0,5025
2455,3766972,3766972,3772047,0,0,0,5075
2456,3766972,3766972,3772214,0,0,0,5242
2444,3766969,3766969,3772234,0,0,0,5265
2439,3766968,3766968,3772235,0,0,0,5267
2440,3766968,3766968,3772243,0,0,0,5275
2442,3766969,3766969,3772243,0,0,0,5274
2438,3766968,3766968,3772244,0,0,0,5276
2457,3766972,3766972,3772244,0,0,0,5272
2446,3766970,3766970,3772250,0,0,0,5280
2443,3766969,3766969,3772254,0,0,0,5285
2454,3766971,3766971,3772276,0,0,0,5305
2445,3766969,3766969,3772318,0,0,0,5349
2464,3767437,3767437,3772415,0,0,0,4978
2461,3767436,3767436,3772430,0,0,0,4994
2447,3766970,3766970,3772471,0,0,0,5501
2458,3766972,3766972,3772472,0,0,0,5500
2448,3766970,3766970,3772494,0,0,0,5524
2462,3767437,3767437,3772722,0,0,0,5285
2463,3767437,3767437,3772981,0,0,0,5544
2482,3768150,3772254,3773111,0,0,4104,4961
2465,3767438,3769215,3774226,0,0,1777,6788
2466,3767438,3769324,3774585,0,0,1886,7147
2467,3767438,3771547,3776808,0,0,4109,9370
2468,3767438,3771554,3776819,0,0,4116,9381
2471,3767439,3771967,3776947,0,0,4528,9508
2474,3767440,3771995,3776976,0,0,4555,9536
2473,3767440,3771981,3776985,0,0,4541,9545
2469,3767439,3771961,3777000,0,0,4522,9561
2470,3767439,3771966,3777058,0,0,4527,9619
2477,3767441,3772234,3777216,0,0,4793,9775
2478,3767441,3772235,3777235,0,0,4794,9794
2481,3767442,3772244,3777255,0,0,4802,9813
2479,3767441,3772243,3777503,0,0,4802,10062
2472,3767439,3771971,3777508,0,0,4532,10069
2480,3767441,3772243,3777508,0,0,4802,10067
2475,3767440,3772047,3777585,0,0,4607,10145
2492,3772767,3772767,3779923,0,0,0,7156
2215,3637701,3637701,3780323,0,0,0,142622
2483,3772527,3772527,3780549,0,0,0,8022
2487,3772616,3772616,3780641,0,0,0,8025
2486,3772592,3772592,3780681,0,0,0,8089
2485,3772564,3772564,3780687,0,0,0,8123
2489,3772684,3772684,3780724,0,0,0,8040
2484,3772551,3772551,3780742,0,0,0,8191
2488,3772653,3772653,3780953,0,0,0,8300
2490,3772730,3772730,3781223,0,0,0,8493
2493,3772805,3772805,3781346,0,0,0,8541
2491,3772749,3772749,3781352,0,0,0,8603
2494,3772886,3772886,3781416,0,0,0,8530
2210,3615668,3615668,3781708,0,0,0,166040
2512,3781920,3781920,3781984,0,0,0,64
2476,3767440,3772214,3782662,0,0,4774,15222
2513,3782964,3782964,3783264,0,0,0,300
2515,3783376,3783376,3783423,0,0,0,47
2514,3783228,3783228,3783560,0,0,0,332
2496,3774723,3774723,3783635,0,0,0,8912
2497,3774756,3774756,3783653,0,0,0,8897
2495,3774693,3774693,3783665,0,0,0,8972
2517,3783599,3783599,3783922,0,0,0,323
2518,3783600,3783600,3783934,0,0,0,334
2519,3783600,3783600,3783934,0,0,0,334
2520,3783600,3783600,3783945,0,0,0,345
2521,3783600,3783600,3783945,0,0,0,345
2522,3783600,3783600,3783956,0,0,0,356
2524,3783601,3783601,3783957,0,0,0,356
2523,3783600,3783600,3783967,0,0,0,367
2525,3783601,3783601,3783968,0,0,0,367
2526,3783601,3783601,3783979,0,0,0,378
2527,3783601,3783601,3783979,0,0,0,378
2528,3783601,3783601,3783979,0,0,0,378
2529,3783663,3783663,3784208,0,0,0,545
2516,3783476,3783476,3784721,0,0,0,1245
2531,3784866,3784866,3784914,0,0,0,48
2499,3777097,3777097,3786117,0,0,0,9020
2498,3777056,3777056,3786370,0,0,0,9314
2500,3777120,3777120,3786521,0,0,0,9401
2211,3615707,3615707,3786727,0,0,0,171020
2507,3779431,3779431,3788529,0,0,0,9098
2506,3779306,3779306,3788732,0,0,0,9426
2508,3779480,3779480,3789192,0,0,0,9712
2511,3781175,3781175,3790329,0,0,0,9154
2510,3781145,3781145,3790755,0,0,0,9610
2162,3564558,3564558,3791188,0,0,0,226630
2545,3792173,3792173,3792220,0,0,0,47
2530,3783831,3783831,3795489,0,0,0,11658
2534,3787102,3787102,3796981,0,0,0,9879
2540,3787162,3787162,3797015,0,0,0,9853
2533,3786541,3786541,3797027,0,0,0,10486
2537,3787126,3787126,3797037,0,0,0,9911
2535,3787105,3787105,3797053,0,0,0,9948
2536,3787108,3787108,3797056,0,0,0,9948
2539,3787136,3787136,3797683,0,0,0,10547
2538,3787133,3787133,3797801,0,0,0,10668
2541,3788556,3788556,3799632,0,0,0,11076
2542,3789811,3789811,3800658,0,0,0,10847
2543,3789871,3789871,3800732,0,0,0,10861
2549,3801150,3801150,3801221,0,0,0,71
2550,3801267,3801267,3802572,0,0,0,1305
2544,3792170,3792170,3803358,0,0,0,11188
2552,3803247,3803247,3803623,0,0,0,376
2546,3792404,3792404,3810544,0,0,0,18140
2532,3785382,3785382,3813139,0,0,0,27757
2565,3823085,3823085,3823136,0,0,0,51
2568,3824355,3824355,3824404,0,0,0,49
2593,3830630,3830630,3830737,0,0,0,107
2551,3802550,3802550,3831617,0,0,0,29067
2548,3797428,3797428,3833428,0,0,0,36000
2594,3830736,3830736,3834312,0,0,0,3576
2595,3830899,3830899,3835078,0,0,0,4179
2600,3834168,3834168,3837486,0,0,0,3318
2559,3822961,3822961,3839464,0,0,0,16503
2564,3823064,3823064,3839466,0,0,0,16402
2556,3822762,3822762,3839504,0,0,0,16742
2563,3823039,3823039,3839521,0,0,0,16482
2557,3822808,3822808,3839526,0,0,0,16718
2554,3822692,3822692,3839557,0,0,0,16865
2560,3822988,3822988,3839578,0,0,0,16590
2567,3823306,3823306,3839589,0,0,0,16283
2558,3822839,3822839,3839591,0,0,0,16752
2562,3823022,3823022,3839591,0,0,0,16569
2566,3823293,3823293,3839617,0,0,0,16324
2561,3823002,3823002,3839644,0,0,0,16642
2555,3822735,3822735,3839660,0,0,0,16925
2553,3822658,3822658,3839827,0,0,0,17169
2607,3836503,3836503,3840334,0,0,0,3831
2611,3841629,3841629,3841681,0,0,0,52
2609,3837621,3837621,3842661,0,0,0,5040
2574,3824762,3824762,3842754,0,0,0,17992
2572,3824726,3824726,3842755,0,0,0,18029
2576,3824801,3824801,3842767,0,0,0,17966
2575,3824783,3824783,3842776,0,0,0,17993
2581,3825023,3825023,3842778,0,0,0,17755
2571,3824712,3824712,3842779,0,0,0,18067
2586,3825544,3825544,3842789,0,0,0,17245
2584,3825350,3825350,3842791,0,0,0,17441
2577,3824820,3824820,3842801,0,0,0,17981
2585,3825520,3825520,3842811,0,0,0,17291
2587,3825591,3825591,3842812,0,0,0,17221
2579,3824857,3824857,3842823,0,0,0,17966
2573,3824742,3824742,3842824,0,0,0,18082
2569,3824543,3824543,3842828,0,0,0,18285
2580,3824983,3824983,3842834,0,0,0,17851
2582,3825065,3825065,3842843,0,0,0,17778
2578,3824841,3824841,3842845,0,0,0,18004
2570,3824671,3824671,3842867,0,0,0,18196
2623,3842844,3842844,3842939,0,0,0,95
2589,3825865,3825865,3843073,0,0,0,17208
2608,3836848,3836848,3843914,0,0,0,7066
2625,3845239,3845239,3845286,0,0,0,47
2622,3842335,3842335,3845718,0,0,0,3383
2300,3685544,3685544,3847636,0,0,0,162092
2590,3829247,3829247,3850847,0,0,0,21600
2591,3829484,3829484,3851084,0,0,0,21600
2604,3835360,3835360,3851303,0,0,0,15943
2601,3834477,3834477,3851326,0,0,0,16849
2606,3835673,3835673,3851327,0,0,0,15654
2605,3835530,3835530,3851403,0,0,0,15873
2592,3830611,3830611,3851419,0,0,0,20808
2598,3833579,3833579,3851435,0,0,0,17856
2597,3833504,3833504,3851451,0,0,0,17947
2603,3834787,3834787,3851467,0,0,0,16680
2596,3831774,3831774,3851493,0,0,0,19719
2599,3833997,3833997,3851571,0,0,0,17574
2626,3851412,3851412,3851578,0,0,0,166
2624,3844609,3844609,3851809,0,0,0,7200
2588,3825630,3825630,3853007,0,0,0,27377
2628,3853075,3853075,3853120,0,0,0,45
2620,3841958,3841958,3853404,0,0,0,11446
2615,3841884,3841884,3853489,0,0,0,11605
2618,3841926,3841926,3853489,0,0,0,11563
2616,3841900,3841900,3853540,0,0,0,11640
2612,3841852,3841852,3853578,0,0,0,11726
2617,3841916,3841916,3853613,0,0,0,11697
2610,3841596,3841596,3853668,0,0,0,12072
2614,3841877,3841877,3853688,0,0,0,11811
2627,3852600,3852600,3853744,0,0,0,1144
2621,3842041,3842041,3853764,0,0,0,11723
2619,3841942,3841942,3853850,0,0,0,11908
2613,3841867,3841867,3853886,0,0,0,12019
2650,3854327,3854327,3855644,0,0,0,1317
2642,3853979,3853979,3858955,0,0,0,4976
2649,3853980,3853980,3858958,0,0,0,4978
2631,3853976,3853976,3858964,0,0,0,4988
2635,3853977,3853977,3858976,0,0,0,4999
2638,3853978,3853978,3858977,0,0,0,4999
2643,3853979,3853979,3858978,0,0,0,4999
2632,3853976,3853976,3858986,0,0,0,5010
2646,3853980,3853980,3858990,0,0,0,5010
2633,3853976,3853976,3858997,0,0,0,5021
2647,3853980,3853980,3859029,0,0,0,5049
2672,3858254,3858997,3859143,0,0,743,889
2636,3853977,3853977,3859230,0,0,0,5253
2648,3853980,3853980,3859244,0,0,0,5264
2634,3853976,3853976,3859251,0,0,0,5275
2644,3853979,3853979,3859254,0,0,0,5275
2639,3853978,3853978,3859487,0,0,0,5509
2637,3853977,3853977,3859498,0,0,0,5521
2645,3853979,3853979,3859500,0,0,0,5521
2629,3853975,3853975,3859538,0,0,0,5563
2640,3853978,3853978,3859541,0,0,0,5563
2641,3853978,3853978,3859574,0,0,0,5596
2673,3858709,3859230,3860586,0,0,521,1877
2651,3856894,3856894,3861871,0,0,0,4977
2659,3856897,3856897,3861881,0,0,0,4984
2653,3856895,3856895,3861892,0,0,0,4997
2655,3856896,3856896,3861893,0,0,0,4997
2660,3856897,3856897,3861895,0,0,0,4998
2661,3856897,3856897,3861907,0,0,0,5010
2656,3856896,3856896,3861938,0,0,0,5042
2654,3856895,3856895,3862145,0,0,0,5250
2663,3856898,3856898,3862147,0,0,0,5249
2664,3856898,3856898,3862147,0,0,0,5249
2662,3856897,3856897,3862163,0,0,0,5266
2652,3856894,3856894,3862169,0,0,0,5275
2657,3856896,3856896,3862171,0,0,0,5275
2658,3856896,3856896,3862177,0,0,0,5281
2665,3856898,3856898,3862180,0,0,0,5282
2602,3834736,3834736,3862356,0,0,0,27620
2667,3856899,3858958,3863984,0,0,2059,7085
2671,3856900,3858978,3864221,0,0,2078,7321
2670,3856900,3858977,3864230,0,0,2077,7330
2666,3856898,3858955,3864476,0,0,2057,7578
2669,3856899,3858976,3864489,0,0,2077,7590
2668,3856899,3858964,3864556,0,0,2065,7657
2630,3853975,3853975,3869088,0,0,0,15113
2678,3874549,3874549,3874830,0,0,0,281
2356,3748129,3748129,3886575,0,0,0,138446
2676,3870878,3870878,3887718,0,0,0,16840
2675,3862962,3862962,3888246,0,0,0,25284
2680,3888878,3888878,3894558,0,0,0,5680
2505,3778941,3781708,3904802,0,0,2767,125861
2501,3777950,3777950,3905436,0,0,0,127486
2504,3778516,3778516,3905499,0,0,0,126983
2503,3778324,3778324,3906426,0,0,0,128102
2583,3825094,3825094,3909121,0,0,0,84027
2677,3874101,3874101,3912873,0,0,0,38772
2332,3747647,3747647,3915813,0,0,0,168166
2502,3778026,3778026,3923594,0,0,0,145568
2509,3780270,3780270,3924533,0,0,0,144263
2400,3755169,3755169,3925317,0,0,0,170148
2674,3860742,3860742,3926323,0,0,0,65581
2403,3758388,3758388,3932886,0,0,0,174498
2690,3941711,3941711,3956226,0,0,0,14515
2689,3937587,3937587,3956236,0,0,0,18649
2691,3944218,3944218,3956285,0,0,0,12067
2682,3915139,3915139,3956347,0,0,0,41208
2693,3956426,3956426,3956671,0,0,0,245
2694,3956454,3956454,3956688,0,0,0,234
2695,3956468,3956468,3956698,0,0,0,230
2699,3956885,3956885,3959722,0,0,0,2837
2325,3740052,3740052,3959755,0,0,0,219703
2700,3956982,3956982,3960249,0,0,0,3267
2685,3916594,3916594,3961268,0,0,0,44674
2702,3964300,3964300,3967704,0,0,0,3404
2703,3964565,3964565,3967741,0,0,0,3176
2696,3956672,3956672,3977927,0,0,0,21255
2704,3981253,3981253,3984366,0,0,0,3113
2705,3981272,3981272,3984726,0,0,0,3454
2701,3960074,3960074,3985588,0,0,0,25514
2324,3737594,3737594,3995845,0,0,0,258251
2709,4007346,4007346,4007438,0,0,0,92
2707,4002115,4002115,4008102,0,0,0,5987
2710,4007544,4007544,4012178,0,0,0,4634
2547,3794157,3794157,4017590,0,0,0,223433
2679,3887183,3887183,4022524,0,0,0,135341
2714,4030874,4030874,4031150,0,0,0,276
2711,4010436,4010436,4058498,0,0,0,48062
2718,4078556,4078556,4078662,0,0,0,106
2720,4078789,4078789,4078894,0,0,0,105
2716,4077775,4077775,4079176,0,0,0,1401
2719,4078628,4078628,4079363,0,0,0,735
2683,3915778,3915778,4082834,0,0,0,167056
2721,4078840,4078840,4085201,0,0,0,6361
2723,4080798,4080798,4090064,0,0,0,9266
2715,4035773,4035773,4091014,0,0,0,55241
2717,4078100,4078100,4093377,0,0,0,15277
2724,4080859,4080859,4098341,0,0,0,17482
2686,3930158,3930158,4098621,0,0,0,168463
2729,4099707,4099707,4100106,0,0,0,399
2684,3915942,3915942,4102860,0,0,0,186918
2722,4079271,4079271,4104924,0,0,0,25653
2688,3934505,3934505,4107743,0,0,0,173238
2732,4114227,4114227,4114559,0,0,0,332
2733,4114619,4114619,4115860,0,0,0,1241
2737,4121832,4121832,4121922,0,0,0,90
2738,4122976,4122976,4123078,0,0,0,102
2740,4124737,4124737,4124779,0,0,0,42
2681,3894952,3894952,4141936,0,0,0,246984
2727,4091780,4091780,4142040,0,0,0,50260
2734,4117088,4117088,4145221,0,0,0,28133
2687,3931478,3931478,4165478,0,0,0,234000
2713,4022523,4022523,4170357,0,0,0,147834
2692,3956356,3956356,4177002,0,0,0,220646
2698,3956721,3956721,4181292,0,0,0,224571
2730,4100182,4100182,4182478,0,0,0,82296
2748,4182661,4182661,4183382,0,0,0,721
2749,4183508,4183508,4183654,0,0,0,146
2747,4177249,4177249,4184449,0,0,0,7200
2752,4187618,4187618,4190961,0,0,0,3343
2758,4191428,4191428,4191471,0,0,0,43
2759,4191484,4191484,4191593,0,0,0,109
2757,4191245,4191245,4194845,0,0,0,3600
2763,4195179,4195179,4195297,0,0,0,118
2764,4195359,4195359,4195637,0,0,0,278
2765,4195639,4195639,4195732,0,0,0,93
2766,4195815,4195815,4195919,0,0,0,104
2761,4192751,4192751,4197348,0,0,0,4597
2750,4183682,4183682,4197390,0,0,0,13708
2708,4006079,4006079,4200014,0,0,0,193935
2745,4173252,4173252,4201267,0,0,0,28015
2770,4202157,4202157,4202272,0,0,0,115
2769,4202148,4202148,4202748,0,0,0,600
2697,3956700,3956700,4203212,0,0,0,246512
2726,4091142,4091142,4208727,0,0,0,117585
2744,4170892,4170892,4242892,0,0,0,72000
2712,4019293,4019293,4244989,0,0,0,225696
2768,4196970,4196970,4253277,0,0,0,56307
2725,4082795,4082795,4253784,0,0,0,170989
2776,4257585,4257585,4257675,0,0,0,90
2777,4258440,4258440,4258540,0,0,0,100
2706,4001294,4001294,4258959,0,0,0,257665
2778,4260403,4260403,4260487,0,0,0,84
2767,4195947,4195947,4261917,0,0,0,65970
2780,4266105,4266105,4266163,0,0,0,58
2781,4266206,4266206,4266264,0,0,0,58
2782,4267053,4267053,4267584,0,0,0,531
2728,4098580,4098580,4268800,0,0,0,170220
2790,4274291,4274291,4274891,0,0,0,600
2791,4275811,4275811,4276411,0,0,0,600
2771,4204801,4204801,4276820,0,0,0,72019
2792,4277349,4277349,4277444,0,0,0,95
2731,4107707,4107707,4277472,0,0,0,169765
2794,4277533,4277533,4277629,0,0,0,96
2795,4278496,4278496,4279096,0,0,0,600
2798,4280044,4280044,4280241,0,0,0,197
2799,4281834,4281834,4281950,0,0,0,116
2796,4278976,4278976,4283484,0,0,0,4508
2735,4118596,4118596,4290041,0,0,0,171445
2739,4124239,4124239,4295334,0,0,0,171095
2741,4124850,4124850,4295954,0,0,0,171104
2742,4125032,4125032,4296129,0,0,0,171097
2736,4120077,4141936,4307928,0,0,21859,187851
2774,4256456,4256456,4313278,0,0,0,56822
2746,4175549,4175549,4319881,0,0,0,144332
2779,4263137,4263137,4322070,0,0,0,58933
2743,4170317,4170357,4324923,0,0,40,154606
2800,4284589,4284589,4325535,0,0,0,40946
2809,4323883,4323883,4326514,0,0,0,2631
2808,4320514,4320514,4326950,0,0,0,6436
2755,4188801,4188801,4330263,0,0,0,141462
2816,4349525,4349525,4349615,0,0,0,90
2817,4349623,4349623,4349670,0,0,0,47
2820,4351749,4351749,4351791,0,0,0,42
2819,4351282,4351282,4351824,0,0,0,542
2821,4351829,4351829,4351975,0,0,0,146
2823,4352087,4352087,4352225,0,0,0,138
2822,4352039,4352039,4352285,0,0,0,246
2825,4352733,4352733,4352851,0,0,0,118
2801,4290173,4307928,4353137,0,0,17755,62964
2824,4352596,4352596,4353170,0,0,0,574
2826,4355869,4355869,4356109,0,0,0,240
2827,4358046,4358046,4358316,0,0,0,270
2751,4187608,4187608,4358890,0,0,0,171282
2753,4188226,4188226,4359436,0,0,0,171210
2754,4188301,4188301,4359481,0,0,0,171180
2756,4188870,4188870,4360078,0,0,0,171208
2760,4191703,4191703,4362879,0,0,0,171176
2762,4193214,4193214,4363823,0,0,0,170609
2828,4367859,4367859,4368459,0,0,0,600
2829,4369243,4369243,4369843,0,0,0,600
2830,4370279,4370279,4370670,0,0,0,391
2831,4371096,4371096,4371696,0,0,0,600
2818,4349737,4349737,4374073,0,0,0,24336
2832,4374785,4374785,4374889,0,0,0,104
2815,4342252,4342252,4383722,0,0,0,41470
2785,4270123,4270123,4392833,0,0,0,122710
2784,4269980,4269980,4394599,0,0,0,124619
2812,4341639,4341639,4396453,0,0,0,54814
2811,4341576,4341576,4398519,0,0,0,56943
2845,4399133,4399133,4399239,0,0,0,106
2787,4270344,4276820,4400709,0,0,6476,130365
2814,4342249,4342249,4409184,0,0,0,66935
2806,4319924,4319924,4421244,0,0,0,101320
2834,4375067,4375067,4421291,0,0,0,46224
2772,4253779,4253779,4422199,0,0,0,168420
2807,4319958,4319958,4422513,0,0,0,102555
2835,4375106,4375106,4422886,0,0,0,47780
2836,4375188,4375188,4423405,0,0,0,48217
2833,4374919,4374919,4424695,0,0,0,49776
2773,4254813,4254813,4426119,0,0,0,171306
2788,4271425,4290041,4426737,0,0,18616,155312
2789,4271568,4307928,4432065,0,0,36360,160497
2775,4257557,4257557,4435121,0,0,0,177564
2783,4268760,4268760,4438437,0,0,0,169677
2853,4436244,4436244,4440969,0,0,0,4725
2855,4450312,4450312,4450407,0,0,0,95
2856,4450367,4450367,4450461,0,0,0,94
2857,4450375,4450375,4450466,0,0,0,91
2793,4277431,4277431,4451143,0,0,0,173712
2859,4451097,4451097,4451188,0,0,0,91
2797,4279201,4279201,4452001,0,0,0,172800
2863,4452397,4452397,4452483,0,0,0,86
2864,4452662,4452662,4452758,0,0,0,96
2846,4399209,4399209,4455926,0,0,0,56717
2805,4319840,4319840,4464420,0,0,0,144580
2802,4296237,4296237,4467344,0,0,0,171107
2803,4296265,4296265,4467363,0,0,0,171098
2804,4296292,4296292,4467395,0,0,0,171103
2847,4405678,4405678,4467665,0,0,0,61987
2810,4324880,4324923,4477298,0,0,43,152418
2870,4478511,4478511,4478765,0,0,0,254
2871,4478853,4478853,4479129,0,0,0,276
2872,4479380,4479380,4481804,0,0,0,2424
2849,4427283,4427283,4482101,0,0,0,54818
2786,4270270,4270270,4494847,0,0,0,224577
2813,4341837,4341837,4514637,0,0,0,172800
2841,4398904,4398904,4529007,0,0,0,130103
2840,4398835,4398835,4530641,0,0,0,131806
2838,4389205,4389205,4534877,0,0,0,145672
2878,4534411,4534877,4534992,0,0,466,581
2879,4534416,4534992,4535096,0,0,576,680
2850,4429547,4429547,4537774,0,0,0,108227
2839,4389804,4389804,4541543,0,0,0,151739
2882,4550750,4550750,4550865,0,0,0,115
2883,4550923,4550923,4551014,0,0,0,91
2852,4432931,4432931,4553718,0,0,0,120787
2885,4551112,4553718,4553823,0,0,2606,2711
2875,4525043,4525043,4554308,0,0,0,29265
2837,4388925,4388925,4561725,0,0,0,172800
2842,4398948,4398948,4570137,0,0,0,171189
2843,4398981,4398981,4570170,0,0,0,171189
2844,4399027,4399027,4570178,0,0,0,171151
2862,4451522,4451522,4581646,0,0,0,130124
2860,4451121,4451121,4582109,0,0,0,130988
2858,4450973,4450973,4584556,0,0,0,133583
2848,4422158,4422158,4589991,0,0,0,167833
2861,4451356,4451356,4595987,0,0,0,144631
2873,4486144,4486144,4596365,0,0,0,110221
2854,4438437,4438437,4607744,0,0,0,169307
2889,4555245,4555245,4616104,0,0,0,60859
2865,4452735,4452735,4625535,0,0,0,172800
2866,4452854,4452854,4625654,0,0,0,172800
2867,4452862,4452862,4625662,0,0,0,172800
2851,4429587,4429587,4632049,0,0,0,202462
2880,4536428,4536428,4642062,0,0,0,105634
2895,4642949,4642949,4643209,0,0,0,260
2896,4645222,4645222,4645761,0,0,0,539
2886,4551504,4553718,4647122,0,0,2214,95618
2881,4536638,4541543,4647801,0,0,4905,111163
2876,4530651,4530651,4701813,0,0,0,171162
2884,4551051,4551051,4704020,0,0,0,152969
2877,4530882,4534877,4706079,0,0,3995,175197
2911,4710248,4710248,4710342,0,0,0,94
2897,4646104,4646104,4712887,0,0,0,66783
2914,4713029,4713029,4713124,0,0,0,95
2869,4464382,4464382,4716382,0,0,0,252000
2887,4551558,4553718,4726518,0,0,2160,174960
2888,4551594,4553718,4726518,0,0,2124,174924
2868,4453899,4477298,4728295,0,0,23399,274396
2894,4615919,4615919,4741353,0,0,0,125434
2919,4720913,4720913,4752612,0,0,0,31699
2893,4611525,4611525,4755276,0,0,0,143751
2890,4589953,4589953,4758068,0,0,0,168115
2918,4720495,4720495,4761621,0,0,0,41126
2904,4666861,4666861,4768422,0,0,0,101561
2905,4666867,4666867,4768690,0,0,0,101823
2903,4666645,4666645,4772130,0,0,0,105485
2902,4666594,4666594,4772823,0,0,0,106229
2891,4607701,4607701,4773542,0,0,0,165841
2925,4773691,4773691,4773786,0,0,0,95
2926,4773741,4773741,4773830,0,0,0,89
2907,4696984,4696984,4777509,0,0,0,80525
2874,4499610,4529007,4781007,0,0,29397,281397
2901,4661617,4661617,4783457,0,0,0,121840
2929,4821238,4821238,4821331,0,0,0,93
2898,4652872,4652872,4825672,0,0,0,172800
2899,4652882,4652882,4825682,0,0,0,172800
2900,4652890,4652890,4825690,0,0,0,172800
2892,4611468,4611468,4829673,0,0,0,218205
2916,4718604,4718604,4861897,0,0,0,143293
2921,4731308,4741353,4865679,0,0,10045,134371
2936,4865832,4865832,4865978,0,0,0,146
2917,4718731,4718731,4868467,0,0,0,149736
2937,4869221,4869221,4869342,0,0,0,121
2940,4870021,4870021,4870318,0,0,0,297
2941,4870202,4870202,4870643,0,0,0,441
2942,4870729,4870729,4871171,0,0,0,442
2943,4871059,4871059,4871499,0,0,0,440
2944,4871530,4871530,4871972,0,0,0,442
2946,4872697,4872697,4872824,0,0,0,127
2945,4872151,4872151,4872911,0,0,0,760
2947,4872852,4872852,4873130,0,0,0,278
2948,4874521,4874521,4874688,0,0,0,167
2949,4877820,4877820,4877966,0,0,0,146
2950,4878790,4878790,4878967,0,0,0,177
2951,4879092,4879092,4879270,0,0,0,178
2912,4710469,4710469,4879401,0,0,0,168932
2965,4879836,4879836,4879847,0,0,0,11
2953,4879835,4879835,4880606,0,0,0,771
2954,4879835,4879835,4880626,0,0,0,791
2955,4879835,4879835,4880638,0,0,0,803
2958,4879835,4879835,4880639,0,0,0,804
2960,4879836,4879836,4880639,0,0,0,803
2961,4879836,4879836,4880650,0,0,0,814
2962,4879836,4879836,4880650,0,0,0,814
2963,4879836,4879836,4880650,0,0,0,814
2966,4879837,4879837,4880651,0,0,0,814
2952,4879834,4879834,4880670,0,0,0,836
2956,4879835,4879835,4880682,0,0,0,847
2957,4879835,4879835,4880693,0,0,0,858
2964,4879836,4879836,4880694,0,0,0,858
2967,4879837,4879837,4880695,0,0,0,858
2968,4879837,4879837,4880706,0,0,0,869
2969,4879837,4879837,4880717,0,0,0,880
2970,4879837,4879837,4880728,0,0,0,891
2971,4879837,4879837,4880728,0,0,0,891
2972,4879837,4879837,4880752,0,0,0,915
2959,4879835,4879835,4880785,0,0,0,950
2909,4710203,4710203,4881350,0,0,0,171147
2908,4710183,4710183,4881374,0,0,0,171191
2910,4710223,4710223,4881391,0,0,0,171168
2978,4883108,4883108,4883862,0,0,0,754
2974,4883102,4883102,4883863,0,0,0,761
2975,4883108,4883108,4883863,0,0,0,755
2976,4883108,4883108,4883874,0,0,0,766
2979,4883109,4883109,4883875,0,0,0,766
2980,4883109,4883109,4883875,0,0,0,766
2977,4883108,4883108,4883885,0,0,0,777
2981,4883109,4883109,4883886,0,0,0,777
2982,4883110,4883110,4883898,0,0,0,788
2983,4883110,4883110,4883898,0,0,0,788
2986,4883111,4883111,4883899,0,0,0,788
2984,4883110,4883110,4883909,0,0,0,799
2987,4883111,4883111,4883921,0,0,0,810
2988,4883111,4883111,4883921,0,0,0,810
2990,4883112,4883112,4883922,0,0,0,810
2989,4883111,4883111,4883932,0,0,0,821
2991,4883112,4883112,4883944,0,0,0,832
2992,4883112,4883112,4883944,0,0,0,832
2993,4883112,4883112,4883944,0,0,0,832
2985,4883110,4883110,4884186,0,0,0,1076
2994,4885564,4885564,4885839,0,0,0,275
3006,4888075,4888075,4888231,0,0,0,156
3018,4888077,4888077,4888245,0,0,0,168
2995,4885972,4885972,4889572,0,0,0,3600
2915,4717630,4717630,4893329,0,0,0,175699
2913,4710704,4728295,4894421,0,0,17591,183717
2920,4724955,4724955,4897755,0,0,0,172800
3001,4888075,4888075,4900882,0,0,0,12807
3002,4888075,4888075,4900898,0,0,0,12823
3007,4888076,4888076,4900899,0,0,0,12823
3004,4888075,4888075,4900902,0,0,0,12827
3003,4888075,4888075,4900909,0,0,0,12834
3008,4888076,4888076,4900910,0,0,0,12834
3009,4888076,4888076,4900921,0,0,0,12845
3010,4888076,4888076,4900932,0,0,0,12856
3011,4888076,4888076,4900932,0,0,0,12856
3012,4888076,4888076,4900932,0,0,0,12856
3013,4888077,4888077,4900955,0,0,0,12878
3019,4888148,4888148,4900956,0,0,0,12808
3014,4888077,4888077,4900966,0,0,0,12889
3020,4888149,4888149,4900968,0,0,0,12819
3005,4888075,4888075,4900974,0,0,0,12899
3015,4888077,4888077,4900977,0,0,0,12900
3021,4888149,4888149,4900990,0,0,0,12841
3022,4901444,4901444,4901539,0,0,0,95
3016,4888077,4888077,4901893,0,0,0,13816
3017,4888077,4888077,4902537,0,0,0,14460
3023,4902990,4902990,4903466,0,0,0,476
2928,4781508,4781508,4907669,0,0,0,126161
2935,4842770,4842770,4922486,0,0,0,79716
2923,4771011,4771011,4925902,0,0,0,154891
2922,4758021,4758021,4927870,0,0,0,169849
2931,4840850,4840850,4942787,0,0,0,101937
2924,4773499,4773499,4943041,0,0,0,169542
2930,4840842,4840842,4943409,0,0,0,102567
2933,4840874,4840874,4945522,0,0,0,104648
2906,4688350,4688350,4947550,0,0,0,259200
2932,4840868,4840868,4962522,0,0,0,121654
3030,4964370,4964370,4964551,0,0,0,181
2934,4842769,4842769,4964995,0,0,0,122226
3031,4967074,4967074,4967209,0,0,0,135
3032,4967943,4967943,4968071,0,0,0,128
3033,4968844,4968844,4968979,0,0,0,135
3034,4969023,4969023,4969189,0,0,0,166
3035,4969398,4969398,4969475,0,0,0,77
3036,4969453,4969453,4969653,0,0,0,200
3037,4972070,4972070,4972120,0,0,0,50
3038,4972076,4972076,4972126,0,0,0,50
3040,4972128,4972128,4972251,0,0,0,123
3042,4972162,4972162,4972294,0,0,0,132
3041,4972143,4972143,4972732,0,0,0,589
3039,4972109,4972109,4972754,0,0,0,645
3043,4972873,4972873,4973019,0,0,0,146
3044,4973602,4973602,4975695,0,0,0,2093
2996,4887853,4887853,4986687,0,0,0,98834
3051,4987413,4987413,4988002,0,0,0,589
3050,4987303,4987303,4988091,0,0,0,788
3052,4999184,4999184,5004584,0,0,0,5400
2973,4880322,4880322,5023628,0,0,0,143306
3054,5023583,5023583,5023678,0,0,0,95
2927,4776576,4776576,5024764,0,0,0,248188
3055,5031747,5031747,5031843,0,0,0,96
3029,4952573,4952573,5035091,0,0,0,82518
3057,5038068,5038068,5038154,0,0,0,86
3058,5038262,5038262,5038364,0,0,0,102
2939,4869579,4869579,5038905,0,0,0,169326
3060,5038604,5038604,5039351,0,0,0,747
2938,4869433,4869433,5042233,0,0,0,172800
3061,5042693,5042693,5043441,0,0,0,748
3063,5053159,5053159,5053250,0,0,0,91
3064,5053296,5053296,5053391,0,0,0,95
3024,4905403,4905403,5055376,0,0,0,149973
3066,5055336,5055336,5055431,0,0,0,95
3067,5057878,5057878,5057986,0,0,0,108
3068,5058048,5058048,5058143,0,0,0,95
3069,5058053,5058053,5058181,0,0,0,128
3070,5058151,5058151,5058248,0,0,0,97
3072,5058236,5058236,5058325,0,0,0,89
3071,5058219,5058219,5058614,0,0,0,395
3073,5058588,5058588,5058858,0,0,0,270
3075,5058828,5058828,5058926,0,0,0,98
3076,5058844,5058844,5058946,0,0,0,102
2997,4887900,4887900,5059034,0,0,0,171134
2998,4887922,4887922,5059107,0,0,0,171185
3000,4887998,4887998,5059130,0,0,0,171132
2999,4887972,4887972,5059138,0,0,0,171166
3078,5060463,5060463,5060558,0,0,0,95
3079,5062947,5062947,5063036,0,0,0,89
3080,5063166,5063166,5063261,0,0,0,95
3045,4973614,4973614,5086047,0,0,0,112433
3048,4975673,4975673,5088170,0,0,0,112497
3098,5089982,5089982,5090097,0,0,0,115
3099,5090466,5090466,5090581,0,0,0,115
3100,5090920,5090920,5091028,0,0,0,108
3101,5091915,5091915,5092024,0,0,0,109
3102,5092937,5092937,5093054,0,0,0,117
3025,4927407,4927407,5101720,0,0,0,174313
3095,5080646,5080646,5104400,0,0,0,23754
3028,4945675,4945675,5105350,0,0,0,159675
3026,4939336,4939336,5110576,0,0,0,171240
3027,4942994,4942994,5112458,0,0,0,169464
3096,5080801,5080801,5115336,0,0,0,34535
3094,5080529,5080529,5115856,0,0,0,35327
3097,5086925,5104400,5120147,0,0,17475,33222
3087,5075231,5075231,5137935,0,0,0,62704
3088,5075372,5075372,5138528,0,0,0,63156
3089,5075392,5075392,5140331,0,0,0,64939
3090,5075397,5075397,5140820,0,0,0,65423
3091,5075416,5075416,5140967,0,0,0,65551
3081,5063395,5063395,5145694,0,0,0,82299
3104,5093774,5093774,5160924,0,0,0,67150
3103,5093303,5093303,5161081,0,0,0,67778
3046,4973618,4973618,5191253,0,0,0,217635
3047,4973623,4973623,5192062,0,0,0,218439
3108,5205890,5205890,5206199,0,0,0,309
3109,5205912,5205912,5206211,0,0,0,299
3092,5080054,5080054,5208574,0,0,0,128520
3074,5058763,5058763,5208587,0,0,0,149824
3111,5209818,5209818,5209919,0,0,0,101
3059,5038263,5038263,5211063,0,0,0,172800
3062,5053101,5053101,5219058,0,0,0,165957
3115,5222240,5222240,5222683,0,0,0,443
3065,5053297,5053297,5226097,0,0,0,172800
3053,5022094,5022094,5234044,0,0,0,211950
3049,4982740,4982740,5241940,0,0,0,259200
3086,5074694,5074694,5244012,0,0,0,169318
3083,5074552,5074552,5245671,0,0,0,171119
3082,5074535,5074535,5245698,0,0,0,171163
3084,5074588,5074588,5245709,0,0,0,171121
3085,5074609,5074609,5245799,0,0,0,171190
3105,5161201,5161201,5247601,0,0,0,86400
3119,5250205,5250205,5250321,0,0,0,116
3093,5080370,5080370,5253170,0,0,0,172800
3107,5183864,5183864,5254270,0,0,0,70406
3118,5248121,5248121,5255324,0,0,0,7203
3106,5183596,5183596,5255682,0,0,0,72086
3120,5251159,5251159,5291964,0,0,0,40805
3056,5035099,5035099,5292345,0,0,0,257246
3123,5295006,5295006,5298521,0,0,0,3515
3124,5298452,5298452,5298911,0,0,0,459
3116,5223524,5223524,5300555,0,0,0,77031
3125,5299162,5299162,5303463,0,0,0,4301
3126,5300520,5300520,5303813,0,0,0,3293
3077,5058941,5058941,5310941,0,0,0,252000
3129,5311409,5311409,5311776,0,0,0,367
3130,5311898,5311898,5312259,0,0,0,361
3131,5312235,5312235,5312598,0,0,0,363
3133,5314054,5314054,5314934,0,0,0,880
3132,5312584,5312584,5315455,0,0,0,2871
3134,5314972,5314972,5316649,0,0,0,1677
3139,5317623,5317623,5317710,0,0,0,87
3141,5317794,5317794,5317878,0,0,0,84
3142,5317813,5317813,5317907,0,0,0,94
3145,5318273,5318273,5318397,0,0,0,124
3146,5318374,5318374,5318461,0,0,0,87
3147,5318445,5318445,5318546,0,0,0,101
3148,5318631,5318631,5318731,0,0,0,100
3144,5318197,5318197,5320504,0,0,0,2307
3149,5320500,5320500,5320599,0,0,0,99
3150,5320734,5320734,5320830,0,0,0,96
3151,5320813,5320813,5320898,0,0,0,85
3152,5321036,5321036,5321131,0,0,0,95
3135,5315434,5315434,5321791,0,0,0,6357
3153,5321757,5321757,5322220,0,0,0,463
3154,5322231,5322231,5322274,0,0,0,43
3128,5307176,5307176,5324477,0,0,0,17301
3127,5307131,5307131,5324516,0,0,0,17385
3155,5324688,5324688,5324763,0,0,0,75
3156,5324745,5324745,5324837,0,0,0,92
3157,5324969,5324969,5325028,0,0,0,59
3158,5325060,5325060,5325141,0,0,0,81
3159,5325408,5325408,5325518,0,0,0,110
3160,5325507,5325507,5325614,0,0,0,107
3161,5325821,5325821,5325918,0,0,0,97
3162,5325951,5325951,5326046,0,0,0,95
3163,5326252,5326252,5326347,0,0,0,95
3164,5326411,5326411,5326506,0,0,0,95
3165,5326522,5326522,5326609,0,0,0,87
3166,5326784,5326784,5326882,0,0,0,98
3167,5328161,5328161,5331360,0,0,0,3199
3114,5220093,5220093,5346805,0,0,0,126712
3170,5352354,5352354,5352404,0,0,0,50
3117,5224622,5224622,5385971,0,0,0,161349
3110,5208541,5208541,5385973,0,0,0,177432
3176,5388982,5388982,5389072,0,0,0,90
3177,5389902,5389902,5389989,0,0,0,87
3178,5390098,5390098,5390978,0,0,0,880
3179,5393432,5393432,5394291,0,0,0,859
3180,5397198,5397198,5397293,0,0,0,95
3181,5398506,5398506,5398601,0,0,0,95
3190,5405176,5405176,5410170,0,0,0,4994
3194,5405177,5405177,5410183,0,0,0,5006
3184,5405174,5405174,5410191,0,0,0,5017
3185,5405174,5405174,5410191,0,0,0,5017
3186,5405175,5405175,5410192,0,0,0,5017
3191,5405176,5405176,5410193,0,0,0,5017
3195,5405177,5405177,5410194,0,0,0,5017
3199,5405178,5405178,5410195,0,0,0,5017
3203,5405179,5405179,5410196,0,0,0,5017
3187,5405175,5405175,5410420,0,0,0,5245
3192,5405176,5405176,5410421,0,0,0,5245
3193,5405176,5405176,5410432,0,0,0,5256
3196,5405177,5405177,5410433,0,0,0,5256
3200,5405178,5405178,5410434,0,0,0,5256
3204,5405179,5405179,5410446,0,0,0,5267
3201,5405178,5405178,5410467,0,0,0,5289
3197,5405177,5405177,5410509,0,0,0,5332
3188,5405175,5405175,5410681,0,0,0,5506
3198,5405177,5405177,5410683,0,0,0,5506
3189,5405175,5405175,5410703,0,0,0,5528
3202,5405178,5405178,5410722,0,0,0,5544
3113,5212570,5212570,5430553,0,0,0,217983
3112,5212565,5212565,5431055,0,0,0,218490
3174,5383862,5383862,5442428,0,0,0,58566
3171,5352495,5352495,5444086,0,0,0,91591
3122,5292867,5292867,5465667,0,0,0,172800
3173,5383802,5383802,5470202,0,0,0,86400
3175,5383886,5383886,5470286,0,0,0,86400
3138,5317588,5317588,5483566,0,0,0,165978
3169,5346763,5346763,5483818,0,0,0,137055
3143,5317844,5317844,5487161,0,0,0,169317
3140,5317673,5317673,5488796,0,0,0,171123
3136,5317478,5317478,5490278,0,0,0,172800
3137,5317491,5317491,5490291,0,0,0,172800
3207,5490703,5490703,5495383,0,0,0,4680
3208,5498551,5498551,5499830,0,0,0,1279
3206,5490672,5490672,5501499,0,0,0,10827
3172,5358811,5358811,5506796,0,0,0,147985
3220,5509868,5509868,5511809,0,0,0,1941
3221,5511543,5511543,5513002,0,0,0,1459
3121,5292398,5292398,5516319,0,0,0,223921
3222,5512673,5512673,5534120,0,0,0,21447
3223,5523580,5523580,5548387,0,0,0,24807
3227,5559144,5559144,5559383,0,0,0,239
3228,5559557,5559557,5559889,0,0,0,332
3226,5558271,5558271,5560124,0,0,0,1853
3229,5560175,5560175,5561717,0,0,0,1542
3230,5561770,5561770,5562241,0,0,0,471
3231,5562333,5562333,5562886,0,0,0,553
3232,5566734,5566734,5569363,0,0,0,2629
3233,5570055,5570055,5570151,0,0,0,96
3182,5398620,5398620,5571420,0,0,0,172800
3183,5398635,5398635,5571435,0,0,0,172800
3217,5509450,5509450,5574102,0,0,0,64652
3235,5570515,5570515,5574633,0,0,0,4118
3238,5575435,5575435,5575508,0,0,0,73
3234,5570131,5570131,5579131,0,0,0,9000
3239,5579702,5579702,5579848,0,0,0,146
3240,5579972,5579972,5580066,0,0,0,94
3216,5508942,5508942,5580206,0,0,0,71264
3242,5580227,5580227,5580323,0,0,0,96
3241,5580182,5580182,5580531,0,0,0,349
3243,5580389,5580389,5580755,0,0,0,366
3168,5328856,5328856,5580856,0,0,0,252000
3244,5580663,5580663,5580864,0,0,0,201
3246,5581008,5581008,5581243,0,0,0,235
3219,5509842,5509842,5581308,0,0,0,71466
3245,5580907,5580907,5581489,0,0,0,582
3247,5581435,5581435,5581535,0,0,0,100
3218,5509687,5509687,5584692,0,0,0,75005
3250,5584642,5584642,5584884,0,0,0,242
3249,5584288,5584288,5585075,0,0,0,787
3251,5585033,5585033,5585156,0,0,0,123
3252,5585130,5585130,5585284,0,0,0,154
3253,5585171,5585171,5585316,0,0,0,145
3255,5585346,5585346,5585436,0,0,0,90
3256,5585523,5585523,5585613,0,0,0,90
3257,5585663,5585663,5585753,0,0,0,90
3254,5585262,5585262,5587194,0,0,0,1932
3258,5588648,5588648,5592064,0,0,0,3416
3205,5483779,5483779,5612707,0,0,0,128928
3259,5594333,5594333,5635033,0,0,0,40700
3265,5643156,5643156,5643271,0,0,0,115
3266,5644642,5644642,5644913,0,0,0,271
3268,5645045,5645045,5645144,0,0,0,99
3272,5648632,5648632,5648819,0,0,0,187
3273,5648906,5648906,5653999,0,0,0,5093
3274,5656827,5656827,5656912,0,0,0,85
3275,5661093,5661093,5661183,0,0,0,90
3215,5501436,5501436,5661307,0,0,0,159871
3277,5661484,5661484,5661582,0,0,0,98
3278,5661844,5661844,5661970,0,0,0,126
3279,5661886,5661886,5662012,0,0,0,126
3280,5662128,5662128,5662604,0,0,0,476
3282,5662742,5662742,5662827,0,0,0,85
3283,5662845,5662845,5663032,0,0,0,187
3284,5663589,5663589,5663788,0,0,0,199
3286,5664382,5664382,5664548,0,0,0,166
3287,5664642,5664642,5664735,0,0,0,93
3288,5664792,5664792,5664884,0,0,0,92
3285,5663754,5663754,5664959,0,0,0,1205
3289,5664904,5664904,5665023,0,0,0,119
3209,5501064,5501064,5666881,0,0,0,165817
3291,5667027,5667027,5667318,0,0,0,291
3281,5662619,5662619,5668366,0,0,0,5747
3290,5666979,5666979,5668735,0,0,0,1756
3214,5501344,5501344,5670652,0,0,0,169308
3210,5501100,5501100,5672292,0,0,0,171192
3211,5501180,5501180,5672349,0,0,0,171169
3213,5501313,5501313,5672438,0,0,0,171125
3212,5501289,5501289,5672489,0,0,0,171200
3293,5668408,5668408,5672782,0,0,0,4374
3225,5533936,5533936,5682470,0,0,0,148534
3224,5524669,5524669,5697469,0,0,0,172800
3267,5645027,5645027,5706390,0,0,0,61363
3269,5645071,5645071,5712498,0,0,0,67427
3270,5645108,5645108,5714154,0,0,0,69046
3297,5724510,5724510,5724893,0,0,0,383
3260,5612666,5612666,5726919,0,0,0,114253
3296,5724466,5724466,5727143,0,0,0,2677
3300,5728124,5728124,5728473,0,0,0,349
3302,5728972,5728972,5730038,0,0,0,1066
3248,5582878,5582878,5732461,0,0,0,149583
3261,5638225,5638225,5735438,0,0,0,97213
3263,5638401,5638401,5735653,0,0,0,97252
3264,5638443,5638443,5735851,0,0,0,97408
3262,5638349,5638349,5736533,0,0,0,98184
3271,5645220,5645220,5739705,0,0,0,94485
3236,5572558,5572558,5745358,0,0,0,172800
3237,5572577,5572577,5745377,0,0,0,172800
3310,5746366,5746366,5750998,0,0,0,4632
3313,5749570,5749570,5752197,0,0,0,2627
3311,5746662,5746662,5756373,0,0,0,9711
3312,5746693,5746693,5756476,0,0,0,9783
3315,5757162,5757162,5757294,0,0,0,132
3316,5757340,5757340,5762754,0,0,0,5414
3314,5752130,5752130,5766459,0,0,0,14329
3317,5757480,5757480,5766759,0,0,0,9279
3318,5757500,5757500,5766773,0,0,0,9273
3323,5779994,5779994,5780134,0,0,0,140
3324,5780174,5780174,5780221,0,0,0,47
3325,5780249,5780249,5780778,0,0,0,529
3322,5777756,5777756,5782512,0,0,0,4756
3326,5783143,5783143,5791441,0,0,0,8298
3299,5727121,5727121,5798590,0,0,0,71469
3327,5815751,5815751,5816002,0,0,0,251
3328,5816164,5816164,5816424,0,0,0,260
3319,5766474,5766474,5826869,0,0,0,60395
3320,5777282,5777282,5828743,0,0,0,51461
3295,5682424,5682424,5830201,0,0,0,147777
3329,5829945,5829945,5830405,0,0,0,460
3330,5830014,5830014,5830455,0,0,0,441
3292,5667390,5667390,5833504,0,0,0,166114
3276,5661445,5661445,5834245,0,0,0,172800
3321,5777576,5777576,5837634,0,0,0,60058
3303,5732416,5732416,5839784,0,0,0,107368
3334,5837307,5837307,5844134,0,0,0,6827
3298,5726870,5726870,5852301,0,0,0,125431
3339,5858493,5858493,5858540,0,0,0,47
3338,5858463,5858463,5858796,0,0,0,333
3341,5859251,5859251,5860142,0,0,0,891
3340,5858833,5858833,5860767,0,0,0,1934
3294,5669237,5669237,5873664,0,0,0,204427
3332,5830571,5830571,5898665,0,0,0,68094
3304,5733238,5733238,5902576,0,0,0,169338
3305,5733295,5733295,5904433,0,0,0,171138
3306,5733313,5733313,5904493,0,0,0,171180
3308,5733368,5733368,5904496,0,0,0,171128
3307,5733335,5733335,5904511,0,0,0,171176
3343,5904444,5904444,5904940,0,0,0,496
3309,5734274,5734274,5907074,0,0,0,172800
3345,5909013,5909013,5910902,0,0,0,1889
3344,5906306,5906306,5913253,0,0,0,6947
3347,5913863,5913863,5914423,0,0,0,560
3348,5914494,5914494,5914815,0,0,0,321
3350,5915275,5915275,5915515,0,0,0,240
3351,5915908,5915908,5916043,0,0,0,135
3333,5830608,5830608,5917008,0,0,0,86400
3349,5915148,5915148,5920678,0,0,0,5530
3352,5917005,5917005,5925380,0,0,0,8375
3364,5926049,5926049,5926920,0,0,0,871
3366,5933078,5933078,5933335,0,0,0,257
3363,5925349,5925349,5944556,0,0,0,19207
3335,5839747,5839747,5947150,0,0,0,107403
3367,5939955,5939955,5948424,0,0,0,8469
3331,5830153,5830153,5978731,0,0,0,148578
3337,5852261,5852261,5979176,0,0,0,126915
3342,5899485,5899485,5987338,0,0,0,87853
3301,5728174,5728174,5987374,0,0,0,259200
3372,5987656,5987656,5987809,0,0,0,153
3373,5987815,5987815,5988016,0,0,0,201
3365,5926567,5926567,5991503,0,0,0,64936
3377,5991945,5991945,5992202,0,0,0,257
3379,5992280,5992280,5992375,0,0,0,95
3380,5992354,5992354,5992449,0,0,0,95
3378,5992016,5992016,5994817,0,0,0,2801
3381,5994903,5994903,5995109,0,0,0,206
3375,5987997,5987997,5995894,0,0,0,7897
3382,5995430,5995430,5996426,0,0,0,996
3384,5996360,5996360,5996884,0,0,0,524
3385,5997532,5997532,5997741,0,0,0,209
3355,5917964,5917964,6003364,0,0,0,85400
3356,5917981,5917981,6003381,0,0,0,85400
3357,5918064,5918064,6003453,0,0,0,85389
3354,5917884,5917884,6003464,0,0,0,85580
3389,6007512,6007512,6007627,0,0,0,115
3390,6007935,6007935,6008507,0,0,0,572
3395,6008308,6008507,6008600,0,0,199,292
3396,6008410,6008507,6008600,0,0,97,190
3397,6008629,6008629,6008724,0,0,0,95
3398,6008697,6008697,6008825,0,0,0,128
3399,6008897,6008897,6008993,0,0,0,96
3401,6009259,6009259,6009317,0,0,0,58
3402,6009438,6009438,6009487,0,0,0,49
3387,6001907,6001907,6010281,0,0,0,8374
3386,5998295,5998295,6010778,0,0,0,12483
3400,6008940,6010281,6010853,0,0,1341,1913
3403,6011066,6011066,6011296,0,0,0,230
3336,5845930,5845930,6012016,0,0,0,166086
3404,6012226,6012226,6012496,0,0,0,270
3405,6012935,6012935,6013144,0,0,0,209
3407,6013423,6013423,6014579,0,0,0,1156
3406,6013271,6013271,6014862,0,0,0,1591
3409,6016378,6016378,6016588,0,0,0,210
3368,5940701,5940701,6022840,0,0,0,82139
3369,5947108,5947108,6055384,0,0,0,108276
3383,5995868,5995868,6067868,0,0,0,72000
3376,5989374,5989374,6075531,0,0,0,86157
3374,5987889,5987889,6075614,0,0,0,87725
3412,6075422,6075422,6075950,0,0,0,528
3415,6075774,6075774,6076282,0,0,0,508
3416,6077238,6077238,6077467,0,0,0,229
3417,6077490,6077490,6077986,0,0,0,496
3414,6075728,6075728,6078419,0,0,0,2691
3423,6078664,6078664,6078940,0,0,0,276
3424,6080082,6080082,6080361,0,0,0,279
3425,6080510,6080510,6080789,0,0,0,279
3426,6080966,6080966,6081135,0,0,0,169
3427,6081106,6081106,6081238,0,0,0,132
3346,5909033,5909033,6081833,0,0,0,172800
3429,6082503,6082503,6085191,0,0,0,2688
3362,5919263,5919263,6088578,0,0,0,169315
3358,5919073,5919073,6090247,0,0,0,171174
3388,6003894,6003894,6090294,0,0,0,86400
3359,5919151,5919151,6090305,0,0,0,171154
3360,5919181,5919181,6090356,0,0,0,171175
3361,5919213,5919213,6090400,0,0,0,171187
3353,5917709,5917709,6090509,0,0,0,172800
3431,6092893,6092893,6093045,0,0,0,152
3430,6087551,6087551,6093453,0,0,0,5902
3391,6008124,6008124,6093702,0,0,0,85578
3394,6008258,6008507,6093904,0,0,249,85646
3392,6008166,6008507,6093914,0,0,341,85748
3393,6008217,6008507,6093914,0,0,290,85697
3432,6093011,6093011,6097193,0,0,0,4182
3433,6093026,6093026,6105827,0,0,0,12801
3435,6105479,6105479,6109915,0,0,0,4436
3441,6110840,6110840,6111062,0,0,0,222
3442,6110951,6110951,6111089,0,0,0,138
3371,5979139,5979139,6112953,0,0,0,133814
3418,6077515,6077515,6113515,0,0,0,36000
3419,6078145,6078145,6114145,0,0,0,36000
3420,6078151,6078151,6114151,0,0,0,36000
3421,6078164,6078164,6114164,0,0,0,36000
3422,6078166,6078166,6114166,0,0,0,36000
3452,6112888,6114166,6118544,0,0,1278,5656
3370,5978699,5978699,6128126,0,0,0,149427
3455,6155756,6155756,6155851,0,0,0,95
3456,6155876,6155876,6155962,0,0,0,86
3457,6156242,6156242,6156346,0,0,0,104
3458,6156380,6156380,6156475,0,0,0,95
3459,6156663,6156663,6156759,0,0,0,96
3460,6157282,6157282,6157386,0,0,0,104
3411,6055342,6055342,6162252,0,0,0,106910
3413,6075506,6075506,6166970,0,0,0,91464
3434,6093047,6093047,6167087,0,0,0,74040
3484,6166995,6167087,6168289,0,0,92,1294
3485,6167002,6168289,6169478,0,0,1287,2476
3473,6166231,6166231,6171259,0,0,0,5028
3468,6166230,6166230,6171269,0,0,0,5039
3477,6166232,6166232,6171269,0,0,0,5037
3474,6166231,6166231,6171270,0,0,0,5039
3464,6166229,6166229,6171290,0,0,0,5061
3475,6166231,6166231,6171292,0,0,0,5061
3465,6166229,6166229,6171527,0,0,0,5298
3463,6166228,6166228,6171535,0,0,0,5307
3469,6166230,6166230,6171557,0,0,0,5327
3470,6166230,6166230,6171588,0,0,0,5358
3471,6166230,6166230,6171765,0,0,0,5535
3466,6166229,6166229,6171795,0,0,0,5566
3476,6166231,6166231,6171808,0,0,0,5577
3472,6166230,6166230,6171849,0,0,0,5619
3482,6166233,6166970,6171959,0,0,737,5726
3478,6166232,6166970,6172042,0,0,738,5810
3467,6166229,6166229,6172118,0,0,0,5889
3479,6166232,6166970,6172226,0,0,738,5994
3483,6166233,6166970,6172226,0,0,737,5993
3480,6166232,6166970,6172282,0,0,738,6050
3481,6166232,6166970,6172837,0,0,738,6605
3488,6178693,6178693,6178783,0,0,0,90
3489,6178693,6178693,6178783,0,0,0,90
3496,6178694,6178694,6178784,0,0,0,90
3497,6178694,6178694,6178784,0,0,0,90
3505,6178696,6178696,6178791,0,0,0,95
3506,6178696,6178696,6178791,0,0,0,95
3507,6178697,6178697,6178792,0,0,0,95
3487,6178692,6178692,6178794,0,0,0,102
3490,6178693,6178693,6178795,0,0,0,102
3491,6178693,6178693,6178795,0,0,0,102
3492,6178693,6178693,6178795,0,0,0,102
3498,6178695,6178695,6178795,0,0,0,100
3499,6178695,6178695,6178795,0,0,0,100
3500,6178695,6178695,6178795,0,0,0,100
3501,6178695,6178695,6178795,0,0,0,100
3493,6178694,6178694,6178796,0,0,0,102
3494,6178694,6178694,6178796,0,0,0,102
3495,6178694,6178694,6178796,0,0,0,102
3502,6178696,6178696,6178796,0,0,0,100
3503,6178696,6178696,6178796,0,0,0,100
3504,6178696,6178696,6178796,0,0,0,100
3508,6179447,6179447,6180626,0,0,0,1179
3408,6015272,6015272,6181369,0,0,0,166097
3520,6180463,6180463,6181465,0,0,0,1002
3510,6180461,6180461,6181468,0,0,0,1007
3511,6180461,6180461,6181468,0,0,0,1007
3512,6180461,6180461,6181468,0,0,0,1007
3515,6180462,6180462,6181469,0,0,0,1007
3516,6180462,6180462,6181469,0,0,0,1007
3519,6180462,6180462,6181475,0,0,0,1013
3521,6180463,6180463,6181476,0,0,0,1013
3522,6180463,6180463,6181476,0,0,0,1013
3523,6180463,6180463,6181476,0,0,0,1013
3524,6180464,6180464,6181477,0,0,0,1013
3513,6180461,6180461,6181480,0,0,0,1019
3514,6180461,6180461,6181480,0,0,0,1019
3517,6180462,6180462,6181481,0,0,0,1019
3518,6180462,6180462,6181481,0,0,0,1019
3509,6179457,6180626,6181818,0,0,1169,2361
3529,6180465,6181369,6182371,0,0,904,1906
3530,6180465,6181369,6182371,0,0,904,1906
3525,6180464,6181369,6182382,0,0,905,1918
3526,6180464,6181369,6182382,0,0,905,1918
3527,6180464,6181369,6182394,0,0,905,1930
3528,6180464,6181369,6182394,0,0,905,1930
3531,6188303,6188303,6189503,0,0,0,1200
3533,6190292,6190292,6191612,0,0,0,1320
3410,6019022,6019022,6191822,0,0,0,172800
3532,6188500,6188500,6192917,0,0,0,4417
3437,6110538,6110538,6195934,0,0,0,85396
3438,6110572,6110572,6195978,0,0,0,85406
3439,6110615,6110615,6196009,0,0,0,85394
3440,6110647,6110647,6196051,0,0,0,85404
3443,6111044,6111044,6196447,0,0,0,85403
3444,6111096,6111096,6196489,0,0,0,85393
3445,6111174,6111174,6196587,0,0,0,85413
3446,6111259,6111259,6196654,0,0,0,85395
3447,6111344,6111344,6196758,0,0,0,85414
3486,6177198,6177198,6205331,0,0,0,28133
3453,6112911,6112911,6244682,0,0,0,131771
3544,6250342,6250342,6250942,0,0,0,600
3546,6252201,6252201,6252294,0,0,0,93
3547,6252386,6252386,6252492,0,0,0,106
3548,6252672,6252672,6252798,0,0,0,126
3549,6252783,6252783,6252909,0,0,0,126
3550,6253251,6253251,6254807,0,0,0,1556
3552,6254751,6254751,6254872,0,0,0,121
3553,6254851,6254851,6254977,0,0,0,126
3551,6254739,6254739,6255141,0,0,0,402
3554,6255109,6255109,6255234,0,0,0,125
3428,6082476,6082476,6255276,0,0,0,172800
3555,6255254,6255254,6255376,0,0,0,122
3556,6255341,6255341,6255499,0,0,0,158
3557,6257345,6257345,6257708,0,0,0,363
3558,6257863,6257863,6260026,0,0,0,2163
3559,6260000,6260000,6260382,0,0,0,382
3560,6260359,6260359,6260700,0,0,0,341
3562,6261081,6261081,6261186,0,0,0,105
3563,6261176,6261176,6262362,0,0,0,1186
3564,6262328,6262328,6263129,0,0,0,801
3545,6250434,6250434,6263305,0,0,0,12871
3543,6250328,6250328,6264792,0,0,0,14464
3565,6263133,6263133,6265567,0,0,0,2434
3561,6260677,6260677,6269112,0,0,0,8435
3462,6162208,6162208,6269710,0,0,0,107502
3454,6128083,6128083,6275629,0,0,0,147546
3448,6111462,6111462,6282643,0,0,0,171181
3449,6111522,6111522,6282725,0,0,0,171203
3450,6111551,6111551,6282732,0,0,0,171181
3451,6111571,6111571,6282763,0,0,0,171192
3436,6110472,6110472,6283272,0,0,0,172800
3535,6200457,6200457,6285857,0,0,0,85400
3536,6200519,6200519,6285908,0,0,0,85389
3537,6200577,6200577,6285962,0,0,0,85385
3538,6200692,6200692,6286097,0,0,0,85405
3570,6292082,6292082,6292141,0,0,0,59
3542,6245455,6245455,6308573,0,0,0,63118
3540,6245207,6245207,6308749,0,0,0,63542
3461,6157492,6157492,6326391,0,0,0,168899
3541,6245400,6245400,6331758,0,0,0,86358
3569,6276618,6276618,6361454,0,0,0,84836
3534,6200252,6200252,6366082,0,0,0,165830
3539,6244682,6244682,6376076,0,0,0,131394
3573,6376384,6376384,6376863,0,0,0,479
3567,6269662,6269662,6378205,0,0,0,108543
3574,6377224,6377224,6379047,0,0,0,1823
3571,6375378,6375378,6421428,0,0,0,46050
3576,6378992,6378992,6421476,0,0,0,42484
3568,6275587,6275587,6423451,0,0,0,147864
3578,6424209,6424209,6426064,0,0,0,1855
3566,6269596,6269596,6442396,0,0,0,172800
3580,6426056,6426056,6453522,0,0,0,27466
3579,6426030,6426030,6462143,0,0,0,36113
3575,6378170,6378170,6485695,0,0,0,107525
3592,6505465,6505465,6506056,0,0,0,591
3582,6462978,6462978,6506242,0,0,0,43264
3581,6462770,6462770,6506273,0,0,0,43503
3596,6506309,6506309,6509020,0,0,0,2711
3604,6513158,6513158,6513262,0,0,0,104
3602,6511658,6511658,6517264,0,0,0,5606
3587,6485653,6485653,6517279,0,0,0,31626
3608,6517766,6517766,6517946,0,0,0,180
3609,6518235,6518235,6518927,0,0,0,692
3603,6512312,6512312,6519588,0,0,0,7276
3606,6513689,6513689,6519686,0,0,0,5997
3610,6519813,6519813,6520021,0,0,0,208
3612,6520146,6520146,6520204,0,0,0,58
3611,6520073,6520073,6520515,0,0,0,442
3613,6521292,6521292,6521921,0,0,0,629
3615,6522922,6522922,6522980,0,0,0,58
3616,6523212,6523212,6523333,0,0,0,121
3614,6522563,6522563,6523467,0,0,0,904
3617,6523891,6523891,6523958,0,0,0,67
3618,6523984,6523984,6524537,0,0,0,553
3619,6524488,6524488,6526295,0,0,0,1807
3620,6527071,6527071,6527825,0,0,0,754
3621,6528373,6528373,6528499,0,0,0,126
3622,6528478,6528499,6528873,0,0,21,395
3623,6529231,6529231,6529765,0,0,0,534
3625,6530205,6530205,6530264,0,0,0,59
3626,6530259,6530259,6530317,0,0,0,58
3624,6529827,6529827,6530421,0,0,0,594
3627,6530479,6530479,6531810,0,0,0,1331
3629,6532025,6532025,6533340,0,0,0,1315
3628,6530889,6530889,6533467,0,0,0,2578
3572,6376034,6376034,6536007,0,0,0,159973
3605,6513341,6513341,6539483,0,0,0,26142
3607,6517748,6517748,6540828,0,0,0,23080
3590,6505316,6505316,6559342,0,0,0,54026
3594,6506077,6506077,6559624,0,0,0,53547
3593,6505620,6505620,6559747,0,0,0,54127
3591,6505418,6505418,6560340,0,0,0,54922
3601,6510235,6510235,6568422,0,0,0,58187
3597,6506506,6506506,6591896,0,0,0,85390
3598,6506542,6506542,6591938,0,0,0,85396
3599,6506598,6506598,6591982,0,0,0,85384
3600,6506630,6506630,6592034,0,0,0,85404
3577,6423408,6423408,6593792,0,0,0,170384
3641,6597206,6597206,6597577,0,0,0,371
3640,6597185,6597185,6598698,0,0,0,1513
3642,6599370,6599370,6600771,0,0,0,1401
3646,6600963,6600963,6602181,0,0,0,1218
3647,6602250,6602250,6603473,0,0,0,1223
3648,6607035,6607035,6608257,0,0,0,1222
3649,6609956,6609956,6612471,0,0,0,2515
3643,6599730,6599730,6612579,0,0,0,12849
3644,6599737,6599737,6612593,0,0,0,12856
3645,6600495,6600495,6613348,0,0,0,12853
3650,6613134,6613134,6613886,0,0,0,752
3652,6617279,6617279,6617337,0,0,0,58
3653,6617338,6617338,6617396,0,0,0,58
3655,6617390,6617390,6617437,0,0,0,47
3656,6617534,6617534,6617585,0,0,0,51
3637,6594101,6594101,6617676,0,0,0,23575
3657,6617701,6617701,6617760,0,0,0,59
3595,6506211,6506211,6617819,0,0,0,111608
3659,6617883,6617883,6617984,0,0,0,101
3658,6617775,6617775,6619211,0,0,0,1436
3651,6617159,6617159,6619281,0,0,0,2122
3654,6617385,6617385,6619428,0,0,0,2043
3630,6533434,6533434,6619834,0,0,0,86400
3631,6533625,6533625,6620025,0,0,0,86400
3663,6619939,6619939,6620388,0,0,0,449
3669,6621544,6621544,6622007,0,0,0,463
3661,6619460,6619460,6625458,0,0,0,5998
3634,6540995,6540995,6627395,0,0,0,86400
3635,6541104,6541104,6627504,0,0,0,86400
3664,6620137,6620137,6627798,0,0,0,7661
3686,6628563,6628563,6628817,0,0,0,254
3583,6463527,6463527,6630221,0,0,0,166694
3585,6463764,6463764,6634949,0,0,0,171185
3586,6463842,6463842,6634974,0,0,0,171132
3584,6463645,6463645,6636445,0,0,0,172800
3665,6620363,6620363,6636984,0,0,0,16621
3684,6627605,6627605,6640132,0,0,0,12527
3685,6627733,6627733,6642773,0,0,0,15040
3639,6597037,6597037,6650876,0,0,0,53839
3638,6597014,6597014,6651657,0,0,0,54643
3693,6648440,6650876,6656789,0,0,2436,8349
3694,6652040,6652040,6657985,0,0,0,5945
3695,6655641,6655641,6659168,0,0,0,3527
3696,6659241,6659241,6662768,0,0,0,3527
3697,6662840,6662840,6666378,0,0,0,3538
3633,6535963,6536007,6669520,0,0,44,133557
3698,6666440,6666440,6669989,0,0,0,3549
3676,6622848,6622848,6671533,0,0,0,48685
3677,6622869,6622869,6674036,0,0,0,51167
3674,6622715,6622715,6674708,0,0,0,51993
3688,6641241,6641241,6675374,0,0,0,34133
3692,6644840,6644840,6675383,0,0,0,30543
3589,6504485,6504485,6675672,0,0,0,171187
3588,6504447,6504447,6675875,0,0,0,171428
3673,6622677,6622677,6679450,0,0,0,56773
3700,6678483,6678483,6679761,0,0,0,1278
3702,6679443,6679443,6681243,0,0,0,1800
3708,6681534,6681534,6681621,0,0,0,87
3703,6679973,6679973,6681773,0,0,0,1800
3704,6679986,6679986,6681786,0,0,0,1800
3710,6681764,6681764,6682029,0,0,0,265
3711,6682089,6682089,6684789,0,0,0,2700
3713,6684395,6684395,6685442,0,0,0,1047
3715,6687263,6687263,6690272,0,0,0,3009
3714,6687252,6687252,6692294,0,0,0,5042
3679,6623274,6623274,6695528,0,0,0,72254
3668,6621449,6621449,6696318,0,0,0,74869
3675,6622837,6622837,6696657,0,0,0,73820
3682,6623760,6623760,6696730,0,0,0,72970
3718,6693829,6693829,6697139,0,0,0,3310
3671,6622511,6622511,6697896,0,0,0,75385
3716,6692365,6692365,6698412,0,0,0,6047
3719,6698081,6698081,6698552,0,0,0,471
3720,6698142,6698142,6698609,0,0,0,467
3717,6693745,6693745,6698967,0,0,0,5222
3683,6623821,6623821,6699899,0,0,0,76078
3672,6622583,6622583,6701452,0,0,0,78869
3724,6701250,6701250,6702535,0,0,0,1285
3723,6701219,6701219,6702536,0,0,0,1317
3632,6534608,6534608,6703515,0,0,0,168907
3725,6702451,6702451,6703951,0,0,0,1500
3670,6622219,6622219,6704066,0,0,0,81847
3726,6702551,6702551,6704391,0,0,0,1840
3660,6619062,6619062,6705462,0,0,0,86400
3662,6619558,6619558,6705958,0,0,0,86400
3678,6622894,6622894,6709294,0,0,0,86400
3727,6705623,6705623,6709567,0,0,0,3944
3680,6623380,6623380,6709682,0,0,0,86302
3730,6709558,6709558,6709951,0,0,0,393
3728,6705812,6705812,6713292,0,0,0,7480
3667,6621180,6621180,6713835,0,0,0,92655
3733,6714671,6714671,6715732,0,0,0,1061
3744,6714772,6714772,6715765,0,0,0,993
3748,6714846,6714846,6715932,0,0,0,1086
3750,6714899,6714899,6715973,0,0,0,1074
3761,6714998,6714998,6716004,0,0,0,1006
3732,6714589,6714589,6716044,0,0,0,1455
3747,6714798,6714798,6716232,0,0,0,1434
3749,6714890,6714890,6716301,0,0,0,1411
3764,6715020,6715020,6716410,0,0,0,1390
3721,6700782,6700782,6721077,0,0,0,20295
3722,6700827,6700827,6721154,0,0,0,20327
3729,6706098,6706098,6721620,0,0,0,15522
3731,6714584,6714584,6723321,0,0,0,8737
3766,6715045,6715045,6728008,0,0,0,12963
3765,6715025,6715025,6728366,0,0,0,13341
3769,6730088,6730088,6732287,0,0,0,2199
3763,6715019,6715019,6766372,0,0,0,51353
3758,6714972,6714972,6766383,0,0,0,51411
3762,6715004,6715004,6766389,0,0,0,51385
3760,6714980,6714980,6766402,0,0,0,51422
3759,6714975,6714975,6766408,0,0,0,51433
3755,6714946,6714946,6766423,0,0,0,51477
3756,6714949,6714949,6766438,0,0,0,51489
3753,6714925,6714925,6766446,0,0,0,51521
3757,6714953,6714953,6766453,0,0,0,51500
3754,6714933,6714933,6766454,0,0,0,51521
3751,6714903,6714903,6766461,0,0,0,51558
3752,6714907,6714907,6766465,0,0,0,51558
3745,6714774,6714774,6766481,0,0,0,51707
3746,6714781,6714781,6766488,0,0,0,51707
3734,6714680,6714680,6766492,0,0,0,51812
3735,6714685,6714685,6766497,0,0,0,51812
3736,6714699,6714699,6766501,0,0,0,51802
3739,6714725,6714725,6766501,0,0,0,51776
3737,6714703,6714703,6766505,0,0,0,51802
3738,6714709,6714709,6766511,0,0,0,51802
3742,6714751,6714751,6766512,0,0,0,51761
3740,6714727,6714727,6766514,0,0,0,51787
3741,6714733,6714733,6766520,0,0,0,51787
3743,6714761,6714761,6766533,0,0,0,51772
3772,6767662,6767662,6768727,0,0,0,1065
3771,6767649,6767649,6769140,0,0,0,1491
3636,6593742,6593742,6771341,0,0,0,177599
3784,6771850,6771850,6772849,0,0,0,999
3790,6771911,6771911,6773013,0,0,0,1102
3801,6772054,6772054,6773070,0,0,0,1016
3788,6771905,6771905,6773314,0,0,0,1409
3787,6771893,6771893,6773323,0,0,0,1430
3804,6772079,6772079,6773475,0,0,0,1396
3807,6773158,6773158,6774958,0,0,0,1800
3770,6767644,6767644,6776394,0,0,0,8750
3808,6776410,6776410,6776525,0,0,0,115
3810,6781438,6781438,6781523,0,0,0,85
3666,6620778,6620778,6781786,0,0,0,161008
3809,6781319,6781319,6781877,0,0,0,558
3796,6772020,6772020,6782016,0,0,0,9996
3779,6771773,6771773,6782187,0,0,0,10414
3795,6772009,6772009,6782405,0,0,0,10396
3797,6772021,6772021,6784628,0,0,0,12607
3806,6772099,6772099,6785084,0,0,0,12985
3798,6772026,6772026,6785504,0,0,0,13478
3780,6771790,6771790,6785862,0,0,0,14072
3805,6772098,6772098,6787209,0,0,0,15111
3773,6767672,6767672,6790841,0,0,0,23169
3781,6771833,6771833,6792481,0,0,0,20648
3789,6771905,6771905,6794047,0,0,0,22142
3775,6771742,6771742,6794161,0,0,0,22419
3785,6771868,6771868,6796551,0,0,0,24683
3802,6772072,6772072,6796771,0,0,0,24699
3782,6771842,6771842,6797867,0,0,0,26025
3799,6772046,6772046,6798126,0,0,0,26080
3699,6669434,6669434,6801075,0,0,0,131641
3793,6771940,6771940,6801950,0,0,0,30010
3794,6771957,6771957,6804399,0,0,0,32442
3800,6772048,6772048,6805703,0,0,0,33655
3786,6771888,6771888,6806026,0,0,0,34138
3777,6771758,6771758,6806681,0,0,0,34923
3689,6641816,6641816,6807799,0,0,0,165983
3783,6771844,6771844,6808261,0,0,0,36417
3687,6637640,6637640,6810440,0,0,0,172800
3690,6641868,6641868,6813007,0,0,0,171139
3691,6641902,6641902,6813053,0,0,0,171151
3767,6721495,6721495,6829495,0,0,0,108000
3768,6721711,6721711,6829711,0,0,0,108000
3816,6848250,6848250,6848366,0,0,0,116
3817,6848359,6848359,6848630,0,0,0,271
3819,6850105,6850105,6850213,0,0,0,108
3681,6623722,6625458,6850259,0,0,1736,226537
3701,6678940,6678940,6850541,0,0,0,171601
3706,6681001,6681001,6852130,0,0,0,171129
3705,6680868,6680868,6852433,0,0,0,171565
3709,6681681,6681681,6853283,0,0,0,171602
3707,6681030,6681030,6853830,0,0,0,172800
3712,6682723,6682723,6854286,0,0,0,171563
3803,6772074,6772074,6855223,0,0,0,83149
3778,6771769,6771769,6855232,0,0,0,83463
3791,6771931,6771931,6855232,0,0,0,83301
3792,6771932,6771932,6855233,0,0,0,83301
3776,6771753,6771753,6855237,0,0,0,83484
3812,6783789,6783789,6860350,0,0,0,76561
3833,6861857,6861857,6862854,0,0,0,997
3834,6862855,6862855,6862906,0,0,0,51
3828,6855169,6855169,6866163,0,0,0,10994
3829,6855261,6855261,6869479,0,0,0,14218
3830,6855283,6855283,6869822,0,0,0,14539
3831,6855296,6855296,6870145,0,0,0,14849
3839,6869672,6869672,6872622,0,0,0,2950
3844,6869865,6869865,6872984,0,0,0,3119
3840,6869702,6869702,6873075,0,0,0,3373
3841,6869842,6869842,6873442,0,0,0,3600
3842,6869852,6869852,6873452,0,0,0,3600
3843,6869857,6869857,6873457,0,0,0,3600
3845,6873893,6873893,6873936,0,0,0,43
3846,6874166,6874166,6878392,0,0,0,4226
3847,6881105,6881105,6881162,0,0,0,57
3848,6881111,6881111,6881163,0,0,0,52
3849,6881118,6881118,6881181,0,0,0,63
3850,6881793,6881793,6881841,0,0,0,48
3851,6881801,6881801,6881856,0,0,0,55
3852,6881817,6881817,6881874,0,0,0,57
3853,6882516,6882516,6882564,0,0,0,48
3854,6882522,6882522,6882578,0,0,0,56
3855,6882527,6882527,6882594,0,0,0,67
3856,6882748,6882748,6882797,0,0,0,49
3857,6882754,6882754,6882803,0,0,0,49
3858,6882761,6882761,6882822,0,0,0,61
3864,6884399,6884399,6884457,0,0,0,58
3863,6883724,6883724,6884646,0,0,0,922
3860,6883610,6883610,6884657,0,0,0,1047
3862,6883718,6883718,6884668,0,0,0,950
3861,6883615,6883615,6884673,0,0,0,1058
3859,6883604,6883604,6884679,0,0,0,1075
3873,6885200,6885200,6886997,0,0,0,1797
3811,6781673,6781673,6892456,0,0,0,110783
3774,6771296,6771296,6917800,0,0,0,146504
3813,6785083,6785083,6928016,0,0,0,142933
3832,6857117,6857117,6939137,0,0,0,82020
3877,6941702,6941702,6942367,0,0,0,665
3820,6851754,6851754,6942374,0,0,0,90620
3818,6849435,6849435,6942376,0,0,0,92941
3878,6941737,6941737,6942402,0,0,0,665
3879,6941753,6942367,6943032,0,0,614,1279
3871,6884988,6884988,6946025,0,0,0,61037
3869,6884925,6884925,6947232,0,0,0,62307
3883,6947060,6947060,6947990,0,0,0,930
3889,6948500,6948500,6950711,0,0,0,2211
3887,6948463,6948463,6950936,0,0,0,2473
3884,6948434,6948434,6951263,0,0,0,2829
3888,6948492,6948492,6951554,0,0,0,3062
3885,6948441,6948441,6951673,0,0,0,3232
3886,6948457,6948457,6952242,0,0,0,3785
3835,6865318,6865318,6952484,0,0,0,87166
3890,6955868,6955868,6958794,0,0,0,2926
3896,6956087,6956087,6959090,0,0,0,3003
3891,6955882,6955882,6959273,0,0,0,3391
3897,6956096,6956096,6959871,0,0,0,3775
3892,6956060,6956060,6960013,0,0,0,3953
3867,6884904,6884904,6960026,0,0,0,75122
3893,6956067,6956067,6960311,0,0,0,4244
3898,6956104,6956104,6960340,0,0,0,4236
3894,6956074,6956074,6960618,0,0,0,4544
3895,6956081,6956081,6962758,0,0,0,6677
3870,6884981,6884981,6962889,0,0,0,77908
3865,6884893,6884893,6971293,0,0,0,86400
3866,6884899,6884899,6971299,0,0,0,86400
3868,6884909,6884909,6971309,0,0,0,86400
3872,6884993,6884993,6971393,0,0,0,86400
3814,6801031,6801031,6972507,0,0,0,171476
3836,6865385,6865385,6973385,0,0,0,108000
3837,6866316,6866316,6974316,0,0,0,108000
3838,6866937,6866937,6974937,0,0,0,108000
3905,6979581,6979581,6979635,0,0,0,54
3815,6810732,6810732,6983532,0,0,0,172800
3913,6988314,6988314,6988449,0,0,0,135
3914,6988512,6988512,6988645,0,0,0,133
3915,6989203,6989203,6989293,0,0,0,90
3916,6989423,6989423,6989467,0,0,0,44
3917,6989452,6989452,6989607,0,0,0,155
3918,6990206,6990206,6990321,0,0,0,115
3874,6892411,6892411,7003809,0,0,0,111398
3824,6853991,6853991,7020024,0,0,0,166033
3910,6982612,6982612,7022345,0,0,0,39733
3904,6979556,6979556,7023486,0,0,0,43930
3825,6854038,6854038,7025161,0,0,0,171123
3826,6854076,6854076,7025262,0,0,0,171186
3822,6853917,6853917,7025468,0,0,0,171551
3821,6853885,6853885,7025481,0,0,0,171596
3823,6853963,6853963,7025530,0,0,0,171567
3827,6854117,6854117,7026917,0,0,0,172800
3921,7027179,7027179,7027269,0,0,0,90
3922,7027375,7027375,7027468,0,0,0,93
3923,7028657,7028657,7028902,0,0,0,245
3924,7028922,7028922,7029038,0,0,0,116
3925,7029271,7029271,7029469,0,0,0,198
3926,7030870,7030870,7030956,0,0,0,86
3927,7031088,7031088,7031471,0,0,0,383
3907,6979651,6979651,7031645,0,0,0,51994
3928,7031733,7031733,7032337,0,0,0,604
3934,7032838,7032838,7034005,0,0,0,1167
3935,7034780,7034780,7034895,0,0,0,115
3908,6979675,6979675,7038799,0,0,0,59124
3936,7035181,7035181,7040424,0,0,0,5243
3906,6979624,6979624,7043475,0,0,0,63851
3937,7047229,7047229,7048037,0,0,0,808
3903,6979439,6979439,7050850,0,0,0,71411
3909,6982409,6982409,7054554,0,0,0,72145
3899,6961499,6962758,7058014,0,0,1259,96515
3875,6917747,6917747,7065106,0,0,0,147359
3881,6943031,6943031,7067826,0,0,0,124795
3902,6979407,6979407,7068106,0,0,0,88699
3876,6930916,6930916,7075814,0,0,0,144898
3911,6982885,6982885,7103244,0,0,0,120359
3938,7048201,7048201,7110889,0,0,0,62688
3942,7111434,7111434,7113114,0,0,0,1680
3943,7113132,7113132,7114172,0,0,0,1040
3948,7114170,7114170,7115132,0,0,0,962
3944,7113441,7113441,7115861,0,0,0,2420
3945,7113515,7113515,7115872,0,0,0,2357
3950,7115282,7115282,7116002,0,0,0,720
3946,7113527,7113527,7117844,0,0,0,4317
3951,7116519,7116519,7118215,0,0,0,1696
3954,7118404,7118404,7119162,0,0,0,758
3955,7119174,7119174,7120487,0,0,0,1313
3956,7119972,7119972,7120510,0,0,0,538
3952,7118351,7118351,7120779,0,0,0,2428
3953,7118372,7118372,7120788,0,0,0,2416
3957,7121696,7121696,7122004,0,0,0,308
3958,7122115,7122115,7122884,0,0,0,769
3959,7122872,7122872,7122968,0,0,0,96
3960,7123153,7123153,7124012,0,0,0,859
3947,7113545,7113545,7124319,0,0,0,10774
3961,7124373,7124373,7124411,0,0,0,38
3962,7124397,7124397,7125425,0,0,0,1028
3964,7125459,7125459,7125560,0,0,0,101
3920,7003774,7003774,7125773,0,0,0,121999
3975,7126097,7126097,7126174,0,0,0,77
3978,7126208,7126208,7126256,0,0,0,48
3980,7126212,7126212,7126257,0,0,0,45
3979,7126210,7126210,7126275,0,0,0,65
3983,7126217,7126217,7126342,0,0,0,125
3968,7126035,7126035,7126576,0,0,0,541
3982,7126215,7126215,7126617,0,0,0,402
3981,7126214,7126214,7126644,0,0,0,430
3984,7126560,7126560,7126652,0,0,0,92
3976,7126129,7126129,7126714,0,0,0,585
3977,7126202,7126202,7126725,0,0,0,523
3973,7126093,7126093,7126730,0,0,0,637
3974,7126095,7126095,7126732,0,0,0,637
3972,7126092,7126092,7126751,0,0,0,659
3970,7126088,7126088,7126758,0,0,0,670
3971,7126090,7126090,7126760,0,0,0,670
3969,7126082,7126082,7126768,0,0,0,686
3986,7126833,7126833,7126941,0,0,0,108
3987,7127084,7127084,7127142,0,0,0,58
3988,7127373,7127373,7127673,0,0,0,300
3989,7127792,7127792,7127943,0,0,0,151
3990,7127990,7127990,7128228,0,0,0,238
3991,7128026,7128026,7128326,0,0,0,300
3985,7126627,7126627,7128603,0,0,0,1976
3992,7128343,7128343,7128631,0,0,0,288
3994,7128638,7128638,7128814,0,0,0,176
4002,7129019,7129019,7129089,0,0,0,70
3995,7128805,7128805,7129105,0,0,0,300
4005,7129276,7129276,7129327,0,0,0,51
4006,7129292,7129292,7129343,0,0,0,51
4007,7129295,7129295,7129348,0,0,0,53
4012,7129304,7129304,7129373,0,0,0,69
4013,7129361,7129361,7129409,0,0,0,48
4014,7129697,7129697,7129755,0,0,0,58
4015,7129822,7129822,7129869,0,0,0,47
4016,7129912,7129912,7129959,0,0,0,47
4017,7130030,7130030,7130089,0,0,0,59
4018,7130569,7130569,7130612,0,0,0,43
4025,7132626,7132626,7132926,0,0,0,300
4026,7133595,7133595,7133643,0,0,0,48
3963,7125264,7125264,7133983,0,0,0,8719
4027,7134492,7134492,7134792,0,0,0,300
4028,7134843,7134843,7135121,0,0,0,278
3993,7128617,7128617,7135195,0,0,0,6578
4029,7135162,7135162,7135216,0,0,0,54
4030,7135341,7135341,7135399,0,0,0,58
4031,7135423,7135423,7135482,0,0,0,59
4024,7132216,7132216,7135562,0,0,0,3346
4032,7135585,7135585,7135632,0,0,0,47
4033,7135711,7135711,7135759,0,0,0,48
4034,7135799,7135799,7135888,0,0,0,89
4035,7135874,7135874,7135921,0,0,0,47
4036,7136009,7136009,7136058,0,0,0,49
4037,7136114,7136114,7136162,0,0,0,48
4038,7136168,7136168,7136215,0,0,0,47
4023,7132169,7132169,7136396,0,0,0,4227
4039,7136230,7136230,7136443,0,0,0,213
4040,7136435,7136435,7136560,0,0,0,125
4041,7136546,7136546,7136724,0,0,0,178
4042,7136748,7136748,7137043,0,0,0,295
4043,7137102,7137102,7137202,0,0,0,100
3967,7125816,7125816,7139450,0,0,0,13634
3965,7125653,7125653,7140012,0,0,0,14359
4051,7140077,7140077,7140234,0,0,0,157
4052,7141033,7141033,7141148,0,0,0,115
4053,7143151,7143151,7143244,0,0,0,93
4054,7143237,7143237,7143332,0,0,0,95
4055,7143466,7143466,7143571,0,0,0,105
4050,7139624,7139624,7144357,0,0,0,4733
4058,7144342,7144342,7144444,0,0,0,102
3930,7032282,7032282,7149876,0,0,0,117594
4056,7144000,7149876,7149981,0,0,5876,5981
3900,6978870,6978870,7150025,0,0,0,171155
3901,6978928,6978928,7150560,0,0,0,171632
3919,7001065,7020024,7152558,0,0,18959,151493
4008,7129297,7129297,7155156,0,0,0,25859
3912,6983760,6983760,7156560,0,0,0,172800
4022,7130828,7130828,7156849,0,0,0,26021
4048,7138156,7138156,7159934,0,0,0,21778
4047,7138151,7138151,7161371,0,0,0,23220
4004,7129270,7129270,7161749,0,0,0,32479
4020,7130824,7130824,7163618,0,0,0,32794
4009,7129298,7129298,7166785,0,0,0,37487
4001,7129017,7129017,7167849,0,0,0,38832
4000,7129015,7129015,7168410,0,0,0,39395
4010,7129299,7129299,7170764,0,0,0,41465
4045,7138137,7138137,7171036,0,0,0,32899
4049,7138160,7138160,7171310,0,0,0,33150
3998,7129012,7129012,7174100,0,0,0,45088
3997,7129010,7129010,7174744,0,0,0,45734
4059,7145771,7149981,7176743,0,0,4210,30972
4057,7144209,7176743,7176830,0,0,32534,32621
4019,7130822,7130822,7181724,0,0,0,50902
4003,7129051,7129051,7183067,0,0,0,54016
4021,7130826,7130826,7184898,0,0,0,54072
4011,7129301,7129301,7190978,0,0,0,61677
4063,7194065,7194065,7194149,0,0,0,84
4064,7194240,7194240,7194355,0,0,0,115
4065,7194583,7194583,7194672,0,0,0,89
4068,7194647,7194647,7194741,0,0,0,94
4061,7193313,7193313,7194742,0,0,0,1429
4062,7193960,7193960,7194749,0,0,0,789
4067,7194645,7194645,7194750,0,0,0,105
4066,7194643,7194643,7194760,0,0,0,117
4071,7194868,7194868,7194952,0,0,0,84
4074,7194907,7194907,7194996,0,0,0,89
4075,7195049,7195049,7195144,0,0,0,95
4077,7195162,7195162,7195209,0,0,0,47
3999,7129013,7129013,7195560,0,0,0,66547
3880,6943026,6943026,7198497,0,0,0,255471
4080,7199126,7199126,7199170,0,0,0,44
4083,7199552,7199552,7199715,0,0,0,163
4046,7138146,7138146,7199859,0,0,0,61713
4084,7199557,7199715,7199884,0,0,158,327
3882,6943036,6943036,7201718,0,0,0,258682
4087,7202979,7202979,7203125,0,0,0,146
3932,7032342,7032342,7203485,0,0,0,171143
3931,7032315,7032315,7203512,0,0,0,171197
3933,7032383,7032383,7203538,0,0,0,171155
3929,7032265,7032265,7203841,0,0,0,171576
3996,7129004,7129004,7204007,0,0,0,75003
4082,7199543,7199543,7204202,0,0,0,4659
4086,7201405,7201405,7204308,0,0,0,2903
4091,7207369,7207369,7207700,0,0,0,331
4093,7208876,7208876,7208971,0,0,0,95
4098,7209866,7209866,7209970,0,0,0,104
4099,7210008,7210008,7211021,0,0,0,1013
4073,7194904,7194904,7211259,0,0,0,16355
4085,7200731,7200731,7211335,0,0,0,10604
4070,7194864,7194864,7211593,0,0,0,16729
4100,7211123,7211123,7212697,0,0,0,1574
4101,7212769,7212769,7213812,0,0,0,1043
3949,7115057,7115057,7216270,0,0,0,101213
4102,7215977,7215977,7216993,0,0,0,1016
4104,7217974,7217974,7218336,0,0,0,362
4103,7217962,7217962,7218351,0,0,0,389
4076,7195095,7195095,7218651,0,0,0,23556
4078,7195320,7195320,7218833,0,0,0,23513
3940,7075771,7075771,7222336,0,0,0,146565
4107,7222750,7222750,7222848,0,0,0,98
4106,7222571,7222571,7223036,0,0,0,465
4108,7223244,7223244,7223348,0,0,0,104
4110,7223982,7223982,7224079,0,0,0,97
4112,7224720,7224720,7224860,0,0,0,140
4113,7224942,7224942,7225063,0,0,0,121
4114,7225129,7225129,7225350,0,0,0,221
4072,7194901,7194901,7225759,0,0,0,30858
4116,7225653,7225653,7225794,0,0,0,141
4069,7194802,7194802,7226173,0,0,0,31371
4092,7207478,7207478,7226655,0,0,0,19177
4109,7223857,7223857,7229288,0,0,0,5431
4115,7225384,7225384,7232441,0,0,0,7057
4117,7226023,7226023,7233026,0,0,0,7003
4119,7226295,7226295,7234534,0,0,0,8239
4088,7203359,7203359,7234629,0,0,0,31270
4089,7203545,7203545,7234640,0,0,0,31095
4118,7226287,7226287,7234856,0,0,0,8569
4120,7226309,7226309,7234868,0,0,0,8559
4121,7226316,7226316,7235114,0,0,0,8798
4122,7226325,7226325,7235424,0,0,0,9099
3966,7125772,7125772,7235882,0,0,0,110110
4123,7227258,7227258,7239896,0,0,0,12638
4125,7240238,7240238,7240353,0,0,0,115
4126,7240446,7240446,7240574,0,0,0,128
4128,7240510,7240510,7240638,0,0,0,128
4044,7138094,7138094,7267895,0,0,0,129801
3941,7109372,7109372,7276141,0,0,0,166769
4081,7199132,7199132,7285388,0,0,0,86256
4132,7287192,7287192,7287307,0,0,0,115
4133,7287205,7287205,7287331,0,0,0,126
4134,7287324,7287324,7288359,0,0,0,1035
4135,7287493,7287493,7288363,0,0,0,870
4131,7241576,7241576,7292057,0,0,0,50481
4090,7203614,7203614,7292100,0,0,0,88486
4111,7224331,7224331,7301887,0,0,0,77556
4079,7198766,7198766,7304363,0,0,0,105597
4146,7309255,7309255,7309310,0,0,0,55
4147,7309262,7309262,7309321,0,0,0,59
4148,7309268,7309268,7309327,0,0,0,59
4152,7309376,7309376,7309669,0,0,0,293
4153,7310265,7310265,7310316,0,0,0,51
4154,7310371,7310371,7310429,0,0,0,58
4158,7310685,7310685,7310825,0,0,0,140
4159,7311013,7311013,7311889,0,0,0,876
4160,7311282,7311282,7312157,0,0,0,875
4161,7311598,7311598,7312469,0,0,0,871
4163,7312532,7312532,7312667,0,0,0,135
4164,7312784,7312784,7312842,0,0,0,58
4155,7310648,7310648,7316517,0,0,0,5869
3939,7065069,7065069,7317069,0,0,0,252000
4156,7310656,7310656,7323324,0,0,0,12668
4157,7310668,7310668,7324025,0,0,0,13357
4060,7161357,7161357,7334157,0,0,0,172800
4149,7309283,7309283,7337929,0,0,0,28646
4151,7309306,7309306,7339747,0,0,0,30441
4150,7309299,7309299,7340061,0,0,0,30762
4096,7209109,7209109,7341474,0,0,0,132365
4097,7209124,7209124,7343702,0,0,0,134578
4094,7208891,7208891,7344687,0,0,0,135796
4124,7235884,7235884,7346355,0,0,0,110471
4095,7209094,7209094,7347399,0,0,0,138305
4145,7305311,7305311,7350604,0,0,0,45293
4137,7292004,7292004,7356804,0,0,0,64800
4174,7379846,7379846,7379908,0,0,0,62
4175,7383388,7383388,7383447,0,0,0,59
4167,7374192,7374192,7383588,0,0,0,9396
4176,7383617,7383617,7383675,0,0,0,58
4177,7384392,7384392,7384656,0,0,0,264
4180,7385002,7385002,7385059,0,0,0,57
4181,7385314,7385314,7385503,0,0,0,189
4184,7385763,7385763,7386647,0,0,0,884
4185,7385926,7385926,7386799,0,0,0,873
4186,7386057,7386057,7386935,0,0,0,878
4193,7393790,7393790,7393888,0,0,0,98
4162,7312330,7312330,7395628,0,0,0,83298
4192,7391562,7395628,7395734,0,0,4066,4172
4188,7387960,7387960,7396133,0,0,0,8173
4189,7387963,7387963,7396523,0,0,0,8560
4187,7387953,7387953,7396542,0,0,0,8589
4191,7387982,7387982,7396887,0,0,0,8905
4190,7387968,7387968,7404577,0,0,0,16609
4194,7393960,7393960,7411374,0,0,0,17414
4130,7240608,7240608,7411732,0,0,0,171124
4172,7378806,7411374,7411933,0,0,32568,33127
4127,7240468,7240468,7412034,0,0,0,171566
4129,7240530,7240530,7412108,0,0,0,171578
4105,7222329,7222329,7413236,0,0,0,190907
4195,7404568,7404568,7413380,0,0,0,8812
4197,7416809,7416809,7416907,0,0,0,98
4136,7290871,7290871,7429542,0,0,0,138671
4179,7384740,7411933,7434664,0,0,27193,49924
4173,7378813,7434664,7435277,0,0,55851,56464
4138,7296363,7296363,7436954,0,0,0,140591
4198,7417280,7417280,7444967,0,0,0,27687
4165,7346312,7346312,7456047,0,0,0,109735
4200,7458575,7458575,7460975,0,0,0,2400
4201,7462340,7462340,7462641,0,0,0,301
4202,7462586,7462586,7464052,0,0,0,1466
4144,7304666,7304666,7473563,0,0,0,168897
4203,7473784,7473784,7473843,0,0,0,59
4204,7473912,7473912,7473970,0,0,0,58
4205,7474118,7474118,7474177,0,0,0,59
4206,7474394,7474394,7474867,0,0,0,473
4207,7475045,7475045,7475103,0,0,0,58
4142,7304600,7304600,7475739,0,0,0,171139
4141,7304585,7304585,7475777,0,0,0,171192
4143,7304621,7304621,7475777,0,0,0,171156
4139,7304534,7304534,7476100,0,0,0,171566
4140,7304540,7304540,7476100,0,0,0,171560
4208,7475172,7475172,7478732,0,0,0,3560
4211,7480754,7480754,7481064,0,0,0,310
4210,7480731,7480731,7481350,0,0,0,619
4209,7479012,7479012,7482479,0,0,0,3467
4221,7485490,7485490,7486037,0,0,0,547
4220,7485486,7485486,7486050,0,0,0,564
4212,7483158,7483158,7486833,0,0,0,3675
4223,7490647,7490647,7490659,0,0,0,12
4222,7490631,7490631,7490672,0,0,0,41
4182,7385656,7385656,7493485,0,0,0,107829
4214,7485444,7485444,7493599,0,0,0,8155
4213,7485441,7485441,7493988,0,0,0,8547
4215,7485457,7485457,7494062,0,0,0,8605
4216,7485461,7485461,7494335,0,0,0,8874
4217,7485466,7485466,7494383,0,0,0,8917
4218,7485477,7485477,7494591,0,0,0,9114
4219,7485482,7485482,7494707,0,0,0,9225
4171,7377894,7377894,7500087,0,0,0,122193
4168,7377500,7377500,7502078,0,0,0,124578
4170,7377775,7377775,7505103,0,0,0,127328
4169,7377602,7377602,7507471,0,0,0,129869
4183,7385685,7385685,7508770,0,0,0,123085
4224,7495704,7495704,7513428,0,0,0,17724
4166,7369280,7369280,7542406,0,0,0,173126
4225,7547308,7547308,7547472,0,0,0,164
4226,7547686,7547686,7551230,0,0,0,3544
4178,7384679,7384679,7557479,0,0,0,172800
4196,7413194,7413194,7558228,0,0,0,145034
4199,7429500,7429500,7558703,0,0,0,129203
4235,7567186,7567186,7567255,0,0,0,69
4236,7567228,7567228,7567419,0,0,0,191
4237,7567682,7567682,7567843,0,0,0,161
4238,7568297,7568297,7568463,0,0,0,166
4239,7568548,7568548,7569377,0,0,0,829
4240,7569363,7569363,7569416,0,0,0,53
4241,7569382,7569382,7571182,0,0,0,1800
4234,7564034,7564034,7632769,0,0,0,68735
4250,7641579,7641579,7641673,0,0,0,94
4232,7563867,7563867,7644785,0,0,0,80918
4252,7648227,7648227,7648486,0,0,0,259
4253,7648525,7648525,7648598,0,0,0,73
4254,7648615,7648615,7648739,0,0,0,124
4255,7648870,7648870,7649830,0,0,0,960
4256,7649838,7649838,7650285,0,0,0,447
4251,7644150,7644785,7653402,0,0,635,9252
4243,7614703,7614703,7672540,0,0,0,57837
4258,7676122,7676122,7676186,0,0,0,64
4229,7563094,7563094,7686229,0,0,0,123135
4228,7558696,7558696,7693182,0,0,0,134486
4227,7558192,7558192,7701872,0,0,0,143680
4257,7675805,7675805,7706205,0,0,0,30400
4259,7676215,7676215,7706212,0,0,0,29997
4263,7713408,7713408,7713611,0,0,0,203
4262,7708708,7708708,7716570,0,0,0,7862
4266,7716605,7716605,7716931,0,0,0,326
4269,7717627,7717627,7717676,0,0,0,49
4270,7717755,7717755,7717882,0,0,0,127
4267,7716985,7716985,7717950,0,0,0,965
4271,7717947,7717947,7718087,0,0,0,140
4272,7718482,7718482,7718591,0,0,0,109
4273,7718879,7718879,7719837,0,0,0,958
4268,7717026,7717026,7720277,0,0,0,3251
4274,7719903,7719903,7720483,0,0,0,580
4277,7720813,7720813,7720916,0,0,0,103
4279,7721662,7721662,7721859,0,0,0,197
4280,7721872,7721872,7722356,0,0,0,484
4281,7722470,7722470,7722880,0,0,0,410
4282,7722868,7722868,7726549,0,0,0,3681
4283,7732258,7732258,7732622,0,0,0,364
4275,7720364,7720364,7733862,0,0,0,13498
4284,7733978,7733978,7734119,0,0,0,141
4278,7720966,7720966,7734792,0,0,0,13826
4276,7720502,7720502,7734807,0,0,0,14305
4285,7734913,7734913,7735004,0,0,0,91
4286,7735113,7735113,7735205,0,0,0,92
4287,7735756,7735756,7735843,0,0,0,87
4288,7735905,7735905,7736589,0,0,0,684
4289,7736632,7736632,7736732,0,0,0,100
4290,7736677,7736677,7736743,0,0,0,66
4291,7737056,7737056,7737446,0,0,0,390
4293,7737558,7737558,7737648,0,0,0,90
4292,7737358,7737358,7737882,0,0,0,524
4294,7737867,7737867,7738598,0,0,0,731
4296,7738612,7738612,7738711,0,0,0,99
4297,7738851,7738851,7738944,0,0,0,93
4298,7739041,7739041,7739497,0,0,0,456
4295,7737928,7737928,7739556,0,0,0,1628
4300,7739584,7739584,7739662,0,0,0,78
4301,7739761,7739761,7739840,0,0,0,79
4299,7739239,7739239,7739870,0,0,0,631
4303,7740851,7740851,7740902,0,0,0,51
4304,7740973,7740973,7741034,0,0,0,61
4305,7741150,7741150,7741247,0,0,0,97
4306,7741261,7741261,7741361,0,0,0,100
4307,7741302,7741302,7743010,0,0,0,1708
4311,7743061,7743061,7743150,0,0,0,89
4312,7743233,7743233,7743323,0,0,0,90
4313,7745009,7745009,7746612,0,0,0,1603
4314,7746837,7746837,7746926,0,0,0,89
4315,7747573,7747573,7747651,0,0,0,78
4265,7713656,7713656,7758978,0,0,0,45322
4316,7764363,7764363,7764449,0,0,0,86
4317,7764595,7764595,7764686,0,0,0,91
4318,7764812,7764812,7764865,0,0,0,53
4319,7765080,7765080,7765181,0,0,0,101
4244,7614802,7614802,7787602,0,0,0,172800
4245,7614864,7614864,7787664,0,0,0,172800
4246,7614919,7614919,7787719,0,0,0,172800
4247,7614972,7614972,7787772,0,0,0,172800
4248,7615041,7615041,7787841,0,0,0,172800
4242,7614550,7632769,7789540,0,0,18219,174990
4321,7799535,7799535,7799583,0,0,0,48
4322,7800475,7800475,7800824,0,0,0,349
4233,7563986,7563986,7801439,0,0,0,237453
4323,7801742,7801742,7801866,0,0,0,124
4309,7742285,7742285,7802607,0,0,0,60322
4308,7741760,7741760,7802614,0,0,0,60854
4310,7742349,7742349,7802618,0,0,0,60269
4325,7802623,7802623,7802727,0,0,0,104
4326,7803303,7803303,7803399,0,0,0,96
4327,7803550,7803550,7803685,0,0,0,135
4328,7803847,7803847,7803982,0,0,0,135
4329,7804122,7804122,7804209,0,0,0,87
4330,7804619,7804619,7804713,0,0,0,94
4302,7739846,7739870,7805291,0,0,24,65445
4332,7805198,7805198,7805294,0,0,0,96
4333,7805392,7805392,7805483,0,0,0,91
4334,7805652,7805652,7805737,0,0,0,85
4324,7801873,7801873,7808205,0,0,0,6332
4337,7808308,7808308,7808460,0,0,0,152
4230,7563213,7563213,7809799,0,0,0,246586
4341,7810908,7810908,7813429,0,0,0,2521
4231,7563277,7563277,7815188,0,0,0,251911
4340,7810834,7810834,7817620,0,0,0,6786
4343,7817753,7817753,7817909,0,0,0,156
4336,7807526,7807526,7823290,0,0,0,15764
4346,7824935,7824935,7825365,0,0,0,430
4348,7828508,7828508,7828799,0,0,0,291
4347,7828450,7828450,7828817,0,0,0,367
4349,7829011,7829011,7829206,0,0,0,195
4260,7693146,7693146,7829765,0,0,0,136619
4354,7830878,7830878,7833624,0,0,0,2746
4351,7829596,7829596,7834005,0,0,0,4409
4350,7829179,7829179,7839553,0,0,0,10374
4249,7624858,7624858,7840717,0,0,0,215859
4355,7836666,7836666,7840977,0,0,0,4311
4261,7701831,7701831,7845095,0,0,0,143264
4344,7822971,7822971,7850367,0,0,0,27396
4371,7850433,7850433,7851665,0,0,0,1232
4373,7852655,7852655,7852770,0,0,0,115
4374,7852783,7852783,7852899,0,0,0,116
4335,7805911,7805911,7870711,0,0,0,64800
4389,7880916,7880916,7881031,0,0,0,115
4390,7881645,7881645,7881750,0,0,0,105
4391,7881752,7881752,7882011,0,0,0,259
4392,7882017,7882017,7884078,0,0,0,2061
4342,7814328,7814328,7893676,0,0,0,79348
4396,7894745,7894745,7894849,0,0,0,104
4397,7894926,7894926,7900057,0,0,0,5131
4399,7900171,7900171,7900832,0,0,0,661
4320,7798504,7798504,7901057,0,0,0,102553
4331,7804624,7804624,7903699,0,0,0,99075
4398,7900047,7900047,7903796,0,0,0,3749
4339,7809742,7809742,7904162,0,0,0,94420
4395,7893864,7893864,7904476,0,0,0,10612
4400,7905074,7905074,7905179,0,0,0,105
4401,7905361,7905361,7905466,0,0,0,105
4402,7905744,7905744,7905848,0,0,0,104
4403,7905867,7905867,7905971,0,0,0,104
4364,7839759,7839759,7912037,0,0,0,72278
4408,7911824,7911824,7912941,0,0,0,1117
4360,7839015,7839015,7914574,0,0,0,75559
4362,7839179,7839179,7915215,0,0,0,76036
4356,7838041,7838041,7915233,0,0,0,77192
4365,7839834,7839834,7915617,0,0,0,75783
4409,7912849,7915617,7917783,0,0,2768,4934
4361,7839108,7839108,7918661,0,0,0,79553
4367,7839967,7839967,7920291,0,0,0,80324
4357,7838531,7838531,7920848,0,0,0,82317
4411,7915506,7917783,7922742,0,0,2277,7236
4366,7839913,7839913,7924009,0,0,0,84096
4410,7913891,7913891,7924691,0,0,0,10800
4363,7839307,7839307,7925031,0,0,0,85724
4358,7838726,7838726,7931230,0,0,0,92504
4345,7823265,7823265,7931686,0,0,0,108421
4413,7931030,7931030,7933160,0,0,0,2130
4359,7838851,7838851,7938168,0,0,0,99317
4412,7929553,7929553,7949127,0,0,0,19574
4352,7829765,7829765,7956711,0,0,0,126946
4381,7874572,7874572,7959974,0,0,0,85402
4382,7874597,7874597,7959985,0,0,0,85388
4383,7874618,7874618,7960028,0,0,0,85410
4384,7874635,7874635,7960033,0,0,0,85398
4414,7934528,7934528,7962066,0,0,0,27538
4353,7830675,7830675,7962579,0,0,0,131904
4394,7887788,7903796,7968596,0,0,16008,80808
4418,7971311,7971311,7971443,0,0,0,132
4405,7906266,7906266,7972155,0,0,0,65889
4404,7906126,7906126,7972162,0,0,0,66036
4406,7908411,7912941,7972168,0,0,4530,63757
4264,7713466,7713466,7972666,0,0,0,259200
4422,7974497,7974497,7974619,0,0,0,122
4421,7973095,7973095,7978336,0,0,0,5241
4427,7983011,7983011,7983292,0,0,0,281
4370,7845052,7845052,7987740,0,0,0,142688
4368,7840306,7840306,7988158,0,0,0,147852
4429,7988047,7988047,7988447,0,0,0,400
4433,7994616,7994616,7999580,0,0,0,4964
4430,7991352,7991352,8002152,0,0,0,10800
4431,7991353,7991353,8002153,0,0,0,10800
4435,8002372,8002372,8002492,0,0,0,120
4425,7978484,7978484,8008492,0,0,0,30008
4434,7997915,7997915,8010804,0,0,0,12889
4375,7874089,7874089,8040036,0,0,0,165947
4436,8007850,8040036,8040306,0,0,32186,32456
4377,7874174,7874174,8045320,0,0,0,171146
4378,7874204,7874204,8045376,0,0,0,171172
4379,7874251,7874251,8045396,0,0,0,171145
4380,7874312,7874312,8045478,0,0,0,171166
4385,7874695,7874695,8046250,0,0,0,171555
4386,7874722,7874722,8046270,0,0,0,171548
4376,7874128,7874128,8046928,0,0,0,172800
4415,7936859,7936859,8053822,0,0,0,116963
4372,7851733,7851733,8057400,0,0,0,205667
4338,7809507,7809507,8058248,0,0,0,248741
4439,8060163,8060163,8060292,0,0,0,129
4441,8060958,8060958,8061118,0,0,0,160
4369,7840519,7840519,8066589,0,0,0,226070
4420,7972308,7972308,8067177,0,0,0,94869
4423,7975368,7975368,8067199,0,0,0,91831
4424,7978232,7978232,8067208,0,0,0,88976
4442,8070849,8070849,8070953,0,0,0,104
4443,8070950,8070950,8071047,0,0,0,97
4444,8071063,8071063,8071159,0,0,0,96
4445,8071182,8071182,8071286,0,0,0,104
4446,8071310,8071310,8071414,0,0,0,104
4447,8071493,8071493,8071591,0,0,0,98
4451,8072379,8072379,8072473,0,0,0,94
4452,8072416,8072416,8072519,0,0,0,103
4449,8072257,8072257,8072696,0,0,0,439
4450,8072339,8072339,8072793,0,0,0,454
4462,8073009,8073009,8073558,0,0,0,549
4470,8074485,8074485,8074687,0,0,0,202
4466,8074361,8074361,8074892,0,0,0,531
4467,8074407,8074407,8074939,0,0,0,532
4469,8074443,8074443,8074951,0,0,0,508
4476,8074777,8074777,8074968,0,0,0,191
4471,8074524,8074524,8075051,0,0,0,527
4472,8074559,8074559,8075109,0,0,0,550
4480,8075064,8075064,8075615,0,0,0,551
4481,8076167,8076167,8076225,0,0,0,58
4482,8076309,8076309,8076356,0,0,0,47
4483,8076339,8076339,8076393,0,0,0,54
4484,8076367,8076367,8076425,0,0,0,58
4485,8077028,8077028,8077075,0,0,0,47
4486,8077140,8077140,8077198,0,0,0,58
4487,8077298,8077298,8077365,0,0,0,67
4488,8077428,8077428,8077487,0,0,0,59
4489,8077503,8077503,8077562,0,0,0,59
4490,8077589,8077589,8077648,0,0,0,59
4491,8077782,8077782,8077840,0,0,0,58
4492,8077865,8077865,8077928,0,0,0,63
4493,8077909,8077909,8077978,0,0,0,69
4495,8078041,8078041,8078101,0,0,0,60
4496,8078191,8078191,8078249,0,0,0,58
4494,8077970,8077970,8078477,0,0,0,507
4498,8078788,8078788,8078852,0,0,0,64
4499,8078834,8078834,8078892,0,0,0,58
4500,8078896,8078896,8078957,0,0,0,61
4501,8079115,8079115,8079224,0,0,0,109
4502,8079279,8079279,8079866,0,0,0,587
4503,8080308,8080308,8080374,0,0,0,66
4504,8080415,8080415,8080473,0,0,0,58
4505,8080534,8080534,8080592,0,0,0,58
4506,8080805,8080805,8080863,0,0,0,58
4507,8080857,8080857,8080915,0,0,0,58
4508,8080985,8080985,8081332,0,0,0,347
4512,8081646,8081646,8082118,0,0,0,472
4509,8081559,8081559,8082159,0,0,0,600
4510,8081588,8081588,8082188,0,0,0,600
4511,8081616,8081616,8082216,0,0,0,600
4513,8081663,8081663,8082237,0,0,0,574
4514,8082322,8082322,8082922,0,0,0,600
4515,8082447,8082447,8083031,0,0,0,584
4518,8083287,8083287,8083415,0,0,0,128
4519,8083488,8083488,8083546,0,0,0,58
4516,8082665,8082665,8083827,0,0,0,1162
4520,8083578,8083578,8083837,0,0,0,259
4521,8083917,8083917,8084099,0,0,0,182
4522,8084171,8084171,8084353,0,0,0,182
4523,8084545,8084545,8084603,0,0,0,58
4524,8084623,8084623,8084852,0,0,0,229
4525,8085149,8085149,8085208,0,0,0,59
4526,8085217,8085217,8085275,0,0,0,58
4417,7956669,7956711,8085520,0,0,42,128851
4529,8085492,8085492,8085679,0,0,0,187
4530,8085769,8085769,8085841,0,0,0,72
4527,8085414,8085414,8085855,0,0,0,441
4532,8085888,8085888,8085948,0,0,0,60
4533,8085977,8085977,8086036,0,0,0,59
4534,8086027,8086027,8086086,0,0,0,59
4535,8086204,8086204,8086264,0,0,0,60
4536,8086442,8086442,8086620,0,0,0,178
4537,8086922,8086922,8087104,0,0,0,182
4538,8087174,8087174,8087365,0,0,0,191
4393,7883786,7962579,8087628,0,0,78793,203842
4539,8087507,8087507,8087689,0,0,0,182
4540,8088098,8088098,8088362,0,0,0,264
4541,8088590,8088590,8088810,0,0,0,220
4542,8088938,8088938,8089146,0,0,0,208
4543,8089239,8089239,8089423,0,0,0,184
4517,8082704,8082704,8089526,0,0,0,6822
4437,8056409,8056409,8092409,0,0,0,36000
4387,7874761,7931686,8103220,0,0,56925,228459
4388,7874779,7931686,8103246,0,0,56907,228467
4416,7938408,7938408,8104791,0,0,0,166383
4440,8060537,8060537,8117388,0,0,0,56851
4428,7987693,7987693,8130541,0,0,0,142848
4546,8111169,8111169,8139421,0,0,0,28252
4475,8074740,8074740,8142327,0,0,0,67587
4497,8078430,8078430,8145764,0,0,0,67334
4544,8092577,8092577,8162000,0,0,0,69423
4549,8162270,8162270,8163329,0,0,0,1059
4548,8162016,8162016,8164756,0,0,0,2740
4550,8165696,8165696,8166737,0,0,0,1041
4407,7908423,7915215,8174415,0,0,6792,265992
4552,8178288,8178288,8178584,0,0,0,296
4553,8178765,8178765,8182199,0,0,0,3434
4453,8072569,8072569,8195198,0,0,0,122629
4455,8072700,8072700,8195235,0,0,0,122535
4528,8085479,8085479,8213211,0,0,0,127732
4419,7972172,7972172,8231372,0,0,0,259200
4551,8165943,8165943,8231659,0,0,0,65716
4426,7982942,7982942,8232503,0,0,0,249561
4432,7993427,7993427,8252627,0,0,0,259200
4545,8102053,8102053,8258475,0,0,0,156422
4554,8180595,8180595,8262355,0,0,0,81760
4561,8255893,8255893,8271541,0,0,0,15648
4547,8130545,8130545,8273810,0,0,0,143265
4564,8274116,8274116,8278254,0,0,0,4138
4558,8195253,8195253,8291043,0,0,0,95790
4562,8271615,8271615,8297796,0,0,0,26181
4438,8057609,8057609,8311730,0,0,0,254121
4565,8319053,8319053,8323556,0,0,0,4503
4568,8325180,8325180,8325254,0,0,0,74
4569,8325273,8325273,8325377,0,0,0,104
4570,8325685,8325685,8325800,0,0,0,115
4575,8326376,8326376,8326480,0,0,0,104
4578,8326570,8326570,8326667,0,0,0,97
4566,8322603,8322603,8326779,0,0,0,4176
4583,8326742,8326742,8326847,0,0,0,105
4587,8327589,8327589,8327685,0,0,0,96
4588,8327967,8327967,8328086,0,0,0,119
4580,8326610,8326610,8328444,0,0,0,1834
4585,8327457,8327457,8328467,0,0,0,1010
4584,8327421,8327421,8328639,0,0,0,1218
4593,8330425,8330425,8330515,0,0,0,90
4448,8071611,8071611,8330811,0,0,0,259200
4586,8327568,8327568,8330822,0,0,0,3254
4594,8331006,8331006,8331101,0,0,0,95
4454,8072684,8072684,8331884,0,0,0,259200
4456,8072716,8072716,8331916,0,0,0,259200
4457,8072729,8072729,8331929,0,0,0,259200
4458,8072818,8072818,8332018,0,0,0,259200
4459,8072873,8072873,8332073,0,0,0,259200
4460,8072948,8072948,8332148,0,0,0,259200
4461,8072994,8072994,8332194,0,0,0,259200
4597,8333040,8333040,8333328,0,0,0,288
4463,8074173,8074173,8333373,0,0,0,259200
4464,8074246,8074246,8333446,0,0,0,259200
4465,8074312,8074312,8333512,0,0,0,259200
4468,8074421,8074421,8333621,0,0,0,259200
4473,8074561,8074561,8333761,0,0,0,259200
4474,8074703,8074703,8333903,0,0,0,259200
4477,8074782,8074782,8333982,0,0,0,259200
4478,8074823,8074823,8334023,0,0,0,259200
4479,8074863,8074863,8334063,0,0,0,259200
4591,8328478,8328478,8334183,0,0,0,5705
4599,8334074,8334074,8334377,0,0,0,303
4598,8333740,8333740,8334986,0,0,0,1246
4603,8337191,8337191,8337284,0,0,0,93
4596,8332639,8332639,8338064,0,0,0,5425
4604,8337349,8337349,8338544,0,0,0,1195
4557,8195219,8195219,8338739,0,0,0,143520
4556,8195184,8195184,8338768,0,0,0,143584
4555,8192952,8192952,8339167,0,0,0,146215
4607,8338809,8338809,8339227,0,0,0,418
4559,8213777,8213777,8343837,0,0,0,130060
4531,8085831,8085831,8345031,0,0,0,259200
4628,8346503,8346503,8347362,0,0,0,859
4629,8347382,8347382,8347477,0,0,0,95
4632,8347464,8347464,8347612,0,0,0,148
4634,8347509,8347509,8347641,0,0,0,132
4633,8347492,8347612,8347734,0,0,120,242
4635,8348038,8348038,8348185,0,0,0,147
4572,8326118,8326118,8363248,0,0,0,37130
4579,8326598,8326598,8363797,0,0,0,37199
4573,8326236,8326236,8365358,0,0,0,39122
4581,8326634,8326634,8366881,0,0,0,40247
4595,8331616,8331616,8389700,0,0,0,58084
4563,8273758,8273758,8391466,0,0,0,117708
4631,8347425,8347425,8392737,0,0,0,45312
4589,8328289,8328289,8397830,0,0,0,69541
4637,8412066,8412066,8412624,0,0,0,558
4567,8324976,8324976,8420599,0,0,0,95623
4571,8326025,8326025,8420610,0,0,0,94585
4574,8326370,8326370,8420613,0,0,0,94243
4577,8326564,8326564,8420623,0,0,0,94059
4576,8326537,8326537,8420624,0,0,0,94087
4582,8326684,8326684,8420630,0,0,0,93946
4622,8339089,8339089,8420663,0,0,0,81574
4643,8420678,8420678,8420741,0,0,0,63
4644,8420698,8420698,8421255,0,0,0,557
4602,8335102,8335102,8421502,0,0,0,86400
4645,8424107,8424107,8424662,0,0,0,555
4647,8425183,8425183,8425282,0,0,0,99
4646,8424992,8424992,8425552,0,0,0,560
4649,8427181,8427181,8427734,0,0,0,553
4626,8341849,8341849,8428249,0,0,0,86400
4636,8405963,8405963,8429044,0,0,0,23081
4650,8428196,8428196,8429184,0,0,0,988
4648,8425271,8425271,8429861,0,0,0,4590
4653,8430605,8430605,8431160,0,0,0,555
4654,8433522,8433522,8434065,0,0,0,543
4630,8347383,8347383,8435022,0,0,0,87639
4627,8343802,8343802,8471394,0,0,0,127592
4652,8429848,8429848,8471434,0,0,0,41586
4560,8231793,8231793,8485956,0,0,0,254163
4656,8490906,8490906,8491013,0,0,0,107
4651,8429238,8429238,8494038,0,0,0,64800
4657,8496736,8496736,8498799,0,0,0,2063
4661,8497427,8498799,8498821,0,0,1372,1394
4592,8328627,8328627,8501038,0,0,0,172411
4623,8339098,8339098,8512611,0,0,0,173513
4624,8339107,8339107,8512620,0,0,0,173513
4612,8338966,8338966,8514901,0,0,0,175935
4613,8338973,8338973,8514908,0,0,0,175935
4614,8338981,8338981,8514916,0,0,0,175935
4676,8517422,8517422,8521989,0,0,0,4567
4677,8517687,8517687,8523755,0,0,0,6068
4678,8517893,8517893,8525333,0,0,0,7440
4675,8517123,8517123,8528817,0,0,0,11694
4600,8334141,8334141,8545457,0,0,0,211316
4679,8518206,8518206,8546476,0,0,0,28270
4638,8414476,8414476,8549984,0,0,0,135508
4672,8515413,8515413,8557529,0,0,0,42116
4662,8498856,8498856,8563656,0,0,0,64800
4670,8514737,8514737,8571942,0,0,0,57205
4671,8514804,8514804,8572619,0,0,0,57815
4673,8515609,8515609,8573591,0,0,0,57982
4674,8515981,8515981,8574132,0,0,0,58151
4601,8335019,8335019,8578199,0,0,0,243180
4639,8414527,8414527,8580853,0,0,0,166326
4590,8328436,8328436,8582002,0,0,0,253566
4683,8581918,8581918,8582199,0,0,0,281
4687,8582854,8582854,8583335,0,0,0,481
4688,8582874,8582874,8583350,0,0,0,476
4640,8414623,8414623,8585762,0,0,0,171139
4684,8582189,8582189,8585789,0,0,0,3600
4641,8414654,8414654,8585823,0,0,0,171169
4642,8414694,8414694,8585853,0,0,0,171159
4685,8582544,8582544,8586144,0,0,0,3600
4686,8582730,8582730,8586330,0,0,0,3600
4689,8583398,8583398,8586998,0,0,0,3600
4691,8583509,8583509,8587109,0,0,0,3600
4605,8338775,8338775,8587464,0,0,0,248689
4608,8338882,8338882,8587481,0,0,0,248599
4606,8338789,8338789,8587483,0,0,0,248694
4609,8338896,8338896,8587484,0,0,0,248588
4611,8338952,8338952,8587487,0,0,0,248535
4610,8338912,8338912,8587489,0,0,0,248577
4615,8338992,8338992,8587505,0,0,0,248513
4616,8339025,8339025,8587509,0,0,0,248484
4617,8339032,8339032,8587515,0,0,0,248483
4618,8339038,8339038,8587521,0,0,0,248483
4692,8583930,8583930,8587530,0,0,0,3600
4619,8339048,8339048,8587531,0,0,0,248483
4620,8339058,8339058,8587541,0,0,0,248483
4621,8339071,8339071,8587543,0,0,0,248472
4625,8339195,8339195,8587550,0,0,0,248355
4693,8587538,8587538,8587842,0,0,0,304
4708,8590767,8590767,8590983,0,0,0,216
4690,8583471,8583471,8591012,0,0,0,7541
4709,8591512,8591512,8591651,0,0,0,139
4710,8591644,8591644,8591868,0,0,0,224
4711,8592202,8592202,8592297,0,0,0,95
4712,8592386,8592386,8592483,0,0,0,97
4713,8592730,8592730,8592835,0,0,0,105
4714,8592886,8592886,8592983,0,0,0,97
4716,8593054,8593054,8593272,0,0,0,218
4655,8471349,8471349,8593684,0,0,0,122335
4721,8597194,8597194,8597299,0,0,0,105
4723,8597544,8597544,8597648,0,0,0,104
4724,8597726,8597726,8597864,0,0,0,138
4722,8597225,8597225,8597925,0,0,0,700
4726,8597897,8597897,8598057,0,0,0,160
4727,8598784,8598784,8598950,0,0,0,166
4728,8599112,8599112,8599208,0,0,0,96
4729,8599322,8599322,8599488,0,0,0,166
4730,8599582,8599582,8599744,0,0,0,162
4731,8599958,8599958,8600050,0,0,0,92
4725,8597854,8597854,8605314,0,0,0,7460
4732,8607243,8607243,8607523,0,0,0,280
4682,8579969,8579969,8607565,0,0,0,27596
4733,8607618,8607618,8607726,0,0,0,108
4734,8607714,8607714,8611314,0,0,0,3600
4735,8630779,8630779,8630883,0,0,0,104
4658,8496999,8496999,8637457,0,0,0,140458
4660,8497321,8497321,8644436,0,0,0,147115
4659,8497198,8497198,8648977,0,0,0,151779
4665,8513025,8513025,8651966,0,0,0,138941
4737,8666612,8666612,8666747,0,0,0,135
4738,8666735,8666735,8666850,0,0,0,115
4739,8667114,8667114,8667223,0,0,0,109
4740,8667418,8667418,8667533,0,0,0,115
4741,8668038,8668038,8668157,0,0,0,119
4742,8668493,8668493,8668610,0,0,0,117
4743,8668633,8668633,8668738,0,0,0,105
4749,8674718,8674718,8674845,0,0,0,127
4715,8593023,8593023,8676013,0,0,0,82990
4752,8679978,8679978,8680093,0,0,0,115
4694,8587556,8587556,8680640,0,0,0,93084
4754,8680877,8680877,8680980,0,0,0,103
4755,8680951,8680951,8681048,0,0,0,97
4706,8587846,8587846,8681246,0,0,0,93400
4707,8587857,8587857,8681860,0,0,0,94003
4762,8683274,8683274,8683389,0,0,0,115
4751,8678554,8678554,8685874,0,0,0,7320
4696,8587637,8587637,8692139,0,0,0,104502
4697,8587650,8587650,8692141,0,0,0,104491
4699,8587676,8587676,8692145,0,0,0,104469
4698,8587666,8587666,8692146,0,0,0,104480
4703,8587741,8587741,8692155,0,0,0,104414
4702,8587728,8587728,8692164,0,0,0,104436
4701,8587717,8587717,8692165,0,0,0,104448
4705,8587763,8587763,8692166,0,0,0,104403
4704,8587753,8587753,8692167,0,0,0,104414
4773,8694552,8694552,8694627,0,0,0,75
4766,8692654,8692654,8694656,0,0,0,2002
4680,8527136,8527136,8696034,0,0,0,168898
4681,8528363,8528363,8697339,0,0,0,168976
4758,8682186,8682186,8698512,0,0,0,16326
4764,8690101,8690101,8699828,0,0,0,9727
4666,8513083,8563656,8704015,0,0,50573,190932
4781,8701909,8701909,8706664,0,0,0,4755
4778,8695950,8695950,8708877,0,0,0,12927
4669,8513582,8580853,8714943,0,0,67271,201361
4777,8695280,8695280,8715064,0,0,0,19784
4783,8716223,8716223,8717404,0,0,0,1181
4779,8696245,8696245,8718404,0,0,0,22159
4668,8513441,8580853,8718833,0,0,67412,205392
4750,8676534,8676534,8719491,0,0,0,42957
4756,8681587,8681587,8721532,0,0,0,39945
4717,8593642,8593642,8722098,0,0,0,128456
4759,8682448,8682448,8722847,0,0,0,40399
4753,8680200,8680200,8723680,0,0,0,43480
4772,8694270,8694270,8725676,0,0,0,31406
4736,8665039,8665039,8727520,0,0,0,62481
4667,8513206,8580853,8729432,0,0,67647,216226
4769,8693230,8693230,8741624,0,0,0,48394
4767,8692925,8692925,8742216,0,0,0,49291
4780,8696548,8696548,8745405,0,0,0,48857
4761,8683074,8683074,8748005,0,0,0,64931
4760,8682760,8682760,8749763,0,0,0,67003
4765,8692438,8692438,8755741,0,0,0,63303
4768,8693095,8693095,8757152,0,0,0,64057
4757,8682143,8682143,8757542,0,0,0,75399
4718,8593738,8593738,8764892,0,0,0,171154
4719,8593765,8593765,8764949,0,0,0,171184
4720,8593791,8593791,8764975,0,0,0,171184
4763,8683500,8683500,8769900,0,0,0,86400
4775,8694612,8694612,8772352,0,0,0,77740
4770,8693578,8693578,8778655,0,0,0,85077
4695,8587614,8587614,8781188,0,0,0,193574
4744,8673421,8673421,8796071,0,0,0,122650
4771,8693925,8693925,8797414,0,0,0,103489
4747,8673879,8673879,8798830,0,0,0,124951
4748,8673984,8673984,8803501,0,0,0,129517
4663,8512674,8545457,8804657,0,0,32783,291983
4746,8673730,8673730,8809294,0,0,0,135564
4745,8673588,8673588,8809542,0,0,0,135954
4774,8694602,8694602,8831302,0,0,0,136700
4782,8715312,8715312,8836717,0,0,0,121405
4664,8512692,8578199,8837399,0,0,65507,324707
4798,8786351,8786351,8846755,0,0,0,60404
4700,8587691,8587691,8846891,0,0,0,259200
4784,8722058,8722058,8852550,0,0,0,130492
4801,8860455,8860455,8861072,0,0,0,617
4802,8860558,8860558,8861086,0,0,0,528
4803,8861577,8861577,8862286,0,0,0,709
4804,8863053,8863053,8863378,0,0,0,325
4805,8863130,8863130,8863948,0,0,0,818
4806,8864275,8864275,8865387,0,0,0,1112
4799,8841329,8841329,8867939,0,0,0,26610
4808,8867016,8867016,8867986,0,0,0,970
4809,8868932,8868932,8872532,0,0,0,3600
4796,8780097,8781188,8875838,0,0,1091,95741
4776,8694894,8694894,8878683,0,0,0,183789
4810,8888949,8888949,8889390,0,0,0,441
4812,8889549,8889549,8889845,0,0,0,296
4813,8890508,8890508,8891341,0,0,0,833
4814,8891865,8891865,8892758,0,0,0,893
4815,8892740,8892740,8893828,0,0,0,1088
4816,8893169,8893169,8896909,0,0,0,3740
4786,8747952,8764892,8899253,0,0,16940,151301
4797,8781549,8797414,8901224,0,0,15865,119675
4833,8929003,8929003,8929345,0,0,0,342
4835,8929413,8929413,8929522,0,0,0,109
4837,8929734,8929734,8929914,0,0,0,180
4838,8930326,8930326,8930508,0,0,0,182
4839,8930518,8930518,8930701,0,0,0,183
4841,8931481,8931481,8931531,0,0,0,50
4843,8932004,8932004,8932054,0,0,0,50
4842,8931760,8931760,8932063,0,0,0,303
4844,8932088,8932088,8932147,0,0,0,59
4846,8932243,8932243,8932300,0,0,0,57
4847,8932354,8932354,8932406,0,0,0,52
4848,8932363,8932363,8932565,0,0,0,202
4849,8932642,8932642,8932700,0,0,0,58
4850,8932799,8932799,8932850,0,0,0,51
4851,8932925,8932925,8933158,0,0,0,233
4852,8933379,8933379,8933426,0,0,0,47
4853,8933484,8933484,8933531,0,0,0,47
4807,8866393,8866393,8933607,0,0,0,67214
4854,8933559,8933559,8933618,0,0,0,59
4855,8933868,8933868,8933927,0,0,0,59
4856,8933961,8933961,8934014,0,0,0,53
4857,8933992,8934014,8934114,0,0,22,122
4859,8934286,8934286,8934499,0,0,0,213
4864,8935147,8935147,8935340,0,0,0,193
4865,8935504,8935504,8935706,0,0,0,202
4860,8934757,8934757,8937776,0,0,0,3019
4789,8766711,8766711,8937908,0,0,0,171197
4872,8938649,8938649,8938714,0,0,0,65
4873,8938832,8938832,8939077,0,0,0,245
4874,8939601,8939601,8939822,0,0,0,221
4875,8940280,8940280,8940385,0,0,0,105
4876,8940437,8940437,8940492,0,0,0,55
4877,8940988,8940988,8941047,0,0,0,59
4878,8941048,8941048,8941270,0,0,0,222
4879,8941395,8941395,8941583,0,0,0,188
4880,8941800,8941800,8941982,0,0,0,182
4881,8942060,8942060,8942243,0,0,0,183
4882,8942474,8942474,8942537,0,0,0,63
4883,8942496,8942496,8943112,0,0,0,616
4787,8765009,8796071,8943409,0,0,31062,178400
4884,8944883,8944883,8945197,0,0,0,314
4885,8945270,8945270,8945582,0,0,0,312
4886,8945636,8945636,8945945,0,0,0,309
4887,8946077,8946077,8946383,0,0,0,306
4888,8946529,8946529,8946577,0,0,0,48
4890,8946763,8946763,8946810,0,0,0,47
4889,8946611,8946611,8946866,0,0,0,255
4891,8946880,8946880,8946944,0,0,0,64
4892,8946886,8946886,8947451,0,0,0,565
4893,8947592,8947592,8947647,0,0,0,55
4894,8947624,8947624,8947709,0,0,0,85
4895,8947666,8947666,8947752,0,0,0,86
4897,8947772,8947772,8947851,0,0,0,79
4896,8947691,8947691,8948162,0,0,0,471
4898,8948218,8948218,8948556,0,0,0,338
4790,8766801,8778655,8950221,0,0,11854,183420
4834,8929003,8950221,8950919,0,0,21218,21916
4862,8934901,8950221,8951567,0,0,15320,16666
4861,8934871,8950221,8951735,0,0,15350,16864
4858,8934197,8934197,8952028,0,0,0,17831
4836,8929637,8950221,8952517,0,0,20584,22880
4902,8952510,8952510,8952644,0,0,0,134
4863,8934937,8951567,8952888,0,0,16630,17951
4903,8953640,8953640,8953692,0,0,0,52
4926,8953651,8953651,8953693,0,0,0,42
4917,8953650,8953650,8953697,0,0,0,47
4904,8953646,8953646,8953698,0,0,0,52
4909,8953647,8953647,8953705,0,0,0,58
4910,8953648,8953648,8953711,0,0,0,63
4911,8953648,8953648,8953711,0,0,0,63
4912,8953648,8953648,8953711,0,0,0,63
4913,8953649,8953649,8953712,0,0,0,63
4914,8953649,8953649,8953712,0,0,0,63
4915,8953649,8953649,8953712,0,0,0,63
4916,8953649,8953649,8953712,0,0,0,63
4920,8953650,8953650,8953713,0,0,0,63
4905,8953646,8953646,8953714,0,0,0,68
4921,8953651,8953651,8953714,0,0,0,63
4922,8953651,8953651,8953714,0,0,0,63
4923,8953651,8953651,8953714,0,0,0,63
4924,8953651,8953651,8953714,0,0,0,63
4925,8953651,8953651,8953714,0,0,0,63
4906,8953647,8953647,8953715,0,0,0,68
4907,8953647,8953647,8953715,0,0,0,68
4918,8953650,8953650,8953718,0,0,0,68
4919,8953650,8953650,8953718,0,0,0,68
4908,8953647,8953647,8953741,0,0,0,94
4933,8953724,8953724,8953837,0,0,0,113
4934,8953724,8953724,8953837,0,0,0,113
4935,8953724,8953724,8953837,0,0,0,113
4936,8953724,8953724,8953837,0,0,0,113
4937,8953741,8953741,8953854,0,0,0,113
4938,8953741,8953741,8953854,0,0,0,113
4939,8953741,8953741,8953854,0,0,0,113
4940,8953741,8953741,8953854,0,0,0,113
4941,8953742,8953742,8953855,0,0,0,113
4942,8953742,8953742,8953855,0,0,0,113
4943,8953742,8953742,8953855,0,0,0,113
4944,8953743,8953743,8953856,0,0,0,113
4945,8953743,8953743,8953856,0,0,0,113
4946,8953743,8953743,8953856,0,0,0,113
4947,8953743,8953743,8953856,0,0,0,113
4948,8953744,8953744,8953857,0,0,0,113
4949,8953744,8953744,8953857,0,0,0,113
4950,8953744,8953744,8953892,0,0,0,148
4951,8953744,8953744,8953892,0,0,0,148
4952,8953745,8953745,8953893,0,0,0,148
4927,8953723,8953723,8953944,0,0,0,221
4928,8953723,8953723,8953944,0,0,0,221
4929,8953723,8953723,8953944,0,0,0,221
4930,8953723,8953723,8953944,0,0,0,221
4931,8953724,8953724,8953945,0,0,0,221
4932,8953724,8953724,8953945,0,0,0,221
4954,8953908,8953908,8953986,0,0,0,78
4840,8930818,8952888,8954071,0,0,22070,23253
4975,8955162,8955162,8955206,0,0,0,44
4968,8955161,8955161,8955210,0,0,0,49
4955,8955159,8955159,8955211,0,0,0,52
4983,8955164,8955164,8955213,0,0,0,49
4961,8955160,8955160,8955224,0,0,0,64
4962,8955160,8955160,8955224,0,0,0,64
4963,8955160,8955160,8955224,0,0,0,64
4964,8955160,8955160,8955224,0,0,0,64
4965,8955160,8955160,8955224,0,0,0,64
4966,8955161,8955161,8955225,0,0,0,64
4967,8955161,8955161,8955226,0,0,0,65
4956,8955159,8955159,8955227,0,0,0,68
4957,8955159,8955159,8955227,0,0,0,68
4958,8955159,8955159,8955227,0,0,0,68
4971,8955162,8955162,8955227,0,0,0,65
4972,8955162,8955162,8955227,0,0,0,65
4973,8955162,8955162,8955227,0,0,0,65
4974,8955162,8955162,8955227,0,0,0,65
4977,8955163,8955163,8955228,0,0,0,65
4978,8955163,8955163,8955228,0,0,0,65
4979,8955163,8955163,8955228,0,0,0,65
4980,8955163,8955163,8955228,0,0,0,65
4981,8955163,8955163,8955228,0,0,0,65
4982,8955163,8955163,8955228,0,0,0,65
4985,8955164,8955164,8955229,0,0,0,65
4986,8955164,8955164,8955229,0,0,0,65
4987,8955164,8955164,8955229,0,0,0,65
4988,8955164,8955164,8955229,0,0,0,65
4969,8955161,8955161,8955231,0,0,0,70
4970,8955161,8955161,8955231,0,0,0,70
4976,8955162,8955162,8955233,0,0,0,71
4984,8955164,8955164,8955235,0,0,0,71
4991,8955196,8955196,8955245,0,0,0,49
4959,8955159,8955159,8955254,0,0,0,95
4960,8955160,8955160,8955255,0,0,0,95
4989,8955195,8955195,8955260,0,0,0,65
4990,8955196,8955196,8955261,0,0,0,65
4996,8955197,8955197,8955261,0,0,0,64
4998,8955198,8955198,8955261,0,0,0,63
4999,8955198,8955198,8955261,0,0,0,63
4994,8955197,8955197,8955262,0,0,0,65
4995,8955197,8955197,8955262,0,0,0,65
4997,8955198,8955198,8955262,0,0,0,64
5000,8955198,8955198,8955262,0,0,0,64
5001,8955199,8955199,8955263,0,0,0,64
5002,8955199,8955199,8955263,0,0,0,64
5003,8955199,8955199,8955263,0,0,0,64
5004,8955199,8955199,8955264,0,0,0,65
5006,8955200,8955200,8955264,0,0,0,64
5007,8955200,8955200,8955264,0,0,0,64
5008,8955200,8955200,8955264,0,0,0,64
5009,8955200,8955200,8955264,0,0,0,64
5010,8955200,8955200,8955264,0,0,0,64
5005,8955200,8955200,8955265,0,0,0,65
5011,8955201,8955201,8955265,0,0,0,64
5012,8955201,8955201,8955266,0,0,0,65
5013,8955201,8955201,8955266,0,0,0,65
5018,8955202,8955202,8955266,0,0,0,64
5019,8955202,8955202,8955266,0,0,0,64
4992,8955196,8955196,8955267,0,0,0,71
4993,8955196,8955196,8955267,0,0,0,71
5014,8955201,8955201,8955270,0,0,0,69
5015,8955201,8955201,8955270,0,0,0,69
5016,8955201,8955201,8955287,0,0,0,86
5017,8955202,8955202,8955288,0,0,0,86
5020,8955270,8955270,8955352,0,0,0,82
4866,8937662,8954071,8955506,0,0,16409,17844
4901,8951589,8955506,8955596,0,0,3917,4007
5021,8956368,8956368,8956427,0,0,0,59
5022,8956705,8956705,8956766,0,0,0,61
5023,8957015,8957015,8957073,0,0,0,58
5024,8957115,8957115,8957182,0,0,0,67
5025,8957685,8957685,8957759,0,0,0,74
5027,8957866,8957866,8957971,0,0,0,105
5029,8957867,8957867,8957984,0,0,0,117
5098,8958008,8958008,8958098,0,0,0,90
5028,8957866,8957866,8958466,0,0,0,600
5030,8957869,8957869,8958469,0,0,0,600
5031,8957869,8957869,8958469,0,0,0,600
5032,8957869,8957869,8958469,0,0,0,600
5033,8957869,8957869,8958469,0,0,0,600
5034,8957869,8957869,8958469,0,0,0,600
5035,8957869,8957869,8958469,0,0,0,600
5036,8957869,8957869,8958469,0,0,0,600
5037,8957869,8957869,8958469,0,0,0,600
5038,8957869,8957869,8958469,0,0,0,600
5039,8957869,8957869,8958469,0,0,0,600
5040,8957869,8957869,8958469,0,0,0,600
5041,8957869,8957869,8958469,0,0,0,600
5042,8957869,8957869,8958469,0,0,0,600
5043,8957869,8957869,8958469,0,0,0,600
5044,8957869,8957869,8958469,0,0,0,600
5045,8957869,8957869,8958469,0,0,0,600
5046,8957869,8957869,8958469,0,0,0,600
5047,8957869,8957869,8958469,0,0,0,600
5048,8957869,8957869,8958469,0,0,0,600
5049,8957869,8957869,8958469,0,0,0,600
5050,8957869,8957869,8958469,0,0,0,600
5051,8957869,8957869,8958469,0,0,0,600
5052,8957869,8957869,8958469,0,0,0,600
5053,8957869,8957869,8958469,0,0,0,600
5054,8957869,8957869,8958469,0,0,0,600
5055,8957869,8957869,8958469,0,0,0,600
5056,8957869,8957869,8958469,0,0,0,600
5057,8957869,8957869,8958469,0,0,0,600
5058,8957869,8957869,8958469,0,0,0,600
5059,8957869,8957869,8958469,0,0,0,600
5060,8957869,8957869,8958469,0,0,0,600
5061,8957869,8957869,8958469,0,0,0,600
5062,8957869,8957869,8958469,0,0,0,600
5063,8957869,8957869,8958469,0,0,0,600
5064,8957869,8957869,8958469,0,0,0,600
5065,8957869,8957869,8958469,0,0,0,600
5066,8957869,8957869,8958469,0,0,0,600
5067,8957869,8957869,8958469,0,0,0,600
5068,8957869,8957869,8958469,0,0,0,600
5069,8957869,8957869,8958469,0,0,0,600
5070,8957869,8957869,8958469,0,0,0,600
5071,8957869,8957869,8958469,0,0,0,600
5072,8957869,8957869,8958469,0,0,0,600
5073,8957869,8957869,8958469,0,0,0,600
5074,8957869,8957869,8958469,0,0,0,600
5075,8957869,8957869,8958469,0,0,0,600
5076,8957869,8957869,8958469,0,0,0,600
5077,8957869,8957869,8958469,0,0,0,600
5078,8957869,8957869,8958469,0,0,0,600
5079,8957869,8957869,8958469,0,0,0,600
5080,8957869,8957869,8958469,0,0,0,600
5081,8957869,8957869,8958469,0,0,0,600
5082,8957869,8957869,8958469,0,0,0,600
5083,8957869,8957869,8958469,0,0,0,600
5084,8957869,8957869,8958469,0,0,0,600
5085,8957869,8957869,8958469,0,0,0,600
5086,8957869,8957869,8958469,0,0,0,600
5087,8957869,8957869,8958469,0,0,0,600
5088,8957869,8957869,8958469,0,0,0,600
5089,8957869,8957869,8958469,0,0,0,600
5090,8957869,8957869,8958469,0,0,0,600
5091,8957869,8957869,8958469,0,0,0,600
5092,8957869,8957869,8958469,0,0,0,600
5093,8957869,8957869,8958469,0,0,0,600
5094,8957869,8957869,8958469,0,0,0,600
5095,8957869,8957869,8958469,0,0,0,600
5096,8957869,8957869,8958469,0,0,0,600
5097,8957869,8957869,8958469,0,0,0,600
5099,8959461,8959461,8959510,0,0,0,49
5100,8966634,8966634,8966693,0,0,0,59
4817,8896904,8896904,8968904,0,0,0,72000
4791,8766820,8798830,8970396,0,0,32010,203576
4867,8937697,8970396,8971688,0,0,32699,33991
4868,8937732,8970396,8971732,0,0,32664,34000
4899,8951089,8971688,8971794,0,0,20599,20705
5101,8968486,8968486,8974170,0,0,0,5684
4792,8766885,8803501,8975055,0,0,36616,208170
5105,8975086,8975086,8975143,0,0,0,57
5106,8975127,8975127,8975186,0,0,0,59
5107,8975242,8975242,8975293,0,0,0,51
5108,8975258,8975258,8975305,0,0,0,47
5109,8975329,8975329,8975388,0,0,0,59
5110,8975399,8975399,8975444,0,0,0,45
5111,8975405,8975405,8975452,0,0,0,47
5112,8975626,8975626,8975684,0,0,0,58
5113,8975734,8975734,8975853,0,0,0,119
5114,8975908,8975908,8976043,0,0,0,135
4795,8766963,8804657,8976205,0,0,37694,209242
4793,8766906,8804657,8976233,0,0,37751,209327
4794,8766923,8804657,8976236,0,0,37734,209313
5115,8976108,8976108,8976244,0,0,0,136
4869,8937766,8975055,8976591,0,0,37289,38825
5116,8976682,8976682,8976828,0,0,0,146
4870,8937800,8976205,8977742,0,0,38405,39942
5117,8978962,8978962,8979540,0,0,0,578
5118,8979551,8979551,8979702,0,0,0,151
5119,8979859,8979859,8980021,0,0,0,162
5120,8980078,8980078,8980241,0,0,0,163
5121,8980220,8980241,8980252,0,0,21,32
4800,8852550,8852550,8984200,0,0,0,131650
4845,8932230,8970396,8989626,0,0,38166,57396
4785,8747937,8747937,8992488,0,0,0,244551
4788,8766660,8831302,8997275,0,0,64642,230615
4871,8937891,8997275,8998757,0,0,59384,60866
5123,9009296,9009296,9009579,0,0,0,283
5124,9009728,9009728,9010006,0,0,0,278
5102,8969332,8969332,9012532,0,0,0,43200
4832,8921626,8992488,9014506,0,0,70862,92880
5125,9011292,9011292,9014892,0,0,0,3600
5126,9015149,9015149,9016499,0,0,0,1350
5026,8957733,8957733,9016730,0,0,0,58997
5128,9017178,9017178,9017225,0,0,0,47
5129,9017410,9017410,9017748,0,0,0,338
5130,9017792,9017792,9017944,0,0,0,152
5135,9023532,9023532,9023636,0,0,0,104
5136,9023702,9023702,9023795,0,0,0,93
5137,9023916,9023916,9024051,0,0,0,135
5138,9024058,9024058,9024678,0,0,0,620
5139,9024241,9024241,9024683,0,0,0,442
5140,9025228,9025228,9025337,0,0,0,109
5141,9025330,9025330,9025451,0,0,0,121
5144,9028356,9028356,9028442,0,0,0,86
5145,9028356,9028356,9028442,0,0,0,86
5146,9028356,9028356,9028442,0,0,0,86
5147,9028356,9028356,9028442,0,0,0,86
5148,9028357,9028357,9028443,0,0,0,86
5149,9028357,9028357,9028443,0,0,0,86
5150,9028357,9028357,9028443,0,0,0,86
5151,9028357,9028357,9028443,0,0,0,86
5158,9028539,9028539,9028631,0,0,0,92
5157,9028539,9028539,9028643,0,0,0,104
5142,9025395,9025395,9028995,0,0,0,3600
5165,9028933,9028933,9029043,0,0,0,110
5159,9028539,9028539,9029158,0,0,0,619
5153,9028538,9028538,9029234,0,0,0,696
5167,9028934,9029158,9029253,0,0,224,319
5152,9028538,9028538,9029353,0,0,0,815
5168,9029334,9029334,9029392,0,0,0,58
5164,9028933,9028933,9029679,0,0,0,746
5166,9028933,9029043,9029685,0,0,110,752
5163,9028933,9028933,9029802,0,0,0,869
5154,9028538,9028538,9029875,0,0,0,1337
5162,9028933,9028933,9029949,0,0,0,1016
5155,9028538,9028538,9030115,0,0,0,1577
5160,9028932,9028932,9030347,0,0,0,1415
5156,9028538,9028538,9030904,0,0,0,2366
4819,8907071,8907071,9030990,0,0,0,123919
5169,9030937,9030937,9030995,0,0,0,58
5170,9031044,9031044,9031091,0,0,0,47
5171,9031222,9031222,9031267,0,0,0,45
5161,9028932,9028932,9031519,0,0,0,2587
5172,9031711,9031711,9031770,0,0,0,59
5173,9031728,9031728,9031823,0,0,0,95
5174,9031973,9031973,9032077,0,0,0,104
5143,9025495,9025495,9032592,0,0,0,7097
5176,9032916,9032916,9033074,0,0,0,158
5178,9033233,9033233,9033689,0,0,0,456
5179,9033600,9033600,9033722,0,0,0,122
5103,8974901,8974901,9033921,0,0,0,59020
5180,9033863,9033863,9033967,0,0,0,104
5181,9034001,9034001,9034105,0,0,0,104
5177,9032924,9032924,9034124,0,0,0,1200
5182,9034104,9034104,9034717,0,0,0,613
5183,9034370,9034370,9035002,0,0,0,632
5191,9035743,9035743,9036042,0,0,0,299
5193,9036381,9036381,9036478,0,0,0,97
4900,8951327,8971732,9036532,0,0,20405,85205
5184,9034418,9034418,9037110,0,0,0,2692
4821,8907095,8907095,9037420,0,0,0,130325
5194,9037052,9037052,9037522,0,0,0,470
5195,9037459,9037459,9037556,0,0,0,97
5196,9037569,9037569,9037625,0,0,0,56
5197,9037674,9037674,9037732,0,0,0,58
5198,9037806,9037806,9037941,0,0,0,135
5199,9038075,9038075,9038133,0,0,0,58
5200,9038169,9038169,9038247,0,0,0,78
5201,9038654,9038654,9038794,0,0,0,140
5203,9038989,9038989,9039057,0,0,0,68
5202,9038936,9038936,9039069,0,0,0,133
5204,9039213,9039213,9039303,0,0,0,90
5206,9039458,9039458,9039594,0,0,0,136
5205,9039308,9039308,9039599,0,0,0,291
4820,8907080,8907080,9040140,0,0,0,133060
5192,9035946,9035946,9040158,0,0,0,4212
5207,9041026,9041026,9041130,0,0,0,104
5208,9041240,9041240,9041369,0,0,0,129
5209,9042174,9042174,9042339,0,0,0,165
5210,9042553,9042553,9042622,0,0,0,69
5211,9042768,9042768,9042831,0,0,0,63
5212,9043030,9043030,9043120,0,0,0,90
5214,9043158,9043158,9043237,0,0,0,79
5215,9043601,9043601,9043672,0,0,0,71
4818,8907060,8907060,9044013,0,0,0,136953
4822,8907103,8907103,9044938,0,0,0,137835
4823,8907110,8907110,9046156,0,0,0,139046
5175,9032500,9032500,9046738,0,0,0,14238
5216,9047760,9047760,9047876,0,0,0,116
5217,9047872,9047872,9048173,0,0,0,301
5218,9048137,9048137,9048438,0,0,0,301
5219,9048578,9048578,9048797,0,0,0,219
5220,9048760,9048760,9048928,0,0,0,168
5221,9048846,9048846,9049034,0,0,0,188
5222,9048928,9048928,9049065,0,0,0,137
5223,9049210,9049210,9049337,0,0,0,127
5224,9049226,9049226,9049372,0,0,0,146
5225,9049356,9049356,9049588,0,0,0,232
5227,9049673,9049673,9049819,0,0,0,146
5226,9049532,9049532,9049837,0,0,0,305
5228,9049930,9049930,9050530,0,0,0,600
5230,9050460,9050460,9050617,0,0,0,157
5229,9050392,9050392,9050726,0,0,0,334
5231,9050948,9050948,9051092,0,0,0,144
5232,9051183,9051183,9051368,0,0,0,185
5233,9051858,9051858,9052005,0,0,0,147
5235,9053436,9053436,9053494,0,0,0,58
5236,9053666,9053666,9053713,0,0,0,47
5237,9054014,9054014,9054088,0,0,0,74
5238,9054071,9054071,9054134,0,0,0,63
5239,9054160,9054160,9054218,0,0,0,58
5240,9054286,9054286,9054386,0,0,0,100
5241,9054376,9054376,9054646,0,0,0,270
5242,9054608,9054608,9054932,0,0,0,324
5243,9055281,9055281,9055498,0,0,0,217
5244,9055465,9055465,9055515,0,0,0,50
5245,9055546,9055546,9055593,0,0,0,47
5246,9055808,9055808,9056129,0,0,0,321
5247,9059554,9059554,9059648,0,0,0,94
5250,9059782,9059782,9060001,0,0,0,219
5253,9059975,9059975,9060473,0,0,0,498
5104,8974922,8974922,9061322,0,0,0,86400
4824,8907116,8943409,9065532,0,0,36293,158416
4826,8907174,8976591,9099472,0,0,69417,192298
4825,8907151,8976236,9099705,0,0,69085,192554
4827,8907196,8977742,9105793,0,0,70546,198597
4828,8907237,8984200,9107676,0,0,76963,200439
4829,8918137,8937908,9109058,0,0,19771,190921
5248,9059760,9059760,9111291,0,0,0,51531
5252,9059786,9059786,9111927,0,0,0,52141
5255,9112229,9112229,9112294,0,0,0,65
5249,9059776,9059776,9113887,0,0,0,54111
5257,9114630,9114630,9116344,0,0,0,1714
4831,8918236,8950221,9119193,0,0,31985,200957
4830,8918161,8950221,9121359,0,0,32060,203198
5122,8984200,8997275,9123565,0,0,13075,139365
5251,9059782,9059782,9136607,0,0,0,76825
5234,9052712,9052712,9137062,0,0,0,84350
5131,9018101,9018101,9144572,0,0,0,126471
4953,8953896,8971794,9144594,0,0,17898,190698
5132,9018356,9018356,9146032,0,0,0,127676
4811,8889163,8889163,9148363,0,0,0,259200
5267,9146886,9146886,9163213,0,0,0,16327
5256,9112241,9112241,9165528,0,0,0,53287
5254,9112205,9112205,9167154,0,0,0,54949
5185,9034965,9034965,9173537,0,0,0,138572
5188,9035393,9035393,9173840,0,0,0,138447
5262,9145937,9145937,9180557,0,0,0,34620
5261,9145931,9145931,9181879,0,0,0,35948
5127,9016437,9016437,9182887,0,0,0,166450
5268,9186130,9186130,9186226,0,0,0,96
5189,9035448,9035448,9186528,0,0,0,151080
5263,9145948,9145948,9186870,0,0,0,40922
5260,9145921,9145921,9188049,0,0,0,42128
5186,9035098,9035098,9189495,0,0,0,154397
5270,9190994,9190994,9191166,0,0,0,172
5272,9191637,9191637,9192816,0,0,0,1179
5274,9194543,9194543,9197878,0,0,0,3335
5273,9193916,9193916,9198003,0,0,0,4087
5264,9145953,9145953,9198018,0,0,0,52065
5276,9199226,9199226,9200581,0,0,0,1355
5187,9035265,9035265,9208065,0,0,0,172800
5190,9035528,9035528,9208328,0,0,0,172800
5213,9043030,9043030,9211946,0,0,0,168916
5133,9018627,9018627,9219650,0,0,0,201023
5271,9191261,9191261,9221182,0,0,0,29921
5277,9199508,9199508,9229880,0,0,0,30372
5265,9145957,9145957,9231724,0,0,0,85767
5266,9145974,9145974,9232374,0,0,0,86400
5284,9216882,9216882,9232532,0,0,0,15650
5285,9237173,9237173,9245085,0,0,0,7912
5134,9019766,9019766,9278966,0,0,0,259200
5280,9200500,9200500,9284614,0,0,0,84114
5275,9198086,9198086,9285580,0,0,0,87494
5258,9117166,9117166,9289966,0,0,0,172800
5259,9123227,9123227,9296027,0,0,0,172800
5292,9284675,9284675,9298378,0,0,0,13703
5296,9298957,9298957,9299139,0,0,0,182
5293,9286298,9286298,9299852,0,0,0,13554
5297,9299835,9299835,9299955,0,0,0,120
5283,9214222,9214222,9307803,0,0,0,93581
5287,9277095,9277095,9309609,0,0,0,32514
5288,9277104,9277104,9310383,0,0,0,33279
5289,9277107,9277107,9321187,0,0,0,44080
5300,9323566,9323566,9331151,0,0,0,7585
5290,9277110,9277110,9337623,0,0,0,60513
5301,9323573,9323573,9342813,0,0,0,19240
5303,9323636,9323636,9343267,0,0,0,19631
5302,9323615,9323615,9344084,0,0,0,20469
5304,9323639,9323639,9346328,0,0,0,22689
5305,9323642,9323642,9348423,0,0,0,24781
5306,9323645,9323645,9351127,0,0,0,27482
5307,9323666,9323666,9354104,0,0,0,30438
5269,9190528,9190528,9356502,0,0,0,165974
5298,9301675,9301675,9362154,0,0,0,60479
5308,9323682,9323682,9364067,0,0,0,40385
5310,9368878,9368878,9375174,0,0,0,6296
5281,9209455,9209455,9382255,0,0,0,172800
5282,9210395,9210395,9383195,0,0,0,172800
5313,9376999,9376999,9397102,0,0,0,20103
5312,9376991,9376991,9397921,0,0,0,20930
5314,9377015,9377015,9398342,0,0,0,21327
5321,9398280,9398280,9398406,0,0,0,126
5315,9377018,9377018,9402326,0,0,0,25308
5316,9377022,9377022,9402763,0,0,0,25741
5286,9273595,9273595,9407254,0,0,0,133659
5317,9377025,9377025,9412336,0,0,0,35311
5278,9199817,9199817,9413047,0,0,0,213230
5279,9200128,9200128,9413215,0,0,0,213087
5318,9377046,9377046,9421962,0,0,0,44916
5330,9401200,9401200,9425580,0,0,0,24380
5343,9447928,9447928,9448221,0,0,0,293
5344,9447977,9447977,9448278,0,0,0,301
5347,9459038,9459038,9459815,0,0,0,777
5337,9404589,9404589,9460468,0,0,0,55879
5348,9459836,9459836,9460809,0,0,0,973
5336,9404579,9404579,9462895,0,0,0,58316
5294,9293665,9293665,9466465,0,0,0,172800
5338,9404596,9404596,9470905,0,0,0,66309
5295,9298322,9298322,9471122,0,0,0,172800
5339,9404599,9404599,9490999,0,0,0,86400
5340,9404615,9404615,9491015,0,0,0,86400
5341,9404619,9404619,9491019,0,0,0,86400
5342,9404623,9404623,9491023,0,0,0,86400
5334,9401516,9401516,9496451,0,0,0,94935
5335,9401549,9401549,9497849,0,0,0,96300
5327,9400767,9400767,9500408,0,0,0,99641
5325,9400374,9400374,9500977,0,0,0,100603
5332,9401409,9401409,9501928,0,0,0,100519
5329,9401028,9401028,9502549,0,0,0,101521
5350,9498043,9498043,9502901,0,0,0,4858
5333,9401467,9401467,9503916,0,0,0,102449
5351,9498045,9498045,9504743,0,0,0,6698
5328,9400853,9400853,9505221,0,0,0,104368
5324,9400316,9400316,9507336,0,0,0,107020
5352,9498056,9498056,9515929,0,0,0,17873
5326,9400709,9400709,9517485,0,0,0,116776
5309,9359709,9359709,9525645,0,0,0,165936
5354,9527162,9527162,9527220,0,0,0,58
5355,9527384,9527384,9527442,0,0,0,58
5356,9527590,9527590,9527639,0,0,0,49
5357,9527611,9527611,9527704,0,0,0,93
5291,9280391,9280391,9528286,0,0,0,247895
5358,9530569,9530569,9530665,0,0,0,96
5359,9530639,9530639,9530688,0,0,0,49
5361,9530770,9530770,9530817,0,0,0,47
5360,9530737,9530737,9530839,0,0,0,102
5363,9531038,9531038,9531097,0,0,0,59
5364,9531074,9531074,9531530,0,0,0,456
5365,9531498,9531498,9531541,0,0,0,43
5323,9399245,9399245,9531665,0,0,0,132420
5367,9534389,9534389,9534448,0,0,0,59
5362,9531015,9531015,9534583,0,0,0,3568
5368,9534555,9534555,9534605,0,0,0,50
5369,9534786,9534786,9534844,0,0,0,58
5322,9398494,9398494,9535119,0,0,0,136625
5370,9534865,9534865,9535335,0,0,0,470
5371,9535605,9535605,9535680,0,0,0,75
5372,9535815,9535815,9535873,0,0,0,58
5373,9535904,9535904,9535970,0,0,0,66
5375,9536081,9536081,9536159,0,0,0,78
5374,9536069,9536069,9536333,0,0,0,264
5376,9536281,9536281,9536352,0,0,0,71
5377,9536442,9536442,9536506,0,0,0,64
5378,9536542,9536542,9536600,0,0,0,58
5379,9536626,9536626,9536684,0,0,0,58
5381,9537113,9537113,9537160,0,0,0,47
5380,9536915,9536915,9537395,0,0,0,480
5382,9537501,9537501,9537615,0,0,0,114
5383,9537866,9537866,9537924,0,0,0,58
5384,9538438,9538438,9538919,0,0,0,481
5385,9539419,9539419,9539536,0,0,0,117
5387,9540250,9540250,9540298,0,0,0,48
5386,9539740,9539740,9540722,0,0,0,982
5388,9541328,9541328,9541386,0,0,0,58
5390,9541445,9541445,9541503,0,0,0,58
5392,9541654,9541654,9541746,0,0,0,92
5393,9541757,9541757,9541850,0,0,0,93
5389,9541407,9541407,9541891,0,0,0,484
5395,9541982,9541982,9542029,0,0,0,47
5394,9541944,9541944,9542044,0,0,0,100
5396,9542082,9542082,9542202,0,0,0,120
5397,9542145,9542145,9542235,0,0,0,90
5398,9542210,9542210,9542252,0,0,0,42
5399,9542310,9542310,9542430,0,0,0,120
5400,9542943,9542943,9542991,0,0,0,48
5401,9543322,9543322,9543415,0,0,0,93
5402,9543520,9543520,9543612,0,0,0,92
5403,9543630,9543630,9543726,0,0,0,96
5404,9543712,9543712,9543873,0,0,0,161
5405,9543915,9543915,9544495,0,0,0,580
5406,9544942,9544942,9544989,0,0,0,47
5407,9544989,9544989,9545079,0,0,0,90
5408,9545772,9545772,9545830,0,0,0,58
5409,9546017,9546017,9546179,0,0,0,162
5410,9546134,9546134,9546192,0,0,0,58
5411,9546634,9546634,9546692,0,0,0,58
5412,9546704,9546704,9546795,0,0,0,91
5413,9546984,9546984,9547150,0,0,0,166
5414,9547214,9547214,9547304,0,0,0,90
5415,9547345,9547345,9547407,0,0,0,62
5417,9547814,9547814,9547964,0,0,0,150
5416,9547414,9547414,9547975,0,0,0,561
5418,9548367,9548367,9548425,0,0,0,58
5419,9548576,9548576,9548666,0,0,0,90
5420,9548890,9548890,9548975,0,0,0,85
5422,9549446,9549446,9549495,0,0,0,49
5421,9549055,9549055,9549630,0,0,0,575
5423,9549545,9549545,9549644,0,0,0,99
5424,9549925,9549925,9550028,0,0,0,103
5425,9550075,9550075,9550127,0,0,0,52
5426,9550859,9550859,9550949,0,0,0,90
5427,9551260,9551260,9551318,0,0,0,58
5428,9551331,9551331,9551389,0,0,0,58
5429,9551616,9551616,9551708,0,0,0,92
5430,9551734,9551734,9551793,0,0,0,59
5431,9551799,9551799,9551895,0,0,0,96
5432,9552958,9552958,9553507,0,0,0,549
5434,9554034,9554034,9554084,0,0,0,50
5433,9553634,9553634,9554181,0,0,0,547
5435,9554146,9554146,9554195,0,0,0,49
5436,9554283,9554283,9554343,0,0,0,60
5437,9554320,9554320,9554415,0,0,0,95
5438,9554500,9554500,9554586,0,0,0,86
5439,9554634,9554634,9554693,0,0,0,59
5441,9554753,9554753,9554840,0,0,0,87
5445,9555313,9555313,9555371,0,0,0,58
5446,9555415,9555415,9555463,0,0,0,48
5319,9382764,9382764,9555564,0,0,0,172800
5448,9555771,9555771,9555823,0,0,0,52
5447,9555549,9555549,9555827,0,0,0,278
5450,9555810,9555810,9555854,0,0,0,44
5452,9555907,9555907,9555966,0,0,0,59
5453,9556011,9556011,9556059,0,0,0,48
5451,9555831,9555831,9556131,0,0,0,300
5320,9383465,9383465,9556265,0,0,0,172800
5454,9556115,9556115,9556715,0,0,0,600
5456,9557941,9557941,9558189,0,0,0,248
5458,9558801,9558801,9558968,0,0,0,167
5459,9559606,9559606,9559720,0,0,0,114
5460,9559734,9559734,9559838,0,0,0,104
5461,9559871,9559871,9560471,0,0,0,600
5462,9560109,9560109,9560675,0,0,0,566
5465,9561050,9561050,9561102,0,0,0,52
5463,9560650,9560650,9561186,0,0,0,536
5466,9561127,9561127,9561186,0,0,0,59
5468,9561570,9561570,9561623,0,0,0,53
5469,9561798,9561798,9561856,0,0,0,58
5470,9564153,9564153,9564211,0,0,0,58
5471,9564224,9564224,9564282,0,0,0,58
5299,9305177,9305177,9564317,0,0,0,259140
5472,9564274,9564274,9564332,0,0,0,58
5473,9565090,9565090,9565149,0,0,0,59
5474,9565244,9565244,9565293,0,0,0,49
5457,9558568,9558568,9577435,0,0,0,18867
5366,9534179,9534179,9592301,0,0,0,58122
5464,9561037,9561037,9604171,0,0,0,43134
5391,9541513,9541513,9606313,0,0,0,64800
5475,9612461,9612461,9612508,0,0,0,47
5476,9615837,9615837,9615896,0,0,0,59
5477,9616068,9616068,9616127,0,0,0,59
5478,9616135,9616135,9616193,0,0,0,58
5479,9617048,9617048,9617106,0,0,0,58
5480,9618311,9618311,9618361,0,0,0,50
5481,9618373,9618373,9618429,0,0,0,56
5482,9618487,9618487,9618545,0,0,0,58
5483,9619786,9619786,9620012,0,0,0,226
5484,9619985,9619985,9620284,0,0,0,299
5485,9620754,9620754,9620801,0,0,0,47
5486,9621345,9621345,9621403,0,0,0,58
5487,9622830,9622830,9622877,0,0,0,47
5488,9622904,9622904,9622962,0,0,0,58
5489,9627748,9627748,9627798,0,0,0,50
5490,9627890,9627890,9627948,0,0,0,58
5311,9368882,9368882,9628022,0,0,0,259140
5491,9629557,9629557,9629620,0,0,0,63
5492,9629603,9629603,9629650,0,0,0,47
5493,9630791,9630791,9630840,0,0,0,49
5494,9630951,9630951,9631009,0,0,0,58
5495,9632030,9632030,9632077,0,0,0,47
5496,9632079,9632079,9632131,0,0,0,52
5497,9632840,9632840,9632898,0,0,0,58
5498,9633392,9633392,9633419,0,0,0,27
5499,9633422,9633422,9633473,0,0,0,51
5500,9633677,9633677,9633731,0,0,0,54
5501,9633717,9633717,9633807,0,0,0,90
5502,9634620,9634620,9635200,0,0,0,580
5503,9634621,9634621,9635201,0,0,0,580
5506,9636070,9636070,9636130,0,0,0,60
5507,9636097,9636097,9636141,0,0,0,44
5505,9635906,9635906,9636144,0,0,0,238
5504,9635572,9635572,9636155,0,0,0,583
5508,9636121,9636121,9636414,0,0,0,293
5509,9636822,9636822,9636881,0,0,0,59
5518,9640680,9640680,9640739,0,0,0,59
5519,9640884,9640884,9640932,0,0,0,48
5517,9639967,9639967,9641112,0,0,0,1145
5520,9641239,9641239,9641297,0,0,0,58
5522,9641330,9641330,9641381,0,0,0,51
5521,9641317,9641317,9641413,0,0,0,96
5523,9641383,9641383,9641562,0,0,0,179
5524,9641542,9641542,9641637,0,0,0,95
5525,9641753,9641753,9641817,0,0,0,64
5526,9641795,9641795,9641845,0,0,0,50
5527,9641878,9641878,9641975,0,0,0,97
5529,9641955,9641955,9642013,0,0,0,58
5528,9641910,9641910,9642032,0,0,0,122
5510,9638776,9638776,9642376,0,0,0,3600
5530,9642405,9642405,9642508,0,0,0,103
5531,9642600,9642600,9642658,0,0,0,58
5532,9642657,9642657,9642715,0,0,0,58
5534,9642876,9642876,9643053,0,0,0,177
5535,9643017,9643017,9643617,0,0,0,600
5533,9642727,9642727,9646327,0,0,0,3600
5539,9644706,9644706,9646776,0,0,0,2070
5565,9647154,9647154,9647210,0,0,0,56
5536,9643615,9643615,9647215,0,0,0,3600
5537,9643717,9643717,9647317,0,0,0,3600
5467,9561371,9561371,9647771,0,0,0,86400
5540,9645495,9645495,9650476,0,0,0,4981
5542,9645496,9645496,9650489,0,0,0,4993
5546,9645497,9645497,9650490,0,0,0,4993
5543,9645496,9645496,9650500,0,0,0,5004
5547,9645497,9645497,9650501,0,0,0,5004
5554,9645500,9645500,9650503,0,0,0,5003
5551,9645499,9645499,9650513,0,0,0,5014
5558,9645501,9645501,9650515,0,0,0,5014
5552,9645499,9645499,9650524,0,0,0,5025
5559,9645501,9645501,9650537,0,0,0,5036
5560,9645501,9645501,9650537,0,0,0,5036
5541,9645495,9645495,9650751,0,0,0,5256
5548,9645497,9645497,9650753,0,0,0,5256
5553,9645499,9645499,9650754,0,0,0,5255
5555,9645500,9645500,9650755,0,0,0,5255
5556,9645500,9645500,9650755,0,0,0,5255
5544,9645496,9645496,9650763,0,0,0,5267
5549,9645497,9645497,9650775,0,0,0,5278
5545,9645496,9645496,9650821,0,0,0,5325
5550,9645497,9645497,9651033,0,0,0,5536
5557,9645500,9645500,9651050,0,0,0,5550
5567,9648883,9648883,9651092,0,0,0,2209
5566,9648877,9648877,9653554,0,0,0,4677
5569,9648904,9648904,9654528,0,0,0,5624
5572,9654928,9654928,9657055,0,0,0,2127
5573,9654952,9654952,9657073,0,0,0,2121
5574,9654974,9654974,9657117,0,0,0,2143
5575,9655006,9655006,9657137,0,0,0,2131
5576,9655032,9655032,9657157,0,0,0,2125
5577,9655070,9655070,9657171,0,0,0,2101
5578,9655105,9655105,9657217,0,0,0,2112
5568,9648886,9648886,9658927,0,0,0,10041
5570,9648907,9648907,9658950,0,0,0,10043
5580,9659027,9659027,9659298,0,0,0,271
5512,9639484,9639484,9659344,0,0,0,19860
5511,9639477,9639477,9659373,0,0,0,19896
5331,9401277,9401277,9660477,0,0,0,259200
5563,9646450,9646450,9660629,0,0,0,14179
5562,9646300,9646300,9660904,0,0,0,14604
5561,9646146,9646146,9660920,0,0,0,14774
5345,9448386,9448386,9661234,0,0,0,212848
5564,9646568,9646568,9661377,0,0,0,14809
5346,9448410,9448410,9661577,0,0,0,213167
5586,9663328,9663328,9663463,0,0,0,135
5585,9663305,9663305,9663472,0,0,0,167
5513,9639492,9639492,9663539,0,0,0,24047
5592,9663473,9663473,9663640,0,0,0,167
5587,9663349,9663349,9665418,0,0,0,2069
5588,9663377,9663377,9665499,0,0,0,2122
5589,9663405,9663405,9665530,0,0,0,2125
5591,9663446,9663446,9665545,0,0,0,2099
5590,9663424,9663424,9665557,0,0,0,2133
5514,9639516,9639516,9669612,0,0,0,30096
5579,9659023,9659023,9672904,0,0,0,13881
5516,9639534,9639534,9674222,0,0,0,34688
5515,9639523,9639523,9676630,0,0,0,37107
5594,9670347,9670347,9684222,0,0,0,13875
5538,9643869,9643869,9687069,0,0,0,43200
5449,9555780,9555780,9691644,0,0,0,135864
5353,9526817,9526817,9693278,0,0,0,166461
5597,9697326,9697326,9697416,0,0,0,90
5598,9697477,9697477,9697566,0,0,0,89
5599,9697584,9697584,9697678,0,0,0,94
5600,9697706,9697706,9697796,0,0,0,90
5601,9697837,9697837,9697927,0,0,0,90
5602,9698246,9698246,9698336,0,0,0,90
5603,9698436,9698436,9698520,0,0,0,84
5604,9698874,9698874,9698964,0,0,0,90
5605,9701374,9701374,9701467,0,0,0,93
5606,9702105,9702105,9702165,0,0,0,60
5607,9702658,9702658,9702815,0,0,0,157
5610,9702778,9702778,9702876,0,0,0,98
5613,9703806,9703806,9703895,0,0,0,89
5614,9703957,9703957,9704044,0,0,0,87
5616,9704104,9704104,9704202,0,0,0,98
5620,9704290,9704290,9704379,0,0,0,89
5608,9702730,9702730,9704833,0,0,0,2103
5609,9702749,9702749,9704866,0,0,0,2117
5612,9703087,9703087,9705183,0,0,0,2096
5619,9704263,9704263,9705846,0,0,0,1583
5618,9704251,9704251,9705857,0,0,0,1606
5622,9706411,9706411,9706506,0,0,0,95
5624,9706687,9706687,9706866,0,0,0,179
5625,9706775,9706775,9706941,0,0,0,166
5623,9706428,9706428,9707028,0,0,0,600
5626,9707184,9707184,9707325,0,0,0,141
5627,9707496,9707496,9707596,0,0,0,100
5628,9707547,9707547,9707642,0,0,0,95
5630,9707801,9707801,9707919,0,0,0,118
5631,9707859,9707859,9707973,0,0,0,114
5635,9707925,9707925,9708040,0,0,0,115
5629,9707737,9707737,9708257,0,0,0,520
5640,9708198,9708198,9708257,0,0,0,59
5647,9711306,9711306,9711396,0,0,0,90
5649,9711520,9711520,9711587,0,0,0,67
5650,9711721,9711721,9711784,0,0,0,63
5652,9711956,9711956,9712021,0,0,0,65
5653,9712120,9712120,9712176,0,0,0,56
5632,9707866,9707866,9712268,0,0,0,4402
5654,9712251,9712251,9712320,0,0,0,69
5655,9712425,9712425,9712492,0,0,0,67
5656,9712585,9712585,9712643,0,0,0,58
5633,9707885,9708257,9712721,0,0,372,4836
5657,9712691,9712691,9712754,0,0,0,63
5658,9712827,9712827,9712885,0,0,0,58
5659,9712906,9712906,9712969,0,0,0,63
5661,9715188,9715188,9715283,0,0,0,95
5663,9715977,9715977,9716036,0,0,0,59
5664,9716070,9716070,9716137,0,0,0,67
5665,9716234,9716234,9716292,0,0,0,58
5666,9716307,9716307,9716400,0,0,0,93
5667,9716333,9716333,9716424,0,0,0,91
5668,9716462,9716462,9716555,0,0,0,93
5634,9707889,9712268,9718224,0,0,4379,10335
5637,9707938,9718224,9718312,0,0,10286,10374
5636,9707931,9712721,9718995,0,0,4790,11064
5349,9461296,9461296,9720496,0,0,0,259200
5682,9720528,9720528,9720588,0,0,0,60
5688,9722233,9722233,9722325,0,0,0,92
5691,9723001,9723001,9723059,0,0,0,58
5693,9723528,9723528,9723585,0,0,0,57
5694,9723907,9723907,9723976,0,0,0,69
5638,9707940,9718312,9724744,0,0,10372,16804
5641,9708310,9724744,9724830,0,0,16434,16520
5642,9708472,9724830,9725359,0,0,16358,16887
5440,9554679,9554679,9725798,0,0,0,171119
5442,9554754,9554754,9725916,0,0,0,171162
5444,9554791,9554791,9725931,0,0,0,171140
5443,9554772,9554772,9725951,0,0,0,171179
5669,9717489,9725951,9726046,0,0,8462,8557
5648,9711465,9725798,9726163,0,0,14333,14698
5639,9707947,9718995,9726283,0,0,11048,18336
5643,9708813,9726283,9726373,0,0,17470,17560
5644,9709024,9726373,9726463,0,0,17349,17439
5660,9715159,9726463,9726565,0,0,11304,11406
5645,9709262,9724830,9726602,0,0,15568,17340
5673,9719358,9726602,9726678,0,0,7244,7320
5675,9719516,9726565,9726691,0,0,7049,7175
5672,9719295,9726565,9726692,0,0,7270,7397
5674,9719392,9726678,9726774,0,0,7286,7382
5685,9721826,9726692,9726845,0,0,4866,5019
5676,9719601,9726774,9726878,0,0,7173,7277
5677,9719726,9726878,9727222,0,0,7152,7496
5679,9720028,9727222,9727348,0,0,7194,7320
5646,9710989,9725359,9727463,0,0,14370,16474
5686,9721941,9721941,9727516,0,0,0,5575
5681,9720422,9727463,9727558,0,0,7041,7136
5687,9722097,9726845,9727684,0,0,4748,5587
5662,9715732,9725931,9728396,0,0,10199,12664
5678,9719809,9726691,9728397,0,0,6882,8588
5692,9723416,9728397,9728470,0,0,4981,5054
5689,9722260,9727684,9728526,0,0,5424,6266
5697,9727318,9728470,9728786,0,0,1152,1468
5455,9556631,9556631,9729431,0,0,0,172800
5651,9711801,9725916,9729516,0,0,14115,17715
5671,9718175,9726163,9729763,0,0,7988,11588
5700,9729721,9729721,9729769,0,0,0,48
5696,9727073,9729763,9730037,0,0,2690,2964
5701,9729992,9729992,9730083,0,0,0,91
5703,9730536,9730536,9730603,0,0,0,67
5698,9727632,9728526,9730615,0,0,894,2983
5704,9730657,9730657,9730746,0,0,0,89
5705,9730789,9730789,9730868,0,0,0,79
5680,9720138,9727348,9730948,0,0,7210,10810
5706,9730878,9730878,9730956,0,0,0,78
5708,9730977,9730977,9731024,0,0,0,47
5707,9730973,9730973,9731050,0,0,0,77
5710,9731084,9731084,9731162,0,0,0,78
5711,9731246,9731246,9731332,0,0,0,86
5712,9731316,9731316,9731404,0,0,0,88
5713,9731377,9731377,9731463,0,0,0,86
5714,9731434,9731434,9731483,0,0,0,49
5715,9731473,9731473,9731557,0,0,0,84
5690,9722936,9728396,9731996,0,0,5460,9060
5709,9731067,9731067,9732447,0,0,0,1380
5716,9732415,9732415,9732571,0,0,0,156
5717,9732603,9732603,9732698,0,0,0,95
5718,9732672,9732672,9732773,0,0,0,101
5720,9732936,9732936,9733030,0,0,0,94
5721,9733713,9733713,9733817,0,0,0,104
5722,9734374,9734374,9734495,0,0,0,121
5699,9727969,9727969,9734816,0,0,0,6847
5723,9734882,9734882,9734934,0,0,0,52
5571,9648909,9648909,9735309,0,0,0,86400
5725,9735423,9735423,9735483,0,0,0,60
5726,9735601,9735601,9735648,0,0,0,47
5727,9737159,9737159,9737217,0,0,0,58
5728,9737377,9737377,9737448,0,0,0,71
5729,9737481,9737481,9737528,0,0,0,47
5730,9737584,9737584,9737632,0,0,0,48
5731,9737803,9737803,9737892,0,0,0,89
5732,9738090,9738090,9738159,0,0,0,69
5733,9738146,9738146,9738215,0,0,0,69
5734,9738146,9738146,9738226,0,0,0,80
5735,9738146,9738146,9738226,0,0,0,80
5736,9738147,9738147,9738227,0,0,0,80
5724,9735041,9735041,9738641,0,0,0,3600
5775,9738690,9738690,9738761,0,0,0,71
5818,9738948,9738948,9739007,0,0,0,59
5819,9739214,9739214,9739274,0,0,0,60
5820,9739322,9739322,9739381,0,0,0,59
5822,9742905,9742905,9742955,0,0,0,50
5740,9738148,9738226,9743224,0,0,78,5076
5823,9743143,9743143,9743234,0,0,0,91
5741,9738148,9738227,9743235,0,0,79,5087
5824,9743271,9743271,9743334,0,0,0,63
5737,9738147,9738147,9743417,0,0,0,5270
5702,9730349,9730349,9743587,0,0,0,13238
5738,9738147,9738215,9743735,0,0,68,5588
5739,9738147,9738226,9743768,0,0,79,5621
5826,9744087,9744087,9745150,0,0,0,1063
5827,9745119,9745150,9746424,0,0,31,1305
5828,9746353,9746424,9747340,0,0,71,987
5581,9661025,9661025,9747425,0,0,0,86400
5829,9747080,9747340,9747758,0,0,260,678
5742,9738148,9743224,9748217,0,0,5076,10069
5743,9738148,9743235,9748248,0,0,5087,10100
5744,9738148,9743417,9748683,0,0,5269,10535
5745,9738149,9743735,9748761,0,0,5586,10612
5746,9738149,9743768,9748806,0,0,5619,10657
5821,9742337,9742337,9749537,0,0,0,7200
5747,9738149,9747758,9752762,0,0,9609,14613
5748,9738149,9748217,9753205,0,0,10068,15056
5749,9738149,9748248,9753260,0,0,10099,15111
5750,9738150,9748683,9753703,0,0,10533,15553
5751,9738150,9748761,9753786,0,0,10611,15636
5752,9738150,9748806,9754324,0,0,10656,16174
5670,9717643,9726046,9756419,0,0,8403,38776
5595,9670354,9670354,9756754,0,0,0,86400
5596,9670358,9670358,9756758,0,0,0,86400
5753,9738150,9752762,9758034,0,0,14612,19884
5754,9738211,9753205,9758463,0,0,14994,20252
5755,9738212,9753260,9758804,0,0,15048,20592
5756,9738212,9753703,9758997,0,0,15491,20785
5757,9738212,9753786,9759346,0,0,15574,21134
5758,9738212,9754324,9759858,0,0,16112,21646
5759,9738213,9756419,9761688,0,0,18206,23475
5760,9738213,9756419,9761934,0,0,18206,23721
5761,9738213,9758034,9763040,0,0,19821,24827
5762,9738214,9758463,9763493,0,0,20249,25279
5763,9738214,9758804,9763822,0,0,20590,25608
5764,9738214,9758997,9764000,0,0,20783,25786
5765,9738214,9759346,9764622,0,0,21132,26408
5766,9738215,9759858,9764856,0,0,21643,26641
5767,9738215,9761688,9766697,0,0,23473,28482
5768,9738215,9761934,9766970,0,0,23719,28755
5769,9738215,9763040,9768059,0,0,24825,29844
5770,9738216,9763493,9768504,0,0,25277,30288
5771,9738216,9763822,9768819,0,0,25606,30603
5772,9738216,9764000,9769546,0,0,25784,31330
5773,9738216,9764622,9769634,0,0,26406,31418
5774,9738217,9764856,9770153,0,0,26639,31936
5776,9738737,9766697,9771719,0,0,27960,32982
5777,9738737,9766970,9771984,0,0,28233,33247
5778,9738737,9768059,9773073,0,0,29322,34336
5779,9738737,9768504,9773758,0,0,29767,35021
5780,9738738,9768819,9774092,0,0,30081,35354
5781,9738738,9769546,9774840,0,0,30808,36102
5782,9738738,9769634,9774941,0,0,30896,36203
5783,9738738,9770153,9775686,0,0,31415,36948
5784,9738738,9771719,9776724,0,0,32981,37986
5785,9738739,9771984,9776972,0,0,33245,38233
5786,9738739,9773073,9778347,0,0,34334,39608
5787,9738739,9773758,9778795,0,0,35019,40056
5788,9738739,9774092,9779374,0,0,35353,40635
5789,9738740,9774840,9779849,0,0,36100,41109
5790,9738740,9774941,9780465,0,0,36201,41725
5791,9738741,9775686,9780947,0,0,36945,42206
5792,9738741,9776724,9781739,0,0,37983,42998
5793,9738741,9776972,9782525,0,0,38231,43784
5795,9738742,9778795,9783827,0,0,40053,45085
5794,9738741,9778347,9783888,0,0,39606,45147
5797,9738906,9779849,9784851,0,0,40943,45945
5796,9738742,9779374,9784938,0,0,40632,46196
5798,9738906,9780465,9785741,0,0,41559,46835
5799,9738906,9780947,9786195,0,0,42041,47289
5800,9738907,9781739,9786744,0,0,42832,47837
5801,9738907,9782525,9787548,0,0,43618,48641
5830,9788027,9788027,9788094,0,0,0,67
5802,9738907,9783827,9788847,0,0,44920,49940
5803,9738907,9783888,9788911,0,0,44981,50004
5804,9738908,9784851,9789863,0,0,45943,50955
5805,9738908,9784938,9789971,0,0,46030,51063
5806,9738909,9785741,9790734,0,0,46832,51825
5807,9738909,9786195,9791463,0,0,47286,52554
5808,9738909,9786744,9792027,0,0,47835,53118
5684,9721596,9727558,9792358,0,0,5962,70762
5809,9738909,9787548,9792573,0,0,48639,53664
5810,9738910,9788847,9793864,0,0,49937,54954
5834,9794037,9794037,9794158,0,0,0,121
5811,9738910,9788911,9794199,0,0,50001,55289
5835,9794265,9794265,9794324,0,0,0,59
5836,9794473,9794473,9794532,0,0,0,59
5831,9788937,9792358,9794839,0,0,3421,5902
5812,9738910,9789863,9794871,0,0,50953,55961
5813,9738910,9789971,9795010,0,0,51061,56100
5814,9738911,9790734,9795728,0,0,51823,56817
5837,9795752,9795752,9795856,0,0,0,104
5833,9791389,9792573,9796173,0,0,1184,4784
5838,9796149,9796149,9796253,0,0,0,104
5815,9738911,9791463,9796736,0,0,52552,57825
5839,9796540,9796540,9796932,0,0,0,392
5840,9796896,9796896,9797004,0,0,0,108
5841,9797182,9797182,9797247,0,0,0,65
5842,9797259,9797259,9797361,0,0,0,102
5843,9797305,9797305,9797377,0,0,0,72
5844,9797374,9797374,9797445,0,0,0,71
5816,9738911,9792027,9797566,0,0,53116,58655
5825,9743366,9794199,9797799,0,0,50833,54433
5845,9797735,9797735,9797839,0,0,0,104
5817,9738912,9792358,9797913,0,0,53446,59001
5846,9797933,9797933,9798037,0,0,0,104
5847,9798124,9798124,9799420,0,0,0,1296
5848,9799379,9799379,9800340,0,0,0,961
5850,9800314,9800314,9800926,0,0,0,612
5832,9789186,9794871,9801395,0,0,5685,12209
5851,9800893,9800893,9804493,0,0,0,3600
5854,9804383,9804383,9804558,0,0,0,175
5857,9805253,9805253,9805342,0,0,0,89
5858,9805456,9805456,9805514,0,0,0,58
5859,9805596,9805596,9805655,0,0,0,59
5860,9805879,9805879,9805957,0,0,0,78
5862,9806010,9806010,9806074,0,0,0,64
5863,9806051,9806051,9806117,0,0,0,66
5864,9806084,9806084,9806261,0,0,0,177
5866,9806385,9806385,9806567,0,0,0,182
5877,9811329,9811329,9811407,0,0,0,78
5879,9812029,9812029,9812077,0,0,0,48
5880,9812157,9812157,9812204,0,0,0,47
5881,9812521,9812521,9812569,0,0,0,48
5883,9812612,9812612,9812701,0,0,0,89
5884,9812752,9812752,9812814,0,0,0,62
5886,9813773,9813773,9813821,0,0,0,48
5887,9813921,9813921,9813979,0,0,0,58
5889,9815341,9815341,9815402,0,0,0,61
5890,9815505,9815505,9815566,0,0,0,61
5892,9816371,9816371,9816447,0,0,0,76
5891,9816338,9816338,9816501,0,0,0,163
5894,9816616,9816616,9816675,0,0,0,59
5895,9816702,9816702,9816760,0,0,0,58
5896,9816854,9816854,9817014,0,0,0,160
5893,9816377,9816377,9817454,0,0,0,1077
5897,9817825,9817825,9817883,0,0,0,58
5901,9818950,9818950,9819186,0,0,0,236
5902,9819227,9819227,9820854,0,0,0,1627
5904,9822094,9822094,9822141,0,0,0,47
5912,9828532,9828532,9828612,0,0,0,80
5914,9828554,9828554,9828616,0,0,0,62
5913,9828540,9828540,9828630,0,0,0,90
5915,9828658,9828658,9828733,0,0,0,75
5916,9828676,9828676,9828746,0,0,0,70
5906,9827236,9827236,9828974,0,0,0,1738
5907,9827239,9828974,9829248,0,0,1735,2009
5917,9829254,9829254,9829353,0,0,0,99
5918,9829301,9829301,9829381,0,0,0,80
5919,9829344,9829344,9829415,0,0,0,71
5920,9829397,9829397,9829479,0,0,0,82
5908,9827242,9829248,9831380,0,0,2006,4138
5909,9827245,9831380,9831665,0,0,4135,4420
5910,9827267,9831665,9833778,0,0,4398,6511
5911,9827270,9833778,9834043,0,0,6508,6773
5922,9829569,9834043,9836653,0,0,4474,7084
5923,9829575,9836653,9839525,0,0,7078,9950
5924,9829578,9839525,9841918,0,0,9947,12340
5925,9829581,9841918,9844737,0,0,12337,15156
5926,9829585,9844737,9847567,0,0,15152,17982
5927,9829606,9847567,9850014,0,0,17961,20408
5930,9833989,9850014,9856780,0,0,16025,22791
5931,9833996,9856780,9860169,0,0,22784,26173
5932,9833998,9860169,9863206,0,0,26171,29208
5933,9834001,9863206,9865033,0,0,29205,31032
5934,9834005,9865033,9865846,0,0,31028,31841
5935,9834006,9865846,9866643,0,0,31840,32637
5617,9704191,9704191,9870138,0,0,0,165947
5871,9809169,9870138,9870259,0,0,60969,61090
5869,9808407,9870138,9870289,0,0,61731,61882
5861,9806004,9870138,9870302,0,0,64134,64298
5898,9818633,9870302,9870406,0,0,51669,51773
5872,9809807,9870138,9870428,0,0,60331,60621
5876,9810844,9870138,9870451,0,0,59294,59607
5874,9810096,9870138,9870502,0,0,60042,60406
5899,9818752,9870406,9870510,0,0,51654,51758
5875,9810281,9870138,9870521,0,0,59857,60240
5900,9818877,9870428,9870541,0,0,51551,51664
5878,9811570,9870138,9870623,0,0,58568,59053
5921,9829412,9870502,9870631,0,0,41090,41219
5865,9806244,9870138,9870726,0,0,63894,64482
5867,9806581,9870138,9870843,0,0,63557,64262
5870,9808844,9870138,9871005,0,0,61294,62161
5868,9806831,9870138,9871024,0,0,63307,64193
5885,9813623,9870289,9871179,0,0,56666,57556
5615,9704015,9704015,9871252,0,0,0,167237
5882,9812593,9870259,9871325,0,0,57666,58732
5928,9829622,9870521,9871578,0,0,40899,41956
5929,9829655,9870623,9872137,0,0,40968,42482
5888,9814715,9870302,9873902,0,0,55587,59187
5903,9820270,9870428,9874028,0,0,50158,53758
5938,9876725,9876725,9878913,0,0,0,2188
5943,9879048,9879048,9879106,0,0,0,58
5944,9879109,9879109,9879163,0,0,0,54
5945,9879790,9879790,9879894,0,0,0,104
5946,9879936,9879936,9879988,0,0,0,52
5947,9880317,9880317,9880395,0,0,0,78
5937,9876723,9876723,9881366,0,0,0,4643
5948,9881476,9881476,9881535,0,0,0,59
5949,9881579,9881579,9881626,0,0,0,47
5950,9881946,9881946,9882004,0,0,0,58
5940,9876743,9876743,9882387,0,0,0,5644
5951,9882460,9882460,9882512,0,0,0,52
5954,9882959,9882959,9883031,0,0,0,72
5953,9882947,9882947,9883041,0,0,0,94
5955,9883119,9883119,9883177,0,0,0,58
5952,9882897,9882897,9883242,0,0,0,345
5957,9884589,9884589,9884752,0,0,0,163
5956,9884415,9884415,9885048,0,0,0,633
5958,9885061,9885061,9885160,0,0,0,99
5959,9885256,9885256,9885324,0,0,0,68
5960,9885331,9885331,9885398,0,0,0,67
5611,9702998,9702998,9885620,0,0,0,182622
5961,9885625,9885625,9885729,0,0,0,104
5962,9886897,9886897,9886992,0,0,0,95
5963,9887822,9887822,9887880,0,0,0,58
5964,9888814,9888814,9888872,0,0,0,58
5965,9889401,9889401,9889504,0,0,0,103
5968,9889629,9889629,9889687,0,0,0,58
5966,9889428,9889428,9889728,0,0,0,300
5971,9890156,9890156,9890247,0,0,0,91
5972,9890200,9890200,9890293,0,0,0,93
5969,9889788,9889788,9890336,0,0,0,548
5970,9889855,9889855,9890381,0,0,0,526
5939,9876727,9876727,9890740,0,0,0,14013
5975,9891566,9891566,9891626,0,0,0,60
5976,9891684,9891684,9891743,0,0,0,59
5973,9891197,9891197,9891785,0,0,0,588
5974,9891319,9891319,9891830,0,0,0,511
5978,9892200,9892200,9892292,0,0,0,92
5977,9891932,9891932,9892511,0,0,0,579
5941,9876748,9876748,9892529,0,0,0,15781
5980,9892683,9892683,9892741,0,0,0,58
5979,9892439,9892439,9892943,0,0,0,504
5982,9892884,9892884,9893223,0,0,0,339
5981,9892760,9892760,9893328,0,0,0,568
5983,9892980,9892980,9893471,0,0,0,491
5985,9896128,9896128,9896254,0,0,0,126
5967,9889600,9889600,9896800,0,0,0,7200
5986,9896795,9896795,9897756,0,0,0,961
5987,9898155,9898155,9898250,0,0,0,95
5989,9898516,9898516,9898609,0,0,0,93
5988,9898470,9898470,9898658,0,0,0,188
5990,9898632,9898632,9898708,0,0,0,76
5991,9899179,9899179,9900120,0,0,0,941
5995,9900261,9900261,9900433,0,0,0,172
5994,9899720,9899720,9901338,0,0,0,1618
5683,9720976,9729516,9902316,0,0,8540,181340
5997,9903037,9903037,9903177,0,0,0,140
5998,9903568,9903568,9903657,0,0,0,89
5996,9902029,9902029,9903690,0,0,0,1661
5999,9903806,9903806,9903873,0,0,0,67
6000,9903907,9903907,9904926,0,0,0,1019
5719,9732715,9732715,9905515,0,0,0,172800
5993,9899448,9905515,9905649,0,0,6067,6201
5936,9873609,9873609,9906855,0,0,0,33246
5583,9663047,9663047,9908205,0,0,0,245158
5582,9662989,9662989,9908225,0,0,0,245236
5853,9801847,9801847,9912980,0,0,0,111133
5905,9826174,9870451,9913651,0,0,44277,87477
5584,9663093,9663093,9917973,0,0,0,254880
6002,9918371,9918371,9918496,0,0,0,125
6003,9918511,9918511,9920516,0,0,0,2005
6004,9920559,9920559,9920606,0,0,0,47
6005,9921117,9921117,9921207,0,0,0,90
6006,9921421,9921421,9923182,0,0,0,1761
5593,9666206,9666206,9925406,0,0,0,259200
6007,9924146,9924146,9926024,0,0,0,1878
6009,9929266,9929266,9929357,0,0,0,91
6010,9929827,9929827,9929919,0,0,0,92
6011,9929997,9929997,9930210,0,0,0,213
6013,9930787,9930787,9930910,0,0,0,123
6014,9930960,9930960,9931184,0,0,0,224
6015,9931168,9931168,9931226,0,0,0,58
6016,9931248,9931248,9931307,0,0,0,59
6017,9931471,9931471,9931593,0,0,0,122
6018,9931630,9931630,9931785,0,0,0,155
6019,9931806,9931806,9931897,0,0,0,91
6020,9932016,9932016,9932138,0,0,0,122
5849,9799761,9799761,9934462,0,0,0,134701
5873,9809941,9870138,9934938,0,0,60197,124997
5852,9801520,9801520,9947788,0,0,0,146268
5942,9876750,9876750,9963150,0,0,0,86400
5621,9705671,9705846,9965046,0,0,175,259375
6021,9932256,9932256,9973074,0,0,0,40818
6025,9973117,9973117,9973392,0,0,0,275
6026,9973544,9973544,9973664,0,0,0,120
6012,9930417,9930417,9974267,0,0,0,43850
6028,9974279,9974279,9974900,0,0,0,621
6029,9975045,9975045,9975107,0,0,0,62
6031,9976914,9976914,9977378,0,0,0,464
5855,9804854,9804854,9977654,0,0,0,172800
5856,9805213,9805213,9978013,0,0,0,172800
6032,9979491,9979491,9979595,0,0,0,104
5695,9726335,9726335,9985535,0,0,0,259200
6037,9994911,9994911,9995817,0,0,0,906
6008,9926114,9926114,10012514,0,0,0,86400
6001,9915693,9915693,10026233,0,0,0,110540
6027,9973671,9973671,10053716,0,0,0,80045
6049,10054043,10054043,10054431,0,0,0,388
6050,10054540,10054540,10054660,0,0,0,120
5992,9899423,9899423,10065376,0,0,0,165953
5984,9894951,9894951,10067751,0,0,0,172800
6052,10070980,10070980,10071517,0,0,0,537
6053,10071492,10071492,10072040,0,0,0,548
6054,10072014,10072014,10072368,0,0,0,354
6055,10072345,10072345,10072666,0,0,0,321
6056,10072644,10072644,10072875,0,0,0,231
6057,10072843,10072843,10073443,0,0,0,600
6058,10074304,10074304,10074733,0,0,0,429
6059,10074699,10074699,10075038,0,0,0,339
6060,10075013,10075013,10075290,0,0,0,277
6061,10075253,10075253,10075853,0,0,0,600
6062,10076057,10076057,10076657,0,0,0,600
6063,10076837,10076837,10077403,0,0,0,566
6064,10077261,10077261,10077573,0,0,0,312
6065,10077266,10077266,10077640,0,0,0,374
6069,10077374,10077374,10077656,0,0,0,282
6070,10077615,10077615,10078172,0,0,0,557
6071,10077814,10077814,10078180,0,0,0,366
6073,10078500,10078500,10078542,0,0,0,42
6072,10078142,10078142,10078551,0,0,0,409
6074,10078515,10078515,10078888,0,0,0,373
6075,10078844,10078844,10078926,0,0,0,82
6077,10078993,10078993,10079071,0,0,0,78
6076,10078854,10078854,10079454,0,0,0,600
6033,9994901,9994901,10081301,0,0,0,86400
6034,9994907,9994907,10081307,0,0,0,86400
6035,9994909,9994909,10081309,0,0,0,86400
6036,9994910,9994910,10081310,0,0,0,86400
6038,9994912,9994912,10081312,0,0,0,86400
6039,9994915,9994915,10081315,0,0,0,86400
6040,9994916,9994916,10081316,0,0,0,86400
6041,9994917,9994917,10081317,0,0,0,86400
6042,9994959,9994959,10081359,0,0,0,86400
6066,10077308,10077308,10081633,0,0,0,4325
6068,10077323,10077323,10081937,0,0,0,4614
6067,10077312,10077312,10084289,0,0,0,6977
6079,10083561,10083561,10084850,0,0,0,1289
6081,10083612,10083612,10085041,0,0,0,1429
6080,10083584,10083584,10085333,0,0,0,1749
6022,9950445,9950445,10092802,0,0,0,142357
6043,10003153,10003153,10097767,0,0,0,94614
6046,10016539,10016539,10107011,0,0,0,90472
6051,10054711,10054711,10133246,0,0,0,78535
6047,10020359,10020359,10133767,0,0,0,113408
6084,10133543,10133543,10134049,0,0,0,506
6030,9976175,9976175,10134216,0,0,0,158041
6085,10134013,10134013,10134238,0,0,0,225
6087,10134341,10134341,10134450,0,0,0,109
6078,10079078,10079078,10134486,0,0,0,55408
6088,10134473,10134473,10134547,0,0,0,74
6086,10134203,10134203,10134558,0,0,0,355
6089,10134518,10134518,10134621,0,0,0,103
6092,10134867,10134867,10134988,0,0,0,121
6090,10134518,10134518,10135118,0,0,0,600
6099,10137153,10137153,10137331,0,0,0,178
6093,10136020,10136020,10137378,0,0,0,1358
6098,10136168,10136168,10137476,0,0,0,1308
6095,10136056,10136056,10137530,0,0,0,1474
6097,10136152,10136152,10137687,0,0,0,1535
6100,10137695,10137695,10137804,0,0,0,109
6094,10136030,10136030,10137818,0,0,0,1788
6101,10137858,10137858,10137916,0,0,0,58
6048,10026192,10026192,10138098,0,0,0,111906
6103,10138232,10138232,10138626,0,0,0,394
6104,10138584,10138584,10139184,0,0,0,600
6105,10139302,10139302,10139902,0,0,0,600
6096,10136120,10136120,10140402,0,0,0,4282
6110,10149688,10149688,10150288,0,0,0,600
6045,10005911,10005911,10152610,0,0,0,146699
6113,10153430,10153430,10153701,0,0,0,271
6115,10154426,10154426,10154484,0,0,0,58
6116,10154494,10154494,10154559,0,0,0,65
6118,10154527,10154527,10154603,0,0,0,76
6117,10154509,10154509,10154749,0,0,0,240
6120,10154697,10154697,10155650,0,0,0,953
6119,10154674,10154674,10155691,0,0,0,1017
6121,10154769,10154769,10156263,0,0,0,1494
6123,10160326,10160326,10160373,0,0,0,47
6124,10160517,10160517,10160595,0,0,0,78
6125,10160669,10160669,10160747,0,0,0,78
6126,10160832,10160832,10162411,0,0,0,1579
6130,10162329,10162329,10162493,0,0,0,164
6131,10162400,10162400,10162564,0,0,0,164
6132,10162421,10162421,10162585,0,0,0,164
6133,10162638,10162638,10162686,0,0,0,48
6135,10162898,10162898,10162945,0,0,0,47
6134,10162885,10162885,10163016,0,0,0,131
6136,10162903,10162903,10163056,0,0,0,153
6137,10162916,10162916,10163058,0,0,0,142
6138,10162982,10162982,10163091,0,0,0,109
6139,10163123,10163123,10163228,0,0,0,105
6140,10163141,10163141,10163253,0,0,0,112
6141,10163155,10163155,10163257,0,0,0,102
6142,10167446,10167446,10167999,0,0,0,553
6143,10168037,10168037,10168170,0,0,0,133
6144,10169646,10169646,10169705,0,0,0,59
6145,10170028,10170028,10170088,0,0,0,60
6091,10134581,10134581,10174969,0,0,0,40388
6023,9957286,9957286,10216426,0,0,0,259140
6024,9958532,9958532,10217672,0,0,0,259140
6147,10221841,10221841,10221976,0,0,0,135
6146,10221459,10221459,10222059,0,0,0,600
6148,10221973,10221973,10222156,0,0,0,183
6149,10222247,10222247,10222478,0,0,0,231
6150,10222466,10222466,10223066,0,0,0,600
6151,10222882,10222882,10223182,0,0,0,300
6152,10223264,10223264,10223356,0,0,0,92
6153,10223330,10223330,10223433,0,0,0,103
6154,10223608,10223608,10223908,0,0,0,300
6155,10224313,10224313,10224418,0,0,0,105
6156,10224435,10224435,10225035,0,0,0,600
6158,10225207,10225207,10225296,0,0,0,89
6159,10225581,10225581,10225661,0,0,0,80
6161,10225684,10225684,10225754,0,0,0,70
6163,10226129,10226129,10226361,0,0,0,232
6164,10226332,10226332,10226719,0,0,0,387
6162,10225898,10225898,10226929,0,0,0,1031
6160,10225597,10225597,10227090,0,0,0,1493
6165,10226677,10226677,10227277,0,0,0,600
6166,10227673,10227673,10228273,0,0,0,600
6167,10228345,10228345,10228465,0,0,0,120
6168,10228589,10228589,10228666,0,0,0,77
6169,10228676,10228676,10229670,0,0,0,994
6170,10230573,10230573,10230742,0,0,0,169
6171,10230715,10230715,10230816,0,0,0,101
6181,10232928,10232928,10233528,0,0,0,600
6182,10234274,10234274,10234874,0,0,0,600
6082,10092754,10092754,10235217,0,0,0,142463
6184,10235331,10235331,10235420,0,0,0,89
6185,10235728,10235728,10235797,0,0,0,69
6187,10236119,10236119,10236719,0,0,0,600
6174,10231010,10231010,10236919,0,0,0,5909
6189,10236956,10236956,10237045,0,0,0,89
6190,10237195,10237195,10237274,0,0,0,79
6188,10236905,10236905,10237505,0,0,0,600
6173,10230996,10230996,10237646,0,0,0,6650
6191,10237422,10237422,10237972,0,0,0,550
6192,10237526,10237526,10238126,0,0,0,600
6194,10238297,10238297,10238386,0,0,0,89
6186,10236003,10236003,10238426,0,0,0,2423
6195,10238458,10238458,10238536,0,0,0,78
6193,10238198,10238198,10238798,0,0,0,600
6196,10238553,10238553,10238959,0,0,0,406
6172,10230872,10230872,10239207,0,0,0,8335
6197,10239230,10239230,10239718,0,0,0,488
6198,10239675,10239675,10240158,0,0,0,483
6199,10240125,10240125,10240363,0,0,0,238
6201,10240610,10240610,10240659,0,0,0,49
6200,10240329,10240329,10240662,0,0,0,333
6203,10240801,10240801,10240851,0,0,0,50
6202,10240625,10240625,10241225,0,0,0,600
6204,10241495,10241495,10241542,0,0,0,47
6205,10241860,10241860,10241938,0,0,0,78
6175,10231170,10231170,10241970,0,0,0,10800
6206,10241994,10241994,10242088,0,0,0,94
6176,10231290,10231290,10242090,0,0,0,10800
6177,10231307,10231307,10242107,0,0,0,10800
6178,10231393,10231393,10242193,0,0,0,10800
6179,10231539,10231539,10242339,0,0,0,10800
6180,10231552,10231552,10242352,0,0,0,10800
6208,10242238,10242238,10242364,0,0,0,126
6207,10242102,10242102,10245702,0,0,0,3600
6209,10246997,10246997,10247075,0,0,0,78
6210,10247302,10247302,10247367,0,0,0,65
6102,10138055,10138055,10249601,0,0,0,111546
6214,10249480,10249480,10250080,0,0,0,600
6216,10250059,10250059,10250416,0,0,0,357
6217,10250387,10250387,10250718,0,0,0,331
6220,10250866,10250866,10250908,0,0,0,42
6211,10247398,10247398,10250998,0,0,0,3600
6218,10250812,10250812,10251412,0,0,0,600
6226,10251362,10251362,10251460,0,0,0,98
6219,10250863,10250863,10251510,0,0,0,647
6221,10250904,10250904,10251653,0,0,0,749
6222,10250930,10250930,10251820,0,0,0,890
6227,10251561,10251561,10252074,0,0,0,513
6223,10250933,10250933,10252175,0,0,0,1242
6228,10252454,10252454,10252551,0,0,0,97
6224,10250946,10250946,10253160,0,0,0,2214
6229,10253195,10253195,10253261,0,0,0,66
6230,10253268,10253268,10253326,0,0,0,58
6231,10253337,10253337,10253398,0,0,0,61
6044,10005511,10005511,10253589,0,0,0,248078
6232,10253876,10253876,10253954,0,0,0,78
6233,10254024,10254024,10254155,0,0,0,131
6234,10254036,10254036,10254914,0,0,0,878
6225,10250961,10250961,10255073,0,0,0,4112
6235,10254159,10254159,10255178,0,0,0,1019
6236,10255089,10255089,10255771,0,0,0,682
6237,10255904,10255904,10255967,0,0,0,63
6238,10255947,10255947,10256621,0,0,0,674
6239,10256956,10256956,10257015,0,0,0,59
6240,10257046,10257046,10257093,0,0,0,47
6241,10257214,10257214,10257275,0,0,0,61
6242,10257285,10257285,10257345,0,0,0,60
6243,10257428,10257428,10257492,0,0,0,64
6244,10257472,10257472,10257537,0,0,0,65
6245,10257585,10257585,10257643,0,0,0,58
6246,10257869,10257869,10257927,0,0,0,58
6247,10257959,10257959,10258021,0,0,0,62
6248,10258571,10258571,10258635,0,0,0,64
6249,10258611,10258611,10258674,0,0,0,63
6250,10258664,10258664,10258753,0,0,0,89
6251,10259142,10259142,10259198,0,0,0,56
6253,10265643,10265643,10265721,0,0,0,78
6255,10266331,10266331,10266401,0,0,0,70
6254,10265741,10265741,10266696,0,0,0,955
6257,10266644,10266644,10266734,0,0,0,90
6258,10267574,10267574,10267653,0,0,0,79
6252,10259288,10259288,10267848,0,0,0,8560
6259,10267667,10267667,10267969,0,0,0,302
6260,10267938,10267938,10268008,0,0,0,70
6262,10268305,10268305,10268487,0,0,0,182
6106,10140204,10140204,10269287,0,0,0,129083
6263,10269369,10269369,10269458,0,0,0,89
6261,10268110,10268110,10269505,0,0,0,1395
6264,10269485,10269485,10270072,0,0,0,587
6265,10270048,10270048,10270126,0,0,0,78
6266,10270195,10270195,10270275,0,0,0,80
6267,10270251,10270251,10270687,0,0,0,436
6268,10270688,10270688,10270815,0,0,0,127
6270,10271876,10271876,10271965,0,0,0,89
6271,10272067,10272067,10272193,0,0,0,126
6272,10272246,10272246,10272464,0,0,0,218
6273,10272436,10272436,10272527,0,0,0,91
6274,10272515,10272515,10272640,0,0,0,125
6275,10272609,10272609,10272947,0,0,0,338
6276,10272917,10272917,10272991,0,0,0,74
6269,10271006,10271006,10273271,0,0,0,2265
6277,10273096,10273096,10273327,0,0,0,231
6278,10273292,10273292,10273370,0,0,0,78
6279,10273371,10273371,10273502,0,0,0,131
6281,10273475,10273475,10273544,0,0,0,69
6280,10273472,10273472,10273685,0,0,0,213
6282,10273692,10273692,10273759,0,0,0,67
6283,10273880,10273880,10274151,0,0,0,271
6284,10274137,10274137,10274459,0,0,0,322
6285,10274380,10274380,10274703,0,0,0,323
6286,10276157,10276157,10278848,0,0,0,2691
6127,10161239,10161239,10283233,0,0,0,121994
6112,10152710,10152710,10291171,0,0,0,138461
6157,10224973,10224973,10305578,0,0,0,80605
6114,10154376,10154376,10305897,0,0,0,151521
6289,10305971,10305971,10306704,0,0,0,733
6290,10306658,10306658,10306747,0,0,0,89
6291,10306667,10306667,10306750,0,0,0,83
6292,10306680,10306680,10306789,0,0,0,109
6293,10306852,10306852,10306862,0,0,0,10
6295,10306977,10306977,10307037,0,0,0,60
6297,10307174,10307174,10307234,0,0,0,60
6294,10306915,10306915,10307497,0,0,0,582
6298,10307269,10307269,10307706,0,0,0,437
6300,10307667,10307667,10307727,0,0,0,60
6301,10307753,10307753,10307813,0,0,0,60
6302,10307834,10307834,10307894,0,0,0,60
6299,10307607,10307607,10307938,0,0,0,331
6296,10307125,10307125,10308015,0,0,0,890
6303,10308000,10308000,10308060,0,0,0,60
6304,10308158,10308158,10308453,0,0,0,295
6305,10308884,10308884,10308944,0,0,0,60
6306,10308974,10308974,10309034,0,0,0,60
6307,10309080,10309080,10309140,0,0,0,60
6308,10309278,10309278,10309338,0,0,0,60
6310,10309532,10309532,10309609,0,0,0,77
6311,10309602,10309602,10309708,0,0,0,106
6313,10310026,10310026,10310084,0,0,0,58
6312,10309912,10309912,10310100,0,0,0,188
6314,10310085,10310085,10310141,0,0,0,56
6315,10310337,10310337,10310395,0,0,0,58
6316,10310427,10310427,10310516,0,0,0,89
6317,10310558,10310558,10311382,0,0,0,824
6318,10311613,10311613,10311692,0,0,0,79
6319,10312275,10312275,10312334,0,0,0,59
6320,10312349,10312349,10312656,0,0,0,307
6322,10312825,10312825,10312883,0,0,0,58
6321,10312791,10312791,10312924,0,0,0,133
6323,10312922,10312922,10313000,0,0,0,78
6324,10313234,10313234,10313442,0,0,0,208
6107,10141088,10141088,10313888,0,0,0,172800
6108,10141135,10141135,10313935,0,0,0,172800
6325,10314170,10314170,10314229,0,0,0,59
6326,10314464,10314464,10314523,0,0,0,59
6288,10304785,10304785,10315874,0,0,0,11089
6328,10315794,10315794,10316359,0,0,0,565
6329,10316334,10316334,10316934,0,0,0,600
6327,10314627,10314627,10317063,0,0,0,2436
6109,10147438,10147438,10320238,0,0,0,172800
6331,10320214,10320214,10320415,0,0,0,201
6330,10319703,10319703,10320646,0,0,0,943
6333,10322383,10322383,10322499,0,0,0,116
6111,10149745,10149745,10322545,0,0,0,172800
6335,10323232,10323232,10323311,0,0,0,79
6336,10323569,10323569,10323781,0,0,0,212
6337,10323912,10323912,10324694,0,0,0,782
6338,10324822,10324822,10325031,0,0,0,209
6339,10325137,10325137,10325350,0,0,0,213
6340,10325546,10325546,10325730,0,0,0,184
6334,10322534,10322534,10326066,0,0,0,3532
6342,10329079,10329079,10329350,0,0,0,271
6343,10329326,10329326,10329405,0,0,0,79
6341,10327874,10327874,10329511,0,0,0,1637
6344,10329416,10329416,10329842,0,0,0,426
6346,10330989,10330989,10331078,0,0,0,89
6345,10330979,10330979,10331225,0,0,0,246
6348,10331203,10331203,10331312,0,0,0,109
6351,10331285,10331285,10331499,0,0,0,214
6349,10331253,10331253,10331501,0,0,0,248
6350,10331270,10331270,10331506,0,0,0,236
6347,10331110,10331110,10331533,0,0,0,423
6356,10331628,10331628,10331743,0,0,0,115
6355,10331584,10331584,10331893,0,0,0,309
6357,10331809,10331809,10331904,0,0,0,95
6358,10332298,10332298,10332554,0,0,0,256
6359,10332792,10332792,10332899,0,0,0,107
6360,10332873,10332873,10332999,0,0,0,126
6361,10333193,10333193,10333297,0,0,0,104
6363,10333360,10333360,10333593,0,0,0,233
6362,10333354,10333354,10333804,0,0,0,450
6364,10333654,10333654,10333830,0,0,0,176
6367,10333793,10333793,10333903,0,0,0,110
6369,10334008,10334008,10334100,0,0,0,92
6365,10333726,10333726,10334152,0,0,0,426
6370,10334142,10334142,10334246,0,0,0,104
6371,10334414,10334414,10334518,0,0,0,104
6368,10333921,10333921,10334581,0,0,0,660
6372,10334531,10334531,10334927,0,0,0,396
6376,10335605,10335605,10335694,0,0,0,89
6377,10335714,10335714,10335841,0,0,0,127
6378,10335888,10335888,10335958,0,0,0,70
6373,10334908,10334908,10336254,0,0,0,1346
6380,10335983,10335983,10336415,0,0,0,432
6381,10336389,10336389,10336614,0,0,0,225
6375,10335164,10335164,10336964,0,0,0,1800
6382,10336942,10336942,10337221,0,0,0,279
6383,10337245,10337245,10337365,0,0,0,120
6385,10337592,10337592,10337708,0,0,0,116
6386,10337760,10337760,10337884,0,0,0,124
6387,10338163,10338163,10338292,0,0,0,129
6388,10338410,10338410,10338518,0,0,0,108
6389,10338636,10338636,10338739,0,0,0,103
6332,10322160,10322160,10338858,0,0,0,16698
6391,10338941,10338941,10339242,0,0,0,301
6374,10334936,10334936,10340028,0,0,0,5092
6390,10338809,10338809,10340325,0,0,0,1516
6392,10339282,10339282,10341082,0,0,0,1800
6379,10335931,10335931,10345557,0,0,0,9626
6256,10266438,10266438,10360301,0,0,0,93863
6215,10249559,10249559,10361073,0,0,0,111514
6183,10235181,10235181,10377122,0,0,0,141941
6352,10331477,10331477,10389077,0,0,0,57600
6353,10331497,10331497,10389097,0,0,0,57600
6354,10331511,10331511,10389111,0,0,0,57600
6083,10131273,10131273,10389602,0,0,0,258329
6394,10388642,10388642,10390866,0,0,0,2224
6396,10390829,10390829,10391467,0,0,0,638
6397,10397235,10397235,10397350,0,0,0,115
6398,10397241,10397241,10397541,0,0,0,300
6399,10397786,10397786,10398086,0,0,0,300
6400,10397890,10397890,10398490,0,0,0,600
6401,10398688,10398688,10399053,0,0,0,365
6402,10399263,10399263,10399563,0,0,0,300
6404,10400869,10400869,10400967,0,0,0,98
6405,10400899,10400899,10401243,0,0,0,344
6403,10399268,10399268,10401668,0,0,0,2400
6406,10401303,10401303,10401716,0,0,0,413
6407,10401675,10401675,10403475,0,0,0,1800
6408,10403628,10403628,10403732,0,0,0,104
6409,10403786,10403786,10403879,0,0,0,93
6410,10403956,10403956,10404216,0,0,0,260
6411,10404181,10404181,10404287,0,0,0,106
6413,10404831,10404831,10405011,0,0,0,180
6412,10404570,10404570,10405408,0,0,0,838
6415,10405428,10405428,10405439,0,0,0,11
6416,10405585,10405585,10405597,0,0,0,12
6414,10405314,10405314,10405649,0,0,0,335
6419,10405894,10405894,10405906,0,0,0,12
6417,10405710,10405710,10406078,0,0,0,368
6421,10406061,10406061,10406159,0,0,0,98
6418,10405870,10405870,10406233,0,0,0,363
6420,10406033,10406033,10406333,0,0,0,300
6422,10406194,10406194,10406403,0,0,0,209
6424,10406793,10406793,10406806,0,0,0,13
6425,10407374,10407374,10407385,0,0,0,11
6427,10410329,10410329,10410452,0,0,0,123
6428,10410515,10410515,10410526,0,0,0,11
6423,10406370,10406370,10410566,0,0,0,4196
6426,10408595,10408595,10410965,0,0,0,2370
6431,10410962,10410962,10410973,0,0,0,11
6433,10411394,10411394,10411406,0,0,0,12
6432,10411388,10411388,10411672,0,0,0,284
6129,10162237,10162237,10412389,0,0,0,250152
6429,10410921,10410921,10412421,0,0,0,1500
6434,10412441,10412441,10412453,0,0,0,12
6436,10412828,10412828,10412840,0,0,0,12
6435,10412545,10412545,10413079,0,0,0,534
6437,10412960,10412960,10413086,0,0,0,126
6430,10410929,10410929,10413329,0,0,0,2400
6439,10413404,10413404,10413415,0,0,0,11
6441,10413714,10413714,10413868,0,0,0,154
6443,10414226,10414226,10414237,0,0,0,11
6444,10414364,10414364,10414377,0,0,0,13
6122,10155507,10155507,10414707,0,0,0,259200
6445,10414988,10414988,10414999,0,0,0,11
6309,10309395,10309395,10415588,0,0,0,106193
6446,10415922,10415922,10415933,0,0,0,11
6448,10417100,10417100,10417223,0,0,0,123
6449,10417607,10417607,10417790,0,0,0,183
6442,10414032,10414032,10419065,0,0,0,5033
6450,10419604,10419604,10419616,0,0,0,12
6451,10419774,10419774,10419785,0,0,0,11
6452,10419823,10419823,10419930,0,0,0,107
6453,10419885,10419885,10419985,0,0,0,100
6454,10420060,10420060,10420660,0,0,0,600
6455,10420087,10420087,10420687,0,0,0,600
6128,10161665,10161665,10420865,0,0,0,259200
6457,10421116,10421116,10421127,0,0,0,11
6458,10421121,10421121,10421132,0,0,0,11
6456,10421073,10421073,10421148,0,0,0,75
6287,10291175,10291175,10421168,0,0,0,129993
6459,10421280,10421280,10421291,0,0,0,11
6438,10413059,10413059,10421308,0,0,0,8249
6460,10421313,10421313,10421325,0,0,0,12
6461,10421601,10421601,10421612,0,0,0,11
6463,10422477,10422477,10422488,0,0,0,11
6462,10422357,10422357,10422605,0,0,0,248
6464,10422725,10422725,10422736,0,0,0,11
6465,10423098,10423098,10423109,0,0,0,11
6466,10423222,10423222,10423359,0,0,0,137
6469,10423394,10423394,10423405,0,0,0,11
6474,10423753,10423753,10423830,0,0,0,77
6475,10423824,10423824,10423882,0,0,0,58
6477,10424038,10424038,10424116,0,0,0,78
6478,10424609,10424609,10424648,0,0,0,39
6467,10423237,10423237,10424886,0,0,0,1649
6479,10424899,10424899,10424946,0,0,0,47
6468,10423332,10423332,10425041,0,0,0,1709
6480,10425198,10425198,10425245,0,0,0,47
6471,10423549,10423549,10425470,0,0,0,1921
6481,10425440,10425440,10425480,0,0,0,40
6473,10423705,10423705,10425506,0,0,0,1801
6472,10423625,10423625,10425706,0,0,0,2081
6482,10425682,10425682,10425721,0,0,0,39
6470,10423426,10423426,10425745,0,0,0,2319
6476,10423877,10423877,10426574,0,0,0,2697
6384,10337273,10337273,10426660,0,0,0,89387
6483,10444156,10444156,10444900,0,0,0,744
6440,10413430,10413430,10471030,0,0,0,57600
6393,10361027,10361027,10473911,0,0,0,112884
6447,10417081,10417081,10474681,0,0,0,57600
6486,10475439,10475439,10475556,0,0,0,117
6489,10479450,10479450,10479462,0,0,0,12
6490,10479548,10479548,10479559,0,0,0,11
6491,10479647,10479647,10479658,0,0,0,11
6492,10481106,10481106,10481118,0,0,0,12
6493,10481488,10481488,10481579,0,0,0,91
6494,10481649,10481649,10481738,0,0,0,89
6495,10481873,10481873,10481920,0,0,0,47
6496,10482204,10482204,10482288,0,0,0,84
6497,10484657,10484657,10484668,0,0,0,11
6504,10486230,10486230,10486241,0,0,0,11
6499,10485603,10485603,10487555,0,0,0,1952
6501,10485666,10485666,10487566,0,0,0,1900
6498,10485597,10485597,10487618,0,0,0,2021
6505,10487614,10487614,10487653,0,0,0,39
6500,10485650,10485650,10487813,0,0,0,2163
6506,10488005,10488005,10488044,0,0,0,39
6503,10485795,10485795,10488266,0,0,0,2471
6507,10488621,10488621,10488699,0,0,0,78
6502,10485770,10485770,10490673,0,0,0,4903
6508,10491636,10491636,10491797,0,0,0,161
6509,10492940,10492940,10493037,0,0,0,97
6510,10493042,10493042,10493084,0,0,0,42
6511,10493098,10493098,10493202,0,0,0,104
6513,10493368,10493368,10493379,0,0,0,11
6512,10493309,10493309,10493402,0,0,0,93
6514,10493521,10493521,10493626,0,0,0,105
6515,10493721,10493721,10493818,0,0,0,97
6517,10494084,10494084,10494159,0,0,0,75
6519,10494149,10494149,10494160,0,0,0,11
6516,10493948,10493948,10494169,0,0,0,221
6527,10496834,10496834,10496986,0,0,0,152
6518,10494131,10494131,10497350,0,0,0,3219
6529,10497878,10497878,10497889,0,0,0,11
6521,10496226,10496226,10498123,0,0,0,1897
6530,10498180,10498180,10498239,0,0,0,59
6531,10498231,10498231,10498242,0,0,0,11
6523,10496237,10496237,10498290,0,0,0,2053
6532,10498403,10498403,10498473,0,0,0,70
6533,10498577,10498577,10498588,0,0,0,11
6534,10498723,10498723,10498801,0,0,0,78
6520,10494305,10494305,10498834,0,0,0,4529
6535,10499107,10499107,10499175,0,0,0,68
6536,10499620,10499620,10499771,0,0,0,151
6537,10499845,10499845,10499997,0,0,0,152
6212,10248618,10248618,10500007,0,0,0,251389
6525,10496241,10496241,10500141,0,0,0,3900
6538,10500148,10500148,10500217,0,0,0,69
6539,10500902,10500902,10501055,0,0,0,153
6540,10501166,10501166,10501234,0,0,0,68
6528,10497850,10497850,10501450,0,0,0,3600
6541,10501636,10501636,10501706,0,0,0,70
6542,10501878,10501878,10501946,0,0,0,68
6543,10501977,10501977,10502044,0,0,0,67
6545,10503653,10503653,10503782,0,0,0,129
6546,10503917,10503917,10504000,0,0,0,83
6547,10503923,10503923,10504012,0,0,0,89
6548,10504039,10504039,10504050,0,0,0,11
6549,10504123,10504123,10504225,0,0,0,102
6550,10504178,10504178,10504267,0,0,0,89
6551,10504391,10504391,10504402,0,0,0,11
6552,10504415,10504415,10504515,0,0,0,100
6553,10504671,10504671,10504769,0,0,0,98
6366,10333731,10333731,10506014,0,0,0,172283
6544,10502810,10502810,10506410,0,0,0,3600
6555,10506553,10506553,10506565,0,0,0,12
6554,10505161,10505161,10506961,0,0,0,1800
6556,10507492,10507492,10507638,0,0,0,146
6557,10507675,10507675,10507686,0,0,0,11
6213,10248626,10248626,10507766,0,0,0,259140
6559,10507883,10507883,10507894,0,0,0,11
6558,10507753,10507753,10507917,0,0,0,164
6561,10508464,10508464,10508475,0,0,0,11
6563,10508849,10508849,10508860,0,0,0,11
6564,10509348,10509348,10509359,0,0,0,11
6565,10510728,10510728,10510739,0,0,0,11
6560,10507974,10507974,10511574,0,0,0,3600
6562,10508711,10508711,10522949,0,0,0,14238
6484,10444234,10444234,10539390,0,0,0,95156
6522,10496234,10496234,10582634,0,0,0,86400
6524,10496240,10496240,10582640,0,0,0,86400
6526,10496263,10496263,10582663,0,0,0,86400
6485,10473872,10473872,10584681,0,0,0,110809
6567,10588688,10588688,10588700,0,0,0,12
6568,10588913,10588913,10589017,0,0,0,104
6571,10589092,10589092,10589134,0,0,0,42
6569,10589039,10589039,10589162,0,0,0,123
6570,10589066,10589066,10589185,0,0,0,119
6572,10589144,10589144,10589267,0,0,0,123
6395,10389534,10389534,10591074,0,0,0,201540
6574,10590441,10590441,10591182,0,0,0,741
6576,10591352,10591352,10591364,0,0,0,12
6577,10592066,10592066,10592215,0,0,0,149
6573,10589254,10589254,10592854,0,0,0,3600
6578,10593694,10593694,10593706,0,0,0,12
6579,10593707,10593707,10594108,0,0,0,401
6582,10594498,10594498,10594509,0,0,0,11
6583,10594654,10594654,10594666,0,0,0,12
6584,10594937,10594937,10594948,0,0,0,11
6580,10593935,10593935,10595322,0,0,0,1387
6581,10593968,10593968,10595324,0,0,0,1356
6585,10595176,10595176,10595335,0,0,0,159
6587,10595579,10595579,10595643,0,0,0,64
6588,10595727,10595727,10596062,0,0,0,335
6590,10596867,10596867,10596878,0,0,0,11
6592,10598381,10598381,10598429,0,0,0,48
6593,10598528,10598528,10598843,0,0,0,315
6595,10600931,10600931,10601597,0,0,0,666
6596,10602607,10602607,10602693,0,0,0,86
6597,10602807,10602807,10602831,0,0,0,24
6598,10605603,10605603,10605910,0,0,0,307
6599,10605995,10605995,10606390,0,0,0,395
6601,10606778,10606778,10606789,0,0,0,11
6589,10595877,10595877,10609034,0,0,0,13157
6602,10610522,10610522,10610534,0,0,0,12
6586,10595237,10595237,10613164,0,0,0,17927
6603,10612999,10612999,10613335,0,0,0,336
6600,10606250,10606250,10619724,0,0,0,13474
6605,10652689,10652689,10652702,0,0,0,13
6607,10652734,10652734,10652815,0,0,0,81
6608,10653221,10653221,10653234,0,0,0,13
6606,10652713,10652713,10653403,0,0,0,690
6609,10653272,10653272,10653806,0,0,0,534
6610,10654715,10654715,10655439,0,0,0,724
6613,10677136,10677136,10677251,0,0,0,115
6614,10677479,10677479,10677614,0,0,0,135
6615,10677696,10677696,10677949,0,0,0,253
6616,10677913,10677913,10678156,0,0,0,243
6617,10678108,10678108,10678366,0,0,0,258
6618,10678330,10678330,10678603,0,0,0,273
6619,10678549,10678549,10678686,0,0,0,137
6620,10678737,10678737,10679475,0,0,0,738
6621,10679432,10679432,10679965,0,0,0,533
6622,10679976,10679976,10683098,0,0,0,3122
6623,10683057,10683057,10686657,0,0,0,3600
6566,10584639,10584639,10696926,0,0,0,112287
6487,10475523,10475523,10726986,0,0,0,251463
6488,10475536,10475536,10734736,0,0,0,259200
6625,10747485,10747485,10750671,0,0,0,3186
6626,10750640,10750640,10754240,0,0,0,3600
6628,10758413,10758413,10758426,0,0,0,13
6627,10757130,10757130,10760730,0,0,0,3600
6630,10762593,10762593,10762606,0,0,0,13
6629,10762136,10762136,10765736,0,0,0,3600
6631,10766130,10766130,10766142,0,0,0,12
6632,10769444,10769444,10771566,0,0,0,2122
6633,10771526,10771526,10774281,0,0,0,2755
6634,10774262,10774262,10776496,0,0,0,2234
6637,10779197,10779197,10779781,0,0,0,584
6575,10590883,10590883,10780909,0,0,0,190026
6611,10654742,10654742,10786570,0,0,0,131828
6612,10654968,10654968,10788158,0,0,0,133190
6594,10598851,10598851,10789518,0,0,0,190667
6604,10613209,10613209,10791290,0,0,0,178081
6624,10696894,10696894,10808302,0,0,0,111408
6639,10821399,10821399,10821544,0,0,0,145
6640,10821645,10821645,10822313,0,0,0,668
6642,10822504,10822504,10823213,0,0,0,709
6635,10776455,10776455,10825080,0,0,0,48625
6643,10825040,10825040,10825930,0,0,0,890
6644,10826357,10826357,10827733,0,0,0,1376
6646,10827957,10827957,10828215,0,0,0,258
6645,10826735,10826735,10828514,0,0,0,1779
6647,10828467,10828467,10828602,0,0,0,135
6650,10831671,10831671,10831760,0,0,0,89
6648,10831263,10831263,10832338,0,0,0,1075
6652,10833409,10833409,10833784,0,0,0,375
6649,10831413,10831413,10834435,0,0,0,3022
6653,10834184,10834184,10834900,0,0,0,716
6654,10835549,10835549,10835693,0,0,0,144
6655,10835831,10835831,10837631,0,0,0,1800
6651,10831789,10831789,10846045,0,0,0,14256
6657,10851033,10851033,10851044,0,0,0,11
6656,10850212,10850212,10851079,0,0,0,867
6658,10851575,10851575,10852175,0,0,0,600
6591,10596907,10596907,10856107,0,0,0,259200
6660,10856713,10856713,10856806,0,0,0,93
6659,10853517,10853517,10857013,0,0,0,3496
6661,10856998,10856998,10857093,0,0,0,95
6662,10857103,10857103,10857203,0,0,0,100
6663,10857153,10857153,10857242,0,0,0,89
6664,10857271,10857271,10857362,0,0,0,91
6665,10857523,10857523,10857615,0,0,0,92
6666,10857593,10857593,10857663,0,0,0,70
6667,10857689,10857689,10857820,0,0,0,131
6668,10857816,10857816,10857942,0,0,0,126
6669,10857830,10857830,10857987,0,0,0,157
6670,10914725,10914725,10914978,0,0,0,253
6671,10914989,10914989,10915251,0,0,0,262
6672,10915050,10915050,10915316,0,0,0,266
6673,10917065,10917065,10917155,0,0,0,90
6638,10808260,10808260,10919693,0,0,0,111433
6674,10919556,10919556,10920192,0,0,0,636
6676,10921394,10921394,10921761,0,0,0,367
6677,10922050,10922050,10922650,0,0,0,600
6678,10923164,10923164,10923392,0,0,0,228
6679,10925358,10925358,10927158,0,0,0,1800
6681,10932840,10932840,10932930,0,0,0,90
6682,10932969,10932969,10933028,0,0,0,59
6683,10933008,10933008,10933103,0,0,0,95
6684,10933387,10933387,10933522,0,0,0,135
6685,10933523,10933523,10933581,0,0,0,58
6686,10934040,10934040,10934147,0,0,0,107
6687,10934821,10934821,10934913,0,0,0,92
6688,10938843,10938843,10940643,0,0,0,1800
6689,10948366,10948366,10948453,0,0,0,87
6690,10948474,10948474,10948534,0,0,0,60
6691,10958791,10958791,10958908,0,0,0,117
6692,10958910,10958910,10958992,0,0,0,82
6693,10960679,10960679,10960826,0,0,0,147
6636,10776607,10776607,11018084,0,0,0,241477
6695,11018861,11018861,11018919,0,0,0,58
6696,11019002,11019002,11019052,0,0,0,50
6697,11019015,11019015,11019067,0,0,0,52
6698,11019231,11019231,11019280,0,0,0,49
6699,11019398,11019398,11019496,0,0,0,98
6700,11020447,11020447,11020505,0,0,0,58
6701,11020641,11020641,11020823,0,0,0,182
6702,11021030,11021030,11021183,0,0,0,153
6703,11022719,11022719,11022797,0,0,0,78
6704,11022824,11022824,11022882,0,0,0,58
6705,11022935,11022935,11022998,0,0,0,63
6706,11023002,11023002,11023054,0,0,0,52
6707,11023072,11023072,11023125,0,0,0,53
6708,11023121,11023121,11023241,0,0,0,120
6709,11023225,11023225,11023294,0,0,0,69
6710,11023696,11023696,11023749,0,0,0,53
6711,11023732,11023732,11023844,0,0,0,112
6712,11023823,11023823,11023881,0,0,0,58
6713,11023929,11023929,11024050,0,0,0,121
6714,11024082,11024082,11024160,0,0,0,78
6715,11024335,11024335,11024393,0,0,0,58
6716,11024415,11024415,11024530,0,0,0,115
6717,11024607,11024607,11024666,0,0,0,59
6718,11024715,11024715,11024878,0,0,0,163
6719,11024841,11024841,11024910,0,0,0,69
6720,11025103,11025103,11025161,0,0,0,58
6721,11025284,11025284,11025468,0,0,0,184
6722,11025439,11025439,11025514,0,0,0,75
6723,11025914,11025914,11025972,0,0,0,58
6724,11025989,11025989,11026171,0,0,0,182
6725,11026135,11026135,11026202,0,0,0,67
6726,11026266,11026266,11026324,0,0,0,58
6727,11026478,11026478,11026637,0,0,0,159
6728,11026892,11026892,11026956,0,0,0,64
6729,11028698,11028698,11028757,0,0,0,59
6730,11028873,11028873,11029025,0,0,0,152
6731,11029193,11029193,11029258,0,0,0,65
6732,11029808,11029808,11029875,0,0,0,67
6733,11029897,11029897,11029955,0,0,0,58
6734,11029960,11029960,11030113,0,0,0,153
6735,11030083,11030083,11030163,0,0,0,80
6675,10919651,10919651,11030204,0,0,0,110553
6737,11030987,11030987,11031053,0,0,0,66
6738,11031080,11031080,11031138,0,0,0,58
6739,11031145,11031145,11031299,0,0,0,154
6740,11031271,11031271,11031351,0,0,0,80
6741,11031663,11031663,11031715,0,0,0,52
6742,11031704,11031704,11031861,0,0,0,157
6743,11031910,11031910,11031969,0,0,0,59
6745,11032205,11032205,11032273,0,0,0,68
6746,11032797,11032797,11032855,0,0,0,58
6747,11033213,11033213,11033376,0,0,0,163
6748,11033340,11033340,11033408,0,0,0,68
6749,11034170,11034170,11034228,0,0,0,58
6751,11035216,11035216,11035286,0,0,0,70
6752,11035305,11035305,11035364,0,0,0,59
6750,11034257,11034257,11035369,0,0,0,1112
6753,11035531,11035531,11035635,0,0,0,104
6755,11036586,11036586,11036633,0,0,0,47
6754,11036480,11036480,11069230,0,0,0,32750
6641,10821835,10821835,11080847,0,0,0,259012
6758,11084524,11084524,11085167,0,0,0,643
6759,11085497,11085497,11085813,0,0,0,316
6761,11088408,11088408,11088541,0,0,0,133
6760,11088388,11088388,11088544,0,0,0,156
6762,11088420,11088420,11088553,0,0,0,133
6764,11088491,11088491,11088608,0,0,0,117
6765,11088506,11088506,11088634,0,0,0,128
6766,11088523,11088523,11088660,0,0,0,137
6768,11089982,11089982,11090049,0,0,0,67
6769,11090176,11090176,11090424,0,0,0,248
6767,11088733,11088733,11090533,0,0,0,1800
6770,11090649,11090649,11090744,0,0,0,95
6771,11092234,11092234,11092326,0,0,0,92
6772,11092401,11092401,11092494,0,0,0,93
6773,11092505,11092505,11092594,0,0,0,89
6694,10960859,10960859,11093995,0,0,0,133136
6776,11097754,11097754,11097818,0,0,0,64
6777,11100663,11100663,11100721,0,0,0,58
6778,11100904,11100904,11100997,0,0,0,93
6680,10928822,10928822,11101029,0,0,0,172207
6779,11101133,11101133,11101212,0,0,0,79
6775,11094837,11094837,11106698,0,0,0,11861
6780,11101183,11101183,11110173,0,0,0,8990
6782,11110149,11110149,11110229,0,0,0,80
6783,11110611,11110611,11110733,0,0,0,122
6785,11110856,11110856,11111158,0,0,0,302
6786,11111492,11111492,11111624,0,0,0,132
6787,11111604,11111604,11111662,0,0,0,58
6788,11112085,11112085,11112189,0,0,0,104
6789,11113262,11113262,11113386,0,0,0,124
6790,11113407,11113407,11113698,0,0,0,291
6781,11102176,11102176,11113812,0,0,0,11636
6791,11113682,11113682,11113934,0,0,0,252
6792,11113901,11113901,11113976,0,0,0,75
6794,11114297,11114297,11114369,0,0,0,72
6795,11114419,11114419,11114626,0,0,0,207
6796,11114669,11114669,11114747,0,0,0,78
6797,11114806,11114806,11114983,0,0,0,177
6798,11115235,11115235,11115313,0,0,0,78
6799,11115327,11115327,11115493,0,0,0,166
6800,11115485,11115485,11115673,0,0,0,188
6756,11036860,11036860,11124009,0,0,0,87149
6736,11030157,11030157,11141357,0,0,0,111200
6784,11110723,11110723,11144656,0,0,0,33933
6744,11032002,11032002,11204802,0,0,0,172800
6774,11093961,11093961,11225697,0,0,0,131736
6801,11141321,11141321,11254048,0,0,0,112727
6763,11088488,11088488,11259168,0,0,0,170680
6807,11267286,11267286,11267410,0,0,0,124
6805,11267253,11267253,11267567,0,0,0,314
6806,11267272,11267272,11267872,0,0,0,600
6793,11114039,11114039,11286839,0,0,0,172800
6817,11283171,11283171,11291650,0,0,0,8479
6815,11283148,11283148,11291922,0,0,0,8774
6809,11283062,11283062,11292284,0,0,0,9222
6813,11283128,11283128,11292326,0,0,0,9198
6811,11283101,11283101,11293879,0,0,0,10778
6816,11283158,11283158,11333731,0,0,0,50573
6812,11283113,11283113,11334652,0,0,0,51539
6814,11283140,11283140,11334737,0,0,0,51597
6808,11282901,11282901,11336256,0,0,0,53355
6757,11080763,11080763,11339963,0,0,0,259200
6819,11342144,11342144,11342847,0,0,0,703
6820,11343609,11343609,11343651,0,0,0,42
6821,11343675,11343675,11343768,0,0,0,93
6822,11344133,11344133,11350838,0,0,0,6705
6823,11344665,11344665,11351045,0,0,0,6380
6825,11351125,11351125,11351218,0,0,0,93
6827,11351233,11351233,11351291,0,0,0,58
6826,11351227,11351227,11351328,0,0,0,101
6828,11351243,11351243,11351339,0,0,0,96
6830,11352303,11352303,11352396,0,0,0,93
6831,11352480,11352480,11352604,0,0,0,124
6829,11351321,11351321,11352672,0,0,0,1351
6832,11352641,11352641,11352887,0,0,0,246
6833,11352653,11352653,11352899,0,0,0,246
6834,11352831,11352831,11352981,0,0,0,150
6835,11352853,11352853,11352990,0,0,0,137
6836,11352863,11352863,11352999,0,0,0,136
6837,11352889,11352889,11353025,0,0,0,136
6838,11352907,11352907,11353043,0,0,0,136
6839,11352923,11352923,11353070,0,0,0,147
6840,11352978,11352978,11353120,0,0,0,142
6841,11352992,11352992,11353122,0,0,0,130
6842,11353007,11353007,11353137,0,0,0,130
6843,11353025,11353025,11353151,0,0,0,126
6844,11353044,11353044,11353171,0,0,0,127
6845,11353055,11353055,11353195,0,0,0,140
6847,11357308,11357308,11357572,0,0,0,264
6848,11357694,11357694,11358020,0,0,0,326
6849,11358130,11358130,11358394,0,0,0,264
6846,11353224,11353224,11358635,0,0,0,5411
6850,11358704,11358704,11358968,0,0,0,264
6851,11359103,11359103,11359373,0,0,0,270
6853,11364309,11364309,11364413,0,0,0,104
6802,11225655,11225655,11366387,0,0,0,140732
6803,11254001,11254001,11366515,0,0,0,112514
6852,11359263,11359263,11370560,0,0,0,11297
6856,11370932,11370932,11371339,0,0,0,407
6857,11371923,11371923,11372262,0,0,0,339
6858,11372453,11372453,11372505,0,0,0,52
6859,11372653,11372653,11372749,0,0,0,96
6860,11372692,11372692,11372752,0,0,0,60
6861,11373198,11373198,11373614,0,0,0,416
6862,11375104,11375104,11375482,0,0,0,378
6864,11435187,11435187,11435246,0,0,0,59
6865,11435259,11435259,11435364,0,0,0,105
6866,11435486,11435486,11435544,0,0,0,58
6867,11437706,11437706,11438012,0,0,0,306
6868,11437715,11437715,11438037,0,0,0,322
6869,11437728,11437728,11438059,0,0,0,331
6870,11437732,11437732,11438121,0,0,0,389
6871,11437737,11437737,11438143,0,0,0,406
6872,11437744,11437744,11438158,0,0,0,414
6873,11437755,11437755,11438189,0,0,0,434
6875,11437769,11437769,11438237,0,0,0,468
6877,11444467,11444467,11444562,0,0,0,95
6876,11444447,11444447,11444564,0,0,0,117
6878,11444612,11444612,11444760,0,0,0,148
6879,11444629,11444629,11444777,0,0,0,148
6880,11444643,11444643,11444793,0,0,0,150
6881,11445571,11445571,11445621,0,0,0,50
6882,11445780,11445780,11445860,0,0,0,80
6883,11445854,11445854,11445977,0,0,0,123
6884,11446326,11446326,11447084,0,0,0,758
6885,11447187,11447187,11447265,0,0,0,78
6886,11447242,11447242,11447368,0,0,0,126
6887,11447979,11447979,11448101,0,0,0,122
6888,11448621,11448621,11448740,0,0,0,119
6889,11452560,11452560,11452923,0,0,0,363
6890,11453697,11453697,11453792,0,0,0,95
6891,11453776,11453776,11453845,0,0,0,69
6892,11453832,11453832,11453999,0,0,0,167
6893,11455227,11455227,11455316,0,0,0,89
6894,11455456,11455456,11455622,0,0,0,166
6874,11437765,11437765,11455765,0,0,0,18000
6810,11283076,11283076,11455876,0,0,0,172800
6818,11283700,11283700,11456500,0,0,0,172800
6895,11457790,11457790,11457907,0,0,0,117
6896,11458039,11458039,11458251,0,0,0,212
6897,11458315,11458315,11458747,0,0,0,432
6899,11459833,11459833,11459961,0,0,0,128
6900,11459845,11459845,11459973,0,0,0,128
6898,11459810,11459810,11460024,0,0,0,214
6901,11459918,11459918,11460048,0,0,0,130
6902,11459937,11459937,11460063,0,0,0,126
6903,11459949,11459949,11460087,0,0,0,138
6904,11460007,11460007,11460137,0,0,0,130
6905,11460031,11460031,11460153,0,0,0,122
6906,11460043,11460043,11460165,0,0,0,122
6907,11461258,11461258,11461347,0,0,0,89
6804,11260374,11260374,11466367,0,0,0,205993
6855,11366477,11366477,11479236,0,0,0,112759
6854,11366351,11366351,11503218,0,0,0,136867
6910,11519315,11519315,11519400,0,0,0,85
6911,11519370,11519370,11519463,0,0,0,93
6912,11519583,11519583,11519678,0,0,0,95
6824,11348415,11348415,11521215,0,0,0,172800
6913,11519731,11519731,11526384,0,0,0,6653
6914,11520053,11520053,11526704,0,0,0,6651
6863,11434100,11434100,11527492,0,0,0,93392
6915,11521426,11521426,11528247,0,0,0,6821
6917,11521663,11521663,11528321,0,0,0,6658
6916,11521615,11521615,11528399,0,0,0,6784
6918,11532229,11532229,11534477,0,0,0,2248
6919,11534526,11534526,11534584,0,0,0,58
6920,11534633,11534633,11535511,0,0,0,878
6922,11536237,11536237,11536285,0,0,0,48
6923,11536403,11536403,11536461,0,0,0,58
6924,11536788,11536788,11536866,0,0,0,78
6925,11536870,11536870,11537005,0,0,0,135
6926,11536996,11536996,11537173,0,0,0,177
6927,11537424,11537424,11537593,0,0,0,169
6928,11537732,11537732,11537790,0,0,0,58
6929,11537791,11537791,11537949,0,0,0,158
6930,11538407,11538407,11538553,0,0,0,146
6931,11538847,11538847,11538994,0,0,0,147
6932,11541862,11541862,11541997,0,0,0,135
6933,11542438,11542438,11542573,0,0,0,135
6934,11542650,11542650,11542741,0,0,0,91
6935,11543371,11543371,11543486,0,0,0,115
6936,11543912,11543912,11544172,0,0,0,260
6937,11544221,11544221,11544489,0,0,0,268
6939,11544752,11544752,11545039,0,0,0,287
6938,11544330,11544330,11545560,0,0,0,1230
6941,11545524,11545524,11545628,0,0,0,104
6921,11536089,11536089,11546034,0,0,0,9945
6943,11546045,11546045,11546114,0,0,0,69
6942,11545873,11545873,11546430,0,0,0,557
6940,11545003,11545003,11548603,0,0,0,3600
6946,11550348,11550348,11550425,0,0,0,77
6947,11550402,11550402,11550624,0,0,0,222
6948,11550597,11550597,11550774,0,0,0,177
6945,11550205,11550205,11553584,0,0,0,3379
6951,11553749,11553749,11554280,0,0,0,531
6952,11554272,11554272,11554337,0,0,0,65
6950,11553551,11553551,11557151,0,0,0,3600
6953,11554401,11554401,11557729,0,0,0,3328
6944,11546395,11546395,11568959,0,0,0,22564
6908,11479196,11479196,11590466,0,0,0,111270
6958,11594499,11594499,11598099,0,0,0,3600
6955,11558250,11558250,11601778,0,0,0,43528
6959,11600524,11600524,11602275,0,0,0,1751
6960,11602254,11602254,11602391,0,0,0,137
6954,11558094,11558094,11602667,0,0,0,44573
6962,11602640,11602640,11602780,0,0,0,140
6963,11602865,11602865,11603211,0,0,0,346
6961,11602349,11602349,11603289,0,0,0,940
6964,11603254,11603254,11604158,0,0,0,904
6967,11604922,11604922,11605135,0,0,0,213
6966,11604847,11604847,11606161,0,0,0,1314
6965,11604826,11604826,11606173,0,0,0,1347
6968,11606363,11606363,11607682,0,0,0,1319
6970,11607661,11607661,11607764,0,0,0,103
6969,11607288,11607288,11607936,0,0,0,648
6971,11607883,11607883,11607979,0,0,0,96
6973,11608189,11608189,11608304,0,0,0,115
6974,11608647,11608647,11608744,0,0,0,97
6976,11609063,11609063,11609159,0,0,0,96
6977,11609115,11609115,11609173,0,0,0,58
6975,11608748,11608748,11609176,0,0,0,428
6978,11609538,11609538,11609638,0,0,0,100
6980,11610039,11610039,11610133,0,0,0,94
6972,11608173,11608173,11615569,0,0,0,7396
6982,11616777,11616777,11616859,0,0,0,82
6983,11617949,11617949,11618556,0,0,0,607
6984,11618676,11618676,11618766,0,0,0,90
6985,11619686,11619686,11619781,0,0,0,95
6986,11620209,11620209,11620301,0,0,0,92
6988,11620241,11620241,11620343,0,0,0,102
6949,11550654,11550654,11620453,0,0,0,69799
6989,11620376,11620376,11620457,0,0,0,81
6991,11620522,11620522,11620615,0,0,0,93
6987,11620225,11620225,11620621,0,0,0,396
6992,11620685,11620685,11620831,0,0,0,146
6993,11620831,11620831,11620976,0,0,0,145
6994,11620858,11620858,11620994,0,0,0,136
6990,11620431,11620431,11621468,0,0,0,1037
6995,11621515,11621515,11622514,0,0,0,999
6996,11622084,11622084,11622641,0,0,0,557
6997,11622655,11622655,11622753,0,0,0,98
6998,11623470,11623470,11623560,0,0,0,90
6999,11623771,11623771,11623917,0,0,0,146
7000,11623936,11623936,11624013,0,0,0,77
7001,11623970,11623970,11624120,0,0,0,150
7002,11624027,11624027,11624217,0,0,0,190
7003,11624266,11624266,11624412,0,0,0,146
7004,11624279,11624279,11624425,0,0,0,146
7006,11626308,11626308,11626481,0,0,0,173
7007,11626361,11626361,11626518,0,0,0,157
7008,11627322,11627322,11627417,0,0,0,95
7009,11627552,11627552,11627645,0,0,0,93
7010,11627705,11627705,11627852,0,0,0,147
7011,11628375,11628375,11628453,0,0,0,78
7013,11628679,11628679,11628836,0,0,0,157
7014,11629027,11629027,11629098,0,0,0,71
7015,11629326,11629326,11629554,0,0,0,228
7016,11630325,11630325,11630429,0,0,0,104
7018,11630530,11630530,11630588,0,0,0,58
7019,11630700,11630700,11630773,0,0,0,73
7012,11628622,11628622,11630797,0,0,0,2175
7017,11630369,11630369,11630890,0,0,0,521
7021,11630840,11630840,11630922,0,0,0,82
7022,11631134,11631134,11631218,0,0,0,84
7023,11631958,11631958,11632050,0,0,0,92
7024,11631988,11631988,11632087,0,0,0,99
7025,11632066,11632066,11632162,0,0,0,96
7026,11632329,11632329,11632424,0,0,0,95
7028,11632469,11632469,11632541,0,0,0,72
7027,11632398,11632398,11632548,0,0,0,150
7030,11633159,11633159,11633243,0,0,0,84
7029,11632822,11632822,11633430,0,0,0,608
7020,11630770,11630770,11634370,0,0,0,3600
7032,11634533,11634533,11634624,0,0,0,91
7033,11634881,11634881,11635036,0,0,0,155
7034,11635769,11635769,11635859,0,0,0,90
7035,11636964,11636964,11637055,0,0,0,91
7036,11637076,11637076,11637222,0,0,0,146
7037,11637845,11637845,11637940,0,0,0,95
7038,11637872,11637872,11637962,0,0,0,90
7039,11637887,11637887,11637988,0,0,0,101
7040,11637973,11637973,11638115,0,0,0,142
7041,11638022,11638022,11638164,0,0,0,142
7042,11638048,11638048,11638189,0,0,0,141
7043,11638073,11638073,11638208,0,0,0,135
7044,11639612,11639612,11639877,0,0,0,265
7045,11639775,11639775,11639922,0,0,0,147
6909,11503175,11503175,11641855,0,0,0,138680
7047,11644612,11644612,11644654,0,0,0,42
7048,11644674,11644674,11644780,0,0,0,106
7005,11624695,11624695,11668246,0,0,0,43551
6957,11592541,11592541,11674884,0,0,0,82343
7051,11686796,11686796,11686900,0,0,0,104
7052,11687087,11687087,11687202,0,0,0,115
7053,11691604,11691604,11691708,0,0,0,104
7054,11691730,11691730,11691845,0,0,0,115
7055,11692348,11692348,11692463,0,0,0,115
7056,11693007,11693007,11693111,0,0,0,104
7057,11693548,11693548,11693653,0,0,0,105
7058,11693637,11693637,11693743,0,0,0,106
7059,11697426,11697426,11697542,0,0,0,116
7060,11698442,11698442,11698500,0,0,0,58
7061,11698512,11698512,11698560,0,0,0,48
7062,11700731,11700731,11700921,0,0,0,190
7063,11701775,11701775,11701968,0,0,0,193
7064,11701956,11701956,11702243,0,0,0,287
7065,11702421,11702421,11702610,0,0,0,189
7066,11702751,11702751,11702953,0,0,0,202
7068,11703094,11703094,11703302,0,0,0,208
7069,11705828,11705828,11706030,0,0,0,202
7070,11706095,11706095,11706278,0,0,0,183
7071,11706308,11706308,11706508,0,0,0,200
7072,11707090,11707090,11707307,0,0,0,217
7073,11707564,11707564,11707865,0,0,0,301
7074,11707867,11707867,11708158,0,0,0,291
7076,11708710,11708710,11708815,0,0,0,105
7077,11708790,11708790,11708861,0,0,0,71
7075,11708250,11708250,11709185,0,0,0,935
7078,11708881,11708881,11709570,0,0,0,689
6979,11609549,11609549,11713940,0,0,0,104391
7079,11714882,11714882,11715260,0,0,0,378
7031,11633586,11633586,11716145,0,0,0,82559
7081,11715889,11715889,11716649,0,0,0,760
7082,11718816,11718816,11718931,0,0,0,115
7083,11719420,11719420,11719535,0,0,0,115
7085,11719629,11719629,11719718,0,0,0,89
7086,11719971,11719971,11720064,0,0,0,93
7084,11719614,11719614,11720096,0,0,0,482
7087,11720076,11720076,11720164,0,0,0,88
7088,11720244,11720244,11720338,0,0,0,94
7089,11720386,11720386,11720497,0,0,0,111
7090,11720466,11720466,11720628,0,0,0,162
7091,11720723,11720723,11721019,0,0,0,296
7093,11721124,11721124,11721186,0,0,0,62
7095,11722086,11722086,11722179,0,0,0,93
7096,11722259,11722259,11722352,0,0,0,93
7097,11723384,11723384,11723479,0,0,0,95
7098,11723567,11723567,11723660,0,0,0,93
7099,11724523,11724523,11724638,0,0,0,115
7100,11725882,11725882,11725997,0,0,0,115
7101,11726314,11726314,11726405,0,0,0,91
7102,11726410,11726410,11726669,0,0,0,259
7103,11726971,11726971,11727280,0,0,0,309
7104,11727348,11727348,11727441,0,0,0,93
7105,11727568,11727568,11727672,0,0,0,104
7049,11644897,11644897,11728142,0,0,0,83245
7092,11720731,11720731,11747247,0,0,0,26516
7106,11727897,11727897,11760627,0,0,0,32730
7050,11685237,11685237,11766711,0,0,0,81474
7046,11641803,11641803,11782870,0,0,0,141067
7094,11721227,11721227,11791198,0,0,0,69971
7111,11801917,11801917,11802064,0,0,0,147
7080,11715814,11715814,11826165,0,0,0,110351
7107,11754090,11754090,11831225,0,0,0,77135
6956,11590422,11590422,11842422,0,0,0,252000
7109,11786196,11786196,11868388,0,0,0,82192
7110,11788454,11788454,11874177,0,0,0,85723
6981,11616179,11616179,11875379,0,0,0,259200
7118,11889753,11889753,11889868,0,0,0,115
7119,11889971,11889971,11890077,0,0,0,106
7120,11890328,11890328,11890415,0,0,0,87
7113,11862665,11862665,11890943,0,0,0,28278
7121,11890742,11890742,11890957,0,0,0,215
7123,11891415,11891415,11891566,0,0,0,151
7124,11891665,11891665,11893465,0,0,0,1800
7125,11893420,11893420,11893518,0,0,0,98
7126,11893505,11893505,11893549,0,0,0,44
7127,11893529,11893529,11893636,0,0,0,107
7128,11893646,11893646,11894438,0,0,0,792
7130,11894443,11894443,11895928,0,0,0,1485
7067,11702912,11702912,11897599,0,0,0,194687
7129,11894403,11894403,11898003,0,0,0,3600
7132,11901782,11901782,11902746,0,0,0,964
7108,11782837,11782837,11918987,0,0,0,136150
7131,11894858,11894858,11945910,0,0,0,51052
7134,11949132,11949132,11949909,0,0,0,777
7116,11885253,11885253,11950053,0,0,0,64800
7117,11885467,11885467,11950267,0,0,0,64800
7135,11949884,11949884,11951040,0,0,0,1156
7137,11952793,11952793,11952888,0,0,0,95
7138,11952965,11952965,11953065,0,0,0,100
7139,11953105,11953105,11953344,0,0,0,239
7136,11951773,11951773,11953378,0,0,0,1605
7141,11954300,11954300,11954423,0,0,0,123
7144,11954808,11954808,11954940,0,0,0,132
7140,11954074,11954074,11955147,0,0,0,1073
7146,11955115,11955115,11955831,0,0,0,716
7148,11955905,11955905,11956029,0,0,0,124
7147,11955797,11955797,11956809,0,0,0,1012
7149,11956062,11956062,11956964,0,0,0,902
7152,11957108,11957108,11957248,0,0,0,140
7153,11957221,11957221,11957505,0,0,0,284
7151,11957040,11957040,11957725,0,0,0,685
7154,11957679,11957679,11957819,0,0,0,140
7155,11958162,11958162,11958302,0,0,0,140
7156,11958290,11958290,11958348,0,0,0,58
7157,11958816,11958816,11958863,0,0,0,47
7158,11959266,11959266,11959325,0,0,0,59
7115,11878683,11878683,11960814,0,0,0,82131
7114,11878661,11878661,11960832,0,0,0,82171
7160,11961999,11961999,11962042,0,0,0,43
7159,11961891,11961891,11962080,0,0,0,189
7163,11962298,11962298,11962356,0,0,0,58
7166,11962478,11962478,11962536,0,0,0,58
7167,11962647,11962647,11962695,0,0,0,48
7168,11962991,11962991,11963013,0,0,0,22
7169,11963094,11963094,11963152,0,0,0,58
7170,11963317,11963317,11963403,0,0,0,86
7165,11962374,11962374,11964022,0,0,0,1648
7175,11964189,11964189,11964239,0,0,0,50
7176,11964485,11964485,11964543,0,0,0,58
7174,11963986,11963986,11964634,0,0,0,648
7178,11965214,11965214,11965471,0,0,0,257
7179,11965562,11965562,11965819,0,0,0,257
7162,11962293,11962293,11966444,0,0,0,4151
7171,11963548,11963548,11967148,0,0,0,3600
7177,11965094,11965094,11967725,0,0,0,2631
7180,11967984,11967984,11969609,0,0,0,1625
7181,11968746,11968746,11969720,0,0,0,974
7142,11954727,11954727,11970615,0,0,0,15888
7143,11954776,11954776,11970621,0,0,0,15845
7145,11954831,11954831,11970621,0,0,0,15790
7188,11971348,11971348,11971458,0,0,0,110
7122,11891047,11891047,11971800,0,0,0,80753
7183,11969567,11969567,11972690,0,0,0,3123
7194,11973286,11973286,11973372,0,0,0,86
7193,11973274,11973274,11974066,0,0,0,792
7198,11974031,11974031,11974253,0,0,0,222
7112,11802076,11802076,11974876,0,0,0,172800
7199,11974559,11974559,11976984,0,0,0,2425
7182,11968793,11968793,11979140,0,0,0,10347
7164,11962335,11962335,11980141,0,0,0,17806
7203,11979453,11979453,11982070,0,0,0,2617
7204,11980948,11980948,11992676,0,0,0,11728
7185,11970837,11970837,12000714,0,0,0,29877
7186,11970845,11970845,12000879,0,0,0,30034
7206,12003321,12003321,12003409,0,0,0,88
7150,11957031,11957031,12020146,0,0,0,63115
7172,11963771,11963771,12028571,0,0,0,64800
7173,11963801,11963801,12028601,0,0,0,64800
7207,12003490,12003490,12034168,0,0,0,30678
7208,12003517,12003517,12034183,0,0,0,30666
7211,12039558,12039558,12039822,0,0,0,264
7161,11962235,11962235,12043615,0,0,0,81380
7187,11971158,11971158,12050834,0,0,0,79676
7213,12052542,12052542,12052657,0,0,0,115
7214,12052967,12052967,12053631,0,0,0,664
7216,12053769,12053769,12053866,0,0,0,97
7217,12054004,12054004,12054283,0,0,0,279
7215,12053609,12053609,12055163,0,0,0,1554
7218,12054386,12054386,12055717,0,0,0,1331
7219,12055206,12055206,12056504,0,0,0,1298
7133,11918945,11918945,12056733,0,0,0,137788
7220,12055518,12055518,12057616,0,0,0,2098
7225,12058034,12058034,12058335,0,0,0,301
7226,12058825,12058825,12059928,0,0,0,1103
7228,12061819,12061819,12061866,0,0,0,47
7229,12061994,12061994,12062052,0,0,0,58
7230,12062143,12062143,12062202,0,0,0,59
7232,12062629,12062629,12062687,0,0,0,58
7231,12062256,12062256,12063354,0,0,0,1098
7209,12036476,12036476,12066346,0,0,0,29870
7210,12036625,12036625,12066644,0,0,0,30019
7195,11973340,11973340,12066815,0,0,0,93475
7196,11973397,11973397,12067021,0,0,0,93624
7190,11973109,11973109,12067201,0,0,0,94092
7197,11973513,11973513,12068222,0,0,0,94709
7192,11973249,11973249,12068337,0,0,0,95088
7212,12046677,12046677,12096167,0,0,0,49490
7233,12066811,12066811,12097022,0,0,0,30211
7234,12066903,12066903,12098517,0,0,0,31614
7191,11973162,11973162,12100588,0,0,0,127426
7227,12059979,12059979,12108225,0,0,0,48246
7184,11970749,11970749,12115779,0,0,0,145030
7235,12085388,12085388,12123777,0,0,0,38389
7237,12126785,12126785,12129516,0,0,0,2731
7239,12129654,12129654,12131672,0,0,0,2018
7240,12132062,12132062,12132994,0,0,0,932
7241,12133108,12133108,12135857,0,0,0,2749
7243,12136372,12136372,12136636,0,0,0,264
7244,12137018,12137018,12137282,0,0,0,264
7245,12137692,12137692,12137751,0,0,0,59
7246,12137948,12137948,12138006,0,0,0,58
7242,12135837,12135837,12138083,0,0,0,2246
7248,12139115,12139115,12139165,0,0,0,50
7249,12139128,12139128,12139178,0,0,0,50
7254,12139541,12139541,12139600,0,0,0,59
7247,12138375,12138375,12140532,0,0,0,2157
7264,12141278,12141278,12141375,0,0,0,97
7259,12140465,12140465,12141929,0,0,0,1464
7266,12141902,12141902,12141961,0,0,0,59
7268,12142543,12142543,12142595,0,0,0,52
7269,12142550,12142550,12142675,0,0,0,125
7262,12141047,12141047,12143308,0,0,0,2261
7272,12143155,12143155,12143403,0,0,0,248
7271,12142869,12142869,12143782,0,0,0,913
7267,12142305,12142305,12143897,0,0,0,1592
7275,12143650,12143650,12144160,0,0,0,510
7278,12144103,12144103,12144223,0,0,0,120
7270,12142797,12142797,12144454,0,0,0,1657
7277,12143927,12143927,12144487,0,0,0,560
7189,11971716,11971716,12144516,0,0,0,172800
7279,12144373,12144373,12144517,0,0,0,144
7281,12144510,12144510,12144560,0,0,0,50
7282,12144613,12144613,12144671,0,0,0,58
7283,12144808,12144808,12144866,0,0,0,58
7285,12145282,12145282,12145340,0,0,0,58
7284,12145222,12145222,12145342,0,0,0,120
7286,12145384,12145384,12145434,0,0,0,50
7287,12145417,12145417,12145537,0,0,0,120
7288,12146041,12146041,12146136,0,0,0,95
7290,12146260,12146260,12146310,0,0,0,50
7280,12144395,12144395,12146579,0,0,0,2184
7289,12146057,12146057,12146730,0,0,0,673
7293,12146882,12146882,12146941,0,0,0,59
7294,12147759,12147759,12147806,0,0,0,47
7200,11975609,11975609,12148409,0,0,0,172800
7295,12148372,12148372,12148428,0,0,0,56
7296,12148641,12148641,12148700,0,0,0,59
7297,12149370,12149370,12149418,0,0,0,48
7292,12146653,12146653,12149519,0,0,0,2866
7298,12149463,12149463,12149522,0,0,0,59
7299,12151240,12151240,12151567,0,0,0,327
7236,12087093,12087093,12151893,0,0,0,64800
7300,12152622,12152622,12152669,0,0,0,47
7221,12055683,12055683,12159807,0,0,0,104124
7274,12143609,12143609,12162426,0,0,0,18817
7276,12143694,12143694,12162708,0,0,0,19014
7273,12143458,12143458,12162978,0,0,0,19520
7301,12169022,12169022,12169130,0,0,0,108
7261,12141046,12141046,12172777,0,0,0,31731
7263,12141221,12141221,12173302,0,0,0,32081
7222,12056690,12056690,12194412,0,0,0,137722
7303,12206028,12206028,12206075,0,0,0,47
7305,12208557,12208557,12208703,0,0,0,146
7306,12208703,12208703,12208849,0,0,0,146
7307,12208993,12208993,12209170,0,0,0,177
7308,12209194,12209194,12209351,0,0,0,157
7309,12209472,12209472,12209622,0,0,0,150
7310,12209650,12209650,12209809,0,0,0,159
7311,12210287,12210287,12210450,0,0,0,163
7312,12210694,12210694,12210752,0,0,0,58
7313,12210970,12210970,12211022,0,0,0,52
7314,12211014,12211014,12211174,0,0,0,160
7315,12211379,12211379,12211438,0,0,0,59
7316,12211488,12211488,12211582,0,0,0,94
7317,12211777,12211777,12211835,0,0,0,58
7304,12208264,12208264,12211888,0,0,0,3624
7318,12211901,12211901,12212131,0,0,0,230
7320,12212401,12212401,12212459,0,0,0,58
7321,12212790,12212790,12212839,0,0,0,49
7322,12213022,12213022,12213091,0,0,0,69
7323,12213542,12213542,12213620,0,0,0,78
7324,12213877,12213877,12213949,0,0,0,72
7325,12214009,12214009,12214140,0,0,0,131
7326,12214193,12214193,12214310,0,0,0,117
7327,12214426,12214426,12214598,0,0,0,172
7329,12214520,12214520,12214601,0,0,0,81
7328,12214429,12214429,12214714,0,0,0,285
7330,12214578,12214578,12214870,0,0,0,292
7331,12214939,12214939,12214986,0,0,0,47
7332,12215152,12215152,12215318,0,0,0,166
7238,12129271,12129271,12215418,0,0,0,86147
7333,12215335,12215335,12215625,0,0,0,290
7334,12215859,12215859,12216009,0,0,0,150
7335,12216447,12216447,12216613,0,0,0,166
7336,12216609,12216609,12216756,0,0,0,147
7337,12216840,12216840,12216987,0,0,0,147
7338,12217005,12217005,12217053,0,0,0,48
7339,12217263,12217263,12217449,0,0,0,186
7340,12217419,12217419,12217564,0,0,0,145
7342,12217720,12217720,12217866,0,0,0,146
7343,12217885,12217885,12218031,0,0,0,146
7344,12218175,12218175,12218322,0,0,0,147
7345,12218352,12218352,12218498,0,0,0,146
7346,12218588,12218588,12218722,0,0,0,134
7347,12218692,12218692,12218839,0,0,0,147
7341,12217564,12217564,12218966,0,0,0,1402
7349,12218848,12218848,12218988,0,0,0,140
7348,12218798,12218798,12219312,0,0,0,514
7265,12141808,12141808,12219475,0,0,0,77667
7350,12220760,12220760,12221339,0,0,0,579
7351,12221612,12221612,12222299,0,0,0,687
7357,12222305,12222305,12223315,0,0,0,1010
7201,11977418,11977418,12223699,0,0,0,246281
7359,12223553,12223553,12225395,0,0,0,1842
7202,11977656,11977656,12225472,0,0,0,247816
7360,12225478,12225478,12225489,0,0,0,11
7361,12225683,12225683,12225694,0,0,0,11
7364,12225763,12225763,12225913,0,0,0,150
7252,12139262,12139262,12225995,0,0,0,86733
7365,12226049,12226049,12226101,0,0,0,52
7366,12226074,12226074,12226226,0,0,0,152
7367,12226160,12226160,12226313,0,0,0,153
7250,12139169,12139169,12227310,0,0,0,88141
7257,12139948,12139948,12227317,0,0,0,87369
7253,12139327,12139327,12227333,0,0,0,88006
7255,12139735,12139735,12227334,0,0,0,87599
7256,12139828,12139828,12227349,0,0,0,87521
7368,12227688,12227688,12227847,0,0,0,159
7369,12228264,12228264,12228412,0,0,0,148
7370,12228314,12228314,12228514,0,0,0,200
7371,12228441,12228441,12228592,0,0,0,151
7372,12228450,12228450,12228868,0,0,0,418
7373,12228699,12228699,12228940,0,0,0,241
7374,12228914,12228914,12228978,0,0,0,64
7375,12229061,12229061,12229300,0,0,0,239
7376,12229156,12229156,12229436,0,0,0,280
7258,12139988,12139988,12229475,0,0,0,89487
7377,12229281,12229281,12229527,0,0,0,246
7379,12229769,12229769,12229827,0,0,0,58
7378,12229500,12229500,12229928,0,0,0,428
7380,12229872,12229872,12230111,0,0,0,239
7381,12230250,12230250,12230496,0,0,0,246
7382,12230901,12230901,12231146,0,0,0,245
7386,12231570,12231570,12231581,0,0,0,11
7385,12231257,12231257,12231675,0,0,0,418
7387,12232569,12232569,12232810,0,0,0,241
7388,12232998,12232998,12233242,0,0,0,244
7389,12234077,12234077,12234305,0,0,0,228
7383,12231021,12231021,12234621,0,0,0,3600
7384,12231097,12231097,12234697,0,0,0,3600
7390,12234522,12234522,12234748,0,0,0,226
7391,12234852,12234852,12235080,0,0,0,228
7392,12235472,12235472,12235621,0,0,0,149
7393,12235531,12235531,12235757,0,0,0,226
7394,12235728,12235728,12235876,0,0,0,148
7396,12237229,12237229,12237240,0,0,0,11
7402,12237638,12237638,12237649,0,0,0,11
7403,12237737,12237737,12237750,0,0,0,13
7404,12237940,12237940,12237952,0,0,0,12
7405,12237999,12237999,12238143,0,0,0,144
7354,12222287,12222287,12239467,0,0,0,17180
7356,12222300,12222300,12239725,0,0,0,17425
7355,12222293,12222293,12239834,0,0,0,17541
7407,12240293,12240293,12240371,0,0,0,78
7408,12241438,12241438,12241496,0,0,0,58
7409,12241512,12241512,12241926,0,0,0,414
7205,11988525,11988525,12242832,0,0,0,254307
7410,12242779,12242779,12243000,0,0,0,221
7352,12222216,12222216,12253809,0,0,0,31593
7353,12222224,12222224,12254065,0,0,0,31841
7358,12222558,12222558,12255879,0,0,0,33321
7251,12139216,12139216,12256512,0,0,0,117296
7260,12140632,12140632,12282721,0,0,0,142089
7412,12289552,12289552,12289595,0,0,0,43
7406,12238424,12238424,12289627,0,0,0,51203
7414,12289650,12289650,12289661,0,0,0,11
7413,12289611,12289611,12290296,0,0,0,685
7415,12295836,12295836,12296263,0,0,0,427
7416,12296505,12296505,12297868,0,0,0,1363
7418,12298048,12298048,12299424,0,0,0,1376
7421,12300304,12300304,12300506,0,0,0,202
7423,12300380,12300380,12300659,0,0,0,279
7422,12300329,12300329,12300771,0,0,0,442
7420,12299719,12299719,12301073,0,0,0,1354
7419,12299633,12299633,12301117,0,0,0,1484
7424,12300401,12300401,12301200,0,0,0,799
7425,12301189,12301189,12301427,0,0,0,238
7426,12301486,12301486,12301627,0,0,0,141
7427,12301698,12301698,12301934,0,0,0,236
7428,12302140,12302140,12302375,0,0,0,235
7223,12057079,12057079,12303552,0,0,0,246473
7429,12304150,12304150,12304200,0,0,0,50
7430,12304448,12304448,12304936,0,0,0,488
7431,12304547,12304547,12304955,0,0,0,408
7432,12305053,12305053,12305323,0,0,0,270
7433,12306053,12306053,12306349,0,0,0,296
7435,12307501,12307501,12307517,0,0,0,16
7437,12307776,12307776,12307792,0,0,0,16
7438,12307868,12307868,12307879,0,0,0,11
7439,12308043,12308043,12308059,0,0,0,16
7440,12308463,12308463,12308474,0,0,0,11
7397,12237239,12237239,12308700,0,0,0,71461
7399,12237268,12237268,12308818,0,0,0,71550
7398,12237250,12237250,12308879,0,0,0,71629
7444,12308948,12308948,12308959,0,0,0,11
7401,12237296,12237296,12308972,0,0,0,71676
7400,12237278,12237278,12309178,0,0,0,71900
7442,12308921,12308921,12309193,0,0,0,272
7445,12309508,12309508,12309520,0,0,0,12
7447,12309532,12309532,12309591,0,0,0,59
7448,12309757,12309757,12309773,0,0,0,16
7449,12309865,12309865,12309876,0,0,0,11
7450,12310023,12310023,12310081,0,0,0,58
7451,12310156,12310156,12310221,0,0,0,65
7453,12310459,12310459,12310515,0,0,0,56
7455,12311775,12311775,12311823,0,0,0,48
7457,12312153,12312153,12312201,0,0,0,48
7456,12312106,12312106,12312214,0,0,0,108
7458,12312471,12312471,12312578,0,0,0,107
7460,12312524,12312524,12312855,0,0,0,331
7463,12312854,12312854,12312908,0,0,0,54
7464,12312856,12312856,12313115,0,0,0,259
7465,12312888,12312888,12313208,0,0,0,320
7467,12313559,12313559,12313654,0,0,0,95
7224,12057131,12057131,12316331,0,0,0,259200
7470,12316307,12316307,12316415,0,0,0,108
7471,12316402,12316402,12317718,0,0,0,1316
7472,12317877,12317877,12317888,0,0,0,11
7473,12318043,12318043,12318054,0,0,0,11
7474,12318281,12318281,12318292,0,0,0,11
7291,12146272,12146272,12319072,0,0,0,172800
7434,12306334,12306334,12319686,0,0,0,13352
7476,12324600,12324600,12324611,0,0,0,11
7477,12326165,12326165,12326176,0,0,0,11
7478,12326591,12326591,12326602,0,0,0,11
7302,12194366,12194366,12327605,0,0,0,133239
7479,12327568,12327568,12327659,0,0,0,91
7446,12309521,12309521,12328026,0,0,0,18505
7454,12311493,12311493,12330287,0,0,0,18794
7417,12296517,12296517,12332517,0,0,0,36000
7436,12307563,12307563,12334231,0,0,0,26668
7475,12319658,12319658,12335226,0,0,0,15568
7441,12308631,12308631,12338711,0,0,0,30080
7443,12308946,12308946,12340668,0,0,0,31722
7395,12237219,12237219,12344112,0,0,0,106893
7459,12312512,12312512,12348512,0,0,0,36000
7481,12330846,12330846,12349359,0,0,0,18513
7480,12330829,12330829,12349390,0,0,0,18561
7466,12312953,12312953,12367142,0,0,0,54189
7483,12341299,12341299,12368437,0,0,0,27138
7461,12312777,12312777,12384256,0,0,0,71479
7462,12312795,12312795,12384361,0,0,0,71566
7319,12212387,12212387,12385187,0,0,0,172800
7362,12225724,12225724,12400825,0,0,0,175101
7468,12313581,12313581,12403118,0,0,0,89537
7469,12314103,12314103,12403505,0,0,0,89402
7452,12310293,12310293,12412245,0,0,0,101952
7484,12421075,12421075,12421909,0,0,0,834
7485,12422657,12422657,12424197,0,0,0,1540
7487,12424182,12424182,12424288,0,0,0,106
7486,12424083,12424083,12425761,0,0,0,1678
7488,12424445,12424445,12425979,0,0,0,1534
7489,12425870,12425870,12427522,0,0,0,1652
7490,12426900,12426900,12428063,0,0,0,1163
7492,12430242,12430242,12431460,0,0,0,1218
7491,12429667,12429667,12432363,0,0,0,2696
7493,12431995,12431995,12468419,0,0,0,36424
7363,12225732,12225732,12476516,0,0,0,250784
7496,12476907,12476907,12477005,0,0,0,98
7497,12477039,12477039,12477150,0,0,0,111
7499,12479725,12479725,12479862,0,0,0,137
7500,12479878,12479878,12480013,0,0,0,135
7501,12480034,12480034,12480172,0,0,0,138
7502,12480497,12480497,12480508,0,0,0,11
7503,12480627,12480627,12480638,0,0,0,11
7498,12477379,12477379,12482505,0,0,0,5126
7505,12483945,12483945,12484040,0,0,0,95
7506,12484307,12484307,12484401,0,0,0,94
7411,12242831,12242831,12501580,0,0,0,258749
7507,12502512,12502512,12502686,0,0,0,174
7510,12502938,12502938,12503061,0,0,0,123
7508,12502630,12502630,12503629,0,0,0,999
7512,12503633,12503633,12503644,0,0,0,11
7509,12502835,12502835,12503668,0,0,0,833
7515,12504033,12504033,12504218,0,0,0,185
7511,12503324,12503324,12505631,0,0,0,2307
7513,12503706,12503706,12505957,0,0,0,2251
7514,12503771,12503771,12509667,0,0,0,5896
7495,12473341,12473341,12509828,0,0,0,36487
7494,12432450,12432450,12510806,0,0,0,78356
7516,12514324,12514324,12514476,0,0,0,152
7504,12482841,12482841,12518841,0,0,0,36000
7519,12516964,12516964,12529071,0,0,0,12107
7518,12515212,12515212,12549696,0,0,0,34484
7521,12558184,12558184,12558195,0,0,0,11
7523,12558935,12558935,12558946,0,0,0,11
7524,12565927,12565927,12567114,0,0,0,1187
7525,12568451,12568451,12568771,0,0,0,320
7528,12570621,12570621,12570772,0,0,0,151
7527,12570615,12570615,12570789,0,0,0,174
7526,12570578,12570578,12570794,0,0,0,216
7529,12571169,12571169,12571284,0,0,0,115
7530,12573154,12573154,12573356,0,0,0,202
7535,12573403,12573403,12573415,0,0,0,12
7532,12573402,12573402,12573515,0,0,0,113
7536,12573404,12573404,12573517,0,0,0,113
7537,12573404,12573404,12573517,0,0,0,113
7533,12573402,12573402,12573526,0,0,0,124
7534,12573403,12573403,12573527,0,0,0,124
7538,12573404,12573404,12573528,0,0,0,124
7531,12573401,12573401,12573537,0,0,0,136
7539,12574540,12574540,12574655,0,0,0,115
7542,12575130,12575130,12575142,0,0,0,12
7543,12575130,12575130,12575252,0,0,0,122
7545,12575131,12575131,12575253,0,0,0,122
7546,12575131,12575131,12575253,0,0,0,122
7547,12575131,12575131,12575253,0,0,0,122
7540,12575129,12575129,12575262,0,0,0,133
7544,12575130,12575130,12575263,0,0,0,133
7541,12575129,12575129,12575284,0,0,0,155
7548,12575329,12575329,12575454,0,0,0,125
7549,12575469,12575469,12575769,0,0,0,300
7550,12576461,12576461,12576472,0,0,0,11
7551,12576504,12576504,12576515,0,0,0,11
7553,12577658,12577658,12577770,0,0,0,112
7552,12576534,12576534,12577815,0,0,0,1281
7555,12578063,12578063,12578074,0,0,0,11
7482,12330970,12330970,12580719,0,0,0,249749
7554,12577783,12577783,12581383,0,0,0,3600
7520,12549655,12549655,12584120,0,0,0,34465
7517,12514542,12514542,12595248,0,0,0,80706
7557,12595197,12595197,12604582,0,0,0,9385
7556,12584077,12584077,12618758,0,0,0,34681
7522,12558848,12558848,12645248,0,0,0,86400
7558,12660396,12660396,12660478,0,0,0,82
7559,12664016,12664016,12667833,0,0,0,3817
7560,12665820,12665820,12671789,0,0,0,5969
7562,12770229,12770229,12773068,0,0,0,2839
7567,12773142,12773142,12773878,0,0,0,736
7569,12775203,12775203,12775941,0,0,0,738
7563,12770251,12770251,12778790,0,0,0,8539
7565,12770280,12770280,12779446,0,0,0,9166
7568,12773952,12773952,12784999,0,0,0,11047
7561,12767102,12767102,12786818,0,0,0,19716
7570,12775915,12775915,12796895,0,0,0,20980
7564,12770264,12770264,12801352,0,0,0,31088
7566,12770287,12770287,12802596,0,0,0,32309
7571,12776557,12776557,12806916,0,0,0,30359
7584,12816076,12816076,12816169,0,0,0,93
7585,12816199,12816199,12816322,0,0,0,123
7586,12816351,12816351,12816470,0,0,0,119
7587,12816560,12816560,12816664,0,0,0,104
7588,12816848,12816848,12816994,0,0,0,146
7589,12817024,12817024,12817142,0,0,0,118
7590,12817227,12817227,12817353,0,0,0,126
7591,12817378,12817378,12817504,0,0,0,126
7593,12817566,12817566,12817689,0,0,0,123
7581,12815459,12815459,12817937,0,0,0,2478
7597,12817879,12817879,12817973,0,0,0,94
7594,12817831,12817831,12818059,0,0,0,228
7595,12817846,12817846,12818088,0,0,0,242
7596,12817873,12817873,12818089,0,0,0,216
7599,12818093,12818093,12818217,0,0,0,124
7572,12797427,12797427,12819162,0,0,0,21735
7607,12819185,12819185,12819247,0,0,0,62
7608,12819352,12819352,12819586,0,0,0,234
7609,12819752,12819752,12819886,0,0,0,134
7598,12817948,12817948,12819892,0,0,0,1944
7610,12819896,12819896,12820042,0,0,0,146
7577,12812585,12812585,12820709,0,0,0,8124
7612,12820925,12820925,12821293,0,0,0,368
7613,12821506,12821506,12821854,0,0,0,348
7604,12818742,12818742,12825714,0,0,0,6972
7575,12809198,12809198,12825919,0,0,0,16721
7606,12819182,12819182,12826846,0,0,0,7664
7574,12809190,12809190,12827133,0,0,0,17943
7617,12827995,12827995,12828106,0,0,0,111
7618,12828426,12828426,12830188,0,0,0,1762
7579,12815442,12815442,12830680,0,0,0,15238
7582,12815467,12815467,12831226,0,0,0,15759
7583,12815471,12815471,12831381,0,0,0,15910
7580,12815451,12815451,12831562,0,0,0,16111
7616,12826955,12826955,12833486,0,0,0,6531
7626,12835085,12835085,12835237,0,0,0,152
7627,12835131,12835131,12836214,0,0,0,1083
7573,12809179,12809179,12836562,0,0,0,27383
7620,12833118,12833118,12839672,0,0,0,6554
7623,12833272,12833272,12840269,0,0,0,6997
7622,12833231,12833231,12840381,0,0,0,7150
7615,12823262,12823262,12841033,0,0,0,17771
7621,12833187,12833187,12841152,0,0,0,7965
7629,12841672,12841672,12841797,0,0,0,125
7624,12833318,12833318,12841891,0,0,0,8573
7592,12817400,12817400,12844197,0,0,0,26797
7634,12841704,12841704,12847097,0,0,0,5393
7630,12841680,12841680,12847903,0,0,0,6223
7632,12841693,12841693,12848200,0,0,0,6507
7635,12845806,12845806,12848360,0,0,0,2554
7633,12841698,12841698,12848619,0,0,0,6921
7576,12810875,12810875,12848749,0,0,0,37874
7631,12841688,12841688,12849293,0,0,0,7605
7605,12818867,12818867,12849545,0,0,0,30678
7578,12812683,12812683,12850323,0,0,0,37640
7637,12856902,12856902,12857037,0,0,0,135
7636,12856458,12856458,12857972,0,0,0,1514
7639,12858771,12858771,12858861,0,0,0,90
7638,12857494,12857494,12859023,0,0,0,1529
7640,12858918,12858918,12860663,0,0,0,1745
7641,12859135,12859135,12860668,0,0,0,1533
7628,12839973,12839973,12860789,0,0,0,20816
7642,12861092,12861092,12861157,0,0,0,65
7643,12861145,12861145,12861266,0,0,0,121
7644,12861340,12861340,12861886,0,0,0,546
7645,12862183,12862183,12863636,0,0,0,1453
7601,12818466,12818466,12893342,0,0,0,74876
7647,12893164,12893164,12894398,0,0,0,1234
7625,12834470,12834470,12898138,0,0,0,63668
7646,12865092,12865092,12899940,0,0,0,34848
7654,12899764,12899764,12901198,0,0,0,1434
7655,12900140,12900140,12901849,0,0,0,1709
7649,12895934,12895934,12902529,0,0,0,6595
7652,12899268,12899268,12902571,0,0,0,3303
7656,12902678,12902678,12902798,0,0,0,120
7657,12903264,12903264,12903384,0,0,0,120
7658,12904051,12904051,12904140,0,0,0,89
7650,12898092,12898092,12905160,0,0,0,7068
7659,12904166,12904166,12905456,0,0,0,1290
7660,12904926,12904926,12906674,0,0,0,1748
7648,12894360,12894360,12907235,0,0,0,12875
7667,12907199,12907199,12907326,0,0,0,127
7662,12906452,12906452,12907958,0,0,0,1506
7664,12906453,12906453,12907970,0,0,0,1517
7665,12906453,12906453,12907970,0,0,0,1517
7663,12906452,12906452,12907980,0,0,0,1528
7666,12906453,12906453,12907981,0,0,0,1528
7661,12906446,12906446,12908068,0,0,0,1622
7669,12908099,12908099,12908151,0,0,0,52
7670,12908099,12908099,12908162,0,0,0,63
7671,12908099,12908099,12908162,0,0,0,63
7672,12908099,12908099,12908162,0,0,0,63
7673,12908099,12908099,12908173,0,0,0,74
7674,12908099,12908099,12908471,0,0,0,372
7668,12907874,12907874,12911032,0,0,0,3158
7651,12899217,12899217,12911885,0,0,0,12668
7603,12818583,12818583,12913195,0,0,0,94612
7653,12899320,12899320,12916403,0,0,0,17083
7681,12911054,12911054,12916542,0,0,0,5488
7686,12911841,12911841,12917646,0,0,0,5805
7689,12916487,12916487,12918418,0,0,0,1931
7690,12918431,12918431,12918520,0,0,0,89
7687,12912722,12912722,12919222,0,0,0,6500
7699,12920381,12920381,12920658,0,0,0,277
7695,12920319,12920319,12921191,0,0,0,872
7696,12920340,12920340,12922639,0,0,0,2299
7704,12921228,12921228,12924968,0,0,0,3740
7701,12920408,12920408,12925258,0,0,0,4850
7707,12925454,12925454,12926102,0,0,0,648
7710,12926660,12926660,12926783,0,0,0,123
7711,12926900,12926900,12927023,0,0,0,123
7712,12927219,12927219,12927334,0,0,0,115
7713,12927449,12927449,12927580,0,0,0,131
7715,12927540,12927540,12927675,0,0,0,135
7714,12927539,12927539,12929006,0,0,0,1467
7694,12920304,12920304,12929803,0,0,0,9499
7717,12931460,12931460,12931580,0,0,0,120
7718,12931626,12931626,12931746,0,0,0,120
7702,12920422,12920422,12931819,0,0,0,11397
7719,12931627,12931627,12932695,0,0,0,1068
7721,12932749,12932749,12932986,0,0,0,237
7700,12920394,12920394,12933322,0,0,0,12928
7720,12932159,12932159,12934206,0,0,0,2047
7723,12934039,12934039,12934265,0,0,0,226
7693,12920294,12920294,12936317,0,0,0,16023
7697,12920350,12920350,12936368,0,0,0,16018
7725,12937640,12937640,12937733,0,0,0,93
7691,12919844,12919844,12937844,0,0,0,18000
7692,12920099,12920099,12938099,0,0,0,18000
7705,12922664,12922664,12938605,0,0,0,15941
7727,12938706,12938706,12938889,0,0,0,183
7728,12939160,12939160,12939357,0,0,0,197
7698,12920368,12920368,12939773,0,0,0,19405
7703,12920630,12920630,12939790,0,0,0,19160
7729,12939632,12939632,12939888,0,0,0,256
7722,12933792,12933792,12939903,0,0,0,6111
7724,12934173,12934173,12939939,0,0,0,5766
7734,12939924,12939924,12940120,0,0,0,196
7736,12940713,12940713,12940830,0,0,0,117
7735,12940409,12940409,12941019,0,0,0,610
7706,12925418,12925418,12941127,0,0,0,15709
7708,12926059,12926059,12941163,0,0,0,15104
7737,12941074,12941074,12941192,0,0,0,118
7738,12941241,12941241,12941362,0,0,0,121
7680,12908183,12908183,12941539,0,0,0,33356
7726,12938526,12938526,12941995,0,0,0,3469
7740,12944839,12944839,12944959,0,0,0,120
7716,12931228,12931228,12945339,0,0,0,14111
7611,12820205,12820205,12948443,0,0,0,128238
7741,12948441,12948441,12948562,0,0,0,121
7688,12916426,12916426,12948692,0,0,0,32266
7733,12939904,12939904,12949587,0,0,0,9683
7743,12949711,12949711,12951748,0,0,0,2037
7742,12949703,12949703,12951920,0,0,0,2217
7730,12939765,12939765,12952211,0,0,0,12446
7746,12952041,12952041,12952279,0,0,0,238
7745,12951992,12951992,12952729,0,0,0,737
7749,12954470,12954470,12954836,0,0,0,366
7751,12955640,12955640,12955860,0,0,0,220
7750,12954809,12954809,12957835,0,0,0,3026
7752,12959240,12959240,12959457,0,0,0,217
7685,12911760,12911760,12960876,0,0,0,49116
7753,12962840,12962840,12963069,0,0,0,229
7732,12939866,12939866,12964549,0,0,0,24683
7754,12966441,12966441,12966659,0,0,0,218
7748,12952688,12952688,12968842,0,0,0,16154
7744,12951774,12951774,12969458,0,0,0,17684
7755,12970040,12970040,12970268,0,0,0,228
7731,12939778,12939778,12971846,0,0,0,32068
7756,12973640,12973640,12973873,0,0,0,233
7709,12926587,12926587,12976739,0,0,0,50152
7757,12977239,12977239,12977457,0,0,0,218
7739,12941465,12941465,12977677,0,0,0,36212
7759,12980840,12980840,12981084,0,0,0,244
7747,12952222,12952222,12983378,0,0,0,31156
7760,12984440,12984440,12984659,0,0,0,219
7761,12988040,12988040,12988289,0,0,0,249
7600,12818177,12818177,12989647,0,0,0,171470
7762,12991640,12991640,12991868,0,0,0,228
7765,12995240,12995240,12995468,0,0,0,228
7764,12993024,12993024,12998126,0,0,0,5102
7766,12998839,12998839,12999116,0,0,0,277
7619,12829235,12829235,13002035,0,0,0,172800
7767,13002439,13002439,13002715,0,0,0,276
7769,13006040,13006040,13006322,0,0,0,282
7602,12818481,12818481,13006565,0,0,0,188084
7770,13009640,13009640,13009912,0,0,0,272
7683,12911670,12911670,13010763,0,0,0,99093
7771,13013239,13013239,13013638,0,0,0,399
7675,12908182,12908182,13016290,0,0,0,108108
7772,13016840,13016840,13017048,0,0,0,208
7676,12908182,12908182,13017495,0,0,0,109313
7677,12908182,12908182,13019382,0,0,0,111200
7678,12908182,12908182,13020076,0,0,0,111894
7773,13020441,13020441,13020687,0,0,0,246
7682,12911626,12911626,13020916,0,0,0,109290
7679,12908182,12908182,13021147,0,0,0,112965
7774,13024040,13024040,13024244,0,0,0,204
7775,13027640,13027640,13027853,0,0,0,213
7776,13031240,13031240,13031559,0,0,0,319
7777,13034840,13034840,13035057,0,0,0,217
7778,13038440,13038440,13038595,0,0,0,155
7768,13004345,13004345,13041114,0,0,0,36769
7684,12911717,12911717,13041317,0,0,0,129600
7779,13042040,13042040,13042280,0,0,0,240
7780,13045640,13045640,13045884,0,0,0,244
7758,12977611,12977611,13046034,0,0,0,68423
7781,13045920,13045920,13046078,0,0,0,158
7783,13046121,13046121,13046234,0,0,0,113
7785,13049240,13049240,13049395,0,0,0,155
7786,13052840,13052840,13053068,0,0,0,228
7784,13046206,13046206,13053651,0,0,0,7445
7787,13056440,13056440,13056695,0,0,0,255
7788,13060040,13060040,13060257,0,0,0,217
7789,13063640,13063640,13063891,0,0,0,251
7782,13045987,13045987,13066963,0,0,0,20976
7790,13067241,13067241,13067334,0,0,0,93
7791,13070840,13070840,13070960,0,0,0,120
7792,13074440,13074440,13074561,0,0,0,121
7793,13078039,13078039,13078132,0,0,0,93
7614,12822647,12822647,13081847,0,0,0,259200
7795,13081640,13081640,13081857,0,0,0,217
7798,13085240,13085240,13085492,0,0,0,252
7796,13082224,13082224,13086686,0,0,0,4462
7800,13088840,13088840,13089038,0,0,0,198
7801,13092440,13092440,13092641,0,0,0,201
7797,13082299,13082299,13093671,0,0,0,11372
7803,13096041,13096041,13096234,0,0,0,193
7763,12992610,12992610,13098285,0,0,0,105675
7804,13099641,13099641,13099843,0,0,0,202
7799,13088561,13088561,13100866,0,0,0,12305
7806,13103241,13103241,13103437,0,0,0,196
7802,13093632,13093632,13104960,0,0,0,11328
7809,13106840,13106840,13107037,0,0,0,197
7807,13103599,13103599,13107489,0,0,0,3890
7810,13107482,13107482,13109171,0,0,0,1689
7813,13110440,13110440,13110637,0,0,0,197
7812,13109290,13109290,13110834,0,0,0,1544
7811,13107667,13107667,13110838,0,0,0,3171
7815,13110819,13110819,13111134,0,0,0,315
7794,13079851,13079851,13111144,0,0,0,31293
7817,13111198,13111198,13111506,0,0,0,308
7805,13100823,13100823,13113122,0,0,0,12299
7816,13111121,13111121,13113379,0,0,0,2258
7822,13114040,13114040,13114313,0,0,0,273
7820,13113177,13113177,13114531,0,0,0,1354
7818,13111474,13111474,13115366,0,0,0,3892
7814,13110807,13110807,13115867,0,0,0,5060
7808,13104915,13104915,13116282,0,0,0,11367
7824,13115817,13115817,13116949,0,0,0,1132
7823,13114500,13114500,13116970,0,0,0,2470
7821,13113478,13113478,13118348,0,0,0,4870
7819,13113080,13113080,13119287,0,0,0,6207
7828,13117019,13117019,13119413,0,0,0,2394
7831,13119429,13119429,13123373,0,0,0,3944
7825,13115899,13115899,13124994,0,0,0,9095
7833,13125003,13125003,13125366,0,0,0,363
7826,13116239,13116239,13127612,0,0,0,11373
7830,13119331,13119331,13131771,0,0,0,12440
7836,13131746,13131746,13132970,0,0,0,1224
7832,13124732,13124732,13136812,0,0,0,12080
7835,13127535,13127535,13138911,0,0,0,11376
7837,13138832,13138832,13160432,0,0,0,21600
7834,13125396,13125396,13166157,0,0,0,40761
7840,13166197,13166197,13167303,0,0,0,1106
7841,13167026,13167026,13167584,0,0,0,558
7842,13167027,13167027,13167584,0,0,0,557
7843,13167027,13167027,13167584,0,0,0,557
7844,13167027,13167027,13167584,0,0,0,557
7845,13167028,13167028,13167596,0,0,0,568
7847,13167749,13167749,13168246,0,0,0,497
7848,13168221,13168221,13168458,0,0,0,237
7849,13168361,13168361,13168509,0,0,0,148
7858,13168551,13168551,13168609,0,0,0,58
7859,13168551,13168551,13168671,0,0,0,120
7866,13168630,13168630,13168681,0,0,0,51
7867,13168664,13168664,13168841,0,0,0,177
7868,13168867,13168867,13168940,0,0,0,73
7869,13168964,13168964,13169023,0,0,0,59
7870,13168981,13168981,13169074,0,0,0,93
7871,13169117,13169117,13169159,0,0,0,42
7872,13169182,13169182,13169261,0,0,0,79
7827,13116988,13116988,13169343,0,0,0,52355
7873,13169218,13169218,13169349,0,0,0,131
7874,13169393,13169393,13169465,0,0,0,72
7875,13169402,13169402,13169535,0,0,0,133
7876,13169544,13169544,13169586,0,0,0,42
7877,13169555,13169555,13169686,0,0,0,131
7878,13169920,13169920,13169962,0,0,0,42
7879,13169926,13169926,13170046,0,0,0,120
7880,13170139,13170139,13170217,0,0,0,78
7881,13170175,13170175,13170320,0,0,0,145
7882,13170299,13170299,13170340,0,0,0,41
7883,13170307,13170307,13170452,0,0,0,145
7860,13168552,13168552,13170708,0,0,0,2156
7884,13170754,13170754,13170826,0,0,0,72
7885,13170773,13170773,13170908,0,0,0,135
7864,13168553,13168553,13171572,0,0,0,3019
7850,13168413,13168413,13172083,0,0,0,3670
7886,13172084,13172084,13172137,0,0,0,53
7887,13172144,13172144,13172186,0,0,0,42
7888,13172589,13172589,13172643,0,0,0,54
7853,13168485,13168485,13172842,0,0,0,4357
7854,13168498,13168498,13172887,0,0,0,4389
7851,13168460,13168460,13173423,0,0,0,4963
7865,13168559,13168559,13173589,0,0,0,5030
7852,13168479,13168479,13173840,0,0,0,5361
7829,13118357,13118357,13174037,0,0,0,55680
7838,13159116,13159116,13175126,0,0,0,16010
7846,13167256,13167256,13175166,0,0,0,7910
7861,13168552,13168552,13175915,0,0,0,7363
7891,13175866,13175866,13175959,0,0,0,93
7862,13168552,13168552,13176117,0,0,0,7565
7855,13168519,13168519,13176438,0,0,0,7919
7839,13165918,13165918,13176562,0,0,0,10644
7857,13168535,13168535,13176922,0,0,0,8387
7856,13168524,13168524,13179001,0,0,0,10477
7893,13176401,13176401,13179645,0,0,0,3244
7892,13175979,13175979,13180807,0,0,0,4828
7896,13181393,13181393,13181495,0,0,0,102
7889,13173584,13173584,13181801,0,0,0,8217
7901,13181729,13181729,13182364,0,0,0,635
7897,13181450,13181450,13182508,0,0,0,1058
7900,13181716,13181716,13182565,0,0,0,849
7903,13182620,13182620,13182733,0,0,0,113
7898,13181475,13181475,13182968,0,0,0,1493
7904,13182722,13182722,13183407,0,0,0,685
7905,13185461,13185461,13185565,0,0,0,104
7906,13185519,13185519,13185639,0,0,0,120
7907,13185585,13185585,13185704,0,0,0,119
7908,13185654,13185654,13185747,0,0,0,93
7910,13185697,13185697,13185799,0,0,0,102
7909,13185682,13185682,13185806,0,0,0,124
7914,13186069,13186069,13186149,0,0,0,80
7911,13185899,13185899,13186239,0,0,0,340
7912,13185965,13185965,13186265,0,0,0,300
7913,13186004,13186004,13186446,0,0,0,442
7915,13186254,13186254,13186455,0,0,0,201
7919,13187752,13187752,13187884,0,0,0,132
7917,13186531,13186531,13188211,0,0,0,1680
7895,13176538,13176538,13188264,0,0,0,11726
7920,13188599,13188599,13188719,0,0,0,120
7902,13181771,13181771,13189041,0,0,0,7270
7921,13188954,13188954,13189044,0,0,0,90
7922,13188961,13188961,13189432,0,0,0,471
7924,13190369,13190369,13190489,0,0,0,120
7926,13190955,13190955,13191075,0,0,0,120
7927,13191460,13191460,13191540,0,0,0,80
7918,13186981,13186981,13191600,0,0,0,4619
7925,13190762,13190762,13191724,0,0,0,962
7931,13191909,13191909,13192039,0,0,0,130
7929,13191746,13191746,13192121,0,0,0,375
7932,13191984,13191984,13192124,0,0,0,140
7894,13176441,13176441,13192469,0,0,0,16028
7939,13192520,13192520,13192658,0,0,0,138
7933,13192250,13192250,13193618,0,0,0,1368
7940,13193573,13193573,13193706,0,0,0,133
7942,13193787,13193787,13193920,0,0,0,133
7943,13194002,13194002,13194126,0,0,0,124
7928,13191600,13191600,13194294,0,0,0,2694
7899,13181480,13181480,13194329,0,0,0,12849
7916,13186423,13186423,13194390,0,0,0,7967
7944,13194286,13194286,13194416,0,0,0,130
7945,13194346,13194346,13194493,0,0,0,147
7946,13194697,13194697,13194832,0,0,0,135
7948,13195445,13195445,13195607,0,0,0,162
7947,13195405,13195405,13195816,0,0,0,411
7949,13196451,13196451,13196553,0,0,0,102
7934,13192390,13192390,13199739,0,0,0,7349
7950,13196557,13196557,13201479,0,0,0,4922
7935,13192407,13192407,13203792,0,0,0,11385
7941,13193769,13193769,13206063,0,0,0,12294
7951,13196775,13196775,13208499,0,0,0,11724
7923,13189082,13189082,13209325,0,0,0,20243
7952,13203727,13203727,13209854,0,0,0,6127
7953,13206022,13206022,13218345,0,0,0,12323
7954,13218283,13218283,13230547,0,0,0,12264
7955,13230507,13230507,13232535,0,0,0,2028
7956,13243778,13243778,13243882,0,0,0,104
7957,13245270,13245270,13245411,0,0,0,141
7958,13245466,13245466,13245594,0,0,0,128
7863,13168552,13168552,13245677,0,0,0,77125
7959,13245839,13245839,13245965,0,0,0,126
7960,13246238,13246238,13246341,0,0,0,103
7938,13192493,13192493,13258369,0,0,0,65876
7963,13258444,13258444,13264632,0,0,0,6188
7964,13265887,13265887,13265994,0,0,0,107
7966,13266589,13266589,13267036,0,0,0,447
7937,13192459,13192459,13268921,0,0,0,76462
7965,13265950,13265950,13270138,0,0,0,4188
7967,13273424,13273424,13274106,0,0,0,682
7972,13274876,13274876,13275406,0,0,0,530
7968,13273424,13273424,13276494,0,0,0,3070
7936,13192427,13192427,13279055,0,0,0,86628
7973,13281227,13281227,13281347,0,0,0,120
7974,13282270,13282270,13282379,0,0,0,109
7961,13258384,13258384,13283735,0,0,0,25351
7962,13258409,13258409,13283805,0,0,0,25396
7979,13283958,13283958,13286821,0,0,0,2863
7970,13273425,13273425,13291408,0,0,0,17983
7969,13273424,13273424,13292175,0,0,0,18751
7978,13283937,13283937,13292710,0,0,0,8773
7981,13292770,13292770,13292979,0,0,0,209
7971,13273425,13273425,13296958,0,0,0,23533
7987,13296350,13296350,13302587,0,0,0,6237
7983,13292910,13292910,13303652,0,0,0,10742
7977,13283421,13283421,13310031,0,0,0,26610
7990,13298870,13298870,13310211,0,0,0,11341
7989,13298852,13298852,13311151,0,0,0,12299
7992,13311110,13311110,13311383,0,0,0,273
7988,13296350,13296350,13318385,0,0,0,22035
7890,13175800,13175800,13319750,0,0,0,143950
7991,13310174,13310174,13321468,0,0,0,11294
7993,13321425,13321425,13322204,0,0,0,779
7976,13283205,13283205,13324443,0,0,0,41238
7975,13282523,13282523,13329198,0,0,0,46675
7994,13333947,13333947,13334015,0,0,0,68
7995,13334263,13334263,13334336,0,0,0,73
7997,13334541,13334541,13335368,0,0,0,827
7996,13334505,13334505,13335743,0,0,0,1238
7982,13292817,13292817,13335787,0,0,0,42970
7999,13336637,13336637,13337495,0,0,0,858
8000,13337150,13337150,13337665,0,0,0,515
8001,13337193,13337193,13337745,0,0,0,552
7984,13296349,13296349,13338019,0,0,0,41670
7980,13284028,13284028,13338029,0,0,0,54001
7998,13336610,13336610,13338029,0,0,0,1419
8002,13337868,13337868,13338293,0,0,0,425
7930,13191763,13191763,13338380,0,0,0,146617
8003,13338586,13338586,13338777,0,0,0,191
7985,13296349,13296349,13338968,0,0,0,42619
7986,13296349,13296349,13339836,0,0,0,43487
8009,13349035,13349035,13349186,0,0,0,151
8010,13349421,13349421,13349560,0,0,0,139
8013,13349857,13349857,13350004,0,0,0,147
8008,13342942,13342942,13350302,0,0,0,7360
8014,13350703,13350703,13350850,0,0,0,147
8015,13350765,13350765,13350850,0,0,0,85
8016,13350771,13350771,13350892,0,0,0,121
8017,13350897,13350897,13351018,0,0,0,121
8018,13351047,13351047,13351190,0,0,0,143
8012,13349617,13349617,13351232,0,0,0,1615
8019,13351148,13351148,13351294,0,0,0,146
8020,13351497,13351497,13351602,0,0,0,105
8021,13351822,13351822,13351959,0,0,0,137
8022,13352135,13352135,13352175,0,0,0,40
8026,13352540,13352540,13352675,0,0,0,135
8027,13352759,13352759,13352891,0,0,0,132
8028,13353196,13353196,13353300,0,0,0,104
8029,13353509,13353509,13353637,0,0,0,128
8030,13354059,13354059,13354192,0,0,0,133
8031,13354352,13354352,13354485,0,0,0,133
8032,13354695,13354695,13354826,0,0,0,131
8033,13354885,13354885,13354989,0,0,0,104
8034,13356390,13356390,13356537,0,0,0,147
8035,13357088,13357088,13357234,0,0,0,146
8036,13357402,13357402,13357507,0,0,0,105
8037,13357691,13357691,13357837,0,0,0,146
8038,13358213,13358213,13358349,0,0,0,136
8039,13358494,13358494,13358598,0,0,0,104
8040,13358799,13358799,13358955,0,0,0,156
8041,13359307,13359307,13359453,0,0,0,146
8042,13359637,13359637,13359741,0,0,0,104
8043,13359948,13359948,13360052,0,0,0,104
8044,13360639,13360639,13360776,0,0,0,137
8045,13360971,13360971,13361075,0,0,0,104
8046,13361337,13361337,13361458,0,0,0,121
8047,13361697,13361697,13361827,0,0,0,130
8048,13361912,13361912,13362017,0,0,0,105
8049,13362244,13362244,13362383,0,0,0,139
8050,13362892,13362892,13362997,0,0,0,105
8051,13363010,13363010,13363132,0,0,0,122
8052,13363318,13363318,13363449,0,0,0,131
8053,13363450,13363450,13363584,0,0,0,134
8054,13363531,13363531,13363665,0,0,0,134
8056,13363699,13363699,13363833,0,0,0,134
8055,13363691,13363691,13363837,0,0,0,146
8057,13363772,13363772,13363934,0,0,0,162
8058,13363849,13363849,13363976,0,0,0,127
8059,13364508,13364508,13364599,0,0,0,91
8060,13364587,13364587,13364675,0,0,0,88
8061,13364658,13364658,13364710,0,0,0,52
8062,13364910,13364910,13364983,0,0,0,73
8063,13365501,13365501,13365590,0,0,0,89
8064,13365652,13365652,13365741,0,0,0,89
8065,13366242,13366242,13366318,0,0,0,76
8066,13366388,13366388,13366435,0,0,0,47
8067,13366854,13366854,13366941,0,0,0,87
8068,13366941,13366941,13367031,0,0,0,90
8069,13367115,13367115,13367205,0,0,0,90
8070,13367251,13367251,13367298,0,0,0,47
8071,13367438,13367438,13367520,0,0,0,82
8007,13342376,13342376,13368331,0,0,0,25955
8072,13368527,13368527,13368613,0,0,0,86
8073,13368767,13368767,13368815,0,0,0,48
8074,13368848,13368848,13368937,0,0,0,89
8006,13342216,13342216,13371301,0,0,0,29085
8024,13352317,13352317,13373297,0,0,0,20980
8076,13377162,13377162,13388501,0,0,0,11339
8075,13377140,13377140,13389470,0,0,0,12330
8077,13388460,13388460,13399786,0,0,0,11326
8078,13389390,13389390,13401706,0,0,0,12316
8079,13399753,13399753,13411150,0,0,0,11397
8080,13401628,13401628,13413865,0,0,0,12237
8083,13414556,13414556,13414672,0,0,0,116
8084,13414705,13414705,13414840,0,0,0,135
8085,13414978,13414978,13415110,0,0,0,132
8086,13415225,13415225,13415334,0,0,0,109
8087,13415447,13415447,13415551,0,0,0,104
8088,13415769,13415769,13415915,0,0,0,146
8089,13416058,13416058,13416162,0,0,0,104
8090,13416389,13416389,13416516,0,0,0,127
8091,13417511,13417511,13417622,0,0,0,111
8092,13417639,13417639,13417728,0,0,0,89
8093,13418116,13418116,13418268,0,0,0,152
8094,13418309,13418309,13418444,0,0,0,135
8095,13418852,13418852,13418956,0,0,0,104
8096,13420258,13420258,13420574,0,0,0,316
8098,13420624,13420624,13420930,0,0,0,306
8100,13421719,13421719,13422034,0,0,0,315
8081,13411107,13411107,13422431,0,0,0,11324
8097,13420489,13420489,13424089,0,0,0,3600
8102,13424298,13424298,13424611,0,0,0,313
8105,13424420,13424420,13424653,0,0,0,233
8103,13424419,13424419,13424694,0,0,0,275
8104,13424419,13424419,13424789,0,0,0,370
8106,13424643,13424643,13424918,0,0,0,275
8107,13424860,13424860,13425089,0,0,0,229
8005,13340541,13340541,13425189,0,0,0,84648
8108,13425036,13425036,13425224,0,0,0,188
8109,13425276,13425276,13425488,0,0,0,212
8110,13425512,13425512,13425701,0,0,0,189
8112,13425621,13425621,13425764,0,0,0,143
8111,13425620,13425620,13425816,0,0,0,196
8113,13425621,13425621,13425817,0,0,0,196
8116,13426001,13426001,13426119,0,0,0,118
8115,13425907,13425907,13426167,0,0,0,260
8082,13413832,13413832,13426198,0,0,0,12366
8118,13426108,13426108,13426439,0,0,0,331
8120,13426724,13426724,13427045,0,0,0,321
8011,13349593,13349593,13428286,0,0,0,78693
8121,13428934,13428934,13429282,0,0,0,348
8114,13425699,13425699,13430197,0,0,0,4498
8123,13431710,13431710,13431773,0,0,0,63
8101,13422390,13422390,13433772,0,0,0,11382
8125,13434353,13434353,13434474,0,0,0,121
8128,13434566,13434566,13434948,0,0,0,382
8127,13434562,13434562,13435013,0,0,0,451
8126,13434553,13434553,13435015,0,0,0,462
8137,13435959,13435959,13437642,0,0,0,1683
8131,13435030,13435030,13437643,0,0,0,2613
8135,13435610,13435610,13437646,0,0,0,2036
8138,13435964,13435964,13437647,0,0,0,1683
8132,13435036,13435036,13437649,0,0,0,2613
8136,13435614,13435614,13437650,0,0,0,2036
8134,13435605,13435605,13437652,0,0,0,2047
8139,13435969,13435969,13437652,0,0,0,1683
8130,13435028,13435028,13437653,0,0,0,2625
8119,13426116,13426116,13438420,0,0,0,12304
8150,13439857,13439857,13440006,0,0,0,149
8151,13439952,13439952,13440259,0,0,0,307
8152,13440303,13440303,13440505,0,0,0,202
8153,13440410,13440410,13440547,0,0,0,137
8154,13440454,13440454,13440622,0,0,0,168
8155,13440641,13440641,13440804,0,0,0,163
8156,13440799,13440799,13440967,0,0,0,168
8157,13440919,13440919,13441092,0,0,0,173
8158,13441040,13441040,13441183,0,0,0,143
8159,13441052,13441052,13441242,0,0,0,190
8160,13441116,13441116,13441252,0,0,0,136
8161,13441193,13441193,13441403,0,0,0,210
8162,13441473,13441473,13441619,0,0,0,146
8163,13441769,13441769,13441873,0,0,0,104
8165,13442109,13442109,13442255,0,0,0,146
8164,13442040,13442040,13442289,0,0,0,249
8122,13429411,13429411,13442322,0,0,0,12911
8167,13442482,13442482,13442587,0,0,0,105
8166,13442339,13442339,13442644,0,0,0,305
8168,13442691,13442691,13442795,0,0,0,104
8169,13443090,13443090,13443237,0,0,0,147
8170,13443383,13443383,13443493,0,0,0,110
8171,13443400,13443400,13443592,0,0,0,192
8172,13443622,13443622,13443757,0,0,0,135
8173,13444114,13444114,13444250,0,0,0,136
8124,13433726,13433726,13445130,0,0,0,11404
8174,13444213,13444213,13445411,0,0,0,1198
8180,13445798,13445798,13445821,0,0,0,23
8178,13445725,13445725,13445828,0,0,0,103
8182,13445830,13445830,13445863,0,0,0,33
8179,13445725,13445725,13445865,0,0,0,140
8177,13445331,13445331,13445925,0,0,0,594
8184,13445945,13445945,13445978,0,0,0,33
8181,13445823,13445823,13446032,0,0,0,209
8183,13445926,13445926,13446048,0,0,0,122
8185,13446039,13446039,13446171,0,0,0,132
8186,13446264,13446264,13446396,0,0,0,132
8187,13446528,13446528,13446661,0,0,0,133
8188,13446895,13446895,13446950,0,0,0,55
8189,13447438,13447438,13447606,0,0,0,168
8190,13447667,13447667,13447690,0,0,0,23
8191,13447896,13447896,13447929,0,0,0,33
8192,13448086,13448086,13448236,0,0,0,150
8195,13448373,13448373,13448491,0,0,0,118
8194,13448269,13448269,13448576,0,0,0,307
8196,13448606,13448606,13448732,0,0,0,126
8193,13448178,13448178,13448778,0,0,0,600
8198,13448889,13448889,13449010,0,0,0,121
8199,13448984,13448984,13449119,0,0,0,135
8197,13448700,13448700,13449141,0,0,0,441
8201,13449448,13449448,13449564,0,0,0,116
8200,13449307,13449307,13449644,0,0,0,337
8202,13449546,13449546,13449671,0,0,0,125
8203,13449832,13449832,13450100,0,0,0,268
8204,13450112,13450112,13450136,0,0,0,24
8205,13450290,13450290,13450379,0,0,0,89
8206,13450472,13450472,13450494,0,0,0,22
8207,13450943,13450943,13451190,0,0,0,247
8208,13451580,13451580,13451602,0,0,0,22
8149,13438377,13438377,13451805,0,0,0,13428
8117,13426082,13426082,13453388,0,0,0,27306
8210,13456316,13456316,13456361,0,0,0,45
8176,13445060,13445060,13456386,0,0,0,11326
8209,13451737,13451737,13464054,0,0,0,12317
8099,13420748,13420748,13471389,0,0,0,50641
8211,13462109,13462109,13473473,0,0,0,11364
8212,13463991,13463991,13476305,0,0,0,12314
8023,13352231,13352231,13476715,0,0,0,124484
8213,13476302,13476302,13488614,0,0,0,12312
8129,13434738,13434738,13489516,0,0,0,54778
8214,13482685,13482685,13495163,0,0,0,12478
8215,13488609,13488609,13500932,0,0,0,12323
8025,13352381,13352381,13501929,0,0,0,149548
8218,13504132,13504132,13504274,0,0,0,142
8219,13504261,13504261,13504473,0,0,0,212
8220,13504725,13504725,13504858,0,0,0,133
8221,13504831,13504831,13504939,0,0,0,108
8222,13505003,13505003,13505147,0,0,0,144
8224,13505708,13505708,13505853,0,0,0,145
8225,13505787,13505787,13505893,0,0,0,106
8223,13505536,13505536,13506065,0,0,0,529
8227,13506428,13506428,13506564,0,0,0,136
8228,13506510,13506510,13506596,0,0,0,86
8216,13495417,13495417,13506764,0,0,0,11347
8226,13506198,13506198,13506806,0,0,0,608
8231,13506925,13506925,13507037,0,0,0,112
8232,13507142,13507142,13507306,0,0,0,164
8233,13507304,13507304,13507363,0,0,0,59
8234,13507442,13507442,13507576,0,0,0,134
8230,13506873,13506873,13507580,0,0,0,707
8235,13507528,13507528,13507665,0,0,0,137
8236,13507621,13507621,13507730,0,0,0,109
8237,13507649,13507649,13507799,0,0,0,150
8238,13507822,13507822,13507944,0,0,0,122
8240,13507998,13507998,13508146,0,0,0,148
8239,13507965,13507965,13508192,0,0,0,227
8241,13508068,13508068,13508533,0,0,0,465
8242,13508333,13508333,13508933,0,0,0,600
8243,13508915,13508915,13509036,0,0,0,121
8244,13509168,13509168,13509236,0,0,0,68
8246,13509301,13509301,13509426,0,0,0,125
8245,13509236,13509236,13509461,0,0,0,225
8248,13510391,13510391,13510588,0,0,0,197
8250,13510923,13510923,13510954,0,0,0,31
8251,13510937,13510937,13510963,0,0,0,26
8252,13511032,13511032,13511187,0,0,0,155
8249,13510783,13510783,13511246,0,0,0,463
8253,13511147,13511147,13511255,0,0,0,108
8255,13511219,13511219,13511416,0,0,0,197
8004,13338671,13338671,13511471,0,0,0,172800
8256,13511413,13511413,13511547,0,0,0,134
8257,13511455,13511455,13511624,0,0,0,169
8258,13511791,13511791,13511829,0,0,0,38
8143,13437934,13437934,13512006,0,0,0,74072
8259,13511879,13511879,13512031,0,0,0,152
8261,13512009,13512009,13512151,0,0,0,142
8262,13512123,13512123,13512250,0,0,0,127
8260,13511888,13511888,13512374,0,0,0,486
8264,13512455,13512455,13512581,0,0,0,126
8263,13512285,13512285,13512864,0,0,0,579
8266,13513018,13513018,13513128,0,0,0,110
8217,13500934,13500934,13513245,0,0,0,12311
8267,13513138,13513138,13513342,0,0,0,204
8254,13511147,13511147,13513367,0,0,0,2220
8269,13513338,13513338,13513424,0,0,0,86
8272,13513401,13513401,13513517,0,0,0,116
8270,13513355,13513355,13513586,0,0,0,231
8273,13513517,13513517,13513737,0,0,0,220
8274,13513584,13513584,13513869,0,0,0,285
8276,13513818,13513818,13513900,0,0,0,82
8275,13513757,13513757,13513972,0,0,0,215
8265,13512887,13512887,13514009,0,0,0,1122
8277,13513876,13513876,13514221,0,0,0,345
8133,13435546,13435546,13514866,0,0,0,79320
8279,13514542,13514542,13514906,0,0,0,364
8283,13515876,13515876,13515976,0,0,0,100
8145,13437940,13437940,13516172,0,0,0,78232
8284,13516103,13516103,13516228,0,0,0,125
8285,13516306,13516306,13516432,0,0,0,126
8286,13516545,13516545,13516638,0,0,0,93
8280,13515011,13515011,13516811,0,0,0,1800
8288,13517681,13517681,13517713,0,0,0,32
8229,13506769,13506769,13518093,0,0,0,11324
8291,13518500,13518500,13518752,0,0,0,252
8144,13437937,13437937,13518907,0,0,0,80970
8289,13517799,13517799,13519599,0,0,0,1800
8294,13520396,13520396,13520547,0,0,0,151
8293,13520296,13520296,13520681,0,0,0,385
8287,13517116,13517116,13521665,0,0,0,4549
8295,13522417,13522417,13522535,0,0,0,118
8296,13522479,13522479,13522565,0,0,0,86
8297,13522630,13522630,13522776,0,0,0,146
8298,13522725,13522725,13522813,0,0,0,88
8299,13522992,13522992,13523106,0,0,0,114
8140,13437886,13437886,13524597,0,0,0,86711
8142,13437930,13437930,13524611,0,0,0,86681
8141,13437927,13437927,13524619,0,0,0,86692
8147,13437952,13437952,13525118,0,0,0,87166
8148,13437955,13437955,13525121,0,0,0,87166
8146,13437945,13437945,13525122,0,0,0,87177
8268,13513267,13513267,13525571,0,0,0,12304
8302,13525546,13525546,13525641,0,0,0,95
8303,13526138,13526138,13526412,0,0,0,274
8304,13526294,13526294,13526417,0,0,0,123
8305,13526450,13526450,13526816,0,0,0,366
8306,13526998,13526998,13527115,0,0,0,117
8308,13527187,13527187,13527301,0,0,0,114
8307,13527054,13527054,13527310,0,0,0,256
8309,13527337,13527337,13527442,0,0,0,105
8300,13525335,13525335,13527701,0,0,0,2366
8310,13527635,13527635,13527724,0,0,0,89
8311,13527717,13527717,13527837,0,0,0,120
8312,13527837,13527837,13528089,0,0,0,252
8313,13528061,13528061,13528722,0,0,0,661
8315,13529234,13529234,13529255,0,0,0,21
8290,13518091,13518091,13529523,0,0,0,11432
8318,13532066,13532066,13532250,0,0,0,184
8319,13532491,13532491,13532705,0,0,0,214
8320,13532776,13532776,13532984,0,0,0,208
8322,13533376,13533376,13533571,0,0,0,195
8323,13534009,13534009,13534187,0,0,0,178
8324,13534070,13534070,13534255,0,0,0,185
8325,13534352,13534352,13534550,0,0,0,198
8314,13528662,13528662,13534662,0,0,0,6000
8326,13534553,13534553,13534871,0,0,0,318
8327,13534854,13534854,13534989,0,0,0,135
8328,13534943,13534943,13535098,0,0,0,155
8330,13535239,13535239,13535361,0,0,0,122
8329,13535232,13535232,13535367,0,0,0,135
8331,13535337,13535337,13535493,0,0,0,156
8332,13536221,13536221,13536336,0,0,0,115
8301,13525513,13525513,13537837,0,0,0,12324
8335,13538238,13538238,13538335,0,0,0,97
8333,13536721,13536721,13539230,0,0,0,2509
8338,13539884,13539884,13542089,0,0,0,2205
8336,13538313,13538313,13549692,0,0,0,11379
8334,13537837,13537837,13550112,0,0,0,12275
8340,13554482,13554482,13554505,0,0,0,23
8341,13556071,13556071,13556094,0,0,0,23
8342,13556192,13556192,13556260,0,0,0,68
8339,13550248,13550248,13562500,0,0,0,12252
8281,13515640,13515640,13571662,0,0,0,56022
8317,13531888,13531888,13571859,0,0,0,39971
8282,13515685,13515685,13572033,0,0,0,56348
8344,13562612,13562612,13574865,0,0,0,12253
8321,13532890,13532890,13576090,0,0,0,43200
8345,13575046,13575046,13596646,0,0,0,21600
8247,13510257,13510257,13596657,0,0,0,86400
8271,13513364,13513364,13599764,0,0,0,86400
8175,13444842,13444842,13617642,0,0,0,172800
8278,13514271,13514271,13687071,0,0,0,172800
8292,13518758,13518758,13691558,0,0,0,172800
8316,13529985,13529985,13702785,0,0,0,172800
8343,13556385,13556385,13729185,0,0,0,172800
8346,13767694,13767694,13767870,0,0,0,176
8347,13767816,13767816,13767948,0,0,0,132
8348,13767869,13767869,13768001,0,0,0,132
8349,13768229,13768229,13768361,0,0,0,132
8350,13768359,13768359,13768535,0,0,0,176
8351,13768485,13768485,13768650,0,0,0,165
8352,13768641,13768641,13768811,0,0,0,170
8353,13768729,13768729,13768906,0,0,0,177
8354,13769516,13769516,13769662,0,0,0,146
8355,13769973,13769973,13770099,0,0,0,126
8356,13770411,13770411,13770515,0,0,0,104
8357,13770737,13770737,13770841,0,0,0,104
8358,13771119,13771119,13771307,0,0,0,188
8359,13771219,13771219,13771401,0,0,0,182
8360,13771351,13771351,13771498,0,0,0,147
8361,13771729,13771729,13771824,0,0,0,95
8362,13771797,13771797,13771934,0,0,0,137
8363,13771860,13771860,13771982,0,0,0,122
8365,13771993,13771993,13772393,0,0,0,400
8364,13771890,13771890,13772443,0,0,0,553
8366,13772609,13772609,13773246,0,0,0,637
8368,13773186,13773186,13773277,0,0,0,91
8369,13773539,13773539,13773654,0,0,0,115
8370,13773760,13773760,13773905,0,0,0,145
8372,13774530,13774530,13774654,0,0,0,124
8371,13774388,13774388,13774658,0,0,0,270
8367,13772966,13772966,13774766,0,0,0,1800
8373,13774643,13774643,13774790,0,0,0,147
8374,13774740,13774740,13774869,0,0,0,129
8376,13778155,13778155,13779859,0,0,0,1704
8377,13779806,13779806,13780145,0,0,0,339
8378,13780088,13780088,13780256,0,0,0,168
8380,13781389,13781389,13781559,0,0,0,170
8379,13781054,13781054,13781695,0,0,0,641
8381,13781661,13781661,13781777,0,0,0,116
8382,13781815,13781815,13782006,0,0,0,191
8383,13781978,13781978,13782094,0,0,0,116
8384,13782068,13782068,13782163,0,0,0,95
8386,13782827,13782827,13782849,0,0,0,22
8385,13782190,13782190,13784074,0,0,0,1884
8389,13784364,13784364,13784536,0,0,0,172
8391,13786186,13786186,13786209,0,0,0,23
8392,13786441,13786441,13786464,0,0,0,23
8394,13788338,13788338,13788361,0,0,0,23
8396,13789506,13789506,13789619,0,0,0,113
8397,13790017,13790017,13790089,0,0,0,72
8402,13790231,13790231,13790254,0,0,0,23
8403,13790271,13790271,13790295,0,0,0,24
8395,13789294,13789294,13790439,0,0,0,1145
8337,13539071,13539071,13790975,0,0,0,251904
8407,13791980,13791980,13792046,0,0,0,66
8408,13792098,13792098,13792219,0,0,0,121
8399,13790135,13790135,13792641,0,0,0,2506
8400,13790157,13790157,13792641,0,0,0,2484
8401,13790190,13790190,13792648,0,0,0,2458
8398,13790120,13790120,13792649,0,0,0,2529
8409,13793017,13793017,13793163,0,0,0,146
8393,13787973,13787973,13795173,0,0,0,7200
8388,13784081,13784081,13795449,0,0,0,11368
8413,13795828,13795828,13795940,0,0,0,112
8414,13795923,13795923,13796076,0,0,0,153
8387,13784054,13784054,13796381,0,0,0,12327
8416,13796598,13796598,13796717,0,0,0,119
8418,13796716,13796716,13796790,0,0,0,74
8419,13796743,13796743,13796801,0,0,0,58
8422,13796884,13796884,13796986,0,0,0,102
8421,13796861,13796861,13796994,0,0,0,133
8423,13796909,13796909,13796995,0,0,0,86
8420,13796854,13796854,13797003,0,0,0,149
8410,13793861,13793861,13797461,0,0,0,3600
8417,13796641,13796641,13797602,0,0,0,961
8428,13798213,13798213,13798389,0,0,0,176
8429,13798473,13798473,13798650,0,0,0,177
8432,13799727,13799727,13799772,0,0,0,45
8434,13799805,13799805,13801049,0,0,0,1244
8425,13797074,13797074,13801213,0,0,0,4139
8426,13797095,13797095,13801218,0,0,0,4123
8427,13797111,13797111,13801218,0,0,0,4107
8424,13797054,13797054,13801220,0,0,0,4166
8437,13800589,13800589,13801288,0,0,0,699
8440,13801102,13801102,13801879,0,0,0,777
8404,13790305,13790305,13801938,0,0,0,11633
8405,13790336,13790336,13802025,0,0,0,11689
8431,13799690,13799690,13803550,0,0,0,3860
8433,13799750,13799750,13803572,0,0,0,3822
8442,13803620,13803620,13803688,0,0,0,68
8443,13805062,13805062,13805084,0,0,0,22
8445,13806213,13806213,13806247,0,0,0,34
8412,13795411,13795411,13806753,0,0,0,11342
8430,13799466,13799466,13806933,0,0,0,7467
8447,13807943,13807943,13807965,0,0,0,22
8415,13796330,13796330,13808620,0,0,0,12290
8449,13811074,13811074,13811097,0,0,0,23
8450,13811123,13811123,13811994,0,0,0,871
8452,13812160,13812160,13812183,0,0,0,23
8453,13812225,13812225,13812270,0,0,0,45
8446,13806685,13806685,13818016,0,0,0,11331
8448,13808561,13808561,13820841,0,0,0,12280
8451,13811958,13811958,13825668,0,0,0,13710
8454,13818017,13818017,13829436,0,0,0,11419
8455,13820836,13820836,13833129,0,0,0,12293
8456,13829432,13829432,13840841,0,0,0,11409
8459,13843404,13843404,13843548,0,0,0,144
8460,13843720,13843720,13843842,0,0,0,122
8461,13843975,13843975,13844096,0,0,0,121
8462,13844448,13844448,13844581,0,0,0,133
8457,13833139,13833139,13845422,0,0,0,12283
8463,13845383,13845383,13845516,0,0,0,133
8465,13846622,13846622,13846776,0,0,0,154
8466,13847050,13847050,13847184,0,0,0,134
8467,13847558,13847558,13847703,0,0,0,145
8468,13847796,13847796,13847963,0,0,0,167
8470,13851486,13851486,13851531,0,0,0,45
8458,13840778,13840778,13852115,0,0,0,11337
8464,13845417,13845417,13857740,0,0,0,12323
8469,13851476,13851476,13857937,0,0,0,6461
8482,13859278,13859278,13859456,0,0,0,178
8474,13852651,13852651,13859920,0,0,0,7269
8483,13859842,13859842,13859935,0,0,0,93
8484,13860231,13860231,13860353,0,0,0,122
8485,13860512,13860512,13860633,0,0,0,121
8439,13800612,13800612,13860644,0,0,0,60032
8471,13852046,13852046,13863400,0,0,0,11354
8438,13800600,13800600,13863838,0,0,0,63238
8476,13858301,13858301,13864942,0,0,0,6641
8478,13858423,13858423,13865012,0,0,0,6589
8477,13858367,13858367,13865023,0,0,0,6656
8481,13858570,13858570,13865059,0,0,0,6489
8480,13858524,13858524,13865123,0,0,0,6599
8479,13858472,13858472,13865137,0,0,0,6665
8489,13866333,13866333,13866366,0,0,0,33
8488,13866313,13866313,13866412,0,0,0,99
8487,13866294,13866294,13866437,0,0,0,143
8490,13866425,13866425,13866480,0,0,0,55
8492,13866537,13866537,13866560,0,0,0,23
8495,13867793,13867793,13867971,0,0,0,178
8496,13867928,13867928,13868287,0,0,0,359
8497,13868351,13868351,13868764,0,0,0,413
8498,13869050,13869050,13869479,0,0,0,429
8475,13857742,13857742,13870096,0,0,0,12354
8500,13870852,13870852,13870986,0,0,0,134
8501,13871006,13871006,13871175,0,0,0,169
8486,13863336,13863336,13874727,0,0,0,11391
8503,13879194,13879194,13879227,0,0,0,33
8505,13880007,13880007,13880029,0,0,0,22
8504,13879984,13879984,13880106,0,0,0,122
8506,13880368,13880368,13880505,0,0,0,137
8507,13880423,13880423,13880837,0,0,0,414
8508,13880847,13880847,13880970,0,0,0,123
8512,13881464,13881464,13881541,0,0,0,77
8511,13881445,13881445,13881623,0,0,0,178
8513,13881643,13881643,13881979,0,0,0,336
8514,13882094,13882094,13882227,0,0,0,133
8499,13870025,13870025,13882317,0,0,0,12292
8517,13884345,13884345,13884649,0,0,0,304
8502,13874663,13874663,13886073,0,0,0,11410
8518,13886383,13886383,13886504,0,0,0,121
8515,13882359,13882359,13887619,0,0,0,5260
8519,13887624,13887624,13887757,0,0,0,133
8520,13888371,13888371,13888505,0,0,0,134
8521,13889624,13889624,13890039,0,0,0,415
8522,13890097,13890097,13890240,0,0,0,143
8436,13799940,13799940,13893401,0,0,0,93461
8435,13799892,13799892,13893689,0,0,0,93797
8516,13883241,13883241,13895527,0,0,0,12286
8444,13805135,13805135,13899980,0,0,0,94845
8523,13894662,13894662,13906011,0,0,0,11349
8390,13785893,13785893,13908568,0,0,0,122675
8525,13906947,13906947,13919232,0,0,0,12285
8491,13866526,13866526,13920359,0,0,0,53833
8527,13909608,13909608,13920961,0,0,0,11353
8528,13919231,13919231,13931501,0,0,0,12270
8472,13852090,13852090,13934662,0,0,0,82572
8473,13852148,13852148,13934723,0,0,0,82575
8530,13936263,13936263,13936296,0,0,0,33
8531,13936379,13936379,13936447,0,0,0,68
8532,13938889,13938889,13938912,0,0,0,23
8509,13881029,13881029,13940089,0,0,0,59060
8510,13881033,13881033,13940140,0,0,0,59107
8535,13940290,13940290,13940323,0,0,0,33
8493,13866980,13866980,13942276,0,0,0,75296
8538,13942345,13942345,13942378,0,0,0,33
8533,13940052,13940052,13942385,0,0,0,2333
8534,13940110,13940110,13942397,0,0,0,2287
8540,13942573,13942573,13942606,0,0,0,33
8539,13942357,13942357,13942614,0,0,0,257
8541,13942697,13942697,13942720,0,0,0,23
8542,13942702,13942702,13942724,0,0,0,22
8543,13943704,13943704,13943737,0,0,0,33
8544,13943707,13943707,13943740,0,0,0,33
8529,13931494,13931494,13943839,0,0,0,12345
8547,13945242,13945242,13945275,0,0,0,33
8545,13945212,13945212,13945311,0,0,0,99
8548,13945445,13945445,13945478,0,0,0,33
8549,13945498,13945498,13945531,0,0,0,33
8536,13941105,13941105,13945547,0,0,0,4442
8552,13945720,13945720,13945742,0,0,0,22
8551,13945718,13945718,13945751,0,0,0,33
8555,13946421,13946421,13946542,0,0,0,121
8556,13946546,13946546,13946668,0,0,0,122
8557,13946653,13946653,13946775,0,0,0,122
8558,13946756,13946756,13946867,0,0,0,111
8559,13946831,13946831,13946968,0,0,0,137
8560,13947021,13947021,13947168,0,0,0,147
8561,13947300,13947300,13947436,0,0,0,136
8375,13774929,13774929,13947729,0,0,0,172800
8562,13948068,13948068,13948203,0,0,0,135
8563,13948400,13948400,13948535,0,0,0,135
8564,13948827,13948827,13948961,0,0,0,134
8565,13948906,13948906,13949052,0,0,0,146
8566,13949434,13949434,13949581,0,0,0,147
8567,13949656,13949656,13949792,0,0,0,136
8568,13949836,13949836,13949972,0,0,0,136
8569,13949962,13949962,13950115,0,0,0,153
8524,13897700,13897700,13954450,0,0,0,56750
8571,13956882,13956882,13956905,0,0,0,23
8546,13945239,13945239,13956913,0,0,0,11674
8572,13956892,13956892,13956925,0,0,0,33
8550,13945579,13945579,13957077,0,0,0,11498
8575,13957355,13957355,13957412,0,0,0,57
8576,13957502,13957502,13957525,0,0,0,23
8577,13957774,13957774,13957807,0,0,0,33
8578,13957798,13957798,13957821,0,0,0,23
8580,13958222,13958222,13958245,0,0,0,23
8581,13958298,13958298,13958320,0,0,0,22
8582,13958377,13958377,13958410,0,0,0,33
8583,13959001,13959001,13959034,0,0,0,33
8584,13959745,13959745,13959778,0,0,0,33
8585,13959806,13959806,13959839,0,0,0,33
8588,13960581,13960581,13960614,0,0,0,33
8589,13960772,13960772,13960928,0,0,0,156
8590,13960908,13960908,13961053,0,0,0,145
8591,13961231,13961231,13961264,0,0,0,33
8592,13961379,13961379,13961524,0,0,0,145
8593,13961380,13961380,13961525,0,0,0,145
8594,13961381,13961381,13961526,0,0,0,145
8595,13961382,13961382,13961527,0,0,0,145
8596,13962237,13962237,13962260,0,0,0,23
8598,13962707,13962707,13962894,0,0,0,187
8599,13963193,13963193,13963216,0,0,0,23
8574,13957115,13957115,13963224,0,0,0,6109
8587,13959976,13959976,13963227,0,0,0,3251
8573,13956910,13956910,13963230,0,0,0,6320
8602,13963299,13963299,13963322,0,0,0,23
8603,13963392,13963392,13963415,0,0,0,23
8606,13966741,13966741,13966918,0,0,0,177
8570,13954672,13954672,13966961,0,0,0,12289
8607,13966945,13966945,13967126,0,0,0,181
8610,13968005,13968005,13968182,0,0,0,177
8611,13968723,13968723,13969365,0,0,0,642
8613,13971008,13971008,13971190,0,0,0,182
8615,13971777,13971777,13971857,0,0,0,80
8614,13971754,13971754,13971861,0,0,0,107
8441,13803499,13803499,13975062,0,0,0,171563
8579,13957990,13957990,13975096,0,0,0,17106
8605,13965773,13965773,13977165,0,0,0,11392
8617,13971914,13971914,13979146,0,0,0,7232
8616,13971897,13971897,13980052,0,0,0,8155
8619,13976074,13976074,13988394,0,0,0,12320
8620,13977093,13977093,13988454,0,0,0,11361
8623,13997946,13997946,13998009,0,0,0,63
8622,13988415,13988415,13999768,0,0,0,11353
8624,13997990,13997990,14000015,0,0,0,2025
8621,13988323,13988323,14000758,0,0,0,12435
8586,13959822,13959822,14010198,0,0,0,50376
8625,14000721,14000721,14013049,0,0,0,12328
8626,14012979,14012979,14025323,0,0,0,12344
8629,14026686,14026686,14027242,0,0,0,556
8612,13969324,13969324,14028246,0,0,0,58922
8608,13967042,13967042,14028880,0,0,0,61838
8630,14028910,14028910,14028972,0,0,0,62
8537,13941178,13941178,14029366,0,0,0,88188
8609,13967072,13967072,14030140,0,0,0,63068
8634,14030839,14030839,14031010,0,0,0,171
8618,13973373,13973373,14031093,0,0,0,57720
8526,13908512,13908512,14031549,0,0,0,123037
8600,13963197,13963197,14031704,0,0,0,68507
8635,14031586,14031586,14031706,0,0,0,120
8601,13963202,13963202,14031742,0,0,0,68540
8604,13963474,13963474,14031746,0,0,0,68272
8636,14031726,14031726,14031844,0,0,0,118
8637,14032416,14032416,14032739,0,0,0,323
8639,14033130,14033130,14033296,0,0,0,166
8640,14033325,14033325,14033587,0,0,0,262
8641,14033571,14033571,14033790,0,0,0,219
8553,13945881,13945881,14035169,0,0,0,89288
8554,13945890,13945890,14035190,0,0,0,89300
8643,14036097,14036097,14036294,0,0,0,197
8644,14036349,14036349,14036568,0,0,0,219
8645,14036574,14036574,14037081,0,0,0,507
8628,14025242,14025242,14037591,0,0,0,12349
8646,14037452,14037452,14037660,0,0,0,208
8647,14038022,14038022,14038219,0,0,0,197
8494,13867427,13867427,14038997,0,0,0,171570
8650,14040000,14040000,14040249,0,0,0,249
8411,13794684,13794684,14040280,0,0,0,245596
8651,14040488,14040488,14040612,0,0,0,124
8654,14040790,14040790,14040913,0,0,0,123
8655,14040923,14040923,14041036,0,0,0,113
8656,14041065,14041065,14041211,0,0,0,146
8657,14041931,14041931,14042077,0,0,0,146
8632,14030397,14030397,14042475,0,0,0,12078
8633,14030421,14030421,14042493,0,0,0,12072
8660,14042674,14042674,14042819,0,0,0,145
8661,14042931,14042931,14043110,0,0,0,179
8663,14042952,14042952,14043264,0,0,0,312
8653,14040684,14040684,14043295,0,0,0,2611
8665,14043635,14043635,14043863,0,0,0,228
8666,14043896,14043896,14044076,0,0,0,180
8667,14045008,14045008,14045252,0,0,0,244
8668,14045534,14045534,14045785,0,0,0,251
8669,14045793,14045793,14045918,0,0,0,125
8670,14045977,14045977,14046577,0,0,0,600
8671,14046553,14046553,14046680,0,0,0,127
8672,14046670,14046670,14046816,0,0,0,146
8631,14028946,14028946,14046901,0,0,0,17955
8673,14046786,14046786,14046904,0,0,0,118
8674,14046868,14046868,14046951,0,0,0,83
8677,14046990,14046990,14047094,0,0,0,104
8676,14046927,14046927,14047108,0,0,0,181
8675,14046906,14046906,14047156,0,0,0,250
8678,14047110,14047110,14047289,0,0,0,179
8681,14047744,14047744,14047866,0,0,0,122
8682,14047871,14047871,14048079,0,0,0,208
8406,13791094,13791094,14050294,0,0,0,259200
8685,14052238,14052238,14052364,0,0,0,126
8686,14052308,14052308,14052443,0,0,0,135
8687,14054323,14054323,14054371,0,0,0,48
8688,14054505,14054505,14054574,0,0,0,69
8691,14054862,14054862,14055122,0,0,0,260
8690,14054780,14054780,14055169,0,0,0,389
8693,14055614,14055614,14056569,0,0,0,955
8694,14055698,14055698,14056598,0,0,0,900
8695,14056727,14056727,14057327,0,0,0,600
8699,14057462,14057462,14057578,0,0,0,116
8697,14057407,14057407,14057601,0,0,0,194
8700,14057595,14057595,14057720,0,0,0,125
8696,14057384,14057384,14057804,0,0,0,420
8698,14057432,14057432,14057852,0,0,0,420
8701,14057876,14057876,14058006,0,0,0,130
8703,14058202,14058202,14058277,0,0,0,75
8702,14058165,14058165,14058282,0,0,0,117
8704,14058215,14058215,14058290,0,0,0,75
8708,14058532,14058532,14059143,0,0,0,611
8705,14058265,14058265,14059165,0,0,0,900
8706,14058280,14058280,14059180,0,0,0,900
8707,14058296,14058296,14059196,0,0,0,900
8709,14059515,14059515,14059608,0,0,0,93
8710,14060098,14060098,14060359,0,0,0,261
8711,14060364,14060364,14060577,0,0,0,213
8712,14060577,14060577,14060775,0,0,0,198
8713,14060825,14060825,14061032,0,0,0,207
8714,14061076,14061076,14061310,0,0,0,234
8715,14061319,14061319,14061577,0,0,0,258
8716,14061736,14061736,14061933,0,0,0,197
8717,14061969,14061969,14062152,0,0,0,183
8718,14062249,14062249,14062461,0,0,0,212
8680,14047464,14047464,14110058,0,0,0,62594
8719,14110338,14110338,14110596,0,0,0,258
8720,14110801,14110801,14111105,0,0,0,304
8724,14112398,14112398,14112630,0,0,0,232
8722,14111917,14111917,14112655,0,0,0,738
8723,14112067,14112067,14112671,0,0,0,604
8725,14113609,14113609,14113732,0,0,0,123
8726,14113937,14113937,14114092,0,0,0,155
8679,14047214,14047214,14114187,0,0,0,66973
8727,14114262,14114262,14114384,0,0,0,122
8728,14114485,14114485,14114602,0,0,0,117
8729,14114525,14114525,14114643,0,0,0,118
8730,14114730,14114730,14114936,0,0,0,206
8731,14114852,14114852,14114974,0,0,0,122
8732,14114963,14114963,14115058,0,0,0,95
8733,14115010,14115010,14115137,0,0,0,127
8734,14115184,14115184,14115450,0,0,0,266
8735,14115518,14115518,14115754,0,0,0,236
8649,14039645,14039645,14115961,0,0,0,76316
8638,14032724,14032724,14116028,0,0,0,83304
8737,14115879,14115879,14116110,0,0,0,231
8736,14115680,14115680,14116330,0,0,0,650
8739,14115923,14115923,14116344,0,0,0,421
8740,14116198,14116198,14116395,0,0,0,197
8742,14116342,14116342,14116470,0,0,0,128
8745,14116478,14116478,14116551,0,0,0,73
8744,14116404,14116404,14116629,0,0,0,225
8746,14116579,14116579,14116860,0,0,0,281
8748,14117271,14117271,14117412,0,0,0,141
8749,14117412,14117412,14117516,0,0,0,104
8750,14117587,14117587,14117718,0,0,0,131
8752,14117805,14117805,14117926,0,0,0,121
8753,14117899,14117899,14117993,0,0,0,94
8757,14118065,14118065,14118485,0,0,0,420
8751,14117755,14117755,14118515,0,0,0,760
8754,14117964,14117964,14118564,0,0,0,600
8755,14117994,14117994,14118594,0,0,0,600
8756,14118006,14118006,14118606,0,0,0,600
8758,14120683,14120683,14120784,0,0,0,101
8759,14120735,14120735,14121935,0,0,0,1200
8642,14035774,14035774,14122263,0,0,0,86489
8684,14050521,14050521,14122987,0,0,0,72466
8652,14040627,14040627,14123064,0,0,0,82437
8683,14050472,14050472,14123195,0,0,0,72723
8766,14123107,14123107,14123438,0,0,0,331
8767,14123661,14123661,14123976,0,0,0,315
8764,14122895,14122895,14124095,0,0,0,1200
8765,14122909,14122909,14124109,0,0,0,1200
8658,14042428,14042428,14125204,0,0,0,82776
8659,14042456,14042456,14125238,0,0,0,82782
8770,14129870,14129870,14130022,0,0,0,152
8771,14130283,14130283,14130435,0,0,0,152
8768,14125168,14125168,14130466,0,0,0,5298
8769,14125199,14125199,14130492,0,0,0,5293
8773,14130441,14130441,14130549,0,0,0,108
8743,14116354,14116354,14130773,0,0,0,14419
8776,14130966,14130966,14131110,0,0,0,144
8777,14131185,14131185,14131332,0,0,0,147
8778,14132124,14132124,14132270,0,0,0,146
8779,14132396,14132396,14132502,0,0,0,106
8780,14132411,14132411,14132528,0,0,0,117
8781,14132428,14132428,14132691,0,0,0,263
8664,14043060,14043060,14134300,0,0,0,91240
8782,14132535,14132535,14134335,0,0,0,1800
8784,14134218,14134218,14134335,0,0,0,117
8783,14132545,14132545,14134345,0,0,0,1800
8786,14134360,14134360,14134490,0,0,0,130
8787,14134616,14134616,14134771,0,0,0,155
8790,14134780,14134780,14134919,0,0,0,139
8791,14134917,14134917,14135063,0,0,0,146
8597,13962316,13962316,14135116,0,0,0,172800
8792,14135119,14135119,14135291,0,0,0,172
8793,14135499,14135499,14135677,0,0,0,178
8794,14135878,14135878,14136012,0,0,0,134
8760,14121831,14121831,14136364,0,0,0,14533
8762,14121943,14121943,14136364,0,0,0,14421
8761,14121876,14121876,14136367,0,0,0,14491
8788,14134716,14134716,14137716,0,0,0,3000
8789,14134742,14134742,14137742,0,0,0,3000
8775,14130737,14130737,14138827,0,0,0,8090
8741,14116330,14116330,14138836,0,0,0,22506
8772,14130432,14130432,14141252,0,0,0,10820
8774,14130453,14130453,14141269,0,0,0,10816
8802,14142155,14142155,14142255,0,0,0,100
8803,14153416,14153416,14153574,0,0,0,158
8738,14115896,14115896,14174261,0,0,0,58365
8807,14173329,14173329,14174529,0,0,0,1200
8808,14173346,14173346,14174546,0,0,0,1200
8805,14173256,14173256,14175056,0,0,0,1800
8806,14173283,14173283,14175083,0,0,0,1800
8809,14175703,14175703,14175931,0,0,0,228
8689,14054533,14054533,14177823,0,0,0,123290
8810,14176663,14176663,14178463,0,0,0,1800
8811,14176693,14176693,14178493,0,0,0,1800
8721,14111326,14111326,14181211,0,0,0,69885
8692,14054913,14054913,14186569,0,0,0,131656
8627,14021675,14021675,14193362,0,0,0,171687
8804,14153862,14153862,14207687,0,0,0,53825
8763,14122221,14122221,14208739,0,0,0,86518
8648,14039069,14039069,14210627,0,0,0,171558
8800,14141208,14141208,14212780,0,0,0,71572
8662,14042950,14042950,14215750,0,0,0,172800
8785,14134224,14134224,14225949,0,0,0,91725
8816,14227823,14227823,14229623,0,0,0,1800
8817,14234966,14234966,14242468,0,0,0,7502
8818,14256104,14256104,14256252,0,0,0,148
8819,14256126,14256126,14256274,0,0,0,148
8797,14136768,14136768,14256814,0,0,0,120046
8798,14136841,14136841,14257394,0,0,0,120553
8799,14136898,14136898,14257468,0,0,0,120570
8796,14136738,14136738,14257935,0,0,0,121197
8795,14136526,14136526,14258398,0,0,0,121872
8747,14116646,14116646,14289446,0,0,0,172800
8814,14208665,14208665,14295326,0,0,0,86661
8812,14177742,14177742,14300623,0,0,0,122881
8801,14141234,14141234,14302619,0,0,0,161385
8824,14302866,14302866,14303001,0,0,0,135
8822,14302809,14302809,14303004,0,0,0,195
8825,14302902,14302902,14303006,0,0,0,104
8823,14302834,14302834,14303011,0,0,0,177
8827,14303066,14303066,14306405,0,0,0,3339
8828,14303070,14303070,14306409,0,0,0,3339
8826,14303061,14303061,14306411,0,0,0,3350
8829,14303073,14303073,14306412,0,0,0,3339
8815,14225914,14225914,14317785,0,0,0,91871
8813,14186530,14186530,14318119,0,0,0,131589
8830,14306416,14306416,14372517,0,0,0,66101
8831,14306443,14306443,14372525,0,0,0,66082
8832,14306475,14306475,14372526,0,0,0,66051
8833,14306508,14306508,14372526,0,0,0,66018
8836,14376949,14376949,14377067,0,0,0,118
8837,14377108,14377108,14377378,0,0,0,270
8838,14377506,14377506,14377782,0,0,0,276
8839,14378812,14378812,14379079,0,0,0,267
8840,14379071,14379071,14379314,0,0,0,243
8844,14379381,14379381,14379476,0,0,0,95
8845,14379405,14379405,14379542,0,0,0,137
8843,14379352,14379352,14379570,0,0,0,218
8820,14295253,14295253,14381842,0,0,0,86589
8854,14383109,14383109,14383337,0,0,0,228
8855,14383447,14383447,14383613,0,0,0,166
8856,14383680,14383680,14383889,0,0,0,209
8858,14383997,14383997,14384206,0,0,0,209
8859,14384502,14384502,14384571,0,0,0,69
8860,14384547,14384547,14384673,0,0,0,126
8861,14384739,14384739,14384942,0,0,0,203
8852,14379861,14379861,14385261,0,0,0,5400
8862,14385069,14385069,14385278,0,0,0,209
8850,14379650,14379650,14386850,0,0,0,7200
8851,14379670,14379670,14386870,0,0,0,7200
8863,14387746,14387746,14387963,0,0,0,217
8864,14389105,14389105,14389198,0,0,0,93
8865,14389286,14389286,14389407,0,0,0,121
8866,14389472,14389472,14389590,0,0,0,118
8867,14389754,14389754,14389870,0,0,0,116
8868,14389876,14389876,14389989,0,0,0,113
8869,14390130,14390130,14390234,0,0,0,104
8846,14379469,14379469,14390269,0,0,0,10800
8847,14379508,14379508,14390308,0,0,0,10800
8848,14379570,14379570,14390370,0,0,0,10800
8849,14379591,14379591,14390391,0,0,0,10800
8870,14390315,14390315,14390438,0,0,0,123
8871,14390448,14390448,14390571,0,0,0,123
8872,14390507,14390507,14390847,0,0,0,340
8873,14390857,14390857,14390940,0,0,0,83
8874,14390945,14390945,14390992,0,0,0,47
8875,14391199,14391199,14391321,0,0,0,122
8876,14391336,14391336,14391642,0,0,0,306
8878,14392100,14392100,14392147,0,0,0,47
8879,14392197,14392197,14392244,0,0,0,47
8877,14391954,14391954,14392253,0,0,0,299
8880,14392291,14392291,14392338,0,0,0,47
8882,14392376,14392376,14392454,0,0,0,78
8883,14393249,14393249,14393512,0,0,0,263
8884,14393493,14393493,14393625,0,0,0,132
8881,14392370,14392370,14394461,0,0,0,2091
8886,14394938,14394938,14394985,0,0,0,47
8887,14395125,14395125,14395197,0,0,0,72
8888,14395192,14395192,14395310,0,0,0,118
8889,14395485,14395485,14395533,0,0,0,48
8841,14379274,14379274,14397274,0,0,0,18000
8842,14379317,14379317,14397317,0,0,0,18000
8893,14398102,14398102,14398422,0,0,0,320
8894,14398358,14398358,14398476,0,0,0,118
8892,14396678,14396678,14398478,0,0,0,1800
8896,14398828,14398828,14398917,0,0,0,89
8895,14398748,14398748,14399004,0,0,0,256
8897,14398929,14398929,14399017,0,0,0,88
8899,14399016,14399016,14399141,0,0,0,125
8898,14398976,14398976,14399172,0,0,0,196
8900,14399123,14399123,14399212,0,0,0,89
8902,14399335,14399335,14399424,0,0,0,89
8901,14399250,14399250,14399623,0,0,0,373
8903,14399547,14399547,14399669,0,0,0,122
8904,14399569,14399569,14399680,0,0,0,111
8906,14399701,14399701,14399918,0,0,0,217
8907,14399961,14399961,14400189,0,0,0,228
8908,14400440,14400440,14400656,0,0,0,216
8885,14394086,14394086,14400794,0,0,0,6708
8909,14401302,14401302,14401510,0,0,0,208
8910,14401745,14401745,14402153,0,0,0,408
8911,14401977,14401977,14402157,0,0,0,180
8912,14402225,14402225,14402342,0,0,0,117
8913,14402388,14402388,14402627,0,0,0,239
8915,14402928,14402928,14403021,0,0,0,93
8916,14403081,14403081,14403209,0,0,0,128
8917,14403291,14403291,14403489,0,0,0,198
8918,14404404,14404404,14404466,0,0,0,62
8857,14383937,14383937,14405223,0,0,0,21286
8922,14405563,14405563,14406003,0,0,0,440
8923,14405978,14405978,14406152,0,0,0,174
8925,14406832,14406832,14408632,0,0,0,1800
8834,14317714,14317714,14409548,0,0,0,91834
8919,14404442,14404442,14418374,0,0,0,13932
8821,14300586,14300586,14422985,0,0,0,122399
8920,14404586,14404586,14425037,0,0,0,20451
8890,14395602,14395602,14447978,0,0,0,52376
8891,14395615,14395615,14448117,0,0,0,52502
8835,14318037,14318037,14448825,0,0,0,130788
8921,14405191,14405191,14452258,0,0,0,47067
8929,14457267,14457267,14457449,0,0,0,182
8930,14458245,14458245,14458561,0,0,0,316
8931,14458810,14458810,14458959,0,0,0,149
8905,14399667,14399667,14459165,0,0,0,59498
8932,14459716,14459716,14460916,0,0,0,1200
8914,14402792,14402792,14461547,0,0,0,58755
8935,14461734,14461734,14461912,0,0,0,178
8937,14461929,14461929,14462046,0,0,0,117
8936,14461849,14461849,14462050,0,0,0,201
8939,14462156,14462156,14462279,0,0,0,123
8940,14462317,14462317,14462494,0,0,0,177
8941,14462515,14462515,14462639,0,0,0,124
8942,14462654,14462654,14462819,0,0,0,165
8938,14462063,14462063,14462846,0,0,0,783
8943,14462815,14462815,14462939,0,0,0,124
8924,14406121,14406121,14463296,0,0,0,57175
8945,14463176,14463176,14463347,0,0,0,171
8946,14463211,14463211,14463349,0,0,0,138
8948,14463413,14463413,14463549,0,0,0,136
8947,14463374,14463374,14463711,0,0,0,337
8950,14463685,14463685,14463764,0,0,0,79
8951,14463703,14463703,14463813,0,0,0,110
8949,14463683,14463683,14463865,0,0,0,182
8954,14463873,14463873,14463997,0,0,0,124
8955,14464043,14464043,14464226,0,0,0,183
8957,14464290,14464290,14464596,0,0,0,306
8958,14464731,14464731,14465023,0,0,0,292
8961,14465238,14465238,14465530,0,0,0,292
8962,14465475,14465475,14465710,0,0,0,235
8963,14465937,14465937,14466537,0,0,0,600
8853,14381800,14381800,14468340,0,0,0,86540
8967,14472410,14472410,14472590,0,0,0,180
8968,14472687,14472687,14472855,0,0,0,168
8969,14472803,14472803,14472939,0,0,0,136
8944,14462896,14462896,14475496,0,0,0,12600
8956,14464096,14464096,14476696,0,0,0,12600
8971,14476475,14476475,14477075,0,0,0,600
8933,14461160,14461160,14477360,0,0,0,16200
8934,14461167,14461167,14477367,0,0,0,16200
8970,14474433,14474433,14480873,0,0,0,6440
8982,14482805,14482805,14483342,0,0,0,537
8964,14466391,14466391,14484391,0,0,0,18000
8974,14477976,14477976,14486976,0,0,0,9000
8984,14484220,14484220,14487735,0,0,0,3515
8975,14478860,14480873,14489873,0,0,2013,11013
8976,14478869,14480873,14489873,0,0,2004,11004
8973,14477942,14477942,14490542,0,0,0,12600
8986,14490666,14490666,14491016,0,0,0,350
8985,14490579,14490579,14491050,0,0,0,471
8980,14482431,14484391,14491591,0,0,1960,9160
8966,14469652,14469652,14493719,0,0,0,24067
8981,14482438,14486976,14494176,0,0,4538,11738
8987,14491006,14491006,14494426,0,0,0,3420
8972,14476981,14476981,14494981,0,0,0,18000
8988,14491047,14491047,14495345,0,0,0,4298
8926,14409511,14409511,14501558,0,0,0,92047
8978,14480372,14480372,14504496,0,0,0,24124
8977,14480338,14480338,14504738,0,0,0,24400
8979,14480527,14480873,14505063,0,0,346,24536
8953,14463753,14463753,14510775,0,0,0,47022
8952,14463741,14463741,14511220,0,0,0,47479
8983,14483300,14483300,14518522,0,0,0,35222
8991,14501277,14501277,14524322,0,0,0,23045
8989,14495383,14495383,14533404,0,0,0,38021
8927,14422941,14422941,14545886,0,0,0,122945
8990,14495441,14495441,14548148,0,0,0,52707
8996,14549060,14549060,14549355,0,0,0,295
8959,14464962,14464962,14551362,0,0,0,86400
8960,14464975,14464975,14551375,0,0,0,86400
8965,14468297,14468297,14554509,0,0,0,86212
9000,14554564,14554564,14554668,0,0,0,104
9001,14554696,14554696,14554873,0,0,0,177
8997,14552356,14552356,14556063,0,0,0,3707
8998,14552419,14552419,14556064,0,0,0,3645
9004,14561847,14561847,14563019,0,0,0,1172
9006,14563332,14563332,14563551,0,0,0,219
9002,14561830,14561830,14563917,0,0,0,2087
9005,14563053,14563053,14563934,0,0,0,881
9007,14563943,14563943,14564703,0,0,0,760
9011,14564620,14564620,14564809,0,0,0,189
9013,14564973,14564973,14565155,0,0,0,182
8993,14543406,14543406,14565747,0,0,0,22341
9015,14565624,14565624,14565808,0,0,0,184
9014,14565353,14565353,14565820,0,0,0,467
9016,14565894,14565894,14566045,0,0,0,151
9017,14565982,14565982,14566171,0,0,0,189
9019,14566055,14566055,14566212,0,0,0,157
9023,14566424,14566424,14566632,0,0,0,208
9025,14566903,14566903,14567023,0,0,0,120
9027,14567146,14567146,14567330,0,0,0,184
9028,14567483,14567483,14567691,0,0,0,208
9026,14567043,14567043,14567873,0,0,0,830
9029,14568036,14568036,14568246,0,0,0,210
9003,14561832,14561832,14568478,0,0,0,6646
9030,14568619,14568619,14568776,0,0,0,157
9021,14566180,14566180,14569780,0,0,0,3600
8928,14448760,14448760,14570284,0,0,0,121524
9033,14569247,14569247,14570302,0,0,0,1055
9032,14569045,14569045,14570358,0,0,0,1313
9035,14570217,14570217,14570373,0,0,0,156
9036,14570293,14570293,14570385,0,0,0,92
9040,14570645,14570645,14570771,0,0,0,126
9041,14570716,14570716,14570811,0,0,0,95
9008,14564200,14564200,14570865,0,0,0,6665
9043,14570914,14570914,14571036,0,0,0,122
9044,14570978,14570978,14571103,0,0,0,125
9045,14571059,14571059,14571185,0,0,0,126
9031,14568724,14568724,14571355,0,0,0,2631
9042,14570837,14570837,14571437,0,0,0,600
9022,14566354,14566354,14571449,0,0,0,5095
9049,14571790,14571790,14571967,0,0,0,177
9050,14571936,14571936,14572109,0,0,0,173
9051,14572172,14572172,14572338,0,0,0,166
9048,14571551,14571551,14573087,0,0,0,1536
9052,14573071,14573071,14573429,0,0,0,358
9053,14573388,14573388,14573588,0,0,0,200
9054,14573468,14573468,14573910,0,0,0,442
9046,14571323,14571323,14574250,0,0,0,2927
9056,14574210,14574210,14574275,0,0,0,65
9055,14574014,14574014,14574411,0,0,0,397
9057,14574386,14574386,14574966,0,0,0,580
9009,14564472,14564472,14582472,0,0,0,18000
9010,14564495,14564495,14582495,0,0,0,18000
9012,14564734,14564734,14586334,0,0,0,21600
9060,14587729,14587729,14587833,0,0,0,104
9061,14587834,14587834,14588032,0,0,0,198
9062,14589885,14589885,14590079,0,0,0,194
9063,14591032,14591032,14591632,0,0,0,600
9020,14566175,14566175,14592495,0,0,0,26320
8992,14501515,14501515,14593132,0,0,0,91617
9039,14570540,14570540,14597619,0,0,0,27079
9037,14570454,14570454,14598638,0,0,0,28184
8994,14544679,14544679,14598840,0,0,0,54161
9066,14594934,14594934,14601067,0,0,0,6133
9018,14566047,14566047,14613161,0,0,0,47114
9064,14591850,14591850,14623163,0,0,0,31313
9067,14615864,14615864,14630488,0,0,0,14624
9072,14630003,14630003,14630509,0,0,0,506
9059,14574962,14574962,14630911,0,0,0,55949
9075,14633260,14633260,14633420,0,0,0,160
9076,14633881,14633881,14634146,0,0,0,265
9078,14634768,14634768,14635072,0,0,0,304
9079,14634966,14634966,14635269,0,0,0,303
9080,14635299,14635299,14635595,0,0,0,296
9073,14630827,14630827,14636571,0,0,0,5744
9047,14571401,14571401,14636572,0,0,0,65171
9024,14566767,14566767,14636575,0,0,0,69808
9058,14574663,14574663,14636578,0,0,0,61915
9077,14634367,14634367,14636579,0,0,0,2212
9088,14637658,14637658,14638068,0,0,0,410
9089,14638422,14638422,14638537,0,0,0,115
9091,14639088,14639088,14639265,0,0,0,177
9093,14639765,14639765,14639926,0,0,0,161
9095,14640545,14640545,14640715,0,0,0,170
9098,14641028,14641028,14641090,0,0,0,62
9097,14641014,14641014,14641896,0,0,0,882
9082,14636220,14636220,14642649,0,0,0,6429
9081,14636127,14636127,14642651,0,0,0,6524
9101,14642759,14642759,14642968,0,0,0,209
9085,14636897,14636897,14643087,0,0,0,6190
9105,14643574,14643574,14643691,0,0,0,117
9110,14645133,14645133,14645319,0,0,0,186
9113,14647121,14647121,14647210,0,0,0,89
9114,14647355,14647355,14647403,0,0,0,48
9115,14647496,14647496,14647543,0,0,0,47
9116,14647572,14647572,14647657,0,0,0,85
9117,14647633,14647633,14647720,0,0,0,87
9118,14647698,14647698,14647778,0,0,0,80
9119,14647789,14647789,14647874,0,0,0,85
9120,14647857,14647857,14647904,0,0,0,47
9121,14648003,14648003,14648093,0,0,0,90
9122,14648112,14648112,14648202,0,0,0,90
9123,14648262,14648262,14648309,0,0,0,47
8999,14554463,14554463,14648926,0,0,0,94463
9125,14648875,14648875,14648952,0,0,0,77
9126,14649067,14649067,14649115,0,0,0,48
9074,14632861,14632861,14649497,0,0,0,16636
9127,14650756,14650756,14650862,0,0,0,106
9128,14650903,14650903,14651021,0,0,0,118
9106,14644492,14644492,14651068,0,0,0,6576
9129,14651019,14651019,14651143,0,0,0,124
9130,14651092,14651092,14651266,0,0,0,174
9086,14636951,14636951,14651371,0,0,0,14420
9131,14651548,14651548,14651690,0,0,0,142
9132,14651636,14651636,14651794,0,0,0,158
9038,14570507,14570507,14652444,0,0,0,81937
9133,14652970,14652970,14653129,0,0,0,159
9134,14653072,14653072,14653225,0,0,0,153
9136,14653483,14653483,14654083,0,0,0,600
9138,14655060,14655060,14655268,0,0,0,208
9137,14654867,14654867,14655373,0,0,0,506
9099,14641872,14641872,14655668,0,0,0,13796
9068,14623201,14623201,14655669,0,0,0,32468
9139,14655973,14655973,14656181,0,0,0,208
9141,14656344,14656344,14656465,0,0,0,121
9140,14656289,14656289,14656889,0,0,0,600
9142,14656516,14656516,14656890,0,0,0,374
9143,14657487,14657487,14658087,0,0,0,600
9145,14658245,14658245,14658658,0,0,0,413
9144,14658186,14658186,14658786,0,0,0,600
9146,14659203,14659203,14659466,0,0,0,263
9147,14659232,14659232,14659513,0,0,0,281
9148,14659506,14659506,14660106,0,0,0,600
9149,14660169,14660169,14660432,0,0,0,263
9150,14660194,14660194,14660794,0,0,0,600
9151,14660919,14660919,14661231,0,0,0,312
9152,14661280,14661280,14661582,0,0,0,302
9153,14661571,14661571,14662171,0,0,0,600
9154,14662292,14662292,14662892,0,0,0,600
9100,14642582,14642582,14665402,0,0,0,22820
9107,14644692,14644692,14665559,0,0,0,20867
9111,14645479,14645479,14665937,0,0,0,20458
9109,14645091,14645091,14665990,0,0,0,20899
9112,14645485,14645485,14666006,0,0,0,20521
9092,14639546,14639546,14666076,0,0,0,26530
9094,14640160,14640160,14666738,0,0,0,26578
9103,14643249,14643249,14667226,0,0,0,23977
9096,14640975,14640975,14667258,0,0,0,26283
9104,14643482,14643482,14667459,0,0,0,23977
9135,14653219,14653219,14667558,0,0,0,14339
9090,14638522,14638522,14668219,0,0,0,29697
8995,14545847,14545847,14670159,0,0,0,124312
9108,14644861,14644861,14674915,0,0,0,30054
9083,14636648,14636648,14679848,0,0,0,43200
9084,14636851,14636851,14680051,0,0,0,43200
9069,14626878,14626878,14685363,0,0,0,58485
9070,14626908,14626908,14685540,0,0,0,58632
9065,14593090,14593090,14685717,0,0,0,92627
9156,14665892,14665892,14686336,0,0,0,20444
9158,14665959,14665959,14686423,0,0,0,20464
9155,14665520,14665520,14686465,0,0,0,20945
9157,14665940,14665940,14686772,0,0,0,20832
9161,14667153,14667153,14690685,0,0,0,23532
9163,14667381,14667381,14690890,0,0,0,23509
9159,14666006,14666006,14692470,0,0,0,26464
9160,14666691,14666691,14693191,0,0,0,26500
9162,14667185,14667185,14693415,0,0,0,26230
9034,14570207,14570207,14694118,0,0,0,123911
9164,14668179,14668179,14697839,0,0,0,29660
9166,14674874,14674874,14704368,0,0,0,29494
9168,14686256,14686256,14706900,0,0,0,20644
9169,14686379,14686379,14707003,0,0,0,20624
9071,14626994,14626994,14707179,0,0,0,80185
9170,14686383,14686383,14707391,0,0,0,21008
9171,14686707,14686707,14707737,0,0,0,21030
9172,14690622,14690622,14714626,0,0,0,24004
9184,14714561,14714561,14714828,0,0,0,267
9173,14690848,14690848,14714859,0,0,0,24011
9187,14714793,14714793,14715036,0,0,0,243
9188,14715056,14715056,14715265,0,0,0,209
9189,14715409,14715409,14715599,0,0,0,190
9190,14715604,14715604,14715759,0,0,0,155
9191,14715869,14715869,14716077,0,0,0,208
9192,14715995,14715995,14716246,0,0,0,251
9193,14716261,14716261,14716583,0,0,0,322
9194,14716712,14716712,14716983,0,0,0,271
9195,14717121,14717121,14717392,0,0,0,271
9196,14718362,14718362,14718516,0,0,0,154
9087,14637230,14637230,14718629,0,0,0,81399
9174,14692433,14692433,14719224,0,0,0,26791
9200,14719505,14719505,14719643,0,0,0,138
9176,14693373,14693373,14719701,0,0,0,26328
9201,14719591,14719643,14719773,0,0,52,182
9175,14693150,14693150,14719859,0,0,0,26709
9178,14697795,14697795,14720138,0,0,0,22343
9204,14721134,14721134,14721570,0,0,0,436
9206,14721592,14721592,14721912,0,0,0,320
9205,14721401,14721401,14721981,0,0,0,580
9208,14721923,14721923,14722187,0,0,0,264
9210,14722176,14722176,14722549,0,0,0,373
9211,14722527,14722527,14722767,0,0,0,240
9209,14722073,14722073,14723073,0,0,0,1000
9207,14721754,14721754,14723174,0,0,0,1420
9212,14722609,14722609,14723209,0,0,0,600
9214,14722955,14722955,14723248,0,0,0,293
9213,14722703,14723174,14723449,0,0,471,746
9216,14723339,14723339,14723606,0,0,0,267
9217,14723489,14723489,14723778,0,0,0,289
9215,14723271,14723271,14723871,0,0,0,600
9220,14723766,14723766,14723894,0,0,0,128
9222,14723972,14723972,14724101,0,0,0,129
9221,14723851,14723851,14724149,0,0,0,298
9218,14723740,14723740,14724164,0,0,0,424
9224,14724177,14724177,14724312,0,0,0,135
9225,14724509,14724509,14724604,0,0,0,95
9223,14724154,14724154,14724615,0,0,0,461
9226,14724516,14724516,14724645,0,0,0,129
9227,14724567,14724567,14724685,0,0,0,118
9228,14724711,14724711,14724981,0,0,0,270
9197,14719118,14719118,14725688,0,0,0,6570
9199,14719223,14719223,14725696,0,0,0,6473
9229,14725139,14725139,14725739,0,0,0,600
9219,14723754,14723754,14726284,0,0,0,2530
9232,14727250,14727250,14727346,0,0,0,96
9234,14727273,14727273,14727400,0,0,0,127
9235,14727275,14727275,14727402,0,0,0,127
9180,14706863,14706863,14727666,0,0,0,20803
9236,14727544,14727544,14727811,0,0,0,267
9237,14727551,14727551,14727834,0,0,0,283
9181,14706960,14706960,14727842,0,0,0,20882
9240,14727966,14727966,14728013,0,0,0,47
9241,14728031,14728031,14728172,0,0,0,141
9182,14707357,14707357,14728615,0,0,0,21258
9183,14707661,14707661,14728982,0,0,0,21321
9245,14728972,14728972,14729252,0,0,0,280
9102,14643071,14643071,14729471,0,0,0,86400
9246,14729529,14729529,14729700,0,0,0,171
9243,14728855,14728855,14729770,0,0,0,915
9248,14729785,14729785,14730085,0,0,0,300
9250,14730378,14730378,14730466,0,0,0,88
9251,14730463,14730463,14730560,0,0,0,97
9249,14730307,14730307,14730607,0,0,0,300
9252,14730505,14730505,14730795,0,0,0,290
9253,14730805,14730805,14730934,0,0,0,129
9254,14730806,14730806,14730935,0,0,0,129
9230,14725922,14725922,14730946,0,0,0,5024
9257,14730986,14730986,14731082,0,0,0,96
9256,14730975,14730975,14731087,0,0,0,112
9255,14730955,14730955,14731131,0,0,0,176
9258,14731248,14731248,14731456,0,0,0,208
9262,14731456,14731456,14731526,0,0,0,70
9259,14731301,14731301,14731551,0,0,0,250
9260,14731347,14731347,14731647,0,0,0,300
9263,14731492,14731492,14731663,0,0,0,171
9261,14731428,14731647,14731783,0,0,219,355
9265,14731786,14731786,14731967,0,0,0,181
9266,14732088,14732088,14732269,0,0,0,181
9264,14731785,14731785,14732345,0,0,0,560
9267,14732254,14732254,14732405,0,0,0,151
9268,14732783,14732783,14732918,0,0,0,135
9269,14732929,14732929,14733108,0,0,0,179
9272,14733172,14733172,14733266,0,0,0,94
9271,14733162,14733162,14733272,0,0,0,110
9270,14733138,14733138,14733313,0,0,0,175
9179,14704321,14704321,14734593,0,0,0,30272
9277,14734513,14734513,14734749,0,0,0,236
9278,14734594,14734594,14734776,0,0,0,182
9276,14734382,14734382,14734900,0,0,0,518
9279,14734825,14734825,14734948,0,0,0,123
9274,14733467,14733467,14735215,0,0,0,1748
9124,14648863,14648863,14735878,0,0,0,87015
9280,14735796,14735796,14735919,0,0,0,123
9275,14733499,14735215,14736279,0,0,1716,2780
9281,14736469,14736469,14736518,0,0,0,49
9282,14736502,14736502,14736549,0,0,0,47
9283,14736544,14736544,14736616,0,0,0,72
9231,14726288,14726288,14737089,0,0,0,10801
9285,14737214,14737214,14737391,0,0,0,177
9286,14737358,14737358,14737450,0,0,0,92
9287,14737512,14737512,14737636,0,0,0,124
9288,14737864,14737864,14737981,0,0,0,117
9289,14738032,14738032,14738151,0,0,0,119
9290,14738327,14738327,14738444,0,0,0,117
9291,14738512,14738512,14738632,0,0,0,120
9186,14714784,14714784,14738921,0,0,0,24137
9292,14738668,14738668,14739122,0,0,0,454
9294,14739049,14739122,14739422,0,0,73,373
9295,14739307,14739307,14739433,0,0,0,126
9296,14739728,14739728,14739821,0,0,0,93
9297,14739933,14739933,14740095,0,0,0,162
9298,14740106,14740106,14740202,0,0,0,96
9299,14740106,14740106,14740255,0,0,0,149
9300,14740289,14740289,14740382,0,0,0,93
9301,14740484,14740484,14740593,0,0,0,109
9302,14740570,14740570,14740744,0,0,0,174
9303,14740785,14740785,14740910,0,0,0,125
9304,14741257,14741257,14741379,0,0,0,122
9305,14741412,14741412,14741526,0,0,0,114
9306,14741447,14741447,14741723,0,0,0,276
9307,14741529,14741529,14741856,0,0,0,327
9308,14741850,14741850,14742201,0,0,0,351
9310,14742057,14742057,14742244,0,0,0,187
9312,14742308,14742308,14742383,0,0,0,75
9313,14742324,14742324,14742456,0,0,0,132
9311,14742201,14742201,14742634,0,0,0,433
9314,14742330,14742330,14742930,0,0,0,600
9315,14742716,14742716,14743024,0,0,0,308
9309,14741873,14741873,14743673,0,0,0,1800
9316,14744319,14744319,14744620,0,0,0,301
9317,14745002,14745002,14745125,0,0,0,123
9318,14745342,14745342,14745601,0,0,0,259
9319,14745810,14745810,14746002,0,0,0,192
9320,14745928,14745928,14746098,0,0,0,170
9321,14746108,14746108,14746230,0,0,0,122
9322,14746336,14746336,14746456,0,0,0,120
9284,14737192,14737192,14747783,0,0,0,10591
9185,14714590,14714590,14757790,0,0,0,43200
9323,14747871,14747871,14758410,0,0,0,10539
9325,14759082,14759082,14759399,0,0,0,317
9198,14719183,14719183,14759721,0,0,0,40538
9203,14719820,14719820,14759731,0,0,0,39911
9202,14719658,14719658,14759732,0,0,0,40074
9238,14727626,14727626,14759740,0,0,0,32114
9239,14727772,14727772,14759740,0,0,0,31968
9244,14728914,14728914,14759757,0,0,0,30843
9242,14728573,14728573,14759765,0,0,0,31192
9293,14738836,14738836,14759765,0,0,0,20929
9326,14759366,14759366,14759771,0,0,0,405
9327,14759782,14759782,14760362,0,0,0,580
9328,14760393,14760393,14760632,0,0,0,239
9247,14729708,14729708,14772908,0,0,0,43200
9273,14733278,14733278,14776478,0,0,0,43200
9167,14685671,14685671,14778148,0,0,0,92477
9329,14778067,14778067,14778193,0,0,0,126
9330,14789115,14789115,14789252,0,0,0,137
9165,14670118,14670118,14792487,0,0,0,122369
9332,14792402,14792402,14792529,0,0,0,127
9333,14811505,14811505,14811754,0,0,0,249
9233,14727268,14727268,14813668,0,0,0,86400
9331,14790114,14790114,14821182,0,0,0,31068
9177,14694078,14694078,14828425,0,0,0,134347
9335,14851408,14851408,14852008,0,0,0,600
9336,14852201,14852201,14852497,0,0,0,296
9334,14845149,14845149,14853175,0,0,0,8026
9324,14749919,14749919,14879519,0,0,0,129600
9338,14889441,14889441,14889555,0,0,0,114
9337,14852433,14852433,14897344,0,0,0,44911
9339,14891147,14891147,14901452,0,0,0,10305
9341,14903824,14903824,14903913,0,0,0,89
9340,14897526,14897526,14939661,0,0,0,42135
9343,14974250,14974250,14974349,0,0,0,99
9344,14975256,14975256,14975473,0,0,0,217
9345,14979704,14979704,14979823,0,0,0,119
9346,14980780,14980780,14980902,0,0,0,122
9347,14980944,14980944,14981198,0,0,0,254
9349,14981237,14981237,14981362,0,0,0,125
9351,14981303,14981303,14981448,0,0,0,145
9353,14981416,14981416,14981551,0,0,0,135
9352,14981392,14981392,14981603,0,0,0,211
9354,14982104,14982104,14982239,0,0,0,135
9350,14981280,14981280,14982329,0,0,0,1049
9356,14982497,14982497,14982694,0,0,0,197
9348,14981047,14981047,14982847,0,0,0,1800
9358,14983827,14983827,14983913,0,0,0,86
9357,14983794,14983794,14983915,0,0,0,121
9359,14985043,14985043,14985105,0,0,0,62
9360,14985054,14985054,14985118,0,0,0,64
9361,14985238,14985238,14985302,0,0,0,64
9362,14985262,14985262,14985862,0,0,0,600
9363,14985264,14985264,14985864,0,0,0,600
9364,14985265,14985265,14985865,0,0,0,600
9355,14982373,14982373,14986749,0,0,0,4376
9366,14986816,14986816,14986914,0,0,0,98
9365,14986795,14986795,14986915,0,0,0,120
9367,14987205,14987205,14987327,0,0,0,122
9368,14987227,14987227,14987462,0,0,0,235
9369,14987645,14987645,14987884,0,0,0,239
9370,14987897,14987897,14988015,0,0,0,118
9371,14988126,14988126,14988209,0,0,0,83
9372,14988277,14988277,14988521,0,0,0,244
9374,14989563,14989563,14989644,0,0,0,81
9376,14989769,14989769,14989957,0,0,0,188
9378,14990413,14990413,14990588,0,0,0,175
9379,14990492,14990492,14990661,0,0,0,169
9377,14989848,14989848,14993448,0,0,0,3600
9381,14993823,14993823,14994122,0,0,0,299
9382,14994111,14994111,14994421,0,0,0,310
9383,14994738,14994738,14994833,0,0,0,95
9380,14991029,14991029,14994851,0,0,0,3822
9384,14994776,14994776,14994896,0,0,0,120
9386,14995125,14995125,14995256,0,0,0,131
9387,14995581,14995581,14995705,0,0,0,124
9388,14995843,14995843,14995967,0,0,0,124
9389,14996003,14996003,14996153,0,0,0,150
9342,14972601,14972601,14996235,0,0,0,23634
9390,14996196,14996196,14996345,0,0,0,149
9391,14996295,14996295,14996422,0,0,0,127
9392,14996309,14996345,14996439,0,0,36,130
9393,14996412,14996422,14996600,0,0,10,188
9394,14996677,14996677,14996799,0,0,0,122
9396,14996861,14996861,14996955,0,0,0,94
9395,14996832,14996832,14997017,0,0,0,185
9397,14996973,14996973,14997093,0,0,0,120
9399,14997114,14997114,14997248,0,0,0,134
9373,14989487,14989487,14997349,0,0,0,7862
9400,14997211,14997211,14997349,0,0,0,138
9401,14997334,14997334,14997442,0,0,0,108
9398,14997102,14997102,14997482,0,0,0,380
9402,14997493,14997493,14997622,0,0,0,129
9403,14997514,14997514,14997651,0,0,0,137
9405,14997946,14997946,14998125,0,0,0,179
9406,14998044,14998044,14998172,0,0,0,128
9404,14997901,14997901,14998177,0,0,0,276
9407,14998284,14998284,14998409,0,0,0,125
9385,14994914,14994914,14998659,0,0,0,3745
9408,14998477,14998477,14999077,0,0,0,600
9410,14999147,14999147,14999627,0,0,0,480
9411,15000728,15000728,15000918,0,0,0,190
9412,15002018,15002018,15002099,0,0,0,81
9409,14998659,14998659,15002294,0,0,0,3635
9414,15002239,15002239,15002328,0,0,0,89
9413,15002104,15002104,15002534,0,0,0,430
9417,15002492,15002492,15002568,0,0,0,76
9416,15002464,15002464,15002797,0,0,0,333
9418,15002822,15002822,15002968,0,0,0,146
9419,15002983,15002983,15003072,0,0,0,89
9420,15003079,15003079,15003168,0,0,0,89
9421,15003173,15003173,15003262,0,0,0,89
9422,15003315,15003315,15003363,0,0,0,48
9423,15003381,15003381,15003468,0,0,0,87
9424,15003460,15003460,15003548,0,0,0,88
9427,15003702,15003702,15003749,0,0,0,47
9426,15003694,15003694,15003879,0,0,0,185
9429,15003847,15003847,15003939,0,0,0,92
9428,15003844,15003844,15003949,0,0,0,105
9430,15003894,15003894,15004046,0,0,0,152
9432,15004036,15004036,15004141,0,0,0,105
9431,15003972,15003972,15004152,0,0,0,180
9433,15004089,15004089,15004221,0,0,0,132
9434,15004188,15004188,15004311,0,0,0,123
9435,15004226,15004226,15004317,0,0,0,91
9438,15004332,15004332,15004404,0,0,0,72
9436,15004311,15004311,15004432,0,0,0,121
9439,15004333,15004333,15004458,0,0,0,125
9440,15004426,15004426,15004605,0,0,0,179
9441,15004503,15004503,15004648,0,0,0,145
9444,15004618,15004618,15004685,0,0,0,67
9437,15004325,15004325,15004692,0,0,0,367
9443,15004613,15004613,15004740,0,0,0,127
9442,15004601,15004601,15004741,0,0,0,140
9447,15004687,15004687,15004748,0,0,0,61
9445,15004657,15004657,15004779,0,0,0,122
9446,15004678,15004678,15004791,0,0,0,113
9448,15004691,15004691,15004794,0,0,0,103
9450,15004798,15004798,15004890,0,0,0,92
9449,15004753,15004753,15004917,0,0,0,164
9452,15004929,15004929,15005044,0,0,0,115
9453,15004933,15004933,15005061,0,0,0,128
9455,15004991,15004991,15005071,0,0,0,80
9454,15004980,15004980,15005083,0,0,0,103
9457,15005084,15005084,15005132,0,0,0,48
9456,15005038,15005038,15005245,0,0,0,207
9458,15005199,15005199,15005259,0,0,0,60
9460,15005311,15005311,15005358,0,0,0,47
9459,15005253,15005253,15005419,0,0,0,166
9462,15005459,15005459,15005574,0,0,0,115
9461,15005414,15005414,15005579,0,0,0,165
9463,15005462,15005462,15005600,0,0,0,138
9464,15005517,15005517,15005639,0,0,0,122
9465,15005575,15005575,15005642,0,0,0,67
9466,15005709,15005709,15005831,0,0,0,122
9415,15002347,15002347,15005991,0,0,0,3644
9468,15006018,15006018,15006152,0,0,0,134
9469,15006035,15006035,15006229,0,0,0,194
9467,15006009,15006009,15006261,0,0,0,252
9470,15006313,15006313,15006589,0,0,0,276
9471,15006529,15006529,15006633,0,0,0,104
9472,15006680,15006680,15006770,0,0,0,90
9474,15007090,15007090,15007180,0,0,0,90
9473,15006902,15006902,15007218,0,0,0,316
9476,15007326,15007326,15007492,0,0,0,166
9478,15007663,15007663,15007752,0,0,0,89
9477,15007628,15007628,15007816,0,0,0,188
9479,15007768,15007768,15007848,0,0,0,80
9480,15007836,15007836,15008065,0,0,0,229
9483,15008165,15008165,15008300,0,0,0,135
9481,15007941,15007941,15008684,0,0,0,743
9486,15008741,15008741,15008888,0,0,0,147
9485,15008378,15008378,15008978,0,0,0,600
9475,15007298,15007298,15010941,0,0,0,3643
9451,15004851,15004851,15013851,0,0,0,9000
9488,15010975,15010975,15014692,0,0,0,3717
9489,15015128,15015128,15018957,0,0,0,3829
9484,15008372,15008372,15019172,0,0,0,10800
9487,15009563,15009563,15020363,0,0,0,10800
9490,15019082,15019082,15022861,0,0,0,3779
9493,15024126,15024126,15026489,0,0,0,2363
9494,15026457,15026457,15026958,0,0,0,501
9375,14989618,14989618,15032818,0,0,0,43200
9496,15053644,15053644,15057483,0,0,0,3839
9497,15057450,15057450,15057543,0,0,0,93
9498,15057561,15057561,15057670,0,0,0,109
9425,15003609,15003609,15057912,0,0,0,54303
9500,15057843,15057843,15057939,0,0,0,96
9502,15057854,15057854,15057957,0,0,0,103
9501,15057846,15057846,15057984,0,0,0,138
9504,15058111,15058111,15058241,0,0,0,130
9503,15058103,15058103,15058242,0,0,0,139
9505,15058161,15058161,15058260,0,0,0,99
9506,15058491,15058491,15058598,0,0,0,107
9507,15058660,15058660,15058765,0,0,0,105
9509,15058776,15058776,15058898,0,0,0,122
9508,15058671,15058671,15059146,0,0,0,475
9510,15059753,15059753,15059879,0,0,0,126
9511,15060185,15060185,15060280,0,0,0,95
9499,15057670,15057670,15061359,0,0,0,3689
9482,15008009,15008009,15062009,0,0,0,54000
9515,15063636,15063636,15064205,0,0,0,569
9514,15063165,15063165,15064682,0,0,0,1517
9512,15060294,15060294,15065570,0,0,0,5276
9513,15062934,15062934,15066545,0,0,0,3611
9516,15066433,15066433,15066600,0,0,0,167
9518,15066616,15066616,15066764,0,0,0,148
9519,15066782,15066782,15066899,0,0,0,117
9520,15066832,15066832,15067000,0,0,0,168
9521,15067071,15067071,15067225,0,0,0,154
9522,15067210,15067210,15067305,0,0,0,95
9525,15067497,15067497,15067629,0,0,0,132
9526,15067590,15067590,15067683,0,0,0,93
9527,15067777,15067777,15067894,0,0,0,117
9528,15067897,15067897,15067990,0,0,0,93
9529,15067998,15067998,15068135,0,0,0,137
9531,15068682,15068682,15068803,0,0,0,121
9532,15068713,15068713,15068836,0,0,0,123
9491,15019250,15019250,15069670,0,0,0,50420
9533,15069605,15069605,15070019,0,0,0,414
9523,15067383,15067383,15070083,0,0,0,2700
9524,15067400,15067400,15070100,0,0,0,2700
9535,15069884,15069884,15070254,0,0,0,370
9517,15066612,15066612,15070291,0,0,0,3679
9534,15069823,15069823,15070736,0,0,0,913
9541,15072067,15072067,15072182,0,0,0,115
9537,15070547,15070547,15072323,0,0,0,1776
9543,15072473,15072473,15072566,0,0,0,93
9544,15072581,15072581,15072687,0,0,0,106
9545,15072677,15072677,15072787,0,0,0,110
9542,15072366,15072366,15072875,0,0,0,509
9546,15072791,15072791,15072918,0,0,0,127
9547,15073125,15073125,15073272,0,0,0,147
9549,15073365,15073365,15073512,0,0,0,147
9548,15073310,15073310,15073840,0,0,0,530
9536,15070427,15070427,15074257,0,0,0,3830
9551,15074410,15074410,15074525,0,0,0,115
9495,15027008,15027008,15075359,0,0,0,48351
9553,15075577,15075577,15075754,0,0,0,177
9554,15075707,15075707,15075835,0,0,0,128
9556,15076288,15076288,15076410,0,0,0,122
9557,15076304,15076304,15076427,0,0,0,123
9558,15076419,15076419,15076602,0,0,0,183
9559,15076962,15076962,15077178,0,0,0,216
9561,15078075,15078075,15078261,0,0,0,186
9563,15078498,15078498,15078630,0,0,0,132
9562,15078332,15078332,15078709,0,0,0,377
9565,15078754,15078754,15078931,0,0,0,177
9564,15078631,15078631,15079204,0,0,0,573
9566,15078955,15078955,15079305,0,0,0,350
9567,15079164,15079164,15079343,0,0,0,179
9568,15079287,15079287,15079576,0,0,0,289
9570,15079460,15079460,15079788,0,0,0,328
9569,15079450,15079450,15079800,0,0,0,350
9571,15079709,15079709,15079843,0,0,0,134
9572,15079952,15079952,15080306,0,0,0,354
9560,15077122,15077122,15081004,0,0,0,3882
9577,15080966,15080966,15081121,0,0,0,155
9576,15080951,15080951,15081263,0,0,0,312
9578,15081408,15081408,15081528,0,0,0,120
9580,15081588,15081588,15081708,0,0,0,120
9579,15081436,15081436,15081765,0,0,0,329
9581,15081753,15081753,15081873,0,0,0,120
9582,15081797,15081797,15081874,0,0,0,77
9584,15081957,15081957,15082077,0,0,0,120
9583,15081898,15081898,15082373,0,0,0,475
9585,15081961,15081961,15082375,0,0,0,414
9586,15082357,15082357,15082501,0,0,0,144
9588,15082455,15082455,15082559,0,0,0,104
9587,15082440,15082440,15082806,0,0,0,366
9589,15082811,15082811,15083225,0,0,0,414
9573,15080090,15080090,15085526,0,0,0,5436
9590,15083440,15083440,15087301,0,0,0,3861
9591,15085479,15085479,15088300,0,0,0,2821
9593,15089009,15089009,15089137,0,0,0,128
9594,15089189,15089189,15089307,0,0,0,118
9595,15089307,15089307,15089489,0,0,0,182
9597,15090064,15090064,15090210,0,0,0,146
9598,15090185,15090185,15090467,0,0,0,282
9601,15090458,15090458,15090569,0,0,0,111
9599,15090235,15090235,15090683,0,0,0,448
9604,15090837,15090837,15091056,0,0,0,219
9592,15087378,15087378,15091182,0,0,0,3804
9606,15091008,15091008,15091221,0,0,0,213
9607,15091093,15091093,15091222,0,0,0,129
9608,15091144,15091144,15091232,0,0,0,88
9609,15091297,15091297,15091361,0,0,0,64
9610,15091300,15091300,15091364,0,0,0,64
9613,15091430,15091430,15091491,0,0,0,61
9605,15090998,15090998,15092198,0,0,0,1200
9618,15092136,15092136,15092741,0,0,0,605
9611,15091340,15091340,15095094,0,0,0,3754
9622,15094918,15094918,15095337,0,0,0,419
9629,15096698,15096698,15096876,0,0,0,178
9631,15096880,15096880,15097040,0,0,0,160
9632,15096883,15096883,15097186,0,0,0,303
9633,15097400,15097400,15097779,0,0,0,379
9634,15097889,15097889,15098160,0,0,0,271
9623,15095127,15095127,15099026,0,0,0,3899
9635,15098552,15098552,15099174,0,0,0,622
9637,15099385,15099385,15100313,0,0,0,928
9492,15019377,15019377,15102457,0,0,0,83080
9638,15100143,15100143,15102832,0,0,0,2689
9636,15099182,15099182,15103255,0,0,0,4073
9639,15103173,15103173,15106273,0,0,0,3100
9640,15103303,15103303,15107345,0,0,0,4042
9642,15107416,15107416,15108515,0,0,0,1099
9641,15106230,15106230,15109426,0,0,0,3196
9552,15075104,15075104,15110622,0,0,0,35518
9647,15110194,15110194,15111858,0,0,0,1664
9600,15090401,15090401,15112775,0,0,0,22374
9648,15111853,15111853,15115213,0,0,0,3360
9626,15095996,15095996,15116992,0,0,0,20996
9628,15096464,15096464,15117076,0,0,0,20612
9627,15096213,15096213,15117221,0,0,0,21008
9630,15096700,15096700,15117352,0,0,0,20652
9617,15092105,15092105,15118950,0,0,0,26845
9619,15092323,15092323,15119145,0,0,0,26822
9620,15093089,15093089,15119285,0,0,0,26196
9624,15095570,15095570,15119453,0,0,0,23883
9625,15095837,15095837,15119677,0,0,0,23840
9621,15094396,15094396,15120768,0,0,0,26372
9616,15091647,15091647,15121576,0,0,0,29929
9651,15117030,15117030,15137595,0,0,0,20565
9653,15117289,15117289,15137821,0,0,0,20532
9650,15116950,15116950,15137899,0,0,0,20949
9652,15117178,15117178,15138136,0,0,0,20958
9574,15080740,15080740,15142001,0,0,0,61261
9658,15119638,15119638,15143661,0,0,0,24023
9657,15119410,15119410,15143692,0,0,0,24282
9649,15115410,15115410,15145372,0,0,0,29962
9667,15145336,15145336,15145513,0,0,0,177
9654,15118908,15118908,15145735,0,0,0,26827
9655,15119106,15119106,15145768,0,0,0,26662
9656,15119242,15119242,15145805,0,0,0,26563
9575,15080794,15080794,15146582,0,0,0,65788
9659,15120721,15120721,15146898,0,0,0,26177
9671,15146855,15146855,15147199,0,0,0,344
9615,15091462,15091462,15148835,0,0,0,57373
9596,15089491,15089491,15149159,0,0,0,59668
9643,15108144,15108144,15149836,0,0,0,41692
9672,15149047,15149047,15149847,0,0,0,800
9675,15149934,15149934,15150062,0,0,0,128
9678,15150007,15150007,15150145,0,0,0,138
9674,15149928,15149928,15150182,0,0,0,254
9676,15149950,15149950,15150217,0,0,0,267
9677,15149966,15149966,15150248,0,0,0,282
9679,15150361,15150361,15150466,0,0,0,105
9660,15121534,15121534,15151352,0,0,0,29818
9682,15152792,15152792,15152938,0,0,0,146
9670,15145766,15145766,15153692,0,0,0,7926
9684,15153956,15153956,15154052,0,0,0,96
9685,15154003,15154003,15154121,0,0,0,118
9686,15154027,15154027,15154176,0,0,0,149
9687,15154126,15154126,15154263,0,0,0,137
9688,15154422,15154422,15154622,0,0,0,200
9683,15153737,15153737,15155055,0,0,0,1318
9691,15155335,15155335,15155714,0,0,0,379
9689,15154632,15154632,15155818,0,0,0,1186
9693,15155730,15155730,15155999,0,0,0,269
9690,15155062,15155062,15156149,0,0,0,1087
9694,15156109,15156109,15156236,0,0,0,127
9695,15156190,15156190,15156305,0,0,0,115
9696,15156523,15156523,15156855,0,0,0,332
9697,15156979,15156979,15157401,0,0,0,422
9539,15071321,15071321,15157793,0,0,0,86472
9661,15137516,15137516,15158219,0,0,0,20703
9662,15137783,15137783,15158553,0,0,0,20770
9663,15137856,15137856,15158984,0,0,0,21128
9664,15138096,15138096,15159249,0,0,0,21153
9704,15159478,15159478,15159624,0,0,0,146
9706,15159916,15159916,15160051,0,0,0,135
9705,15159898,15159898,15160123,0,0,0,225
9644,15109439,15109439,15160153,0,0,0,50714
9645,15109776,15109776,15160164,0,0,0,50388
9646,15109997,15109997,15160175,0,0,0,50178
9707,15160282,15160282,15160498,0,0,0,216
9708,15160690,15160690,15160792,0,0,0,102
9709,15160796,15160796,15160905,0,0,0,109
9710,15160942,15160942,15161020,0,0,0,78
9698,15157734,15157734,15161104,0,0,0,3370
9711,15161874,15161874,15161975,0,0,0,101
9712,15161975,15161975,15162104,0,0,0,129
9713,15161995,15161995,15162128,0,0,0,133
9714,15162381,15162381,15162480,0,0,0,99
9715,15162414,15162414,15162483,0,0,0,69
9716,15162768,15162768,15162879,0,0,0,111
9717,15162883,15162883,15163012,0,0,0,129
9538,15071287,15071287,15163431,0,0,0,92144
9721,15163304,15163304,15163722,0,0,0,418
9555,15076181,15076181,15164020,0,0,0,87839
9720,15163252,15163252,15164323,0,0,0,1071
9723,15163710,15163710,15164364,0,0,0,654
9724,15164612,15164612,15164729,0,0,0,117
9726,15164731,15164731,15165203,0,0,0,472
9725,15164676,15164676,15165234,0,0,0,558
9727,15165167,15165167,15165332,0,0,0,165
9728,15165231,15165231,15165556,0,0,0,325
9729,15165381,15165381,15165880,0,0,0,499
9730,15165834,15165834,15166074,0,0,0,240
9692,15155418,15155418,15166703,0,0,0,11285
9731,15165959,15165959,15166730,0,0,0,771
9732,15166201,15166201,15166849,0,0,0,648
9734,15167000,15167000,15167310,0,0,0,310
9719,15163023,15163023,15167367,0,0,0,4344
9737,15167273,15167273,15167463,0,0,0,190
9665,15143586,15143586,15167540,0,0,0,23954
9738,15167451,15167451,15167591,0,0,0,140
9666,15143649,15143649,15167703,0,0,0,24054
9740,15167547,15167547,15167866,0,0,0,319
9744,15167958,15167958,15168287,0,0,0,329
9746,15168321,15168321,15168614,0,0,0,293
9745,15168257,15168257,15168901,0,0,0,644
9668,15145661,15145661,15172357,0,0,0,26696
9669,15145695,15145695,15172660,0,0,0,26965
9753,15173002,15173002,15173153,0,0,0,151
9754,15173171,15173171,15173269,0,0,0,98
9756,15173200,15173200,15173276,0,0,0,76
9755,15173189,15173189,15173298,0,0,0,109
9757,15173262,15173262,15173387,0,0,0,125
9758,15173281,15173281,15173395,0,0,0,114
9759,15173296,15173296,15173430,0,0,0,134
9760,15173312,15173312,15173435,0,0,0,123
9718,15162922,15162922,15173743,0,0,0,10821
9743,15167647,15167647,15174058,0,0,0,6411
9761,15174000,15174000,15174147,0,0,0,147
9764,15176301,15176301,15176430,0,0,0,129
9736,15167209,15167209,15176618,0,0,0,9409
9735,15167180,15167180,15176681,0,0,0,9501
9700,15158182,15158182,15178881,0,0,0,20699
9701,15158482,15158482,15179119,0,0,0,20637
9772,15179722,15179722,15179881,0,0,0,159
9702,15158911,15158911,15180003,0,0,0,21092
9774,15179913,15179913,15180061,0,0,0,148
9703,15159216,15159216,15180312,0,0,0,21096
9776,15180047,15180047,15180350,0,0,0,303
9780,15180685,15180685,15180935,0,0,0,250
9681,15151310,15151310,15181257,0,0,0,29947
9781,15180886,15180886,15182078,0,0,0,1192
9783,15181894,15181894,15182097,0,0,0,203
9784,15182012,15182012,15182127,0,0,0,115
9785,15182050,15182050,15182151,0,0,0,101
9786,15182100,15182100,15182300,0,0,0,200
9787,15182129,15182129,15182310,0,0,0,181
9788,15183464,15183464,15183565,0,0,0,101
9789,15183511,15183511,15183649,0,0,0,138
9733,15166662,15166662,15191236,0,0,0,24574
9614,15091456,15091456,15191329,0,0,0,99873
9612,15091395,15091395,15191550,0,0,0,100155
9739,15167507,15167507,15191670,0,0,0,24163
9742,15167631,15167631,15191747,0,0,0,24116
9782,15181214,15181214,15192396,0,0,0,11182
9540,15071381,15071381,15195397,0,0,0,124016
9779,15180531,15180531,15195801,0,0,0,15270
9791,15184373,15184373,15195820,0,0,0,11447
9790,15184365,15184365,15195890,0,0,0,11525
9749,15170231,15170231,15196077,0,0,0,25846
9751,15172314,15172314,15199001,0,0,0,26687
9770,15178805,15178805,15199398,0,0,0,20593
9752,15172623,15172623,15199528,0,0,0,26905
9771,15179083,15179083,15199605,0,0,0,20522
9775,15179967,15179967,15200950,0,0,0,20983
9777,15180270,15180270,15201282,0,0,0,21012
9805,15204847,15204847,15205055,0,0,0,208
9807,15207421,15207421,15207550,0,0,0,129
9806,15206167,15206167,15213367,0,0,0,7200
9792,15191627,15191627,15215838,0,0,0,24211
9793,15191672,15191672,15215871,0,0,0,24199
9762,15174322,15174322,15217522,0,0,0,43200
9800,15199361,15199361,15220033,0,0,0,20672
9802,15199562,15199562,15220245,0,0,0,20683
9767,15176663,15176663,15221768,0,0,0,45105
9803,15200908,15200908,15221952,0,0,0,21044
9603,15090714,15090714,15222012,0,0,0,131298
9804,15201235,15201235,15222308,0,0,0,21073
9766,15176607,15176607,15224754,0,0,0,48147
9799,15198958,15198958,15225798,0,0,0,26840
9801,15199488,15199488,15226142,0,0,0,26654
9602,15090568,15090568,15227447,0,0,0,136879
9768,15176955,15176955,15230257,0,0,0,53302
9816,15230876,15230876,15231171,0,0,0,295
9818,15232229,15232229,15232499,0,0,0,270
9819,15232505,15232505,15232771,0,0,0,266
9817,15231489,15231489,15233137,0,0,0,1648
9741,15167615,15167615,15233148,0,0,0,65533
9748,15170226,15170226,15233634,0,0,0,63408
9822,15234336,15234336,15234629,0,0,0,293
9765,15176439,15176439,15235508,0,0,0,59069
9823,15235416,15235416,15235548,0,0,0,132
9824,15235444,15235444,15235731,0,0,0,287
9825,15235618,15235618,15235733,0,0,0,115
9673,15149796,15149796,15236196,0,0,0,86400
9750,15170314,15170314,15236875,0,0,0,66561
9832,15238852,15238852,15239158,0,0,0,306
9808,15215747,15215747,15239433,0,0,0,23686
9809,15215796,15215796,15239555,0,0,0,23759
9778,15180314,15180314,15239640,0,0,0,59326
9837,15239796,15239796,15240219,0,0,0,423
9747,15168891,15168891,15240312,0,0,0,71421
9838,15240257,15240257,15240571,0,0,0,314
9810,15219965,15219965,15240599,0,0,0,20634
9839,15240306,15240306,15240609,0,0,0,303
9811,15220202,15220202,15240921,0,0,0,20719
9843,15240878,15240878,15241160,0,0,0,282
9846,15241262,15241262,15241577,0,0,0,315
9844,15241045,15241045,15242101,0,0,0,1056
9845,15241153,15241153,15242116,0,0,0,963
9847,15241852,15241852,15242206,0,0,0,354
9848,15242440,15242440,15242535,0,0,0,95
9849,15242459,15242459,15242720,0,0,0,261
9812,15221910,15221910,15242988,0,0,0,21078
9813,15222269,15222269,15243280,0,0,0,21011
9850,15242878,15242878,15243382,0,0,0,504
9853,15243354,15243354,15243496,0,0,0,142
9828,15236467,15236467,15243750,0,0,0,7283
9854,15243446,15243446,15243750,0,0,0,304
9827,15236454,15236454,15243760,0,0,0,7306
9826,15236330,15236330,15243782,0,0,0,7452
9829,15236486,15236486,15243812,0,0,0,7326
9830,15236497,15236497,15243812,0,0,0,7315
9831,15236507,15236507,15243979,0,0,0,7472
9855,15243986,15243986,15244318,0,0,0,332
9699,15157750,15157750,15244715,0,0,0,86965
9763,15176275,15176275,15245026,0,0,0,68751
9857,15245166,15245166,15245456,0,0,0,290
9858,15245549,15245549,15245789,0,0,0,240
9859,15245955,15245955,15246214,0,0,0,259
9798,15196075,15196075,15247261,0,0,0,51186
9797,15195856,15195856,15247279,0,0,0,51423
9861,15247817,15247817,15247892,0,0,0,75
9860,15247316,15247316,15248506,0,0,0,1190
9862,15247866,15247866,15248604,0,0,0,738
9863,15247913,15247913,15248621,0,0,0,708
9864,15248031,15248031,15248632,0,0,0,601
9870,15249032,15249032,15249279,0,0,0,247
9871,15249876,15249876,15250123,0,0,0,247
9872,15250249,15250249,15250521,0,0,0,272
9875,15250615,15250615,15250752,0,0,0,137
9877,15250782,15250782,15250862,0,0,0,80
9876,15250641,15250641,15250908,0,0,0,267
9879,15250838,15250838,15251094,0,0,0,256
9880,15250933,15250933,15251173,0,0,0,240
9881,15251847,15251847,15251940,0,0,0,93
9814,15225716,15225716,15252511,0,0,0,26795
9815,15226101,15226101,15252718,0,0,0,26617
9882,15252166,15252166,15252791,0,0,0,625
9887,15253150,15253150,15253254,0,0,0,104
9888,15253434,15253434,15253558,0,0,0,124
9889,15253963,15253963,15254056,0,0,0,93
9891,15254402,15254402,15255086,0,0,0,684
9890,15254318,15254318,15255218,0,0,0,900
9722,15163385,15163385,15255510,0,0,0,92125
9893,15256048,15256048,15256815,0,0,0,767
9873,15250298,15250298,15257719,0,0,0,7421
9894,15257113,15257113,15257881,0,0,0,768
9874,15250409,15250409,15258025,0,0,0,7616
9896,15258042,15258042,15259273,0,0,0,1231
9897,15258852,15258852,15259301,0,0,0,449
9898,15258883,15258883,15259483,0,0,0,600
9899,15260049,15260049,15260200,0,0,0,151
9900,15260221,15260221,15260552,0,0,0,331
9902,15260712,15260712,15261071,0,0,0,359
9903,15260991,15260991,15261301,0,0,0,310
9841,15240562,15240562,15261341,0,0,0,20779
9901,15260246,15260246,15261427,0,0,0,1181
9842,15240842,15240842,15261657,0,0,0,20815
9866,15248471,15248471,15262389,0,0,0,13918
9867,15248562,15248562,15262450,0,0,0,13888
9868,15248578,15248578,15262473,0,0,0,13895
9835,15239398,15239398,15262784,0,0,0,23386
9869,15248591,15248591,15262831,0,0,0,14240
9836,15239519,15239519,15262882,0,0,0,23363
9878,15250793,15250793,15263164,0,0,0,12371
9907,15262350,15262350,15263927,0,0,0,1577
9909,15262442,15262442,15263952,0,0,0,1510
9908,15262413,15262413,15263963,0,0,0,1550
9913,15263017,15263017,15263974,0,0,0,957
9911,15262802,15262802,15263975,0,0,0,1173
9851,15242946,15242946,15264075,0,0,0,21129
9852,15243240,15243240,15264393,0,0,0,21153
9923,15264684,15264684,15265007,0,0,0,323
9926,15265075,15265075,15265252,0,0,0,177
9928,15265638,15265638,15265760,0,0,0,122
9929,15265803,15265803,15265958,0,0,0,155
9931,15266761,15266761,15266913,0,0,0,152
9930,15266757,15266757,15267397,0,0,0,640
9680,15150477,15150477,15271304,0,0,0,120827
9924,15264823,15264823,15272023,0,0,0,7200
9927,15265447,15265447,15276512,0,0,0,11065
9865,15248109,15248109,15278294,0,0,0,30185
9773,15179864,15179864,15278498,0,0,0,98634
9883,15252440,15252440,15279224,0,0,0,26784
9884,15252675,15252675,15279886,0,0,0,27211
9904,15261300,15261300,15282020,0,0,0,20720
9938,15281861,15281861,15282681,0,0,0,820
9905,15261587,15261587,15282893,0,0,0,21306
9895,15257123,15257123,15283512,0,0,0,26389
9921,15264032,15264032,15285206,0,0,0,21174
9922,15264350,15264350,15285539,0,0,0,21189
9910,15262752,15262752,15286563,0,0,0,23811
9912,15262814,15262814,15286603,0,0,0,23789
9934,15276436,15276436,15287602,0,0,0,11166
9941,15283378,15283378,15288924,0,0,0,5546
9925,15264971,15264971,15291513,0,0,0,26542
9948,15291471,15291471,15291644,0,0,0,173
9796,15195786,15195786,15296119,0,0,0,100333
9795,15195757,15195757,15297795,0,0,0,102038
9947,15287570,15287570,15298605,0,0,0,11035
9939,15281979,15281979,15302588,0,0,0,20609
9940,15282856,15282856,15303509,0,0,0,20653
9840,15240541,15240541,15304533,0,0,0,63992
9936,15279189,15279189,15305995,0,0,0,26806
9943,15285164,15285164,15306204,0,0,0,21040
9944,15285496,15285496,15306598,0,0,0,21102
9937,15279844,15279844,15306745,0,0,0,26901
9935,15278227,15278227,15307968,0,0,0,29741
9932,15271418,15304533,15308133,0,0,33115,36715
9942,15283473,15283473,15309886,0,0,0,26413
9945,15286492,15286492,15310275,0,0,0,23783
9946,15286563,15286563,15310328,0,0,0,23765
9933,15271457,15308133,15311733,0,0,36676,40276
9949,15291605,15291605,15318220,0,0,0,26615
9794,15195354,15195354,15319150,0,0,0,123796
9961,15318178,15318178,15319793,0,0,0,1615
9963,15319748,15319748,15321393,0,0,0,1645
9917,15263885,15263885,15322141,0,0,0,58256
9920,15263941,15263941,15322346,0,0,0,58405
9769,15176960,15176960,15322543,0,0,0,145583
9964,15321315,15321315,15322960,0,0,0,1645
9951,15302542,15302542,15322964,0,0,0,20422
9952,15303465,15303465,15323925,0,0,0,20460
9919,15263922,15263922,15324321,0,0,0,60399
9967,15323775,15323775,15324771,0,0,0,996
9973,15326579,15326579,15326776,0,0,0,197
9971,15325249,15325249,15326865,0,0,0,1616
9954,15306162,15306204,15327034,0,0,42,20872
9955,15306556,15306598,15327489,0,0,42,20933
9975,15327315,15327315,15327548,0,0,0,233
9530,15068446,15068446,15327646,0,0,0,259200
9950,15298523,15298523,15328446,0,0,0,29923
9980,15329669,15329669,15329959,0,0,0,290
9918,15263906,15263906,15330379,0,0,0,66473
9856,15244677,15244677,15331274,0,0,0,86597
9916,15263678,15263678,15331329,0,0,0,67651
9970,15325128,15325128,15331971,0,0,0,6843
9969,15325091,15325091,15332393,0,0,0,7302
9982,15332009,15332009,15332423,0,0,0,414
9983,15332248,15332248,15332674,0,0,0,426
9953,15305920,15305995,15332891,0,0,75,26971
9550,15073851,15073851,15333051,0,0,0,259200
9984,15332635,15332635,15333235,0,0,0,600
9959,15310226,15310275,15333664,0,0,49,23438
9972,15326575,15326575,15333759,0,0,0,7184
9960,15310285,15310328,15333782,0,0,43,23497
9956,15306702,15306745,15333812,0,0,43,27110
9990,15335974,15335974,15336311,0,0,0,337
9958,15309843,15309886,15336476,0,0,43,26633
9992,15336418,15336418,15336589,0,0,0,171
9993,15336608,15336608,15336839,0,0,0,231
9994,15336776,15336776,15337924,0,0,0,1148
9957,15307894,15307968,15338208,0,0,74,30314
9978,15329662,15329662,15338357,0,0,0,8695
9979,15329665,15329665,15338371,0,0,0,8706
9995,15337970,15337970,15338727,0,0,0,757
9998,15338886,15338886,15338964,0,0,0,78
9997,15338418,15338418,15339189,0,0,0,771
10000,15339875,15339875,15340073,0,0,0,198
10001,15340149,15340149,15340386,0,0,0,237
10002,15340547,15340547,15340769,0,0,0,222
10003,15341035,15341035,15341523,0,0,0,488
10010,15342571,15342571,15343379,0,0,0,808
9966,15322926,15322926,15343646,0,0,0,20720
9968,15323854,15323854,15344512,0,0,0,20658
10015,15344541,15344541,15344699,0,0,0,158
9821,15233862,15233862,15345087,0,0,0,111225
10016,15345138,15345138,15345285,0,0,0,147
10018,15345789,15345789,15345935,0,0,0,146
10011,15343404,15343404,15346696,0,0,0,3292
10019,15346646,15346646,15346792,0,0,0,146
10021,15346981,15346981,15347169,0,0,0,188
10004,15341724,15341724,15347187,0,0,0,5463
10023,15347412,15347412,15347567,0,0,0,155
10024,15347750,15347750,15347908,0,0,0,158
9974,15326947,15326947,15348002,0,0,0,21055
9892,15255471,15255471,15348037,0,0,0,92566
10027,15348061,15348061,15348197,0,0,0,136
9976,15327373,15327373,15348477,0,0,0,21104
9965,15322885,15322885,15349021,0,0,0,26136
9996,15338056,15338056,15349119,0,0,0,11063
10030,15349258,15349258,15349362,0,0,0,104
10031,15349677,15349677,15349823,0,0,0,146
10032,15349967,15349967,15350114,0,0,0,147
10033,15350201,15350201,15350347,0,0,0,146
10034,15350516,15350516,15350578,0,0,0,62
10035,15350549,15350549,15350778,0,0,0,229
9886,15252854,15252854,15350808,0,0,0,97954
9986,15333579,15333579,15356904,0,0,0,23325
9987,15333667,15333667,15357023,0,0,0,23356
9977,15328413,15328413,15358339,0,0,0,29926
9985,15332774,15332774,15359511,0,0,0,26737
9988,15333726,15333726,15360463,0,0,0,26737
10009,15342523,15342523,15361466,0,0,0,18943
9991,15336349,15336349,15362602,0,0,0,26253
10012,15343583,15343583,15364290,0,0,0,20707
10014,15344473,15344473,15365233,0,0,0,20760
10025,15347933,15347933,15369051,0,0,0,21118
10028,15348404,15348404,15369519,0,0,0,21115
9833,15239383,15239383,15370637,0,0,0,131254
9834,15239392,15239392,15371175,0,0,0,131783
10022,15347151,15347151,15374663,0,0,0,27512
10029,15348988,15348988,15375613,0,0,0,26625
10020,15346758,15346758,15376995,0,0,0,30237
10049,15374630,15374630,15377032,0,0,0,2402
10053,15376994,15376994,15380067,0,0,0,3073
10052,15376962,15376962,15380094,0,0,0,3132
10050,15375535,15375535,15383362,0,0,0,7827
10039,15365705,15365705,15386176,0,0,0,20471
10040,15365759,15365759,15386197,0,0,0,20438
10036,15356030,15356030,15386323,0,0,0,30293
10037,15358258,15358258,15388310,0,0,0,30052
10043,15369005,15369005,15389792,0,0,0,20787
10045,15369476,15369476,15390326,0,0,0,20850
10056,15383325,15383325,15391133,0,0,0,7808
9820,15233842,15233842,15391239,0,0,0,157397
10041,15368300,15368300,15392216,0,0,0,23916
10042,15368325,15368325,15392225,0,0,0,23900
9906,15261878,15261878,15393129,0,0,0,131251
9914,15263169,15263169,15394485,0,0,0,131316
9915,15263459,15263459,15394683,0,0,0,131224
10051,15376809,15376809,15395351,0,0,0,18542
10046,15371221,15371221,15397691,0,0,0,26470
10047,15371693,15371693,15398275,0,0,0,26582
10048,15371703,15371703,15398317,0,0,0,26614
10063,15391061,15391061,15398915,0,0,0,7854
10058,15386135,15386135,15406507,0,0,0,20372
10057,15386106,15386106,15406534,0,0,0,20428
10061,15389749,15389749,15410452,0,0,0,20703
9999,15339166,15339166,15410678,0,0,0,71512
10062,15390255,15390255,15410951,0,0,0,20696
10064,15392144,15392144,15416194,0,0,0,24050
10065,15392182,15392182,15416198,0,0,0,24016
10059,15386279,15386279,15416447,0,0,0,30168
10044,15369286,15369286,15417211,0,0,0,47925
9981,15331234,15331234,15417924,0,0,0,86690
10060,15388272,15388272,15417962,0,0,0,29690
10066,15397650,15397650,15424119,0,0,0,26469
10067,15398214,15398214,15425209,0,0,0,26995
10068,15398279,15398279,15425577,0,0,0,27298
10069,15398878,15398878,15425630,0,0,0,26752
10071,15406465,15406465,15426747,0,0,0,20282
10070,15406454,15406454,15426779,0,0,0,20325
10080,15423344,15423344,15426944,0,0,0,3600
10079,15421351,15421351,15428768,0,0,0,7417
10081,15423370,15426944,15430544,0,0,3574,7174
10072,15410384,15410384,15431065,0,0,0,20681
10073,15410904,15410904,15431520,0,0,0,20616
10088,15429798,15429798,15437253,0,0,0,7455
10075,15416124,15416124,15438370,0,0,0,22246
10074,15416115,15416115,15438372,0,0,0,22257
10026,15347964,15347964,15440261,0,0,0,92297
10005,15342163,15342163,15442257,0,0,0,100094
10008,15342341,15342341,15442546,0,0,0,100205
9962,15319105,15319105,15443270,0,0,0,124165
10007,15342295,15342295,15443392,0,0,0,101097
10006,15342274,15342274,15445239,0,0,0,102965
10076,15416404,15416404,15446359,0,0,0,29955
10078,15417890,15417890,15447107,0,0,0,29217
10097,15447070,15447070,15447239,0,0,0,169
10086,15426695,15426695,15447281,0,0,0,20586
10087,15426704,15426704,15447320,0,0,0,20616
10098,15447195,15447195,15447399,0,0,0,204
10101,15447328,15447328,15447541,0,0,0,213
10082,15424041,15424041,15450309,0,0,0,26268
10103,15450273,15450273,15450478,0,0,0,205
10104,15450402,15450402,15450575,0,0,0,173
10105,15450532,15450532,15450703,0,0,0,171
10089,15430984,15430984,15451949,0,0,0,20965
10085,15425584,15425584,15452022,0,0,0,26438
10083,15425166,15425166,15452298,0,0,0,27132
10090,15431482,15431482,15452455,0,0,0,20973
10084,15425503,15425503,15452633,0,0,0,27130
10093,15438301,15438301,15460379,0,0,0,22078
10092,15438281,15438281,15460424,0,0,0,22143
10100,15447243,15447243,15467726,0,0,0,20483
10099,15447238,15447238,15467763,0,0,0,20525
10107,15451913,15451913,15472811,0,0,0,20898
10013,15344234,15344234,15473086,0,0,0,128852
10110,15452378,15452378,15473211,0,0,0,20833
10096,15446281,15446281,15476146,0,0,0,29865
10106,15450662,15450662,15476973,0,0,0,26311
10119,15476893,15476893,15477091,0,0,0,198
10102,15447464,15447464,15477265,0,0,0,29801
10121,15477231,15477231,15477403,0,0,0,172
10122,15477363,15477363,15477540,0,0,0,177
10123,15477494,15477494,15477666,0,0,0,172
10108,15451983,15451983,15478271,0,0,0,26288
10109,15452255,15452255,15478954,0,0,0,26699
10111,15452560,15452560,15479132,0,0,0,26572
10112,15460336,15460336,15482428,0,0,0,22092
10113,15460377,15460377,15482469,0,0,0,22092
10114,15467680,15467680,15488311,0,0,0,20631
10115,15467688,15467688,15488339,0,0,0,20651
10118,15476110,15476110,15490379,0,0,0,14269
10117,15473173,15473173,15494174,0,0,0,21001
10116,15472768,15472768,15494367,0,0,0,21599
10135,15496589,15496589,15498424,0,0,0,1835
10091,15437631,15437631,15499770,0,0,0,62139
10017,15345553,15345553,15500262,0,0,0,154709
10140,15501049,15501049,15502034,0,0,0,985
10138,15498884,15498884,15502035,0,0,0,3151
9989,15333919,15333919,15502604,0,0,0,168685
10120,15477024,15477024,15503352,0,0,0,26328
10146,15503143,15503143,15503411,0,0,0,268
10147,15503308,15503308,15503510,0,0,0,202
10149,15503450,15503450,15503662,0,0,0,212
10077,15417883,15417883,15504381,0,0,0,86498
10125,15478228,15478228,15504649,0,0,0,26421
10126,15478874,15478874,15505351,0,0,0,26477
10127,15479048,15479048,15505543,0,0,0,26495
10128,15482389,15482389,15505662,0,0,0,23273
10129,15482429,15482429,15505744,0,0,0,23315
10158,15506502,15506502,15507022,0,0,0,520
10157,15506474,15506474,15507062,0,0,0,588
10160,15506538,15506538,15507108,0,0,0,570
10159,15506524,15506524,15507117,0,0,0,593
10124,15477627,15477627,15507460,0,0,0,29833
10161,15507380,15507380,15507600,0,0,0,220
10163,15507554,15507554,15508153,0,0,0,599
10131,15488268,15488268,15508717,0,0,0,20449
10130,15488259,15488259,15508751,0,0,0,20492
10167,15509112,15509112,15509694,0,0,0,582
10054,15380024,15380024,15509746,0,0,0,129722
10168,15509194,15509194,15509785,0,0,0,591
10169,15509259,15509259,15509872,0,0,0,613
10055,15380055,15380055,15510007,0,0,0,129952
10150,15503635,15503635,15510837,0,0,0,7202
10170,15510656,15510656,15510880,0,0,0,224
10171,15511546,15511546,15511764,0,0,0,218
9885,15252798,15252798,15511952,0,0,0,259154
10133,15494132,15494132,15514991,0,0,0,20859
10134,15494327,15494327,15515167,0,0,0,20840
10174,15515294,15515294,15515412,0,0,0,118
10176,15515704,15515704,15515765,0,0,0,61
10175,15515681,15515681,15515902,0,0,0,221
10177,15516657,15516657,15516854,0,0,0,197
10178,15517230,15517230,15517458,0,0,0,228
10179,15517486,15517486,15517683,0,0,0,197
10180,15519012,15519012,15519192,0,0,0,180
10132,15490301,15490301,15519418,0,0,0,29117
10144,15502700,15502700,15522013,0,0,0,19313
10143,15502033,15502033,15524400,0,0,0,22367
10155,15505620,15505620,15528985,0,0,0,23365
10156,15505701,15505701,15529034,0,0,0,23333
10166,15508675,15508675,15529229,0,0,0,20554
10165,15508667,15508667,15529233,0,0,0,20566
10148,15503439,15503439,15529839,0,0,0,26400
10152,15504607,15504607,15530858,0,0,0,26251
10153,15505316,15505316,15532120,0,0,0,26804
10191,15532114,15532114,15532222,0,0,0,108
10154,15505511,15505511,15532260,0,0,0,26749
10094,15440220,15440220,15532578,0,0,0,92358
10196,15532429,15532429,15533020,0,0,0,591
10038,15362081,15362081,15534881,0,0,0,172800
10172,15514948,15514948,15535936,0,0,0,20988
10173,15515125,15515125,15536039,0,0,0,20914
10162,15507518,15507518,15536796,0,0,0,29278
10187,15530813,15530813,15540234,0,0,0,9421
10181,15519382,15519382,15549243,0,0,0,29861
10205,15549199,15549199,15549372,0,0,0,173
10185,15529160,15529160,15549764,0,0,0,20604
10184,15529147,15529147,15549804,0,0,0,20657
10182,15528940,15528940,15551856,0,0,0,22916
10183,15528996,15528996,15551879,0,0,0,22883
10199,15532627,15532627,15552242,0,0,0,19615
10186,15529763,15529763,15556508,0,0,0,26745
10211,15556434,15556434,15556611,0,0,0,177
10201,15535892,15535892,15556999,0,0,0,21107
10202,15535997,15535997,15557032,0,0,0,21035
10189,15532055,15532055,15558762,0,0,0,26707
10193,15532186,15532186,15558928,0,0,0,26742
10203,15536758,15536758,15565906,0,0,0,29148
10095,15443182,15443182,15566343,0,0,0,123161
10204,15540195,15540195,15566821,0,0,0,26626
10188,15531872,15531872,15568547,0,0,0,36675
10207,15549725,15549725,15570352,0,0,0,20627
10208,15549727,15549727,15570374,0,0,0,20647
10164,15507701,15507701,15574387,0,0,0,66686
10209,15551782,15551782,15574847,0,0,0,23065
10210,15551817,15551817,15574881,0,0,0,23064
10213,15556922,15556922,15577942,0,0,0,21020
10214,15556990,15556990,15577952,0,0,0,20962
10206,15549332,15549332,15579229,0,0,0,29897
10136,15498343,15498343,15580334,0,0,0,81991
10212,15556574,15556574,15583102,0,0,0,26528
10227,15583063,15583063,15583231,0,0,0,168
10145,15502958,15502958,15584104,0,0,0,81146
10142,15501985,15501985,15584520,0,0,0,82535
10230,15585025,15585025,15585180,0,0,0,155
10215,15558715,15558715,15585249,0,0,0,26534
10216,15558886,15558886,15585585,0,0,0,26699
10234,15587922,15587922,15588135,0,0,0,213
10235,15588213,15588213,15588429,0,0,0,216
10233,15586257,15586257,15589962,0,0,0,3705
10236,15590095,15590095,15590334,0,0,0,239
10220,15570282,15570282,15590719,0,0,0,20437
10151,15504339,15504339,15590748,0,0,0,86409
10221,15570311,15570311,15590750,0,0,0,20439
10237,15590534,15590534,15590792,0,0,0,258
10241,15592731,15592731,15592824,0,0,0,93
10243,15592855,15592855,15592985,0,0,0,130
10244,15593061,15593061,15593191,0,0,0,130
10219,15566778,15566778,15593299,0,0,0,26521
10245,15593196,15593196,15593558,0,0,0,362
10247,15593450,15593450,15593594,0,0,0,144
10250,15593810,15593810,15593932,0,0,0,122
10251,15593996,15593996,15594131,0,0,0,135
10217,15565823,15565823,15595612,0,0,0,29789
10253,15595617,15595617,15595744,0,0,0,127
10254,15595941,15595941,15596034,0,0,0,93
10257,15597974,15597974,15598130,0,0,0,156
10222,15574776,15574776,15598134,0,0,0,23358
10223,15574809,15574809,15598178,0,0,0,23369
10139,15500762,15500762,15598472,0,0,0,97710
10224,15577873,15577873,15598709,0,0,0,20836
10225,15577909,15577909,15598742,0,0,0,20833
10249,15593519,15593519,15598848,0,0,0,5329
10252,15595579,15595579,15599249,0,0,0,3670
10255,15596235,15596235,15599291,0,0,0,3056
10266,15599301,15599301,15599447,0,0,0,146
10264,15598796,15598796,15599565,0,0,0,769
10263,15598747,15598747,15599580,0,0,0,833
10260,15598421,15598421,15599592,0,0,0,1171
10248,15593490,15593490,15599605,0,0,0,6115
10271,15599663,15599663,15599878,0,0,0,215
10272,15600119,15600119,15600266,0,0,0,147
10229,15584057,15584057,15601756,0,0,0,17699
10274,15602043,15602043,15602187,0,0,0,144
10242,15592833,15592833,15602228,0,0,0,9395
10276,15602318,15602318,15602465,0,0,0,147
10275,15602312,15602312,15602774,0,0,0,462
10278,15602403,15602403,15602812,0,0,0,409
10279,15602419,15602419,15602823,0,0,0,404
10277,15602383,15602383,15602851,0,0,0,468
10284,15603637,15603637,15603730,0,0,0,93
10286,15604356,15604356,15604461,0,0,0,105
10285,15604115,15604115,15604749,0,0,0,634
10289,15604854,15604854,15604981,0,0,0,127
10287,15604468,15604468,15605475,0,0,0,1007
10141,15501278,15501278,15605499,0,0,0,104221
10291,15605383,15605383,15605571,0,0,0,188
10293,15605613,15605613,15605750,0,0,0,137
10292,15605589,15605589,15605801,0,0,0,212
10294,15605633,15605633,15605834,0,0,0,201
10288,15604841,15604841,15605869,0,0,0,1028
10296,15606159,15606159,15606378,0,0,0,219
10297,15606204,15606204,15606416,0,0,0,212
10299,15606745,15606745,15606950,0,0,0,205
10300,15606939,15606939,15607066,0,0,0,127
10301,15607229,15607229,15607374,0,0,0,145
10302,15607245,15607245,15607400,0,0,0,155
10303,15608172,15608172,15608320,0,0,0,148
10304,15608330,15608330,15608373,0,0,0,43
10305,15608359,15608359,15608413,0,0,0,54
10306,15608395,15608395,15608437,0,0,0,42
10298,15606558,15606558,15608452,0,0,0,1894
10307,15608447,15608447,15608594,0,0,0,147
10309,15608510,15608510,15608601,0,0,0,91
10308,15608479,15608479,15608616,0,0,0,137
10310,15608621,15608621,15608695,0,0,0,74
10226,15579184,15579184,15608703,0,0,0,29519
10311,15608627,15608627,15608745,0,0,0,118
10313,15608701,15608701,15608761,0,0,0,60
10315,15608849,15608849,15608939,0,0,0,90
10314,15608833,15608833,15609018,0,0,0,185
10316,15608859,15608859,15609070,0,0,0,211
10317,15609095,15609095,15609165,0,0,0,70
10318,15609137,15609137,15609270,0,0,0,133
10320,15609270,15609270,15609405,0,0,0,135
10321,15609410,15609410,15609521,0,0,0,111
10319,15609139,15609139,15609609,0,0,0,470
10323,15609479,15609479,15609644,0,0,0,165
10228,15583189,15583189,15609649,0,0,0,26460
10324,15609569,15609569,15609754,0,0,0,185
10326,15609721,15609721,15609922,0,0,0,201
10322,15609461,15609461,15609940,0,0,0,479
10327,15609816,15609816,15609966,0,0,0,150
10328,15609850,15609850,15610050,0,0,0,200
10312,15608654,15608654,15610070,0,0,0,1416
10329,15609968,15609968,15610102,0,0,0,134
10332,15610009,15610009,15610188,0,0,0,179
10330,15609974,15609974,15610191,0,0,0,217
10331,15609985,15609985,15610456,0,0,0,471
10335,15610409,15610409,15610547,0,0,0,138
10337,15610593,15610593,15610729,0,0,0,136
10338,15610682,15610682,15610859,0,0,0,177
10341,15610988,15610988,15611077,0,0,0,89
10239,15590666,15590666,15611078,0,0,0,20412
10340,15610986,15610986,15611117,0,0,0,131
10238,15590651,15590651,15611127,0,0,0,20476
10339,15610985,15610985,15611170,0,0,0,185
10345,15611587,15611587,15611733,0,0,0,146
10344,15611358,15611358,15611835,0,0,0,477
10346,15611751,15611751,15611897,0,0,0,146
10347,15611933,15611933,15612146,0,0,0,213
10231,15585206,15585206,15612274,0,0,0,27068
10232,15585539,15585539,15612307,0,0,0,26768
10351,15612317,15612317,15612536,0,0,0,219
10352,15612673,15612673,15612737,0,0,0,64
10353,15612706,15612706,15612848,0,0,0,142
10354,15612720,15612720,15612851,0,0,0,131
10355,15612849,15612849,15613004,0,0,0,155
10356,15612913,15612913,15613015,0,0,0,102
10358,15613028,15613028,15613106,0,0,0,78
10359,15613243,15613243,15613378,0,0,0,135
10360,15613486,15613486,15613589,0,0,0,103
10361,15613592,15613592,15613636,0,0,0,44
10362,15613623,15613623,15613714,0,0,0,91
10363,15613660,15613660,15613782,0,0,0,122
10364,15613708,15613708,15613843,0,0,0,135
10366,15613723,15613723,15613878,0,0,0,155
10357,15612936,15612936,15613917,0,0,0,981
10367,15613829,15613829,15613955,0,0,0,126
10368,15614193,15614193,15614317,0,0,0,124
10365,15613721,15613721,15614400,0,0,0,679
10369,15614426,15614426,15614473,0,0,0,47
10370,15614601,15614601,15614722,0,0,0,121
10372,15614772,15614772,15615014,0,0,0,242
10373,15615022,15615022,15615127,0,0,0,105
10374,15615082,15615082,15615163,0,0,0,81
10375,15615235,15615235,15615464,0,0,0,229
10381,15616062,15616062,15616166,0,0,0,104
10377,15615520,15615520,15616208,0,0,0,688
10378,15615553,15615553,15616483,0,0,0,930
10290,15604889,15604889,15617134,0,0,0,12245
10371,15614734,15614734,15618334,0,0,0,3600
10376,15615373,15615373,15618973,0,0,0,3600
10379,15615600,15615600,15619200,0,0,0,3600
10261,15598637,15598637,15619459,0,0,0,20822
10262,15598669,15598669,15619520,0,0,0,20851
10380,15615926,15615926,15619526,0,0,0,3600
10246,15593257,15593257,15619699,0,0,0,26442
10382,15616363,15616363,15619963,0,0,0,3600
10258,15598091,15598091,15621464,0,0,0,23373
10259,15598141,15598141,15621491,0,0,0,23350
10198,15532497,15532497,15625283,0,0,0,92786
10265,15599176,15599176,15629309,0,0,0,30133
10348,15612163,15612163,15629800,0,0,0,17637
10342,15611042,15611042,15631486,0,0,0,20444
10343,15611083,15611083,15631516,0,0,0,20433
10387,15619463,15619463,15631701,0,0,0,12238
10383,15616454,15616454,15634454,0,0,0,18000
10384,15616465,15616465,15634465,0,0,0,18000
10333,15610105,15610105,15636442,0,0,0,26337
10350,15612238,15612238,15638737,0,0,0,26499
10349,15612217,15612217,15638926,0,0,0,26709
10334,15610151,15610151,15639294,0,0,0,29143
10398,15639255,15639255,15639428,0,0,0,173
10385,15619402,15619402,15640250,0,0,0,20848
10386,15619433,15619433,15640281,0,0,0,20848
10389,15621392,15621392,15644540,0,0,0,23148
10390,15621449,15621449,15644628,0,0,0,23179
10388,15619652,15619652,15645824,0,0,0,26172
10137,15498422,15498422,15648992,0,0,0,150570
10393,15631413,15631413,15652019,0,0,0,20606
10394,15631446,15631446,15652073,0,0,0,20627
10392,15629267,15629267,15657553,0,0,0,28286
10273,15601780,15601780,15660356,0,0,0,58576
10400,15640183,15640183,15661199,0,0,0,21016
10401,15640208,15640208,15661231,0,0,0,21023
10192,15532149,15532149,15661260,0,0,0,129111
10197,15532447,15532447,15661527,0,0,0,129080
10194,15532314,15532314,15661761,0,0,0,129447
10195,15532390,15532390,15661907,0,0,0,129517
10395,15636406,15636406,15662877,0,0,0,26471
10396,15638695,15638695,15665403,0,0,0,26708
10397,15638846,15638846,15665863,0,0,0,27017
10413,15666657,15666657,15666877,0,0,0,220
10414,15666756,15666756,15666933,0,0,0,177
10402,15644503,15644503,15667601,0,0,0,23098
10200,15533042,15533042,15667699,0,0,0,134657
10403,15644588,15644588,15667987,0,0,0,23399
10416,15667943,15667943,15668158,0,0,0,215
10418,15668075,15668075,15668266,0,0,0,191
10190,15532086,15532086,15668309,0,0,0,136223
10419,15668309,15668309,15668528,0,0,0,219
10267,15599531,15599531,15668759,0,0,0,69228
10268,15599539,15599539,15668778,0,0,0,69239
10269,15599546,15599546,15668785,0,0,0,69239
10270,15599562,15599562,15668801,0,0,0,69239
10399,15639386,15639386,15669072,0,0,0,29686
10426,15669914,15669914,15670131,0,0,0,217
10427,15670130,15670130,15670343,0,0,0,213
10429,15671561,15671561,15671727,0,0,0,166
10404,15645787,15645787,15672365,0,0,0,26578
10405,15651978,15651978,15672462,0,0,0,20484
10406,15652027,15652027,15672528,0,0,0,20501
10435,15673454,15673454,15673591,0,0,0,137
10436,15673530,15673530,15673918,0,0,0,388
10437,15673713,15673713,15674149,0,0,0,436
10438,15674735,15674735,15674933,0,0,0,198
10439,15676469,15676469,15676728,0,0,0,259
10428,15670993,15670993,15677214,0,0,0,6221
10434,15673409,15673409,15677248,0,0,0,3839
10240,15590672,15590672,15677279,0,0,0,86607
10256,15597843,15597843,15678008,0,0,0,80165
10445,15677839,15677839,15678082,0,0,0,243
10446,15677921,15677921,15678165,0,0,0,244
10440,15677174,15677174,15679984,0,0,0,2810
10442,15677206,15677206,15679997,0,0,0,2791
10443,15677280,15677280,15680016,0,0,0,2736
10444,15677310,15677310,15680016,0,0,0,2706
10408,15661133,15661133,15682076,0,0,0,20943
10409,15661157,15661157,15682114,0,0,0,20957
10454,15682264,15682264,15682482,0,0,0,218
10455,15682313,15682313,15682509,0,0,0,196
10460,15682673,15682673,15682870,0,0,0,197
10421,15668722,15668722,15682882,0,0,0,14160
10423,15668743,15668743,15682892,0,0,0,14149
10422,15668733,15668733,15682893,0,0,0,14160
10424,15668755,15668755,15682904,0,0,0,14149
10461,15682913,15682913,15683104,0,0,0,191
10466,15683281,15683281,15683448,0,0,0,167
10467,15684293,15684293,15684486,0,0,0,193
10468,15685036,15685036,15685225,0,0,0,189
10420,15668370,15668370,15685528,0,0,0,17158
10407,15657521,15657521,15685663,0,0,0,28142
10469,15685616,15685616,15685821,0,0,0,205
10471,15685904,15685904,15686120,0,0,0,216
10430,15671944,15671944,15686946,0,0,0,15002
10472,15688379,15688379,15688463,0,0,0,84
10410,15662805,15662805,15689019,0,0,0,26214
10218,15566303,15566303,15689253,0,0,0,122950
10474,15689409,15689409,15689534,0,0,0,125
10475,15689734,15689734,15689838,0,0,0,104
10476,15689990,15689990,15690136,0,0,0,146
10477,15690241,15690241,15690345,0,0,0,104
10478,15690387,15690387,15690516,0,0,0,129
10479,15690401,15690401,15690530,0,0,0,129
10480,15690518,15690518,15690660,0,0,0,142
10481,15690626,15690626,15690767,0,0,0,141
10482,15690662,15690662,15690786,0,0,0,124
10483,15690785,15690785,15690909,0,0,0,124
10415,15667562,15667562,15691028,0,0,0,23466
10485,15690971,15690971,15691100,0,0,0,129
10486,15691105,15691105,15691246,0,0,0,141
10417,15667944,15667944,15691370,0,0,0,23426
10487,15691312,15691312,15691495,0,0,0,183
10411,15665361,15665361,15692081,0,0,0,26720
10412,15665796,15665796,15692549,0,0,0,26753
10456,15682354,15682354,15692748,0,0,0,10394
10448,15680756,15680756,15692908,0,0,0,12152
10449,15680864,15680864,15692923,0,0,0,12059
10432,15672420,15672420,15692926,0,0,0,20506
10450,15680905,15680905,15692944,0,0,0,12039
10451,15680949,15680949,15692946,0,0,0,11997
10433,15672490,15672490,15692969,0,0,0,20479
10457,15682359,15682359,15692976,0,0,0,10617
10458,15682364,15682364,15692981,0,0,0,10617
10459,15682367,15682367,15692995,0,0,0,10628
10462,15682935,15682935,15693008,0,0,0,10073
10463,15682938,15682938,15693033,0,0,0,10095
10464,15682944,15682944,15693050,0,0,0,10106
10465,15682947,15682947,15693064,0,0,0,10117
10499,15692948,15692948,15693089,0,0,0,141
10325,15609572,15609572,15694459,0,0,0,84887
10510,15695633,15695633,15695810,0,0,0,177
10511,15696607,15696607,15696784,0,0,0,177
10447,15679558,15679558,15697558,0,0,0,18000
10512,15697323,15697323,15698012,0,0,0,689
10513,15698034,15698034,15698123,0,0,0,89
10281,15602741,15602741,15698208,0,0,0,95467
10282,15602757,15602757,15698213,0,0,0,95456
10280,15602725,15602725,15698214,0,0,0,95489
10283,15602792,15602792,15698219,0,0,0,95427
10431,15672293,15672293,15698805,0,0,0,26512
10518,15698675,15698675,15698908,0,0,0,233
10425,15669025,15669025,15699080,0,0,0,30055
10521,15699558,15699558,15699693,0,0,0,135
10523,15700073,15700073,15700190,0,0,0,117
10524,15700107,15700107,15700667,0,0,0,560
10525,15700571,15700571,15700737,0,0,0,166
10527,15700866,15700866,15700926,0,0,0,60
10529,15701367,15701367,15701427,0,0,0,60
10453,15682041,15682041,15702930,0,0,0,20889
10452,15682007,15682007,15702931,0,0,0,20924
10491,15692712,15692712,15704324,0,0,0,11612
10505,15693020,15693020,15704668,0,0,0,11648
10493,15692870,15692870,15704673,0,0,0,11803
10497,15692906,15692906,15704697,0,0,0,11791
10495,15692897,15692897,15704710,0,0,0,11813
10500,15692948,15692948,15704737,0,0,0,11789
10503,15692994,15692994,15704801,0,0,0,11807
10498,15692931,15692931,15704860,0,0,0,11929
10504,15693008,15693008,15704860,0,0,0,11852
10501,15692960,15692960,15704910,0,0,0,11950
10494,15692885,15692885,15704943,0,0,0,12058
10502,15692973,15692973,15705109,0,0,0,12136
10506,15694336,15694336,15706248,0,0,0,11912
10508,15694350,15694350,15706251,0,0,0,11901
10509,15694355,15694355,15706349,0,0,0,11994
10507,15694340,15694340,15706387,0,0,0,12047
10528,15701185,15701185,15707922,0,0,0,6737
10295,15605821,15605821,15708814,0,0,0,102993
10492,15692852,15692852,15713550,0,0,0,20698
10496,15692904,15692904,15713570,0,0,0,20666
10470,15685753,15685753,15713702,0,0,0,27949
10536,15713659,15713659,15713827,0,0,0,168
10484,15690949,15690949,15714466,0,0,0,23517
10488,15691331,15691331,15714844,0,0,0,23513
10473,15688977,15688977,15715672,0,0,0,26695
10391,15625218,15625218,15718951,0,0,0,93733
10489,15692039,15692039,15718989,0,0,0,26950
10490,15692508,15692508,15719237,0,0,0,26729
10531,15702889,15702889,15724000,0,0,0,21111
10530,15702883,15702883,15724061,0,0,0,21178
10519,15698768,15698768,15725118,0,0,0,26350
10520,15699041,15699041,15727411,0,0,0,28370
10551,15727371,15727371,15727544,0,0,0,173
10526,15700860,15700860,15733015,0,0,0,32155
10534,15713478,15713478,15734052,0,0,0,20574
10535,15713508,15713508,15734089,0,0,0,20581
10533,15708995,15708995,15738526,0,0,0,29531
10538,15714425,15714425,15738610,0,0,0,24185
10539,15714761,15714761,15738977,0,0,0,24216
10540,15715626,15715626,15741942,0,0,0,26316
10537,15713785,15713785,15743226,0,0,0,29441
10548,15723931,15723931,15744845,0,0,0,20914
10549,15723970,15723970,15744895,0,0,0,20925
10544,15718916,15718916,15745340,0,0,0,26424
10545,15719194,15719194,15745956,0,0,0,26762
10532,15707817,15707817,15748316,0,0,0,40499
10542,15718711,15718711,15751018,0,0,0,32307
10550,15725074,15725074,15751179,0,0,0,26105
10563,15751136,15751136,15751304,0,0,0,168
10564,15751264,15751264,15751432,0,0,0,168
10541,15718448,15718448,15752250,0,0,0,33802
10566,15752358,15752358,15752418,0,0,0,60
10567,15752540,15752540,15752600,0,0,0,60
10568,15752997,15752997,15753057,0,0,0,60
10569,15753260,15753260,15753320,0,0,0,60
10570,15753382,15753382,15753575,0,0,0,193
10572,15753557,15753557,15754013,0,0,0,456
10554,15734003,15734003,15754424,0,0,0,20421
10553,15733995,15733995,15754459,0,0,0,20464
10552,15727501,15727501,15755807,0,0,0,28306
10580,15761112,15761112,15761251,0,0,0,139
10582,15761183,15761183,15761367,0,0,0,184
10585,15761597,15761597,15761686,0,0,0,89
10592,15761892,15761892,15761972,0,0,0,80
10599,15762031,15762031,15762136,0,0,0,105
10600,15762088,15762088,15762184,0,0,0,96
10583,15761209,15761209,15762189,0,0,0,980
10601,15762135,15762135,15762216,0,0,0,81
10603,15762499,15762499,15762579,0,0,0,80
10604,15762580,15762580,15762670,0,0,0,90
10555,15738571,15738571,15762747,0,0,0,24176
10556,15738904,15738904,15763056,0,0,0,24152
10607,15762837,15762837,15763437,0,0,0,600
10605,15762716,15762716,15763993,0,0,0,1277
10441,15677203,15677203,15764154,0,0,0,86951
10611,15764890,15764890,15764979,0,0,0,89
10612,15765424,15765424,15765484,0,0,0,60
10559,15744810,15744810,15765840,0,0,0,21030
10560,15744860,15744860,15765869,0,0,0,21009
10613,15765616,15765616,15766216,0,0,0,600
10618,15767374,15767374,15767434,0,0,0,60
10616,15767310,15767310,15767494,0,0,0,184
10619,15767668,15767668,15767854,0,0,0,186
10617,15767334,15767334,15768278,0,0,0,944
10557,15741902,15741902,15768415,0,0,0,26513
10623,15768386,15768386,15768446,0,0,0,60
10622,15768362,15768362,15768521,0,0,0,159
10621,15768337,15768337,15768540,0,0,0,203
10624,15768478,15768478,15768696,0,0,0,218
10631,15770048,15770048,15770126,0,0,0,78
10575,15755417,15755417,15770218,0,0,0,14801
10632,15770213,15770213,15770302,0,0,0,89
10634,15770400,15770400,15770537,0,0,0,137
10635,15770632,15770632,15770711,0,0,0,79
10630,15769814,15769814,15770724,0,0,0,910
10638,15771608,15771608,15771720,0,0,0,112
10639,15771920,15771920,15771980,0,0,0,60
10640,15772107,15772107,15772166,0,0,0,59
10561,15745296,15745296,15772190,0,0,0,26894
10642,15772176,15772176,15772236,0,0,0,60
10643,15772188,15772188,15772266,0,0,0,78
10644,15772383,15772383,15772443,0,0,0,60
10645,15772479,15772479,15772564,0,0,0,85
10646,15772552,15772552,15772612,0,0,0,60
10562,15745883,15745883,15772938,0,0,0,27055
10558,15743145,15743145,15772988,0,0,0,29843
10649,15772955,15772955,15773130,0,0,0,175
10647,15772598,15772598,15773198,0,0,0,600
10595,15761909,15761909,15773303,0,0,0,11394
10650,15773129,15773129,15773337,0,0,0,208
10586,15761756,15761756,15773347,0,0,0,11591
10579,15761095,15761095,15773451,0,0,0,12356
10590,15761883,15761883,15773666,0,0,0,11783
10587,15761760,15761760,15773707,0,0,0,11947
10581,15761162,15761162,15773708,0,0,0,12546
10589,15761774,15761774,15773847,0,0,0,12073
10584,15761328,15761328,15773863,0,0,0,12535
10597,15761918,15761918,15773879,0,0,0,11961
10588,15761765,15761765,15773902,0,0,0,12137
10593,15761900,15761900,15773926,0,0,0,12026
10598,15761922,15761922,15773926,0,0,0,12004
10625,15768595,15768595,15773927,0,0,0,5332
10591,15761886,15761886,15773928,0,0,0,12042
10594,15761903,15761903,15773971,0,0,0,12068
10596,15761913,15761913,15774008,0,0,0,12095
10654,15773999,15773999,15774150,0,0,0,151
10602,15762219,15762219,15774408,0,0,0,12189
10577,15755753,15755753,15774448,0,0,0,18695
10656,15774337,15774337,15774468,0,0,0,131
10657,15774507,15774507,15774638,0,0,0,131
10658,15774636,15774636,15774795,0,0,0,159
10573,15754353,15754353,15775036,0,0,0,20683
10659,15774926,15774926,15775069,0,0,0,143
10574,15754386,15754386,15775326,0,0,0,20940
10663,15775035,15775035,15775635,0,0,0,600
10673,15775635,15775635,15775706,0,0,0,71
10672,15775595,15775595,15775748,0,0,0,153
10674,15775821,15775821,15775903,0,0,0,82
10671,15775298,15775298,15776501,0,0,0,1203
10675,15775916,15775916,15776516,0,0,0,600
10565,15751390,15751390,15777724,0,0,0,26334
10677,15777678,15777678,15777738,0,0,0,60
10655,15774151,15774151,15777852,0,0,0,3701
10678,15777815,15777815,15778415,0,0,0,600
10669,15775210,15775210,15781450,0,0,0,6240
10682,15782274,15782274,15782359,0,0,0,85
10681,15782132,15782132,15782484,0,0,0,352
10683,15782385,15782385,15782759,0,0,0,374
10686,15782772,15782772,15782820,0,0,0,48
10336,15610567,15610567,15783367,0,0,0,172800
10685,15782681,15782681,15783505,0,0,0,824
10576,15755728,15755728,15783712,0,0,0,27984
10684,15782392,15782392,15783871,0,0,0,1479
10679,15781111,15781111,15783990,0,0,0,2879
10688,15783196,15783196,15784046,0,0,0,850
10687,15783054,15783054,15784082,0,0,0,1028
10609,15763979,15763979,15784220,0,0,0,20241
10696,15784104,15784104,15784264,0,0,0,160
10695,15784092,15784092,15784721,0,0,0,629
10693,15783739,15783739,15784828,0,0,0,1089
10701,15784728,15784728,15784930,0,0,0,202
10698,15784166,15784166,15785107,0,0,0,941
10662,15775024,15775024,15785279,0,0,0,10255
10652,15773671,15773671,15785480,0,0,0,11809
10653,15773675,15773675,15785484,0,0,0,11809
10702,15785570,15785570,15785719,0,0,0,149
10703,15785649,15785649,15785820,0,0,0,171
10700,15784602,15784602,15786187,0,0,0,1585
10637,15771192,15771192,15786190,0,0,0,14998
10705,15786017,15786017,15786364,0,0,0,347
10706,15786249,15786249,15786414,0,0,0,165
10636,15771132,15771132,15786445,0,0,0,15313
10704,15785859,15785859,15786462,0,0,0,603
10606,15762716,15762716,15786663,0,0,0,23947
10666,15775105,15775105,15786703,0,0,0,11598
10608,15763022,15763022,15786854,0,0,0,23832
10699,15784300,15784300,15786863,0,0,0,2563
10615,15765798,15765798,15786878,0,0,0,21080
10664,15775056,15775056,15786882,0,0,0,11826
10614,15765787,15765787,15786936,0,0,0,21149
10661,15775000,15775000,15786989,0,0,0,11989
10667,15775129,15775129,15786989,0,0,0,11860
10668,15775193,15775193,15787137,0,0,0,11944
10707,15786483,15786483,15787422,0,0,0,939
10665,15775080,15775080,15787680,0,0,0,12600
10517,15698306,15698306,15788061,0,0,0,89755
10716,15788366,15788366,15788484,0,0,0,118
10722,15788610,15788610,15789197,0,0,0,587
10731,15789122,15789122,15789345,0,0,0,223
10728,15788748,15788748,15789357,0,0,0,609
10732,15789365,15789365,15789479,0,0,0,114
10726,15788709,15788709,15789786,0,0,0,1077
10730,15788840,15788840,15789928,0,0,0,1088
10727,15788735,15788735,15790622,0,0,0,1887
10729,15788815,15788815,15790714,0,0,0,1899
10719,15788506,15788506,15790786,0,0,0,2280
10723,15788618,15788618,15790876,0,0,0,2258
10725,15788674,15788674,15791268,0,0,0,2594
10724,15788645,15788645,15791319,0,0,0,2674
10629,15769228,15769228,15791609,0,0,0,22381
10692,15783697,15783697,15791929,0,0,0,8232
10689,15783576,15783576,15792330,0,0,0,8754
10690,15783649,15783649,15792560,0,0,0,8911
10733,15789556,15789556,15792756,0,0,0,3200
10721,15788585,15788585,15792887,0,0,0,4302
10718,15788481,15788481,15793076,0,0,0,4595
10680,15781419,15781419,15793125,0,0,0,11706
10717,15788466,15788466,15793377,0,0,0,4911
10720,15788555,15788555,15793421,0,0,0,4866
10736,15792729,15792729,15793422,0,0,0,693
10737,15792761,15792761,15793442,0,0,0,681
10739,15792847,15792847,15793516,0,0,0,669
10734,15789767,15789767,15793573,0,0,0,3806
10738,15792792,15792792,15793592,0,0,0,800
10742,15793697,15793697,15793775,0,0,0,78
10626,15768615,15768615,15795322,0,0,0,26707
10547,15722819,15722819,15795442,0,0,0,72623
10660,15774983,15774983,15795473,0,0,0,20490
10735,15790628,15790628,15795508,0,0,0,4880
10670,15775251,15775251,15795688,0,0,0,20437
10620,15768323,15768323,15795781,0,0,0,27458
10641,15772116,15772116,15798979,0,0,0,26863
10648,15772856,15772856,15799433,0,0,0,26577
10514,15698226,15698226,15799465,0,0,0,101239
10628,15769207,15769207,15799521,0,0,0,30314
10516,15698285,15698285,15799605,0,0,0,101320
10633,15770382,15770382,15800093,0,0,0,29711
10743,15793739,15793739,15800304,0,0,0,6565
10744,15793774,15793774,15800406,0,0,0,6632
10651,15773434,15773434,15802116,0,0,0,28682
10745,15793906,15793906,15803511,0,0,0,9605
10740,15793050,15793050,15803722,0,0,0,10672
10741,15793083,15793083,15803797,0,0,0,10714
10746,15794006,15794006,15803838,0,0,0,9832
10627,15769194,15769194,15804231,0,0,0,35037
10676,15777668,15777668,15804334,0,0,0,26666
10515,15698265,15698265,15805364,0,0,0,107099
10711,15786824,15786824,15805517,0,0,0,18693
10714,15787511,15787511,15806126,0,0,0,18615
10715,15787710,15787710,15806174,0,0,0,18464
10713,15787448,15787448,15806431,0,0,0,18983
10546,15722782,15722782,15807065,0,0,0,84283
10710,15786817,15786817,15807668,0,0,0,20851
10712,15786841,15786841,15807711,0,0,0,20870
10708,15786590,15786590,15810633,0,0,0,24043
10709,15786784,15786784,15810852,0,0,0,24068
10764,15811245,15811245,15811318,0,0,0,73
10543,15718887,15718887,15812086,0,0,0,93199
10752,15800799,15800799,15812538,0,0,0,11739
10753,15800898,15800898,15812725,0,0,0,11827
10691,15783662,15783662,15813069,0,0,0,29407
10754,15801013,15801013,15813283,0,0,0,12270
10748,15795400,15795400,15816020,0,0,0,20620
10749,15795654,15795654,15816196,0,0,0,20542
10747,15795247,15795247,15821613,0,0,0,26366
10756,15803691,15803691,15822240,0,0,0,18549
10578,15758972,15758972,15823334,0,0,0,64362
10757,15803753,15803753,15823744,0,0,0,19991
10750,15798982,15798982,15825737,0,0,0,26755
10751,15799452,15799452,15826166,0,0,0,26714
10760,15807625,15807625,15828564,0,0,0,20939
10759,15807615,15807615,15828691,0,0,0,21076
10762,15810769,15810769,15829877,0,0,0,19108
10765,15811394,15811394,15830075,0,0,0,18681
10767,15811638,15811638,15830153,0,0,0,18515
10766,15811570,15811570,15830228,0,0,0,18658
10758,15804253,15804253,15830711,0,0,0,26458
10777,15830646,15830646,15830850,0,0,0,204
10755,15802077,15802077,15831228,0,0,0,29151
10761,15810589,15810589,15833534,0,0,0,22945
10571,15753431,15753431,15833569,0,0,0,80138
10763,15810807,15810807,15833803,0,0,0,22996
10770,15815934,15815934,15836347,0,0,0,20413
10771,15816154,15816154,15836595,0,0,0,20441
10784,15837214,15837214,15837349,0,0,0,135
10785,15837747,15837747,15838469,0,0,0,722
10790,15839749,15839749,15839838,0,0,0,89
10792,15840066,15840066,15840193,0,0,0,127
10795,15840367,15840367,15840467,0,0,0,100
10797,15840978,15840978,15841076,0,0,0,98
10798,15841042,15841042,15841141,0,0,0,99
10799,15841099,15841099,15841159,0,0,0,60
10800,15841320,15841320,15841489,0,0,0,169
10801,15841535,15841535,15841670,0,0,0,135
10803,15841794,15841794,15841841,0,0,0,47
10791,15839899,15839899,15842013,0,0,0,2114
10796,15840417,15840417,15842372,0,0,0,1955
10804,15841800,15841800,15842407,0,0,0,607
10769,15813047,15813047,15842532,0,0,0,29485
10806,15842468,15842468,15842678,0,0,0,210
10805,15842275,15842275,15842951,0,0,0,676
10807,15842529,15842529,15843077,0,0,0,548
10793,15840313,15840313,15843096,0,0,0,2783
10794,15840345,15840345,15843099,0,0,0,2754
10802,15841699,15841699,15843100,0,0,0,1401
10811,15843146,15843146,15843227,0,0,0,81
10820,15843393,15843393,15843536,0,0,0,143
10829,15843655,15843655,15843731,0,0,0,76
10831,15843696,15843696,15843888,0,0,0,192
10832,15843926,15843926,15843985,0,0,0,59
10834,15844106,15844106,15844213,0,0,0,107
10835,15844280,15844280,15844369,0,0,0,89
10833,15843990,15843990,15844435,0,0,0,445
10830,15843683,15843683,15844551,0,0,0,868
10836,15844461,15844461,15844683,0,0,0,222
10837,15844740,15844740,15844961,0,0,0,221
10839,15845134,15845134,15845211,0,0,0,77
10838,15844977,15844977,15845221,0,0,0,244
10840,15845210,15845210,15845282,0,0,0,72
10841,15845283,15845283,15845336,0,0,0,53
10842,15845289,15845289,15845372,0,0,0,83
10843,15845424,15845424,15845513,0,0,0,89
10814,15843222,15843222,15845889,0,0,0,2667
10810,15843036,15843036,15845985,0,0,0,2949
10813,15843189,15843189,15845985,0,0,0,2796
10812,15843158,15843158,15846007,0,0,0,2849
10816,15843289,15843289,15846051,0,0,0,2762
10817,15843325,15843325,15846056,0,0,0,2731
10819,15843363,15843363,15846061,0,0,0,2698
10818,15843343,15843343,15846079,0,0,0,2736
10821,15843397,15843397,15846111,0,0,0,2714
10822,15843425,15843425,15846129,0,0,0,2704
10823,15843440,15843440,15846139,0,0,0,2699
10824,15843460,15843460,15846148,0,0,0,2688
10825,15843506,15843506,15846163,0,0,0,2657
10826,15843558,15843558,15846173,0,0,0,2615
10827,15843571,15843571,15846186,0,0,0,2615
10828,15843593,15843593,15846197,0,0,0,2604
10809,15843009,15843009,15846239,0,0,0,3230
10815,15843268,15843268,15846306,0,0,0,3038
10860,15846597,15846597,15846719,0,0,0,122
10861,15846929,15846929,15847056,0,0,0,127
10862,15847006,15847006,15847095,0,0,0,89
10865,15847739,15847739,15847833,0,0,0,94
10772,15821559,15821559,15848020,0,0,0,26461
10867,15848042,15848042,15848116,0,0,0,74
10864,15847659,15847659,15849221,0,0,0,1562
10775,15828523,15828523,15849383,0,0,0,20860
10776,15828649,15828649,15849498,0,0,0,20849
10870,15849919,15849919,15850034,0,0,0,115
10871,15850023,15850023,15850123,0,0,0,100
10872,15850169,15850169,15850307,0,0,0,138
10873,15850254,15850254,15850450,0,0,0,196
10874,15850482,15850482,15850571,0,0,0,89
10610,15764073,15764073,15850884,0,0,0,86811
10877,15851144,15851144,15851223,0,0,0,79
10878,15851471,15851471,15851553,0,0,0,82
10879,15851817,15851817,15851895,0,0,0,78
10880,15852182,15852182,15852260,0,0,0,78
10881,15852284,15852284,15852373,0,0,0,89
10773,15825659,15825659,15852461,0,0,0,26802
10882,15852377,15852377,15852634,0,0,0,257
10884,15852553,15852553,15852860,0,0,0,307
10774,15826129,15826129,15852914,0,0,0,26785
10875,15850636,15850636,15853672,0,0,0,3036
10859,15846152,15846152,15853886,0,0,0,7734
10847,15845991,15845991,15853915,0,0,0,7924
10886,15854486,15854486,15854643,0,0,0,157
10887,15854611,15854611,15854764,0,0,0,153
10888,15854701,15854701,15854890,0,0,0,189
10889,15854826,15854826,15854970,0,0,0,144
10846,15845981,15845981,15855304,0,0,0,9323
10890,15855246,15855246,15855380,0,0,0,134
10844,15845958,15845958,15855456,0,0,0,9498
10845,15845971,15845971,15855484,0,0,0,9513
10849,15846022,15846022,15855589,0,0,0,9567
10858,15846142,15846142,15855616,0,0,0,9474
10850,15846038,15846038,15855627,0,0,0,9589
10851,15846065,15846065,15855640,0,0,0,9575
10852,15846081,15846081,15855703,0,0,0,9622
10853,15846093,15846093,15855742,0,0,0,9649
10854,15846105,15846105,15855776,0,0,0,9671
10855,15846115,15846115,15855808,0,0,0,9693
10856,15846123,15846123,15855830,0,0,0,9707
10857,15846133,15846133,15855868,0,0,0,9735
10901,15855734,15855734,15855875,0,0,0,141
10906,15855838,15855838,15855953,0,0,0,115
10780,15833488,15833488,15856022,0,0,0,22534
10910,15856052,15856052,15856172,0,0,0,120
10848,15846012,15846012,15856227,0,0,0,10215
10911,15856168,15856168,15856293,0,0,0,125
10781,15833733,15833733,15856334,0,0,0,22601
10913,15856383,15856383,15856528,0,0,0,145
10916,15856504,15856504,15856621,0,0,0,117
10782,15836310,15836310,15856701,0,0,0,20391
10918,15856634,15856634,15856743,0,0,0,109
10783,15836547,15836547,15856937,0,0,0,20390
10920,15856992,15856992,15857130,0,0,0,138
10921,15857077,15857077,15857225,0,0,0,148
10922,15857171,15857171,15857271,0,0,0,100
10778,15830786,15830786,15857393,0,0,0,26607
10924,15857383,15857383,15857502,0,0,0,119
10923,15857317,15857317,15857524,0,0,0,207
10788,15839176,15839176,15857825,0,0,0,18649
10926,15857829,15857829,15857983,0,0,0,154
10787,15839171,15839171,15857985,0,0,0,18814
10927,15857933,15857933,15858086,0,0,0,153
10928,15858047,15858047,15858162,0,0,0,115
10789,15839179,15839179,15858201,0,0,0,19022
10786,15839167,15839167,15858350,0,0,0,19183
10929,15858271,15858271,15858376,0,0,0,105
10931,15859523,15859523,15859649,0,0,0,126
10930,15859517,15859517,15859655,0,0,0,138
10779,15831190,15831190,15860497,0,0,0,29307
10932,15860441,15860441,15860533,0,0,0,92
10697,15784135,15784135,15860539,0,0,0,76404
10934,15860975,15860975,15861173,0,0,0,198
10935,15861194,15861194,15862172,0,0,0,978
10936,15862380,15862380,15862527,0,0,0,147
10938,15862999,15862999,15863059,0,0,0,60
10940,15863151,15863151,15863211,0,0,0,60
10941,15863187,15863187,15863247,0,0,0,60
10942,15863216,15863216,15863276,0,0,0,60
10943,15863323,15863323,15863445,0,0,0,122
10863,15847583,15847583,15863482,0,0,0,15899
10944,15863434,15863434,15863569,0,0,0,135
10939,15863036,15863036,15863615,0,0,0,579
10946,15864113,15864113,15864202,0,0,0,89
10948,15864335,15864335,15864422,0,0,0,87
10949,15864380,15864380,15864460,0,0,0,80
10950,15864421,15864421,15864493,0,0,0,72
10951,15864848,15864848,15864953,0,0,0,105
10952,15864998,15864998,15865079,0,0,0,81
10954,15865124,15865124,15865211,0,0,0,87
10953,15865082,15865082,15865227,0,0,0,145
10955,15865211,15865211,15865263,0,0,0,52
10956,15865269,15865269,15865321,0,0,0,52
10958,15865362,15865362,15865443,0,0,0,81
10957,15865354,15865354,15865495,0,0,0,141
10959,15865447,15865447,15865519,0,0,0,72
10960,15865519,15865519,15865725,0,0,0,206
10961,15865727,15865727,15865809,0,0,0,82
10962,15865881,15865881,15865950,0,0,0,69
10963,15865920,15865920,15866018,0,0,0,98
10964,15865955,15865955,15866024,0,0,0,69
10966,15866063,15866063,15866110,0,0,0,47
10965,15866043,15866043,15866126,0,0,0,83
10967,15866104,15866104,15866178,0,0,0,74
10969,15866197,15866197,15866286,0,0,0,89
10968,15866166,15866166,15866700,0,0,0,534
10971,15866660,15866660,15866776,0,0,0,116
10972,15866806,15866806,15866922,0,0,0,116
10973,15867039,15867039,15867144,0,0,0,105
10947,15864226,15864226,15867376,0,0,0,3150
10979,15867978,15867978,15868047,0,0,0,69
10978,15867965,15867965,15868068,0,0,0,103
10984,15868254,15868254,15868319,0,0,0,65
10945,15863694,15863694,15868604,0,0,0,4910
10970,15866646,15866646,15868611,0,0,0,1965
10974,15867115,15867115,15869074,0,0,0,1959
10999,15869074,15869074,15869206,0,0,0,132
10975,15867441,15867441,15869367,0,0,0,1926
11000,15869340,15869340,15869477,0,0,0,137
10976,15867573,15867573,15869518,0,0,0,1945
10986,15868362,15868362,15869549,0,0,0,1187
10977,15867699,15867699,15869616,0,0,0,1917
10997,15868978,15868978,15869730,0,0,0,752
11010,15869849,15869849,15869945,0,0,0,96
10981,15868147,15868147,15870092,0,0,0,1945
10868,15849339,15849339,15870143,0,0,0,20804
10694,15783789,15783789,15870189,0,0,0,86400
10985,15868275,15868275,15870195,0,0,0,1920
10869,15849426,15849426,15870230,0,0,0,20804
10987,15868393,15868393,15870289,0,0,0,1896
11003,15869720,15869720,15870322,0,0,0,602
10988,15868499,15868499,15870428,0,0,0,1929
11004,15869816,15869816,15870462,0,0,0,646
11008,15869844,15869844,15870464,0,0,0,620
11006,15869822,15869822,15870490,0,0,0,668
11007,15869839,15869839,15870516,0,0,0,677
10989,15868620,15868620,15870554,0,0,0,1934
10990,15868730,15868730,15870698,0,0,0,1968
10991,15868842,15868842,15870774,0,0,0,1932
10996,15868948,15868948,15870846,0,0,0,1898
11005,15869819,15869819,15870883,0,0,0,1064
11009,15869846,15869846,15870884,0,0,0,1038
11011,15869870,15869870,15870919,0,0,0,1049
10998,15869043,15869043,15870962,0,0,0,1919
10894,15855494,15855494,15871099,0,0,0,15605
11013,15870437,15870437,15871113,0,0,0,676
10908,15855905,15855905,15871156,0,0,0,15251
10903,15855767,15855767,15871261,0,0,0,15494
10898,15855611,15855611,15871281,0,0,0,15670
10808,15842607,15842607,15871477,0,0,0,28870
11017,15871549,15871549,15871620,0,0,0,71
11019,15871642,15871642,15871772,0,0,0,130
11012,15869875,15869875,15872164,0,0,0,2289
10522,15699928,15699928,15872728,0,0,0,172800
10915,15856464,15856464,15872925,0,0,0,16461
11023,15874062,15874062,15874122,0,0,0,60
10866,15847952,15847952,15874363,0,0,0,26411
10937,15862900,15862900,15874546,0,0,0,11646
11024,15874529,15874529,15874589,0,0,0,60
10893,15855475,15855475,15874700,0,0,0,19225
11025,15874707,15874707,15874767,0,0,0,60
11026,15875016,15875016,15875076,0,0,0,60
11027,15875105,15875105,15875165,0,0,0,60
10907,15855867,15855867,15875659,0,0,0,19792
10917,15856616,15856616,15877112,0,0,0,20496
10919,15856892,15856892,15877321,0,0,0,20429
11030,15877191,15877191,15877364,0,0,0,173
11014,15870486,15870486,15878347,0,0,0,7861
10883,15852396,15852396,15879061,0,0,0,26665
10885,15852872,15852872,15879510,0,0,0,26638
10909,15855946,15855946,15879812,0,0,0,23866
10912,15856265,15856265,15880160,0,0,0,23895
11021,15873006,15873006,15880308,0,0,0,7302
11022,15873087,15873087,15881621,0,0,0,8534
11020,15871966,15871966,15883232,0,0,0,11266
10925,15857456,15857456,15883883,0,0,0,26427
11037,15883807,15883807,15883974,0,0,0,167
11038,15883935,15883935,15884101,0,0,0,166
11039,15884069,15884069,15884246,0,0,0,177
10897,15855581,15855581,15885960,0,0,0,30379
10905,15855828,15855828,15886675,0,0,0,30847
10995,15868862,15868862,15887409,0,0,0,18547
10994,15868859,15868859,15887464,0,0,0,18605
10992,15868852,15868852,15887578,0,0,0,18726
10993,15868856,15868856,15887582,0,0,0,18726
10933,15860444,15860444,15889814,0,0,0,29370
11041,15889774,15889774,15889950,0,0,0,176
10982,15868217,15868217,15891188,0,0,0,22971
11001,15869508,15869508,15891544,0,0,0,22036
11002,15869671,15869671,15891930,0,0,0,22259
11016,15871548,15871548,15892358,0,0,0,20810
11018,15871565,15871565,15892364,0,0,0,20799
11029,15877074,15877074,15897443,0,0,0,20369
11031,15877263,15877263,15897694,0,0,0,20431
10891,15855416,15855416,15898616,0,0,0,43200
10892,15855447,15855447,15898647,0,0,0,43200
10895,15855529,15855529,15898729,0,0,0,43200
10896,15855553,15855553,15898753,0,0,0,43200
10899,15855668,15855668,15898868,0,0,0,43200
10900,15855708,15855708,15898908,0,0,0,43200
10902,15855742,15855742,15898942,0,0,0,43200
10904,15855793,15855793,15898993,0,0,0,43200
11015,15871398,15871398,15900490,0,0,0,29092
11047,15900448,15900448,15900652,0,0,0,204
11048,15900579,15900579,15900756,0,0,0,177
11049,15900710,15900710,15900934,0,0,0,224
11032,15877325,15877325,15903369,0,0,0,26044
11035,15879774,15879774,15903635,0,0,0,23861
11036,15880150,15880150,15904021,0,0,0,23871
10768,15812016,15812016,15904650,0,0,0,92634
11033,15878988,15878988,15905875,0,0,0,26887
11034,15879467,15879467,15906416,0,0,0,26949
11040,15884194,15884194,15910602,0,0,0,26408
11043,15892324,15892324,15913076,0,0,0,20752
11044,15892324,15892324,15913149,0,0,0,20825
10914,15856428,15856428,15916808,0,0,0,60380
11045,15897403,15897403,15917944,0,0,0,20541
11046,15897627,15897627,15918111,0,0,0,20484
11042,15889908,15889908,15918903,0,0,0,28995
11061,15918828,15918828,15919000,0,0,0,172
11062,15918958,15918958,15919126,0,0,0,168
11063,15919082,15919082,15919251,0,0,0,169
11064,15919211,15919211,15919382,0,0,0,171
10980,15868044,15868044,15923799,0,0,0,55755
11066,15924321,15924321,15924431,0,0,0,110
11067,15924328,15924328,15924438,0,0,0,110
11068,15924334,15924334,15924480,0,0,0,146
10983,15868230,15868230,15925064,0,0,0,56834
11072,15925178,15925178,15925242,0,0,0,64
11075,15925306,15925306,15925366,0,0,0,60
11077,15926699,15926699,15926871,0,0,0,172
11052,15903594,15903594,15927019,0,0,0,23425
11053,15903977,15903977,15927377,0,0,0,23400
11078,15926881,15926881,15928105,0,0,0,1224
11076,15925722,15925722,15928705,0,0,0,2983
11051,15903326,15903326,15929459,0,0,0,26133
11093,15930042,15930042,15930109,0,0,0,67
11094,15930091,15930091,15930160,0,0,0,69
11050,15900838,15900838,15930186,0,0,0,29348
11097,15930224,15930224,15930286,0,0,0,62
11096,15930219,15930219,15930337,0,0,0,118
11098,15930241,15930241,15930386,0,0,0,145
11099,15930275,15930275,15930392,0,0,0,117
11104,15930777,15930777,15930866,0,0,0,89
11105,15930828,15930828,15930909,0,0,0,81
11103,15930679,15930679,15930995,0,0,0,316
11102,15930554,15930554,15931059,0,0,0,505
11101,15930536,15930536,15931064,0,0,0,528
11106,15931030,15931030,15931098,0,0,0,68
11100,15930366,15930366,15931539,0,0,0,1173
11107,15931988,15931988,15932173,0,0,0,185
11109,15932185,15932185,15932250,0,0,0,65
11108,15932169,15932169,15932310,0,0,0,141
11111,15932325,15932325,15932426,0,0,0,101
11110,15932218,15932218,15932574,0,0,0,356
11054,15905798,15905798,15932883,0,0,0,27085
11084,15929335,15929335,15933201,0,0,0,3866
11081,15927930,15927930,15933228,0,0,0,5298
11085,15929354,15929354,15933231,0,0,0,3877
11086,15929380,15929380,15933251,0,0,0,3871
11088,15929413,15929413,15933295,0,0,0,3882
11089,15929447,15929447,15933305,0,0,0,3858
11082,15928231,15928231,15933312,0,0,0,5081
11083,15928235,15928235,15933327,0,0,0,5092
11090,15929479,15929479,15933338,0,0,0,3859
11055,15906374,15906374,15933448,0,0,0,27074
11129,15933363,15933363,15933552,0,0,0,189
11057,15912998,15912998,15933936,0,0,0,20938
11058,15913107,15913107,15934112,0,0,0,21005
11113,15932759,15932759,15935221,0,0,0,2462
11056,15910536,15910536,15937245,0,0,0,26709
10876,15850819,15850819,15937649,0,0,0,86830
11059,15917866,15917866,15938208,0,0,0,20342
11060,15918068,15918068,15938426,0,0,0,20358
11139,15939590,15939590,15940021,0,0,0,431
11112,15932498,15932498,15940080,0,0,0,7582
11114,15932768,15932768,15940144,0,0,0,7376
11140,15940198,15940198,15940270,0,0,0,72
11141,15940329,15940329,15940402,0,0,0,73
11134,15936374,15936374,15941429,0,0,0,5055
11145,15941625,15941625,15941745,0,0,0,120
11144,15941593,15941593,15941749,0,0,0,156
11122,15933229,15933229,15941789,0,0,0,8560
11126,15933273,15933273,15941789,0,0,0,8516
11127,15933285,15933285,15941790,0,0,0,8505
11119,15933188,15933188,15941792,0,0,0,8604
11117,15933171,15933171,15941797,0,0,0,8626
11118,15933182,15933182,15941797,0,0,0,8615
11123,15933238,15933238,15941798,0,0,0,8560
11121,15933206,15933206,15941799,0,0,0,8593
11125,15933261,15933261,15941799,0,0,0,8538
11128,15933295,15933295,15941836,0,0,0,8541
11120,15933197,15933197,15941837,0,0,0,8640
11092,15929562,15929562,15941846,0,0,0,12284
11124,15933250,15933250,15941846,0,0,0,8596
11091,15929503,15929503,15941908,0,0,0,12405
11142,15940430,15940430,15942185,0,0,0,1755
11143,15941455,15941455,15943209,0,0,0,1754
11149,15943154,15943154,15943299,0,0,0,145
11148,15943112,15943112,15943321,0,0,0,209
11150,15943186,15943186,15943348,0,0,0,162
11151,15943222,15943222,15943370,0,0,0,148
11169,15944230,15944230,15944300,0,0,0,70
11170,15944429,15944429,15944465,0,0,0,36
11171,15945458,15945458,15945815,0,0,0,357
11147,15942143,15942143,15946003,0,0,0,3860
11172,15946704,15946704,15947570,0,0,0,866
11161,15943493,15943493,15948017,0,0,0,4524
11156,15943321,15943321,15948022,0,0,0,4701
11159,15943423,15943423,15948024,0,0,0,4601
11167,15943674,15943674,15948026,0,0,0,4352
11154,15943282,15943282,15948027,0,0,0,4745
11164,15943566,15943566,15948027,0,0,0,4461
11153,15943257,15943257,15948028,0,0,0,4771
11158,15943384,15943384,15948028,0,0,0,4644
11162,15943515,15943515,15948028,0,0,0,4513
11163,15943538,15943538,15948028,0,0,0,4490
11165,15943624,15943624,15948028,0,0,0,4404
11166,15943654,15943654,15948028,0,0,0,4374
11168,15943699,15943699,15948028,0,0,0,4329
11157,15943349,15943349,15948029,0,0,0,4680
11155,15943304,15943304,15948039,0,0,0,4735
11160,15943450,15943450,15948039,0,0,0,4589
11176,15948220,15948220,15948300,0,0,0,80
11065,15919341,15919341,15948421,0,0,0,29080
11175,15948211,15948211,15948429,0,0,0,218
11184,15948342,15948342,15948510,0,0,0,168
11190,15948760,15948760,15948992,0,0,0,232
11189,15948514,15948514,15949014,0,0,0,500
11079,15926949,15926949,15950814,0,0,0,23865
11080,15927337,15927337,15951106,0,0,0,23769
11131,15933746,15933746,15951145,0,0,0,17399
11193,15950878,15950878,15951771,0,0,0,893
11192,15950771,15950771,15952572,0,0,0,1801
11146,15941929,15941929,15953463,0,0,0,11534
11132,15933889,15933889,15954613,0,0,0,20724
11133,15934072,15934072,15954765,0,0,0,20693
11087,15929388,15929388,15955685,0,0,0,26297
11197,15955605,15955605,15955762,0,0,0,157
11198,15955724,15955724,15955874,0,0,0,150
11137,15938171,15938171,15958439,0,0,0,20268
11138,15938385,15938385,15958608,0,0,0,20223
11095,15930110,15930110,15959395,0,0,0,29285
11116,15932809,15932809,15959526,0,0,0,26717
11130,15933365,15933365,15960194,0,0,0,26829
11135,15937203,15937203,15963501,0,0,0,26298
11191,15950742,15950742,15974643,0,0,0,23901
11173,15948177,15948177,15974982,0,0,0,26805
11194,15951063,15951063,15975012,0,0,0,23949
11174,15948199,15948199,15975079,0,0,0,26880
11179,15948285,15948285,15975107,0,0,0,26822
11178,15948268,15948268,15975124,0,0,0,26856
11177,15948243,15948243,15975134,0,0,0,26891
11180,15948303,15948303,15975136,0,0,0,26833
11181,15948316,15948316,15975149,0,0,0,26833
11182,15948326,15948326,15975170,0,0,0,26844
11183,15948337,15948337,15975181,0,0,0,26844
11185,15948350,15948350,15975194,0,0,0,26844
11186,15948361,15948361,15975205,0,0,0,26844
11187,15948371,15948371,15975215,0,0,0,26844
11195,15954576,15954576,15975223,0,0,0,20647
11196,15954729,15954729,15975364,0,0,0,20635
11188,15948468,15948468,15977894,0,0,0,29426
11222,15977855,15977855,15978054,0,0,0,199
11223,15977976,15977976,15978164,0,0,0,188
11200,15958396,15958396,15978747,0,0,0,20351
11201,15958565,15958565,15978844,0,0,0,20279
11199,15955837,15955837,15982244,0,0,0,26407
11203,15959451,15959451,15986264,0,0,0,26813
11204,15960131,15960131,15987100,0,0,0,26969
11202,15959363,15959363,15988561,0,0,0,29198
11230,15988519,15988519,15988677,0,0,0,158
11205,15963458,15963458,15989454,0,0,0,25996
11217,15975152,15975152,15995873,0,0,0,20721
11221,15975322,15975322,15995977,0,0,0,20655
11206,15974601,15974601,15998277,0,0,0,23676
11207,15974929,15974929,15998574,0,0,0,23645
11225,15978668,15978668,15998887,0,0,0,20219
11226,15978802,15978802,15999083,0,0,0,20281
11224,15978088,15978088,16007331,0,0,0,29243
11239,16007296,16007296,16007447,0,0,0,151
11227,15982161,15982161,16008732,0,0,0,26571
11228,15986229,15986229,16012694,0,0,0,26465
11229,15987061,15987061,16013482,0,0,0,26421
11115,15932797,15932797,16015795,0,0,0,82998
11232,15989408,15989408,16015975,0,0,0,26567
11244,16015899,16015899,16016087,0,0,0,188
11233,15995797,15995797,16016457,0,0,0,20660
11234,15995939,15995939,16016706,0,0,0,20767
11231,15988630,15988630,16017656,0,0,0,29026
11248,16017618,16017618,16017800,0,0,0,182
11237,15998854,15998854,16019340,0,0,0,20486
11238,15999037,15999037,16019503,0,0,0,20466
11235,15998235,15998235,16021370,0,0,0,23135
11236,15998535,15998535,16021649,0,0,0,23114
11136,15937613,15937613,16024245,0,0,0,86632
11216,15975141,15975141,16024831,0,0,0,49690
11210,15975069,15975069,16026487,0,0,0,51418
11213,15975105,15975105,16029802,0,0,0,54697
11073,15925224,15925224,16033628,0,0,0,108404
11241,16008699,16008699,16035432,0,0,0,26733
11246,16016410,16016410,16037315,0,0,0,20905
11240,16007406,16007406,16037372,0,0,0,29966
11247,16016627,16016627,16037516,0,0,0,20889
11257,16037326,16037326,16037518,0,0,0,192
11069,15924961,15924961,16038067,0,0,0,113106
11250,16019294,16019294,16039455,0,0,0,20161
11242,16012621,16012621,16039670,0,0,0,27049
11251,16019466,16019466,16039702,0,0,0,20236
11243,16013442,16013442,16040220,0,0,0,26778
11219,15975166,15975166,16040415,0,0,0,65249
11245,16016014,16016014,16042062,0,0,0,26048
11252,16021327,16021327,16045154,0,0,0,23827
11253,16021606,16021606,16045452,0,0,0,23846
11215,15975129,15975129,16045533,0,0,0,70404
11249,16017726,16017726,16047018,0,0,0,29292
11074,15925250,15925250,16047440,0,0,0,122190
11212,15975092,15975092,16049612,0,0,0,74520
11028,15876829,15876829,16049629,0,0,0,172800
11220,15975183,15975183,16050773,0,0,0,75590
11276,16057643,16057643,16057736,0,0,0,93
11256,16037237,16037237,16057803,0,0,0,20566
11278,16057723,16057723,16058013,0,0,0,290
11259,16037480,16037480,16058044,0,0,0,20564
11208,15974947,15974947,16058617,0,0,0,83670
11209,15975041,15975041,16058634,0,0,0,83593
11271,16057130,16057130,16058647,0,0,0,1517
11211,15975082,15975082,16058650,0,0,0,83568
11274,16057246,16057246,16058669,0,0,0,1423
11270,16057116,16057116,16058681,0,0,0,1565
11214,15975119,15975119,16058687,0,0,0,83568
11273,16057213,16057213,16058703,0,0,0,1490
11269,16056597,16056597,16058717,0,0,0,2120
11218,15975153,15975153,16058732,0,0,0,83579
11272,16057189,16057189,16058746,0,0,0,1557
11268,16056582,16056582,16058758,0,0,0,2176
11275,16057567,16057567,16058768,0,0,0,1201
11277,16057690,16057690,16058818,0,0,0,1128
11294,16058735,16058735,16058987,0,0,0,252
11260,16039416,16039416,16060014,0,0,0,20598
11262,16039628,16039628,16060176,0,0,0,20548
11255,16035359,16035359,16061479,0,0,0,26120
11299,16061432,16061432,16061576,0,0,0,144
11070,15925042,15925042,16065590,0,0,0,140548
11261,16039611,16039611,16066287,0,0,0,26676
11263,16040174,16040174,16066750,0,0,0,26576
11258,16037440,16037440,16067191,0,0,0,29751
11264,16041988,16041988,16068636,0,0,0,26648
11265,16045080,16045080,16068926,0,0,0,23846
11266,16045410,16045410,16069185,0,0,0,23775
11267,16046977,16046977,16076671,0,0,0,29694
11279,16057770,16057770,16078729,0,0,0,20959
11280,16057972,16057972,16078924,0,0,0,20952
11297,16059970,16059970,16080282,0,0,0,20312
11298,16060134,16060134,16080478,0,0,0,20344
11316,16081612,16081612,16081698,0,0,0,86
11318,16081620,16081620,16081726,0,0,0,106
11320,16081878,16081878,16082080,0,0,0,202
11321,16082080,16082080,16082308,0,0,0,228
11314,16081605,16081605,16082347,0,0,0,742
11324,16082515,16082515,16082734,0,0,0,219
11323,16082410,16082410,16082745,0,0,0,335
11322,16082319,16082319,16082746,0,0,0,427
11317,16081616,16081616,16082755,0,0,0,1139
11319,16081659,16081659,16082756,0,0,0,1097
11315,16081608,16081608,16082758,0,0,0,1150
11313,16081601,16081601,16082762,0,0,0,1161
11312,16081596,16081596,16082779,0,0,0,1183
11152,15943225,15943225,16083526,0,0,0,140301
11332,16083325,16083325,16083750,0,0,0,425
11331,16083322,16083322,16085402,0,0,0,2080
11300,16061538,16061538,16088040,0,0,0,26502
11330,16083318,16083318,16092000,0,0,0,8682
11305,16068884,16068884,16092578,0,0,0,23694
11301,16066239,16066239,16092760,0,0,0,26521
11306,16069145,16069145,16092849,0,0,0,23704
11302,16066710,16066710,16093273,0,0,0,26563
11304,16068562,16068562,16095148,0,0,0,26586
11339,16095115,16095115,16095272,0,0,0,157
11303,16067154,16067154,16097080,0,0,0,29926
11341,16097034,16097034,16097185,0,0,0,151
11342,16097147,16097147,16097298,0,0,0,151
11343,16097255,16097255,16097406,0,0,0,151
11344,16097363,16097363,16097506,0,0,0,143
11071,15925156,15925156,16097956,0,0,0,172800
11308,16078688,16078688,16099421,0,0,0,20733
11309,16078881,16078881,16099567,0,0,0,20686
11310,16080243,16080243,16100475,0,0,0,20232
11311,16080405,16080405,16100652,0,0,0,20247
11307,16076639,16076639,16106774,0,0,0,30135
11254,16024198,16024198,16110338,0,0,0,86140
11334,16087993,16087993,16114052,0,0,0,26059
11352,16114011,16114011,16114210,0,0,0,199
11353,16114134,16114134,16114322,0,0,0,188
11335,16092535,16092535,16116333,0,0,0,23798
11337,16092768,16092768,16116471,0,0,0,23703
11326,16083297,16083297,16118438,0,0,0,35141
11327,16083300,16083300,16118441,0,0,0,35141
11333,16084542,16084542,16118445,0,0,0,33903
11325,16083294,16083294,16118446,0,0,0,35152
11329,16083312,16083312,16118453,0,0,0,35141
11328,16083303,16083303,16118455,0,0,0,35152
11336,16092684,16092684,16119025,0,0,0,26341
11338,16093192,16093192,16119835,0,0,0,26643
11346,16099378,16099378,16120078,0,0,0,20700
11347,16099523,16099523,16120149,0,0,0,20626
11348,16100430,16100430,16120849,0,0,0,20419
11349,16100608,16100608,16120965,0,0,0,20357
11340,16095226,16095226,16121587,0,0,0,26361
11369,16121548,16121548,16121728,0,0,0,180
11362,16118815,16118815,16123750,0,0,0,4935
11345,16097464,16097464,16127566,0,0,0,30102
11350,16106731,16106731,16136345,0,0,0,29614
11355,16116251,16116251,16139944,0,0,0,23693
11356,16116438,16116438,16140120,0,0,0,23682
11295,16058776,16058776,16140466,0,0,0,81690
11354,16114249,16114249,16140709,0,0,0,26460
11365,16119996,16119996,16140770,0,0,0,20774
11376,16140674,16140674,16140865,0,0,0,191
11378,16140782,16140782,16140933,0,0,0,151
11366,16120106,16120106,16140940,0,0,0,20834
11380,16140900,16140900,16141075,0,0,0,175
11367,16120809,16120809,16141201,0,0,0,20392
11381,16141001,16141001,16141201,0,0,0,200
11382,16141109,16141109,16141257,0,0,0,148
11368,16120922,16120922,16141315,0,0,0,20393
11363,16118950,16118950,16145473,0,0,0,26523
11364,16119802,16119802,16146396,0,0,0,26594
11370,16121654,16121654,16148278,0,0,0,26624
11388,16148232,16148232,16148382,0,0,0,150
11296,16059040,16059040,16152281,0,0,0,93241
11371,16127523,16127523,16156658,0,0,0,29135
11390,16156577,16156577,16156765,0,0,0,188
11391,16156693,16156693,16156881,0,0,0,188
11392,16156806,16156806,16156994,0,0,0,188
11394,16159482,16159482,16159650,0,0,0,168
11405,16159490,16159490,16159651,0,0,0,161
11411,16159491,16159491,16159654,0,0,0,163
11412,16159492,16159492,16159655,0,0,0,163
11404,16159490,16159490,16159661,0,0,0,171
11407,16159490,16159490,16159662,0,0,0,172
11408,16159491,16159491,16159663,0,0,0,172
11409,16159491,16159491,16159663,0,0,0,172
11395,16159487,16159487,16159666,0,0,0,179
11396,16159488,16159488,16159667,0,0,0,179
11406,16159490,16159490,16159667,0,0,0,177
11414,16159492,16159492,16159670,0,0,0,178
11397,16159488,16159488,16159688,0,0,0,200
11398,16159488,16159488,16159688,0,0,0,200
11399,16159488,16159488,16159688,0,0,0,200
11400,16159489,16159489,16159689,0,0,0,200
11410,16159491,16159491,16159689,0,0,0,198
11413,16159492,16159492,16159696,0,0,0,204
11401,16159489,16159489,16159740,0,0,0,251
11402,16159489,16159489,16159740,0,0,0,251
11403,16159489,16159489,16159740,0,0,0,251
11433,16159769,16159769,16159914,0,0,0,145
11452,16159772,16159772,16159915,0,0,0,143
11453,16159772,16159772,16159915,0,0,0,143
11434,16159769,16159769,16159917,0,0,0,148
11444,16159770,16159770,16159918,0,0,0,148
11415,16159764,16159764,16159925,0,0,0,161
11421,16159766,16159766,16159927,0,0,0,161
11416,16159764,16159764,16159930,0,0,0,166
11417,16159765,16159765,16159931,0,0,0,166
11418,16159765,16159765,16159931,0,0,0,166
11436,16159769,16159769,16159934,0,0,0,165
11450,16159771,16159771,16159935,0,0,0,164
11424,16159766,16159766,16159939,0,0,0,173
11437,16159769,16159769,16159939,0,0,0,170
11438,16159769,16159769,16159939,0,0,0,170
11445,16159770,16159770,16159939,0,0,0,169
11425,16159767,16159767,16159940,0,0,0,173
11426,16159767,16159767,16159940,0,0,0,173
11427,16159767,16159767,16159940,0,0,0,173
11439,16159770,16159770,16159940,0,0,0,170
11440,16159770,16159770,16159940,0,0,0,170
11441,16159770,16159770,16159940,0,0,0,170
11428,16159768,16159768,16159941,0,0,0,173
11429,16159768,16159768,16159941,0,0,0,173
11430,16159768,16159768,16159941,0,0,0,173
11431,16159768,16159768,16159941,0,0,0,173
11420,16159765,16159765,16159942,0,0,0,177
11504,16159782,16159782,16159942,0,0,0,160
11461,16159773,16159773,16159943,0,0,0,170
11505,16159782,16159782,16159944,0,0,0,162
11472,16159775,16159775,16159945,0,0,0,170
11473,16159775,16159775,16159945,0,0,0,170
11423,16159766,16159766,16159947,0,0,0,181
11492,16159780,16159780,16159950,0,0,0,170
11493,16159780,16159780,16159950,0,0,0,170
11506,16159782,16159782,16159950,0,0,0,168
11514,16159783,16159783,16159950,0,0,0,167
11422,16159766,16159766,16159951,0,0,0,185
11432,16159769,16159769,16159951,0,0,0,182
11447,16159771,16159771,16159951,0,0,0,180
11448,16159771,16159771,16159951,0,0,0,180
11449,16159771,16159771,16159951,0,0,0,180
11419,16159765,16159765,16159952,0,0,0,187
11455,16159772,16159772,16159952,0,0,0,180
11456,16159772,16159772,16159952,0,0,0,180
11457,16159772,16159772,16159952,0,0,0,180
11458,16159773,16159773,16159953,0,0,0,180
11459,16159773,16159773,16159953,0,0,0,180
11460,16159773,16159773,16159953,0,0,0,180
11464,16159773,16159773,16159953,0,0,0,180
11509,16159783,16159783,16159953,0,0,0,170
11465,16159774,16159774,16159954,0,0,0,180
11466,16159774,16159774,16159954,0,0,0,180
11467,16159774,16159774,16159954,0,0,0,180
11468,16159774,16159774,16159954,0,0,0,180
11469,16159774,16159774,16159954,0,0,0,180
11470,16159774,16159774,16159954,0,0,0,180
11471,16159774,16159774,16159954,0,0,0,180
11511,16159783,16159783,16159954,0,0,0,171
11435,16159769,16159769,16159955,0,0,0,186
11446,16159771,16159771,16159956,0,0,0,185
11474,16159776,16159776,16159956,0,0,0,180
11475,16159776,16159776,16159956,0,0,0,180
11476,16159776,16159776,16159956,0,0,0,180
11477,16159776,16159776,16159956,0,0,0,180
11478,16159777,16159777,16159957,0,0,0,180
11479,16159777,16159777,16159957,0,0,0,180
11480,16159777,16159777,16159957,0,0,0,180
11481,16159777,16159777,16159957,0,0,0,180
11484,16159778,16159778,16159957,0,0,0,179
11485,16159778,16159778,16159957,0,0,0,179
11486,16159779,16159779,16159958,0,0,0,179
11487,16159779,16159779,16159958,0,0,0,179
11488,16159779,16159779,16159958,0,0,0,179
11489,16159779,16159779,16159958,0,0,0,179
11442,16159770,16159770,16159959,0,0,0,189
11443,16159770,16159770,16159959,0,0,0,189
11490,16159780,16159780,16159959,0,0,0,179
11491,16159780,16159780,16159959,0,0,0,179
11494,16159780,16159780,16159960,0,0,0,180
11495,16159780,16159780,16159960,0,0,0,180
11496,16159781,16159781,16159961,0,0,0,180
11497,16159781,16159781,16159961,0,0,0,180
11498,16159781,16159781,16159961,0,0,0,180
11499,16159781,16159781,16159961,0,0,0,180
11500,16159781,16159781,16159961,0,0,0,180
11501,16159781,16159781,16159961,0,0,0,180
11512,16159783,16159783,16159961,0,0,0,178
11513,16159783,16159783,16159961,0,0,0,178
11507,16159782,16159782,16159962,0,0,0,180
11508,16159782,16159782,16159962,0,0,0,180
11510,16159783,16159783,16159964,0,0,0,181
11451,16159771,16159771,16159966,0,0,0,195
11482,16159778,16159778,16159967,0,0,0,189
11483,16159778,16159778,16159967,0,0,0,189
11462,16159773,16159773,16159969,0,0,0,196
11463,16159773,16159773,16159969,0,0,0,196
11502,16159782,16159782,16159972,0,0,0,190
11503,16159782,16159782,16159972,0,0,0,190
11454,16159772,16159772,16159973,0,0,0,201
11377,16140722,16140722,16161654,0,0,0,20932
11379,16140862,16140862,16161754,0,0,0,20892
11383,16141158,16141158,16161798,0,0,0,20640
11385,16141275,16141275,16161840,0,0,0,20565
11374,16139912,16139912,16163989,0,0,0,24077
11375,16140083,16140083,16164129,0,0,0,24046
11373,16136272,16136272,16165977,0,0,0,29705
11384,16141222,16141222,16167477,0,0,0,26255
11386,16145441,16145441,16172040,0,0,0,26599
11387,16146350,16146350,16173113,0,0,0,26763
11389,16148344,16148344,16174875,0,0,0,26531
11525,16174794,16174794,16174982,0,0,0,188
11526,16174910,16174910,16175098,0,0,0,188
11527,16175024,16175024,16175212,0,0,0,188
11528,16175140,16175140,16175328,0,0,0,188
11530,16180459,16180459,16180671,0,0,0,212
11517,16161719,16161719,16182310,0,0,0,20591
11518,16161797,16161797,16182390,0,0,0,20593
11515,16161590,16161590,16182591,0,0,0,21001
11516,16161665,16161665,16182689,0,0,0,21024
11535,16184812,16184812,16184881,0,0,0,69
11393,16156923,16156923,16185199,0,0,0,28276
11536,16185159,16185159,16185340,0,0,0,181
11537,16185273,16185273,16185423,0,0,0,150
11283,16058603,16058603,16186863,0,0,0,128260
11288,16058659,16058659,16187055,0,0,0,128396
11539,16185432,16185432,16187224,0,0,0,1792
11519,16163947,16163947,16187502,0,0,0,23555
11520,16164087,16164087,16187642,0,0,0,23555
11358,16118679,16118679,16191241,0,0,0,72562
11357,16118677,16118677,16191250,0,0,0,72573
11359,16118716,16118716,16191258,0,0,0,72542
11360,16118749,16118749,16191260,0,0,0,72511
11361,16118783,16118783,16191272,0,0,0,72489
11547,16192330,16192330,16192445,0,0,0,115
11522,16167434,16167434,16193660,0,0,0,26226
11549,16193580,16193580,16193762,0,0,0,182
11546,16192272,16192272,16195227,0,0,0,2955
11282,16058591,16058591,16195392,0,0,0,136801
11521,16165939,16165939,16195873,0,0,0,29934
11552,16195832,16195832,16196022,0,0,0,190
11351,16110300,16110300,16196765,0,0,0,86465
11555,16196064,16196064,16196942,0,0,0,878
11554,16196042,16196042,16196943,0,0,0,901
11556,16196090,16196090,16196943,0,0,0,853
11523,16171996,16171996,16198360,0,0,0,26364
11524,16173074,16173074,16199557,0,0,0,26483
11560,16199679,16199679,16199744,0,0,0,65
11561,16199721,16199721,16200157,0,0,0,436
11562,16199734,16199734,16200314,0,0,0,580
11563,16199750,16199750,16201206,0,0,0,1456
11564,16200523,16200523,16201346,0,0,0,823
11566,16200781,16200781,16201543,0,0,0,762
11529,16175254,16175254,16201581,0,0,0,26327
11565,16200742,16200742,16201588,0,0,0,846
11568,16202346,16202346,16202492,0,0,0,146
11569,16202443,16202443,16202585,0,0,0,142
11570,16202525,16202525,16202667,0,0,0,142
11571,16202595,16202595,16202672,0,0,0,77
11572,16202731,16202731,16202787,0,0,0,56
11531,16182275,16182275,16202875,0,0,0,20600
11532,16182349,16182349,16202917,0,0,0,20568
11573,16202765,16202765,16202918,0,0,0,153
11576,16202848,16202848,16202997,0,0,0,149
11577,16202932,16202932,16203083,0,0,0,151
11578,16203007,16203007,16203155,0,0,0,148
11579,16203071,16203071,16203219,0,0,0,148
11580,16203143,16203143,16203306,0,0,0,163
11581,16203206,16203206,16203339,0,0,0,133
11582,16203275,16203275,16203437,0,0,0,162
11583,16203341,16203341,16203469,0,0,0,128
11584,16203397,16203397,16203551,0,0,0,154
11533,16182557,16182557,16203583,0,0,0,21026
11585,16203468,16203468,16203616,0,0,0,148
11534,16182614,16182614,16203651,0,0,0,21037
11587,16203530,16203530,16203656,0,0,0,126
11589,16203600,16203600,16203750,0,0,0,150
11548,16193566,16193566,16204626,0,0,0,11060
11590,16205169,16205169,16205219,0,0,0,50
11591,16205192,16205192,16205989,0,0,0,797
11593,16206056,16206056,16206891,0,0,0,835
11594,16208133,16208133,16208256,0,0,0,123
11595,16208196,16208196,16208267,0,0,0,71
11596,16208353,16208353,16208460,0,0,0,107
11597,16208449,16208449,16208564,0,0,0,115
11599,16210031,16210031,16210148,0,0,0,117
11603,16210110,16210110,16210225,0,0,0,115
11598,16209877,16209877,16210308,0,0,0,431
11600,16210051,16210051,16210611,0,0,0,560
11601,16210060,16210060,16210859,0,0,0,799
11604,16210760,16210760,16210948,0,0,0,188
11602,16210069,16210069,16211453,0,0,0,1384
11541,16187458,16187458,16211524,0,0,0,24066
11542,16187600,16187600,16211883,0,0,0,24283
11605,16210954,16210954,16213780,0,0,0,2826
11609,16213735,16213735,16213834,0,0,0,99
11610,16213907,16213907,16213980,0,0,0,73
11611,16213929,16213929,16214031,0,0,0,102
11612,16213957,16213957,16214031,0,0,0,74
11613,16214121,16214121,16214218,0,0,0,97
11606,16211372,16211372,16214245,0,0,0,2873
11614,16214142,16214142,16214248,0,0,0,106
11616,16214362,16214362,16214420,0,0,0,58
11615,16214317,16214317,16214428,0,0,0,111
11538,16185384,16185384,16215245,0,0,0,29861
11286,16058636,16058636,16217142,0,0,0,158506
11550,16193698,16193698,16220011,0,0,0,26313
11289,16058682,16058682,16220308,0,0,0,161626
11574,16202804,16202804,16223359,0,0,0,20555
11575,16202839,16202839,16223417,0,0,0,20578
11558,16198278,16198278,16224399,0,0,0,26121
11586,16203518,16203518,16224463,0,0,0,20945
11588,16203572,16203572,16224551,0,0,0,20979
11292,16058716,16058716,16224626,0,0,0,165910
11553,16195938,16195938,16224701,0,0,0,28763
11559,16199509,16199509,16225793,0,0,0,26284
11567,16201496,16201496,16227940,0,0,0,26444
11592,16205940,16205940,16229785,0,0,0,23845
11551,16193954,16193954,16229954,0,0,0,36000
11281,16058580,16058580,16231380,0,0,0,172800
11284,16058614,16058614,16231414,0,0,0,172800
11285,16058627,16058627,16231427,0,0,0,172800
11287,16058645,16058645,16231445,0,0,0,172800
11290,16058696,16058696,16231496,0,0,0,172800
11291,16058706,16058706,16231506,0,0,0,172800
11293,16058725,16058725,16231525,0,0,0,172800
11620,16217262,16217262,16232966,0,0,0,15704
11607,16211484,16211484,16235278,0,0,0,23794
11608,16211815,16211815,16235640,0,0,0,23825
11622,16223277,16223277,16243694,0,0,0,20417
11623,16223382,16223382,16243830,0,0,0,20448
11619,16215205,16215205,16244744,0,0,0,29539
11626,16224470,16224470,16245400,0,0,0,20930
11625,16224424,16224424,16245407,0,0,0,20983
11621,16219974,16219974,16246181,0,0,0,26207
11637,16246137,16246137,16246325,0,0,0,188
11624,16224354,16224354,16250669,0,0,0,26315
11628,16225719,16225719,16252268,0,0,0,26549
11627,16224658,16224658,16253156,0,0,0,28498
11629,16227898,16227898,16254382,0,0,0,26484
11630,16235234,16235234,16259121,0,0,0,23887
11631,16235598,16235598,16259404,0,0,0,23806
11632,16243630,16243630,16264320,0,0,0,20690
11633,16243787,16243787,16264576,0,0,0,20789
11635,16245314,16245314,16266046,0,0,0,20732
11636,16245361,16245361,16266127,0,0,0,20766
11638,16246284,16246284,16272326,0,0,0,26042
11540,16186506,16186506,16272608,0,0,0,86102
11651,16272485,16272485,16272612,0,0,0,127
11653,16272725,16272725,16272795,0,0,0,70
11649,16271586,16271586,16273345,0,0,0,1759
11652,16272671,16272671,16273607,0,0,0,936
11658,16273392,16273392,16273891,0,0,0,499
11655,16273301,16273301,16273986,0,0,0,685
11634,16244701,16244701,16274090,0,0,0,29389
11657,16273378,16273378,16274113,0,0,0,735
11659,16273657,16273657,16274288,0,0,0,631
11656,16273323,16273323,16274375,0,0,0,1052
11662,16274646,16274646,16275040,0,0,0,394
11661,16274618,16274618,16275595,0,0,0,977
11664,16275140,16275140,16275980,0,0,0,840
11663,16275068,16275068,16277124,0,0,0,2056
11639,16250628,16250628,16277181,0,0,0,26553
11666,16276953,16276953,16277276,0,0,0,323
11668,16277255,16277255,16277427,0,0,0,172
11665,16276815,16276815,16277615,0,0,0,800
11669,16277402,16277402,16278174,0,0,0,772
11640,16252228,16252228,16278812,0,0,0,26584
11642,16254342,16254342,16280689,0,0,0,26347
11673,16278682,16278682,16280900,0,0,0,2218
11672,16278101,16278101,16281947,0,0,0,3846
11676,16282114,16282114,16282190,0,0,0,76
11643,16259041,16259041,16283127,0,0,0,24086
11641,16253113,16253113,16283166,0,0,0,30053
11644,16259362,16259362,16283465,0,0,0,24103
11557,16196723,16196723,16283496,0,0,0,86773
11677,16282148,16282148,16284419,0,0,0,2271
11645,16264283,16264283,16284999,0,0,0,20716
11679,16282266,16282266,16285052,0,0,0,2786
11646,16264495,16264495,16285234,0,0,0,20739
11670,16277909,16277909,16286197,0,0,0,8288
11687,16285397,16285397,16286229,0,0,0,832
11678,16282227,16282227,16286494,0,0,0,4267
11647,16266013,16266013,16287105,0,0,0,21092
11686,16285355,16285355,16287105,0,0,0,1750
11648,16266089,16266089,16287138,0,0,0,21049
11690,16288129,16288129,16288202,0,0,0,73
11692,16289450,16289450,16289576,0,0,0,126
11696,16290514,16290514,16290608,0,0,0,94
11697,16290566,16290566,16290629,0,0,0,63
11698,16290619,16290619,16290694,0,0,0,75
11699,16290741,16290741,16290811,0,0,0,70
11700,16290839,16290839,16290912,0,0,0,73
11701,16291027,16291027,16291096,0,0,0,69
11705,16291680,16291680,16291787,0,0,0,107
11695,16290069,16290069,16292389,0,0,0,2320
11711,16292833,16292833,16292906,0,0,0,73
11710,16292813,16292813,16293056,0,0,0,243
11712,16293068,16293068,16293141,0,0,0,73
11709,16292764,16292764,16293150,0,0,0,386
11713,16293654,16293654,16293727,0,0,0,73
11714,16293883,16293883,16293956,0,0,0,73
11706,16291725,16291725,16294004,0,0,0,2279
11671,16277940,16277940,16294454,0,0,0,16514
11694,16290042,16290042,16295143,0,0,0,5101
11703,16291282,16291282,16295318,0,0,0,4036
11715,16294999,16294999,16295362,0,0,0,363
11716,16295436,16295436,16295567,0,0,0,131
11718,16295513,16295567,16295771,0,0,54,258
11719,16295706,16295706,16295824,0,0,0,118
11717,16295446,16295446,16295938,0,0,0,492
11721,16295880,16295880,16295958,0,0,0,78
11720,16295727,16295727,16295967,0,0,0,240
11722,16295894,16295894,16296003,0,0,0,109
11723,16295941,16295941,16296011,0,0,0,70
11724,16296009,16296009,16296609,0,0,0,600
11726,16296521,16296521,16296656,0,0,0,135
11727,16296578,16296578,16296876,0,0,0,298
11702,16291205,16291205,16296905,0,0,0,5700
11728,16296753,16296753,16296930,0,0,0,177
11704,16291672,16291672,16297392,0,0,0,5720
11725,16296119,16296119,16297763,0,0,0,1644
11650,16272285,16272285,16298293,0,0,0,26008
11693,16289528,16289528,16298773,0,0,0,9245
11736,16298924,16298924,16298994,0,0,0,70
11731,16297235,16297235,16299079,0,0,0,1844
11733,16297445,16297445,16299469,0,0,0,2024
11730,16297216,16297216,16300501,0,0,0,3285
11732,16297429,16297429,16300781,0,0,0,3352
11707,16292481,16292481,16301176,0,0,0,8695
11737,16298934,16298934,16301718,0,0,0,2784
11739,16300907,16300907,16302618,0,0,0,1711
11372,16130834,16130834,16303634,0,0,0,172800
11660,16274018,16274018,16303769,0,0,0,29751
11667,16277140,16277140,16303809,0,0,0,26669
11738,16300886,16300886,16304134,0,0,0,3248
11674,16278775,16278775,16305148,0,0,0,26373
11734,16297743,16297743,16305409,0,0,0,7666
11684,16284916,16284916,16305594,0,0,0,20678
11729,16296795,16296795,16305795,0,0,0,9000
11685,16285168,16285168,16305815,0,0,0,20647
11743,16301604,16301604,16306621,0,0,0,5017
11675,16280649,16280649,16306694,0,0,0,26045
11680,16283083,16283083,16307110,0,0,0,24027
11682,16283399,16283399,16307424,0,0,0,24025
11689,16287065,16287065,16308127,0,0,0,21062
11688,16287029,16287029,16308229,0,0,0,21200
11741,16301505,16301505,16308807,0,0,0,7302
11758,16310707,16310707,16310822,0,0,0,115
11748,16305532,16305532,16310883,0,0,0,5351
11708,16292488,16292488,16311950,0,0,0,19462
11681,16283091,16283091,16312779,0,0,0,29688
11761,16312700,16312700,16312857,0,0,0,157
11747,16305515,16305515,16318221,0,0,0,12706
11735,16298249,16298249,16324293,0,0,0,26044
11763,16324252,16324252,16324452,0,0,0,200
11764,16324372,16324372,16324534,0,0,0,162
11765,16324498,16324498,16324655,0,0,0,157
11749,16305561,16305561,16326121,0,0,0,20560
11750,16305741,16305741,16326301,0,0,0,20560
11740,16301488,16301488,16329025,0,0,0,27537
11756,16308084,16308084,16329119,0,0,0,21035
11757,16308189,16308189,16329234,0,0,0,21045
11745,16303733,16303733,16330123,0,0,0,26390
11754,16307067,16307067,16331342,0,0,0,24275
11755,16307381,16307381,16331565,0,0,0,24184
11746,16305102,16305102,16331605,0,0,0,26503
11753,16306651,16306651,16332943,0,0,0,26292
11775,16332902,16332902,16333054,0,0,0,152
11744,16303710,16303710,16333425,0,0,0,29715
11742,16301560,16301560,16333657,0,0,0,32097
11762,16312821,16312821,16342061,0,0,0,29240
11778,16342021,16342021,16342178,0,0,0,157
11767,16326074,16326074,16346627,0,0,0,20553
11768,16326230,16326230,16346752,0,0,0,20522
11769,16329038,16329038,16349964,0,0,0,20926
11770,16329151,16329151,16350119,0,0,0,20968
11766,16324610,16324610,16350671,0,0,0,26061
11784,16350600,16350600,16350788,0,0,0,188
11785,16350709,16350709,16350855,0,0,0,146
11691,16288804,16288804,16354429,0,0,0,65625
11772,16331300,16331300,16355557,0,0,0,24257
11773,16331513,16331513,16355743,0,0,0,24230
11789,16355823,16355823,16356423,0,0,0,600
11771,16330079,16330079,16356786,0,0,0,26707
11792,16356923,16356923,16357104,0,0,0,181
11793,16357286,16357286,16357443,0,0,0,157
11543,16192043,16192043,16357485,0,0,0,165442
11774,16331566,16331566,16358515,0,0,0,26949
11776,16333011,16333011,16359142,0,0,0,26131
11797,16360389,16360389,16360493,0,0,0,104
11798,16360439,16360439,16360573,0,0,0,134
11799,16360529,16360529,16360675,0,0,0,146
11802,16362278,16362278,16362381,0,0,0,103
11803,16362342,16362342,16362412,0,0,0,70
11804,16362442,16362442,16362510,0,0,0,68
11805,16362526,16362526,16362576,0,0,0,50
11777,16333347,16333347,16362626,0,0,0,29279
11807,16362635,16362635,16362721,0,0,0,86
11808,16362688,16362688,16362758,0,0,0,70
11809,16362820,16362820,16362890,0,0,0,70
11813,16363559,16363559,16363628,0,0,0,69
11812,16363544,16363544,16363629,0,0,0,85
11810,16363188,16363188,16363861,0,0,0,673
11824,16366160,16366160,16366233,0,0,0,73
11780,16346585,16346585,16367193,0,0,0,20608
11781,16346683,16346683,16367298,0,0,0,20615
11827,16367434,16367434,16367507,0,0,0,73
11828,16367658,16367658,16367754,0,0,0,96
11829,16367716,16367716,16367787,0,0,0,71
11823,16365352,16365352,16368591,0,0,0,3239
11821,16365257,16365257,16368736,0,0,0,3479
11830,16369074,16369074,16369256,0,0,0,182
11831,16369390,16369390,16369437,0,0,0,47
11832,16369494,16369494,16369704,0,0,0,210
11833,16369703,16369703,16369834,0,0,0,131
11683,16283423,16283423,16369835,0,0,0,86412
11834,16370534,16370534,16370670,0,0,0,136
11817,16363743,16363743,16370726,0,0,0,6983
11835,16370633,16370633,16370763,0,0,0,130
11822,16365310,16365310,16370799,0,0,0,5489
11782,16349930,16349930,16370805,0,0,0,20875
11783,16350047,16350047,16370934,0,0,0,20887
11837,16370875,16370875,16371030,0,0,0,155
11839,16371193,16371193,16371340,0,0,0,147
11801,16361858,16361858,16371388,0,0,0,9530
11779,16342131,16342131,16371693,0,0,0,29562
11545,16192239,16192239,16372208,0,0,0,179969
11843,16372305,16372305,16372482,0,0,0,177
11654,16272746,16272746,16372622,0,0,0,99876
11845,16372691,16372691,16372786,0,0,0,95
11844,16372466,16372466,16372818,0,0,0,352
11820,16365010,16365010,16372823,0,0,0,7813
11847,16372897,16372897,16373008,0,0,0,111
11815,16363656,16363656,16373018,0,0,0,9362
11846,16372776,16372776,16373376,0,0,0,600
11840,16371404,16371404,16373454,0,0,0,2050
11617,16214429,16214429,16373635,0,0,0,159206
11618,16214482,16214482,16373646,0,0,0,159164
11544,16192108,16192108,16374684,0,0,0,182576
11850,16375335,16375335,16375383,0,0,0,48
11851,16375779,16375779,16375860,0,0,0,81
11818,16363845,16363845,16376096,0,0,0,12251
11852,16375951,16375951,16376102,0,0,0,151
11853,16376059,16376059,16376137,0,0,0,78
11848,16373436,16373436,16376653,0,0,0,3217
11862,16376545,16376545,16376662,0,0,0,117
11858,16376437,16376437,16376750,0,0,0,313
11854,16376347,16376347,16376751,0,0,0,404
11855,16376358,16376358,16376751,0,0,0,393
11856,16376369,16376369,16376751,0,0,0,382
11857,16376427,16376427,16376751,0,0,0,324
11859,16376504,16376504,16376752,0,0,0,248
11860,16376513,16376513,16376760,0,0,0,247
11861,16376535,16376535,16376760,0,0,0,225
11863,16376599,16376599,16376760,0,0,0,161
11864,16376631,16376631,16376761,0,0,0,130
11865,16376672,16376672,16376780,0,0,0,108
11786,16350817,16350817,16376792,0,0,0,25975
11880,16376947,16376947,16377051,0,0,0,104
11886,16377025,16377025,16377083,0,0,0,58
11890,16377115,16377115,16377210,0,0,0,95
11867,16376750,16376750,16377216,0,0,0,466
11876,16376900,16376900,16377389,0,0,0,489
11868,16376758,16376758,16377390,0,0,0,632
11877,16376923,16376923,16377390,0,0,0,467
11888,16377042,16377042,16377500,0,0,0,458
11878,16376930,16376930,16377523,0,0,0,593
11875,16376892,16376892,16377529,0,0,0,637
11887,16377034,16377034,16377627,0,0,0,593
11869,16376780,16376780,16377696,0,0,0,916
11874,16376880,16376880,16377782,0,0,0,902
11879,16376939,16376939,16377822,0,0,0,883
11893,16377790,16377790,16377868,0,0,0,78
11885,16377019,16377019,16377940,0,0,0,921
11816,16363715,16363715,16377948,0,0,0,14233
11894,16377986,16377986,16378056,0,0,0,70
11895,16378081,16378081,16378206,0,0,0,125
11896,16378305,16378305,16378420,0,0,0,115
11897,16378877,16378877,16378992,0,0,0,115
11898,16379357,16379357,16379472,0,0,0,115
11787,16355509,16355509,16379646,0,0,0,24137
11900,16379656,16379656,16379765,0,0,0,109
11788,16355706,16355706,16379839,0,0,0,24133
11903,16379742,16379742,16379871,0,0,0,129
11908,16379811,16379811,16379948,0,0,0,137
11910,16379817,16379817,16380026,0,0,0,209
11913,16379829,16379829,16380027,0,0,0,198
11907,16379810,16379810,16380030,0,0,0,220
11909,16379813,16379813,16380033,0,0,0,220
11911,16379824,16379824,16380033,0,0,0,209
11906,16379804,16379804,16380035,0,0,0,231
11912,16379827,16379827,16380036,0,0,0,209
11921,16380144,16380144,16380286,0,0,0,142
11922,16380224,16380224,16380295,0,0,0,71
11923,16380240,16380240,16380313,0,0,0,73
11924,16380242,16380242,16380374,0,0,0,132
11915,16380015,16380015,16380399,0,0,0,384
11905,16379785,16379785,16380400,0,0,0,615
11919,16380061,16380061,16380401,0,0,0,340
11916,16380030,16380030,16380403,0,0,0,373
11918,16380052,16380052,16380403,0,0,0,351
11917,16380043,16380043,16380405,0,0,0,362
11901,16379733,16379733,16380407,0,0,0,674
11920,16380079,16380079,16380408,0,0,0,329
11914,16380003,16380003,16380409,0,0,0,406
11935,16380430,16380430,16380541,0,0,0,111
11939,16380754,16380754,16380820,0,0,0,66
11870,16376803,16376803,16381097,0,0,0,4294
11925,16380315,16380315,16381098,0,0,0,783
11873,16376858,16376858,16381217,0,0,0,4359
11926,16380376,16380376,16381278,0,0,0,902
11927,16380380,16380380,16381287,0,0,0,907
11928,16380385,16380385,16381292,0,0,0,907
11929,16380390,16380390,16381297,0,0,0,907
11930,16380397,16380397,16381315,0,0,0,918
11931,16380409,16380409,16381327,0,0,0,918
11884,16377000,16377000,16381334,0,0,0,4334
11932,16380414,16380414,16381343,0,0,0,929
11881,16376958,16376958,16381358,0,0,0,4400
11933,16380418,16380418,16381358,0,0,0,940
11934,16380424,16380424,16381375,0,0,0,951
11936,16380457,16380457,16381394,0,0,0,937
11938,16380496,16380496,16381400,0,0,0,904
11937,16380479,16380479,16381405,0,0,0,926
11940,16381028,16381028,16381417,0,0,0,389
11953,16381397,16381397,16381444,0,0,0,47
11954,16381500,16381500,16381571,0,0,0,71
11941,16381234,16381234,16382183,0,0,0,949
11871,16376823,16376823,16382223,0,0,0,5400
11872,16376850,16376850,16382250,0,0,0,5400
11882,16376967,16376967,16382367,0,0,0,5400
11883,16376990,16376990,16382390,0,0,0,5400
11955,16382333,16382333,16382432,0,0,0,99
11958,16382473,16382473,16382740,0,0,0,267
11957,16382440,16382440,16382837,0,0,0,397
11960,16382799,16382799,16382902,0,0,0,103
11791,16356709,16356709,16383017,0,0,0,26308
11947,16381308,16381308,16383102,0,0,0,1794
11952,16381363,16381363,16383102,0,0,0,1739
11945,16381271,16381271,16383103,0,0,0,1832
11948,16381321,16381321,16383104,0,0,0,1783
11944,16381262,16381262,16383105,0,0,0,1843
11951,16381355,16381355,16383105,0,0,0,1750
11943,16381252,16381252,16383106,0,0,0,1854
11949,16381335,16381335,16383107,0,0,0,1772
11946,16381292,16381292,16383108,0,0,0,1816
11942,16381244,16381244,16383109,0,0,0,1865
11950,16381345,16381345,16383117,0,0,0,1772
11962,16383055,16383055,16383228,0,0,0,173
11974,16383343,16383343,16383471,0,0,0,128
11975,16383411,16383411,16383512,0,0,0,101
11976,16383697,16383697,16383806,0,0,0,109
11889,16377105,16377105,16383835,0,0,0,6730
11964,16383079,16383079,16384034,0,0,0,955
11966,16383088,16383088,16384116,0,0,0,1028
11977,16384010,16384010,16384116,0,0,0,106
11967,16383094,16383094,16384133,0,0,0,1039
11970,16383129,16383129,16384161,0,0,0,1032
11980,16384052,16384052,16384173,0,0,0,121
11973,16383146,16383146,16384178,0,0,0,1032
11800,16361821,16361821,16384351,0,0,0,22530
11814,16363640,16363640,16384497,0,0,0,20857
11986,16384497,16384497,16384548,0,0,0,51
11985,16384455,16384455,16384580,0,0,0,125
11795,16358434,16358434,16384776,0,0,0,26342
11988,16384733,16384733,16384864,0,0,0,131
11990,16384974,16384974,16385099,0,0,0,125
11796,16359100,16359100,16385142,0,0,0,26042
11992,16385311,16385311,16385446,0,0,0,135
11993,16385613,16385613,16385748,0,0,0,135
11994,16385903,16385903,16386027,0,0,0,124
11989,16384762,16384762,16386129,0,0,0,1367
11902,16379735,16379735,16386377,0,0,0,6642
11995,16386240,16386240,16386378,0,0,0,138
11996,16386312,16386312,16386418,0,0,0,106
11997,16386533,16386533,16386626,0,0,0,93
11998,16386696,16386696,16386793,0,0,0,97
11999,16386798,16386798,16386933,0,0,0,135
12000,16387027,16387027,16387138,0,0,0,111
12001,16387059,16387059,16387197,0,0,0,138
12002,16387240,16387240,16387314,0,0,0,74
12003,16387329,16387329,16387433,0,0,0,104
12004,16387504,16387504,16387620,0,0,0,116
12005,16387665,16387665,16387738,0,0,0,73
11825,16367156,16367156,16387846,0,0,0,20690
12006,16387784,16387784,16387910,0,0,0,126
12008,16387853,16387853,16387913,0,0,0,60
11826,16367258,16367258,16387916,0,0,0,20658
12009,16387935,16387935,16387995,0,0,0,60
12010,16387981,16387981,16388087,0,0,0,106
12011,16388036,16388036,16388125,0,0,0,89
12012,16388054,16388054,16388181,0,0,0,127
12013,16388190,16388190,16388265,0,0,0,75
12014,16388245,16388245,16388305,0,0,0,60
12015,16388303,16388303,16388389,0,0,0,86
12016,16388403,16388403,16388513,0,0,0,110
12017,16388465,16388465,16388525,0,0,0,60
12018,16388531,16388531,16388627,0,0,0,96
12019,16388536,16388536,16388664,0,0,0,128
12021,16388808,16388808,16388919,0,0,0,111
12022,16388840,16388840,16388979,0,0,0,139
11751,16306109,16306109,16389039,0,0,0,82930
12023,16388978,16388978,16389081,0,0,0,103
12024,16389144,16389144,16389204,0,0,0,60
12025,16389238,16389238,16389357,0,0,0,119
11759,16311081,16311081,16389590,0,0,0,78509
11760,16311312,16311312,16389593,0,0,0,78281
12026,16389494,16389494,16389631,0,0,0,137
12020,16388702,16388702,16389805,0,0,0,1103
12027,16389710,16389710,16389812,0,0,0,102
12028,16389935,16389935,16390024,0,0,0,89
12029,16390089,16390089,16390162,0,0,0,73
12030,16390416,16390416,16390489,0,0,0,73
11806,16362586,16362586,16391483,0,0,0,28897
12040,16391446,16391446,16391645,0,0,0,199
12041,16391566,16391566,16391754,0,0,0,188
11836,16370763,16370763,16391813,0,0,0,21050
12042,16391681,16391681,16391871,0,0,0,190
11838,16370901,16370901,16391909,0,0,0,21008
11972,16383140,16383140,16392122,0,0,0,8982
11971,16383136,16383136,16392129,0,0,0,8993
11983,16384154,16384154,16392137,0,0,0,7983
12033,16390804,16390804,16392948,0,0,0,2144
12032,16390801,16390801,16393186,0,0,0,2385
11891,16377204,16377204,16395204,0,0,0,18000
12031,16390792,16390792,16395432,0,0,0,4640
12039,16390858,16390858,16395989,0,0,0,5131
12051,16396163,16396163,16396271,0,0,0,108
12038,16390853,16390853,16396292,0,0,0,5439
12036,16390832,16390832,16396467,0,0,0,5635
12052,16396183,16396183,16396694,0,0,0,511
12035,16390810,16390810,16397234,0,0,0,6424
11794,16357408,16357408,16399681,0,0,0,42273
11841,16371657,16371657,16402468,0,0,0,30811
12034,16390806,16390806,16402884,0,0,0,12078
12037,16390842,16390842,16402911,0,0,0,12069
11899,16379605,16379605,16403584,0,0,0,23979
11904,16379772,16379772,16403704,0,0,0,23932
11866,16376726,16376726,16404258,0,0,0,27532
12061,16405408,16405408,16405560,0,0,0,152
11892,16377394,16377394,16406789,0,0,0,29395
11961,16382982,16382982,16409241,0,0,0,26259
11987,16384713,16384713,16411683,0,0,0,26970
11991,16385096,16385096,16412673,0,0,0,27577
12067,16412633,16412633,16412796,0,0,0,163
12056,16400374,16400374,16414820,0,0,0,14446
12048,16395257,16395257,16415958,0,0,0,20701
12047,16395228,16395228,16415962,0,0,0,20734
12057,16400380,16400380,16416629,0,0,0,16249
12049,16395606,16395606,16416665,0,0,0,21059
12050,16395642,16395642,16416691,0,0,0,21049
12043,16391805,16391805,16421358,0,0,0,29553
11984,16384338,16384338,16424249,0,0,0,39911
11978,16384019,16384019,16425213,0,0,0,41194
12075,16412965,16412965,16426870,0,0,0,13905
12069,16412916,16412916,16427225,0,0,0,14309
12073,16412940,16412940,16427456,0,0,0,14516
12058,16403517,16403517,16427478,0,0,0,23961
12071,16412934,16412934,16427505,0,0,0,14571
12059,16403621,16403621,16427623,0,0,0,24002
12070,16412920,16412920,16428803,0,0,0,15883
12074,16412942,16412942,16429257,0,0,0,16315
12076,16412968,16412968,16429293,0,0,0,16325
12072,16412937,16412937,16429340,0,0,0,16403
12060,16404219,16404219,16430114,0,0,0,25895
12084,16430071,16430071,16430217,0,0,0,146
12062,16405517,16405517,16435020,0,0,0,29503
12063,16409198,16409198,16435455,0,0,0,26257
12078,16415883,16415883,16436461,0,0,0,20578
12077,16415882,16415882,16436492,0,0,0,20610
12079,16416595,16416595,16437745,0,0,0,21150
12080,16416623,16416623,16437856,0,0,0,21233
12066,16411609,16411609,16438095,0,0,0,26486
12068,16412797,16412797,16438745,0,0,0,25948
12095,16448199,16448199,16448382,0,0,0,183
12096,16448774,16448774,16448940,0,0,0,166
12098,16449061,16449061,16449134,0,0,0,73
12097,16448986,16448986,16449144,0,0,0,158
12100,16449334,16449334,16449434,0,0,0,100
12099,16449322,16449322,16449444,0,0,0,122
12101,16449451,16449451,16449554,0,0,0,103
12104,16449850,16449850,16449953,0,0,0,103
12105,16449863,16449863,16450059,0,0,0,196
12103,16449833,16449833,16450181,0,0,0,348
12106,16450189,16450189,16450284,0,0,0,95
12108,16450275,16450275,16450615,0,0,0,340
12109,16450567,16450567,16450647,0,0,0,80
12110,16450661,16450661,16450774,0,0,0,113
12107,16450233,16450233,16450822,0,0,0,589
12111,16450717,16450717,16450828,0,0,0,111
12081,16421316,16421316,16450858,0,0,0,29542
12114,16450801,16450801,16450889,0,0,0,88
12115,16450809,16450809,16450970,0,0,0,161
12117,16450927,16450927,16451084,0,0,0,157
12118,16451041,16451041,16451190,0,0,0,149
12113,16450795,16450795,16451328,0,0,0,533
12120,16451222,16451222,16451329,0,0,0,107
12112,16450758,16450758,16451660,0,0,0,902
12082,16427419,16427419,16451669,0,0,0,24250
12122,16451475,16451475,16451698,0,0,0,223
12083,16427559,16427559,16451826,0,0,0,24267
12126,16451935,16451935,16452077,0,0,0,142
12123,16451504,16451504,16452166,0,0,0,662
12128,16452054,16452054,16452259,0,0,0,205
12121,16451461,16451461,16452595,0,0,0,1134
12129,16452078,16452078,16452641,0,0,0,563
12130,16452264,16452264,16452796,0,0,0,532
12127,16451984,16451984,16452934,0,0,0,950
12134,16455298,16455298,16455402,0,0,0,104
12135,16455551,16455551,16455677,0,0,0,126
12085,16430217,16430217,16456646,0,0,0,26429
12089,16436502,16436502,16457045,0,0,0,20543
12088,16436486,16436486,16457052,0,0,0,20566
12131,16452511,16452511,16457919,0,0,0,5408
12139,16458355,16458355,16458481,0,0,0,126
12090,16437730,16437730,16458736,0,0,0,21006
12132,16454298,16454298,16458816,0,0,0,4518
12091,16437849,16437849,16458866,0,0,0,21017
12142,16458869,16458869,16459116,0,0,0,247
12143,16459213,16459213,16459260,0,0,0,47
12144,16459569,16459569,16459617,0,0,0,48
12145,16459614,16459614,16459858,0,0,0,244
12148,16460890,16460890,16461192,0,0,0,302
12147,16460660,16460660,16461228,0,0,0,568
12146,16460639,16460639,16461587,0,0,0,948
12087,16435414,16435414,16461744,0,0,0,26330
12152,16462071,16462071,16462339,0,0,0,268
12156,16462722,16462722,16462997,0,0,0,275
12157,16463634,16463634,16463677,0,0,0,43
12149,16460959,16460959,16463743,0,0,0,2784
12158,16463661,16463661,16463775,0,0,0,114
12159,16463814,16463814,16463928,0,0,0,114
12160,16463876,16463876,16463936,0,0,0,60
12161,16463878,16463878,16463969,0,0,0,91
12162,16464022,16464022,16464120,0,0,0,98
12086,16434978,16434978,16464156,0,0,0,29178
12164,16464247,16464247,16464341,0,0,0,94
12093,16438745,16438745,16464504,0,0,0,25759
12092,16438087,16438087,16464797,0,0,0,26710
12168,16465128,16465128,16465195,0,0,0,67
12169,16465240,16465240,16465334,0,0,0,94
12170,16465864,16465864,16465958,0,0,0,94
12171,16466323,16466323,16466390,0,0,0,67
12166,16464673,16464673,16466844,0,0,0,2171
12172,16466789,16466789,16466868,0,0,0,79
12102,16449493,16449493,16467251,0,0,0,17758
12173,16469515,16469515,16469605,0,0,0,90
12174,16469974,16469974,16470063,0,0,0,89
12175,16470203,16470203,16470307,0,0,0,104
12176,16470269,16470269,16470803,0,0,0,534
12181,16470743,16470743,16470832,0,0,0,89
12182,16471201,16471201,16471316,0,0,0,115
12183,16471270,16471270,16471514,0,0,0,244
12054,16396621,16396621,16472291,0,0,0,75670
12184,16472986,16472986,16473056,0,0,0,70
12007,16387837,16387837,16474237,0,0,0,86400
12124,16451661,16451661,16475746,0,0,0,24085
12125,16451857,16451857,16475932,0,0,0,24075
12188,16477240,16477240,16477323,0,0,0,83
12189,16477542,16477542,16477631,0,0,0,89
12138,16457008,16457008,16477767,0,0,0,20759
12137,16457007,16457007,16477806,0,0,0,20799
12191,16478524,16478524,16478598,0,0,0,74
12192,16478529,16478529,16478632,0,0,0,103
11752,16306155,16306155,16478955,0,0,0,172800
12045,16393866,16393866,16479121,0,0,0,85255
12046,16393892,16393892,16479125,0,0,0,85233
12150,16461276,16461276,16479276,0,0,0,18000
12140,16458664,16458664,16479553,0,0,0,20889
12141,16458829,16458829,16479780,0,0,0,20951
12119,16451152,16451152,16480460,0,0,0,29308
12044,16393816,16393816,16480816,0,0,0,87000
12136,16456643,16456643,16482699,0,0,0,26056
12199,16482698,16482698,16482873,0,0,0,175
12200,16482804,16482804,16482992,0,0,0,188
12201,16482913,16482913,16483101,0,0,0,188
12133,16455042,16455042,16485639,0,0,0,30597
12151,16461699,16461699,16488508,0,0,0,26809
12195,16478772,16478772,16489070,0,0,0,10298
12194,16478742,16478742,16490073,0,0,0,11331
12167,16464763,16464763,16491841,0,0,0,27078
12165,16464461,16464461,16492720,0,0,0,28259
12163,16464156,16464156,16493951,0,0,0,29795
12064,16410200,16410200,16495358,0,0,0,85158
12065,16410237,16410237,16495418,0,0,0,85181
12205,16497600,16497600,16497788,0,0,0,188
12206,16497715,16497715,16497903,0,0,0,188
12207,16497829,16497829,16498017,0,0,0,188
12190,16477808,16477808,16498738,0,0,0,20930
12179,16470418,16470418,16499218,0,0,0,28800
12180,16470443,16470443,16499243,0,0,0,28800
12193,16478638,16478638,16499297,0,0,0,20659
12185,16475712,16475712,16499752,0,0,0,24040
12216,16499661,16499661,16499840,0,0,0,179
12186,16475889,16475889,16499944,0,0,0,24055
12222,16499699,16499699,16499975,0,0,0,276
12221,16499697,16499697,16499985,0,0,0,288
12218,16499690,16499690,16500397,0,0,0,707
12217,16499663,16499663,16500406,0,0,0,743
12214,16499656,16499656,16500442,0,0,0,786
12213,16499654,16499654,16500471,0,0,0,817
12196,16479583,16479583,16500753,0,0,0,21170
12197,16479740,16479740,16500961,0,0,0,21221
12202,16483028,16483028,16508976,0,0,0,25948
12198,16480416,16480416,16509987,0,0,0,29571
12203,16488468,16488468,16515162,0,0,0,26694
12155,16462418,16462418,16516374,0,0,0,53956
12153,16462332,16462332,16518730,0,0,0,56398
12209,16498690,16498690,16519336,0,0,0,20646
12210,16499253,16499253,16519861,0,0,0,20608
11849,16373670,16373670,16521115,0,0,0,147445
12224,16500711,16500711,16521760,0,0,0,21049
12225,16500920,16500920,16521978,0,0,0,21058
12219,16499690,16499690,16522947,0,0,0,23257
12223,16499903,16499903,16523176,0,0,0,23273
12204,16493868,16493868,16523620,0,0,0,29752
12208,16497945,16497945,16524032,0,0,0,26087
12234,16523997,16523997,16524148,0,0,0,151
12235,16524105,16524105,16524256,0,0,0,151
12236,16524214,16524214,16524363,0,0,0,149
12211,16499327,16499327,16526074,0,0,0,26747
11959,16382476,16382476,16531299,0,0,0,148823
12154,16462384,16462384,16533128,0,0,0,70744
12239,16534921,16534921,16535024,0,0,0,103
12226,16508940,16508940,16535232,0,0,0,26292
12242,16535184,16535184,16535352,0,0,0,168
12244,16535311,16535311,16535461,0,0,0,150
12246,16535645,16535645,16535718,0,0,0,73
12248,16536086,16536086,16536150,0,0,0,64
12252,16538013,16538013,16538084,0,0,0,71
12253,16538084,16538084,16538199,0,0,0,115
12227,16509916,16509916,16539397,0,0,0,29481
12257,16538927,16538927,16539746,0,0,0,819
12228,16515089,16515089,16541704,0,0,0,26615
12177,16470275,16470275,16542275,0,0,0,72000
12178,16470278,16470278,16542278,0,0,0,72000
12229,16521717,16521717,16542786,0,0,0,21069
12230,16521915,16521915,16542922,0,0,0,21007
12231,16522915,16522915,16546237,0,0,0,23322
12232,16523131,16523131,16546368,0,0,0,23237
12263,16547517,16547517,16547672,0,0,0,155
12094,16446534,16446534,16550122,0,0,0,103588
11981,16384080,16384080,16550128,0,0,0,166048
11979,16384045,16384045,16550130,0,0,0,166085
11965,16383083,16383083,16550134,0,0,0,167051
11956,16382335,16382335,16550135,0,0,0,167800
11963,16383075,16383075,16550137,0,0,0,167062
11969,16383108,16383108,16550137,0,0,0,167029
11968,16383099,16383099,16550139,0,0,0,167040
11982,16384105,16384105,16550139,0,0,0,166034
12237,16524320,16524320,16550364,0,0,0,26044
12266,16551400,16551400,16551597,0,0,0,197
12267,16551405,16551405,16551602,0,0,0,197
12265,16551396,16551396,16551604,0,0,0,208
12238,16526031,16526031,16552688,0,0,0,26657
12233,16523586,16523586,16552893,0,0,0,29307
12283,16552852,16552852,16553003,0,0,0,151
12285,16555367,16555367,16555730,0,0,0,363
12279,16552575,16552575,16556603,0,0,0,4028
12278,16552548,16552548,16556604,0,0,0,4056
12280,16552583,16552583,16556633,0,0,0,4050
12281,16552587,16552587,16556637,0,0,0,4050
12268,16552297,16552297,16556649,0,0,0,4352
12275,16552374,16552374,16556662,0,0,0,4288
12269,16552302,16552302,16556676,0,0,0,4374
12270,16552305,16552305,16556701,0,0,0,4396
12271,16552349,16552349,16556714,0,0,0,4365
12272,16552353,16552353,16556729,0,0,0,4376
12273,16552365,16552365,16556741,0,0,0,4376
12274,16552368,16552368,16556755,0,0,0,4387
12276,16552378,16552378,16556765,0,0,0,4387
12277,16552382,16552382,16556769,0,0,0,4387
12288,16556573,16556573,16556902,0,0,0,329
12290,16556600,16556600,16556907,0,0,0,307
12287,16556559,16556559,16556911,0,0,0,352
12289,16556593,16556593,16556911,0,0,0,318
12304,16558531,16558531,16558635,0,0,0,104
12305,16558822,16558822,16558917,0,0,0,95
12306,16558887,16558887,16558991,0,0,0,104
12307,16559055,16559055,16559215,0,0,0,160
12308,16560922,16560922,16560970,0,0,0,48
12309,16561050,16561050,16561098,0,0,0,48
12243,16535234,16535234,16561435,0,0,0,26201
12245,16535423,16535423,16561485,0,0,0,26062
12259,16541667,16541667,16568381,0,0,0,26714
12258,16539315,16539315,16569194,0,0,0,29879
12313,16569160,16569160,16569317,0,0,0,157
12314,16569270,16569270,16569420,0,0,0,150
12260,16546163,16546163,16570078,0,0,0,23915
12261,16546328,16546328,16570254,0,0,0,23926
12212,16499648,16499648,16571648,0,0,0,72000
12215,16499659,16499659,16571659,0,0,0,72000
12220,16499694,16499694,16571694,0,0,0,72000
12254,16538727,16538727,16574727,0,0,0,36000
12255,16538731,16538731,16574731,0,0,0,36000
12256,16538735,16538735,16574735,0,0,0,36000
12264,16550322,16550322,16576065,0,0,0,25743
12318,16575989,16575989,16576177,0,0,0,188
12282,16552646,16552646,16579509,0,0,0,26863
12284,16552961,16552961,16582669,0,0,0,29708
12321,16582575,16582575,16582732,0,0,0,157
12310,16561412,16561412,16587644,0,0,0,26232
12316,16570032,16570032,16594162,0,0,0,24130
12317,16570211,16570211,16594323,0,0,0,24112
12312,16568299,16568299,16594767,0,0,0,26468
12315,16569384,16569384,16598475,0,0,0,29091
12327,16598430,16598430,16598581,0,0,0,151
12247,16535820,16535820,16599526,0,0,0,63706
12319,16576135,16576135,16602489,0,0,0,26354
12311,16563153,16563153,16606438,0,0,0,43285
12320,16579466,16579466,16606545,0,0,0,27079
12251,16537827,16537827,16607658,0,0,0,69831
12322,16582695,16582695,16612512,0,0,0,29817
12323,16587596,16587596,16613928,0,0,0,26332
11790,16356664,16356664,16614766,0,0,0,258102
11811,16363271,16363271,16615871,0,0,0,252600
11819,16363917,16363917,16616517,0,0,0,252600
12324,16594093,16594093,16618182,0,0,0,24089
12325,16594283,16594283,16618370,0,0,0,24087
12240,16534939,16534939,16620206,0,0,0,85267
12326,16594692,16594692,16621649,0,0,0,26957
12116,16450846,16450846,16623646,0,0,0,172800
12241,16535012,16535012,16623777,0,0,0,88765
12249,16536127,16536127,16625592,0,0,0,89465
12329,16602419,16602419,16628511,0,0,0,26092
12328,16598541,16598541,16628619,0,0,0,30078
12337,16628466,16628466,16628647,0,0,0,181
12338,16628566,16628566,16628738,0,0,0,172
12339,16628578,16628578,16628759,0,0,0,181
11842,16372167,16372167,16631367,0,0,0,259200
12330,16606498,16606498,16633362,0,0,0,26864
12291,16556609,16556609,16636447,0,0,0,79838
12344,16637937,16637937,16637988,0,0,0,51
12296,16556703,16556703,16638325,0,0,0,81622
12299,16556736,16556736,16638325,0,0,0,81589
12297,16556715,16556715,16638326,0,0,0,81611
12298,16556728,16556728,16638328,0,0,0,81600
12301,16556903,16556903,16638328,0,0,0,81425
12293,16556630,16556630,16638329,0,0,0,81699
12302,16556906,16556906,16638331,0,0,0,81425
12303,16556917,16556917,16638331,0,0,0,81414
12292,16556622,16556622,16638332,0,0,0,81710
12294,16556679,16556679,16638334,0,0,0,81655
12295,16556690,16556690,16638334,0,0,0,81644
12300,16556899,16556899,16638335,0,0,0,81436
12343,16636425,16636425,16638349,0,0,0,1924
12332,16613891,16613891,16639911,0,0,0,26020
12349,16639870,16639870,16640023,0,0,0,153
12354,16639925,16639925,16640058,0,0,0,133
12357,16639947,16639947,16640058,0,0,0,111
12352,16639916,16639916,16640060,0,0,0,144
12356,16639939,16639939,16640061,0,0,0,122
12350,16639907,16639907,16640062,0,0,0,155
12355,16639929,16639929,16640062,0,0,0,133
12358,16639952,16639952,16640063,0,0,0,111
12353,16639920,16639920,16640064,0,0,0,144
12351,16639911,16639911,16640066,0,0,0,155
12359,16639981,16639981,16640156,0,0,0,175
12331,16612474,16612474,16642123,0,0,0,29649
12370,16642081,16642081,16642227,0,0,0,146
12334,16618137,16618137,16642359,0,0,0,24222
12335,16618290,16618290,16642554,0,0,0,24264
12286,16556505,16556505,16645169,0,0,0,88664
12336,16621604,16621604,16648480,0,0,0,26876
12187,16476894,16476894,16649694,0,0,0,172800
12341,16628696,16628696,16655055,0,0,0,26359
12053,16396234,16396234,16655434,0,0,0,259200
12055,16396673,16396673,16655873,0,0,0,259200
12379,16657584,16657584,16657959,0,0,0,375
12380,16658117,16658117,16658431,0,0,0,314
12340,16628670,16628670,16658585,0,0,0,29915
12342,16633284,16633284,16660337,0,0,0,27053
12383,16660686,16660686,16660999,0,0,0,313
12262,16547189,16547189,16666004,0,0,0,118815
12384,16665782,16665782,16666070,0,0,0,288
12372,16642319,16642319,16666523,0,0,0,24204
12386,16666464,16666464,16666697,0,0,0,233
12363,16640089,16640089,16666740,0,0,0,26651
12373,16642472,16642472,16666767,0,0,0,24295
12387,16666666,16666666,16667961,0,0,0,1295
12389,16667919,16667919,16668121,0,0,0,202
12371,16642184,16642184,16671830,0,0,0,29646
12374,16648410,16648410,16675152,0,0,0,26742
12376,16655017,16655017,16681025,0,0,0,26008
12377,16655926,16655926,16683042,0,0,0,27116
12382,16660306,16660306,16687027,0,0,0,26721
12381,16658502,16658502,16688186,0,0,0,29684
12396,16688154,16688154,16688305,0,0,0,151
12385,16666450,16666450,16690675,0,0,0,24225
12388,16666698,16666698,16690918,0,0,0,24220
12390,16668078,16668078,16694185,0,0,0,26107
12392,16671747,16671747,16701943,0,0,0,30196
12393,16675108,16675108,16701993,0,0,0,26885
12401,16701911,16701911,16702061,0,0,0,150
12378,16656094,16656094,16705843,0,0,0,49749
12394,16680980,16680980,16707089,0,0,0,26109
12333,16614703,16614703,16707926,0,0,0,93223
12405,16708924,16708924,16709043,0,0,0,119
12250,16537397,16537397,16710197,0,0,0,172800
12406,16708994,16708994,16712212,0,0,0,3218
12407,16713681,16713681,16713797,0,0,0,116
12395,16686984,16686984,16713911,0,0,0,26927
12398,16690633,16690633,16714739,0,0,0,24106
12399,16690884,16690884,16715058,0,0,0,24174
12397,16688263,16688263,16718019,0,0,0,29756
12400,16694138,16694138,16720456,0,0,0,26318
12409,16714523,16714523,16726285,0,0,0,11762
12402,16701950,16701950,16728722,0,0,0,26772
12403,16702020,16702020,16731954,0,0,0,29934
12404,16707020,16707020,16733519,0,0,0,26499
12420,16733477,16733477,16733656,0,0,0,179
12348,16639681,16639681,16738807,0,0,0,99126
12410,16714698,16714698,16738903,0,0,0,24205
12422,16738761,16738761,16739010,0,0,0,249
12411,16715018,16715018,16739182,0,0,0,24164
12345,16639670,16639670,16739680,0,0,0,100010
12347,16639677,16639677,16740443,0,0,0,100766
12346,16639674,16639674,16740783,0,0,0,101109
12408,16713831,16713831,16740826,0,0,0,26995
12416,16720414,16720414,16746639,0,0,0,26225
12426,16746561,16746561,16746707,0,0,0,146
12415,16717976,16717976,16747508,0,0,0,29532
12428,16747466,16747466,16747614,0,0,0,148
12391,16668390,16668390,16753540,0,0,0,85150
12418,16728684,16728684,16755492,0,0,0,26808
12421,16733583,16733583,16759740,0,0,0,26157
12431,16759693,16759693,16759844,0,0,0,151
12419,16731908,16731908,16761853,0,0,0,29945
12433,16761812,16761812,16761961,0,0,0,149
12434,16761921,16761921,16762072,0,0,0,151
12435,16762030,16762030,16762213,0,0,0,183
12425,16740791,16740791,16767728,0,0,0,26937
12365,16640118,16640118,16772570,0,0,0,132452
12427,16746672,16746672,16773258,0,0,0,26586
12438,16773187,16773187,16773376,0,0,0,189
12439,16773294,16773294,16773475,0,0,0,181
12429,16747571,16747571,16777695,0,0,0,30124
12441,16777650,16777650,16777798,0,0,0,148
12442,16777758,16777758,16777908,0,0,0,150
12430,16755460,16755460,16782481,0,0,0,27021
12367,16640148,16640148,16783136,0,0,0,142988
12412,16716317,16716317,16785154,0,0,0,68837
12432,16759806,16759806,16785903,0,0,0,26097
12445,16785859,16785859,16786005,0,0,0,146
12446,16785965,16785965,16786120,0,0,0,155
12447,16786073,16786073,16786222,0,0,0,149
12448,16786184,16786184,16786333,0,0,0,149
12436,16762139,16762139,16791790,0,0,0,29651
12437,16767655,16767655,16794523,0,0,0,26868
12375,16652580,16652580,16799155,0,0,0,146575
12440,16773411,16773411,16799728,0,0,0,26317
12459,16799691,16799691,16799837,0,0,0,146
12414,16716641,16716641,16801814,0,0,0,85173
12461,16801955,16801955,16802194,0,0,0,239
12462,16802178,16802178,16802402,0,0,0,224
12463,16802431,16802431,16806421,0,0,0,3990
12417,16726356,16726356,16806712,0,0,0,80356
12362,16640070,16640070,16807918,0,0,0,167848
12443,16777865,16777865,16808094,0,0,0,30229
12465,16808000,16808000,16808173,0,0,0,173
12467,16808876,16808876,16809223,0,0,0,347
12444,16782396,16782396,16809491,0,0,0,27095
12469,16809744,16809744,16809828,0,0,0,84
12471,16812296,16812296,16812387,0,0,0,91
12472,16812390,16812390,16812457,0,0,0,67
12449,16786290,16786290,16812777,0,0,0,26487
12473,16812695,16812695,16812862,0,0,0,167
12477,16817811,16817811,16817889,0,0,0,78
12478,16817873,16817873,16817962,0,0,0,89
12479,16818164,16818164,16818253,0,0,0,89
12483,16818535,16818535,16818664,0,0,0,129
12480,16818528,16818528,16818713,0,0,0,185
12481,16818534,16818534,16818726,0,0,0,192
12482,16818534,16818534,16818739,0,0,0,205
12484,16818535,16818535,16818740,0,0,0,205
12485,16818535,16818535,16818757,0,0,0,222
12486,16818750,16818750,16818932,0,0,0,182
12487,16818915,16818915,16818974,0,0,0,59
12488,16818974,16818974,16819145,0,0,0,171
12475,16815818,16815818,16819817,0,0,0,3999
12470,16810472,16810472,16820753,0,0,0,10281
12492,16820074,16820074,16821043,0,0,0,969
12453,16794481,16794481,16821518,0,0,0,27037
12450,16791748,16791748,16821612,0,0,0,29864
12491,16820035,16820035,16821762,0,0,0,1727
12495,16822073,16822073,16822133,0,0,0,60
12474,16812828,16812828,16822906,0,0,0,10078
12490,16819955,16819955,16823042,0,0,0,3087
12489,16819933,16819933,16825781,0,0,0,5848
12460,16799796,16799796,16826441,0,0,0,26645
12500,16826736,16826736,16826806,0,0,0,70
12364,16640105,16640105,16836006,0,0,0,195901
12468,16809420,16809420,16836281,0,0,0,26861
12360,16640032,16640032,16836344,0,0,0,196312
12466,16808047,16808047,16838195,0,0,0,30148
12361,16640051,16640051,16838231,0,0,0,198180
12369,16640175,16640175,16840461,0,0,0,200286
12366,16640135,16640135,16841344,0,0,0,201209
12493,16821476,16821476,16848377,0,0,0,26901
12496,16822860,16822860,16849092,0,0,0,26232
12506,16849054,16849054,16849212,0,0,0,158
12507,16849164,16849164,16849312,0,0,0,148
12508,16849276,16849276,16849426,0,0,0,150
12509,16849384,16849384,16849533,0,0,0,149
12510,16849490,16849490,16849641,0,0,0,151
12494,16821569,16821569,16851560,0,0,0,29991
12512,16851518,16851518,16851675,0,0,0,157
12499,16826367,16826367,16852790,0,0,0,26423
12497,16823490,16823490,16859541,0,0,0,36051
12503,16836237,16836237,16862823,0,0,0,26586
12424,16739024,16739024,16863034,0,0,0,124010
12458,16795814,16795814,16864815,0,0,0,69001
12504,16838123,16838123,16868020,0,0,0,29897
12498,16825813,16825813,16869287,0,0,0,43474
12501,16826785,16826785,16870246,0,0,0,43461
12502,16826867,16826867,16870323,0,0,0,43456
12505,16848334,16848334,16875109,0,0,0,26775
12511,16849599,16849599,16876130,0,0,0,26531
12518,16876087,16876087,16876237,0,0,0,150
12514,16852748,16852748,16879383,0,0,0,26635
12513,16851629,16851629,16881496,0,0,0,29867
12523,16881429,16881429,16881586,0,0,0,157
12368,16640162,16640162,16882353,0,0,0,242191
12522,16881265,16881265,16882535,0,0,0,1270
12528,16881971,16881971,16882711,0,0,0,740
12527,16881922,16881922,16883277,0,0,0,1355
12526,16881674,16881674,16883567,0,0,0,1893
12531,16883879,16883879,16883996,0,0,0,117
12532,16884038,16884038,16884132,0,0,0,94
12521,16881230,16881230,16885622,0,0,0,4392
12539,16886802,16886802,16886922,0,0,0,120
12540,16887019,16887019,16887112,0,0,0,93
12541,16887153,16887153,16887273,0,0,0,120
12524,16881443,16881443,16887724,0,0,0,6281
12413,16716397,16716397,16889197,0,0,0,172800
12515,16862744,16862744,16889917,0,0,0,27173
12543,16888026,16888026,16890181,0,0,0,2155
12456,16794864,16794864,16893107,0,0,0,98243
12565,16893059,16893059,16893186,0,0,0,127
12566,16893143,16893143,16893221,0,0,0,78
12567,16893350,16893350,16893439,0,0,0,89
12454,16794834,16794834,16893667,0,0,0,98833
12455,16794850,16794850,16893703,0,0,0,98853
12457,16794882,16794882,16893709,0,0,0,98827
12544,16888069,16888069,16893820,0,0,0,5751
12568,16893498,16893498,16894064,0,0,0,566
12569,16893575,16893575,16894198,0,0,0,623
12548,16889376,16889376,16894667,0,0,0,5291
12549,16889651,16889651,16894813,0,0,0,5162
12551,16890058,16890058,16895223,0,0,0,5165
12552,16890183,16890183,16895366,0,0,0,5183
12553,16890253,16890253,16895407,0,0,0,5154
12563,16890680,16890680,16895758,0,0,0,5078
12571,16895961,16895961,16896032,0,0,0,71
12572,16896194,16896194,16896260,0,0,0,66
12574,16896754,16896754,16896843,0,0,0,89
12576,16897018,16897018,16897088,0,0,0,70
12577,16897342,16897342,16897412,0,0,0,70
12578,16897752,16897752,16897822,0,0,0,70
12516,16867980,16867980,16897951,0,0,0,29971
12579,16897906,16897906,16898068,0,0,0,162
12582,16898334,16898334,16898441,0,0,0,107
12588,16898541,16898541,16898679,0,0,0,138
12589,16898567,16898567,16898689,0,0,0,122
12594,16899342,16899342,16900740,0,0,0,1398
12593,16898707,16898707,16901370,0,0,0,2663
12517,16875066,16875066,16901996,0,0,0,26930
12586,16898531,16898531,16902496,0,0,0,3965
12519,16876194,16876194,16902603,0,0,0,26409
12597,16902561,16902561,16902823,0,0,0,262
12590,16898602,16898602,16903557,0,0,0,4955
12585,16898457,16898457,16903836,0,0,0,5379
12520,16879336,16879336,16906287,0,0,0,26951
12609,16906550,16906550,16907150,0,0,0,600
12580,16897907,16897907,16908017,0,0,0,10110
12595,16899586,16899586,16908347,0,0,0,8761
12610,16907891,16907891,16909174,0,0,0,1283
12603,16904393,16904393,16909741,0,0,0,5348
12604,16904539,16904539,16909813,0,0,0,5274
12605,16904740,16904740,16909927,0,0,0,5187
12606,16904822,16904822,16910055,0,0,0,5233
12607,16904983,16904983,16910278,0,0,0,5295
12525,16881539,16881539,16911685,0,0,0,30146
12537,16884529,16884529,16912195,0,0,0,27666
12587,16898531,16898531,16916687,0,0,0,18156
12550,16889884,16889884,16916819,0,0,0,26935
12611,16908994,16908994,16917984,0,0,0,8990
12583,16898405,16898405,16918696,0,0,0,20291
12584,16898433,16898433,16920637,0,0,0,22204
12591,16898654,16898654,16920876,0,0,0,22222
12592,16898663,16898663,16921694,0,0,0,23031
12530,16883208,16883208,16926664,0,0,0,43456
12529,16883188,16883188,16926667,0,0,0,43479
12581,16898021,16898021,16928283,0,0,0,30262
12596,16901913,16901913,16928620,0,0,0,26707
12598,16902780,16902780,16929153,0,0,0,26373
12608,16906249,16906249,16932805,0,0,0,26556
12616,16921592,16921592,16933434,0,0,0,11842
12617,16921618,16921618,16935039,0,0,0,13421
12618,16921645,16921645,16936641,0,0,0,14996
12635,16937894,16937894,16938011,0,0,0,117
12633,16937824,16937824,16938050,0,0,0,226
12634,16937847,16937847,16938073,0,0,0,226
12636,16937978,16937978,16938397,0,0,0,419
12638,16938096,16938096,16938594,0,0,0,498
12637,16938054,16938054,16938834,0,0,0,780
12614,16911642,16911642,16941514,0,0,0,29872
12615,16916777,16916777,16943324,0,0,0,26547
12624,16931453,16931453,16945403,0,0,0,13950
12464,16802911,16802911,16950260,0,0,0,147349
12626,16933551,16933551,16952657,0,0,0,19106
12612,16911180,16911180,16954614,0,0,0,43434
12613,16911418,16911418,16954951,0,0,0,43533
12620,16928583,16928583,16955209,0,0,0,26626
12623,16929111,16929111,16955649,0,0,0,26538
12619,16928244,16928244,16958276,0,0,0,30032
12625,16932762,16932762,16959302,0,0,0,26540
12643,16960083,16960083,16960306,0,0,0,223
12644,16960606,16960606,16960775,0,0,0,169
12646,16964114,16964114,16964469,0,0,0,355
12651,16969692,16969692,16969765,0,0,0,73
12645,16962232,16962232,16969969,0,0,0,7737
12654,16970606,16970606,16970898,0,0,0,292
12656,16970851,16970851,16970988,0,0,0,137
12639,16941439,16941439,16971389,0,0,0,29950
12659,16971978,16971978,16972216,0,0,0,238
12621,16929002,16929002,16972468,0,0,0,43466
12622,16929046,16929046,16972512,0,0,0,43466
12628,16937182,16937182,16974739,0,0,0,37557
12629,16937193,16937193,16974998,0,0,0,37805
12658,16971967,16971967,16975675,0,0,0,3708
12627,16937173,16937173,16975736,0,0,0,38563
12660,16976018,16976018,16976184,0,0,0,166
12663,16978411,16978411,16978492,0,0,0,81
12664,16978411,16978411,16978504,0,0,0,93
12665,16978411,16978411,16978504,0,0,0,93
12666,16978411,16978411,16978504,0,0,0,93
12675,16978678,16978678,16978767,0,0,0,89
12667,16978432,16978432,16979032,0,0,0,600
12679,16979074,16979074,16979276,0,0,0,202
12682,16979261,16979261,16979861,0,0,0,600
12684,16979798,16979798,16979873,0,0,0,75
12683,16979789,16979789,16980389,0,0,0,600
12689,16980333,16980333,16980622,0,0,0,289
12690,16980336,16980336,16980636,0,0,0,300
12692,16981370,16981370,16981440,0,0,0,70
12691,16981153,16981153,16981753,0,0,0,600
12640,16955607,16955607,16982058,0,0,0,26451
12693,16981613,16981613,16982213,0,0,0,600
12674,16978610,16978610,16982278,0,0,0,3668
12662,16978244,16978244,16982784,0,0,0,4540
12647,16964497,16964497,16983049,0,0,0,18552
12648,16964844,16964844,16983432,0,0,0,18588
12686,16980326,16980326,16983464,0,0,0,3138
12650,16967577,16967577,16984593,0,0,0,17016
12642,16959226,16959226,16985885,0,0,0,26659
12698,16983841,16983841,16986748,0,0,0,2907
12655,16970659,16970659,16986804,0,0,0,16145
12641,16958230,16958230,16987877,0,0,0,29647
12704,16987840,16987840,16987997,0,0,0,157
12705,16987951,16987951,16988101,0,0,0,150
12701,16986257,16986257,16988179,0,0,0,1922
12661,16978209,16978209,16989609,0,0,0,11400
12712,16989616,16989616,16989680,0,0,0,64
12713,16989669,16989669,16989736,0,0,0,67
12714,16989716,16989716,16989816,0,0,0,100
12707,16988948,16988948,16990771,0,0,0,1823
12715,16989877,16989877,16990831,0,0,0,954
12673,16978572,16978572,16991616,0,0,0,13044
12533,16884528,16884528,16992357,0,0,0,107829
12680,16979118,16979118,16992893,0,0,0,13775
12534,16884528,16884528,16992930,0,0,0,108402
12535,16884528,16884528,16993003,0,0,0,108475
12668,16978464,16978464,16993449,0,0,0,14985
12699,16985844,16985844,16993861,0,0,0,8017
12538,16884529,16884529,16994200,0,0,0,109671
12700,16986215,16986215,16994751,0,0,0,8536
12536,16884528,16884528,16995315,0,0,0,110787
12718,16991110,16991110,16995393,0,0,0,4283
12716,16990175,16990175,16995527,0,0,0,5352
12708,16988997,16988997,16995576,0,0,0,6579
12711,16989566,16989566,16995681,0,0,0,6115
12720,16992739,16992739,16995760,0,0,0,3021
12697,16983809,16983809,16995835,0,0,0,12026
12722,16996814,16996814,16997414,0,0,0,600
12723,16996945,16996945,16997545,0,0,0,600
12710,16989534,16989534,16997552,0,0,0,8018
12728,16997675,16997675,16997840,0,0,0,165
12729,16997686,16997686,16997851,0,0,0,165
12730,16997695,16997695,16997860,0,0,0,165
12423,16738952,16738952,16998152,0,0,0,259200
12601,16903236,16903236,16998781,0,0,0,95545
12599,16903227,16903227,16998783,0,0,0,95556
12600,16903232,16903232,16998788,0,0,0,95556
12731,16998798,16998798,16998901,0,0,0,103
12733,16998889,16998889,16998989,0,0,0,100
12732,16998859,16998859,16998992,0,0,0,133
12727,16997252,16997252,16999168,0,0,0,1916
12725,16997126,16997126,16999603,0,0,0,2477
12657,16971324,16971324,17001412,0,0,0,30088
12719,16992695,16992695,17001801,0,0,0,9106
12721,16993821,16993821,17001926,0,0,0,8105
12649,16967542,16967542,17002227,0,0,0,34685
12555,16890353,16890353,17003203,0,0,0,112850
12709,16989084,16989084,17004404,0,0,0,15320
12602,16903239,16903239,17004566,0,0,0,101327
12726,16997220,16997220,17005308,0,0,0,8088
12724,16997086,16997086,17006095,0,0,0,9009
12717,16991096,16991096,17006949,0,0,0,15853
12741,17007167,17007167,17007252,0,0,0,85
12740,17006296,17006296,17007789,0,0,0,1493
12694,16981987,16981987,17008198,0,0,0,26211
12745,17008528,17008528,17008632,0,0,0,104
12746,17010629,17010629,17010702,0,0,0,73
12747,17010881,17010881,17010954,0,0,0,73
12748,17011377,17011377,17011478,0,0,0,101
12736,16999124,16999124,17011481,0,0,0,12357
12749,17011950,17011950,17012163,0,0,0,213
12751,17012109,17012109,17012211,0,0,0,102
12750,17012058,17012058,17012213,0,0,0,155
12752,17012253,17012253,17012358,0,0,0,105
12734,16999113,16999113,17012647,0,0,0,13534
12753,17012786,17012786,17012888,0,0,0,102
12676,16978731,16978731,17013083,0,0,0,34352
12737,17001375,17001375,17013205,0,0,0,11830
12754,17013162,17013162,17013355,0,0,0,193
12652,16969959,16969959,17013386,0,0,0,43427
12756,17013423,17013423,17013496,0,0,0,73
12653,16970151,16970151,17013569,0,0,0,43418
12758,17014510,17014510,17014583,0,0,0,73
12759,17014603,17014603,17014707,0,0,0,104
12677,16978757,16978757,17014870,0,0,0,36113
12760,17014713,17014713,17014982,0,0,0,269
12761,17014827,17014827,17014989,0,0,0,162
12762,17015045,17015045,17015119,0,0,0,74
12763,17015174,17015174,17015272,0,0,0,98
12735,16999120,16999120,17015729,0,0,0,16609
12764,17015662,17015662,17015736,0,0,0,74
12765,17016038,17016038,17016112,0,0,0,74
12766,17016536,17016536,17016609,0,0,0,73
12767,17016945,17016945,17017019,0,0,0,74
12768,17017105,17017105,17017178,0,0,0,73
12678,16978769,16978769,17017232,0,0,0,38463
12769,17017195,17017195,17017268,0,0,0,73
12706,16988064,16988064,17017493,0,0,0,29429
12771,17017488,17017488,17017577,0,0,0,89
12770,17017410,17017410,17017603,0,0,0,193
12773,17017722,17017722,17017795,0,0,0,73
12774,17018082,17018082,17018155,0,0,0,73
12755,17013283,17013283,17018870,0,0,0,5587
12776,17018833,17018833,17018984,0,0,0,151
12739,17006236,17006236,17019345,0,0,0,13109
12742,17007246,17007246,17026423,0,0,0,19177
12743,17007325,17007325,17026464,0,0,0,19139
12738,17001879,17001879,17028619,0,0,0,26740
12702,16987459,16987459,17030893,0,0,0,43434
12703,16987487,16987487,17030952,0,0,0,43465
12573,16896739,16896739,17033000,0,0,0,136261
12558,16890393,16890393,17034466,0,0,0,144073
12744,17008160,17008160,17034818,0,0,0,26658
12561,16890427,16890427,17036604,0,0,0,146177
12451,16793577,16793577,17046177,0,0,0,252600
12452,16793600,16793600,17046200,0,0,0,252600
12772,17017539,17017539,17046824,0,0,0,29285
12546,16888916,16888916,17048821,0,0,0,159905
12777,17018942,17018942,17049078,0,0,0,30136
12783,17049034,17049034,17049187,0,0,0,153
12787,17050589,17050589,17050726,0,0,0,137
12685,16980320,16980320,17052320,0,0,0,72000
12687,16980328,16980328,17052328,0,0,0,72000
12688,16980331,16980331,17052331,0,0,0,72000
12800,17052465,17052465,17052658,0,0,0,193
12801,17052813,17052813,17052919,0,0,0,106
12805,17053533,17053533,17053663,0,0,0,130
12806,17053693,17053693,17053864,0,0,0,171
12807,17053749,17053749,17053980,0,0,0,231
12808,17053906,17053906,17054085,0,0,0,179
12809,17054069,17054069,17054198,0,0,0,129
12810,17054240,17054240,17054334,0,0,0,94
12813,17054381,17054381,17054558,0,0,0,177
12814,17054509,17054509,17054686,0,0,0,177
12815,17054754,17054754,17054889,0,0,0,135
12786,17049236,17049236,17054937,0,0,0,5701
12784,17049098,17049098,17054941,0,0,0,5843
12780,17028544,17028544,17055094,0,0,0,26550
12757,17013666,17013666,17057145,0,0,0,43479
12825,17057686,17057686,17057782,0,0,0,96
12826,17057723,17057723,17057825,0,0,0,102
12823,17057586,17057586,17058461,0,0,0,875
12802,17053029,17053029,17058790,0,0,0,5761
12799,17052273,17052273,17061000,0,0,0,8727
12781,17034777,17034777,17061311,0,0,0,26534
12798,17052241,17052241,17062723,0,0,0,10482
12797,17052184,17052184,17062789,0,0,0,10605
12821,17057055,17057055,17062851,0,0,0,5796
12839,17062699,17062699,17063880,0,0,0,1181
12840,17062711,17062711,17063881,0,0,0,1170
12841,17062734,17062734,17063882,0,0,0,1148
12837,17059922,17059922,17064229,0,0,0,4307
12564,16892294,16892294,17065094,0,0,0,172800
12788,17051052,17051052,17067264,0,0,0,16212
12804,17053501,17053501,17067430,0,0,0,13929
12822,17057443,17057443,17067678,0,0,0,10235
12795,17052037,17052037,17067763,0,0,0,15726
12792,17051838,17051838,17067807,0,0,0,15969
12824,17057623,17057623,17068418,0,0,0,10795
12830,17058436,17058436,17068986,0,0,0,10550
12832,17059068,17059068,17069133,0,0,0,10065
12831,17059052,17059052,17069139,0,0,0,10087
12843,17063716,17063716,17069427,0,0,0,5711
12842,17063640,17063640,17069430,0,0,0,5790
12833,17059080,17059080,17069455,0,0,0,10375
12855,17070129,17070129,17070233,0,0,0,104
12827,17057880,17057880,17071391,0,0,0,13511
12860,17071442,17071442,17071590,0,0,0,148
12856,17070240,17070240,17071747,0,0,0,1507
12866,17071852,17071852,17071920,0,0,0,68
12867,17071890,17071890,17071961,0,0,0,71
12803,17053463,17053463,17072411,0,0,0,18948
12570,16895852,16895852,17073988,0,0,0,178136
12790,17051151,17051151,17074348,0,0,0,23197
12874,17074480,17074480,17074527,0,0,0,47
12793,17051847,17051847,17074950,0,0,0,23103
12476,16816026,16816026,17075226,0,0,0,259200
12876,17075249,17075249,17075550,0,0,0,301
12796,17052088,17052088,17075684,0,0,0,23596
12850,17064326,17064326,17075815,0,0,0,11489
12782,17046788,17046788,17076847,0,0,0,30059
12879,17076660,17076660,17077188,0,0,0,528
12880,17076710,17076710,17077196,0,0,0,486
12888,17077201,17077201,17077775,0,0,0,574
12887,17077180,17077180,17077901,0,0,0,721
12671,16978569,16978569,17077941,0,0,0,99372
12849,17064291,17064291,17078030,0,0,0,13739
12848,17064254,17064254,17078523,0,0,0,14269
12883,17076843,17076843,17078799,0,0,0,1956
12785,17049145,17049145,17079133,0,0,0,29988
12891,17079053,17079053,17079235,0,0,0,182
12882,17076807,17076807,17079276,0,0,0,2469
12892,17079171,17079171,17079322,0,0,0,151
12889,17078736,17078736,17079411,0,0,0,675
12885,17076878,17076878,17079506,0,0,0,2628
12834,17059762,17059762,17079922,0,0,0,20160
12817,17055232,17055232,17080720,0,0,0,25488
12789,17051148,17051148,17080923,0,0,0,29775
12835,17059826,17059826,17081337,0,0,0,21511
12630,16937659,16937659,17081658,0,0,0,143999
12894,17079379,17079379,17081867,0,0,0,2488
12890,17078746,17078746,17081876,0,0,0,3130
12895,17079392,17079392,17081891,0,0,0,2499
12896,17079549,17079549,17081896,0,0,0,2347
12791,17051735,17051735,17082241,0,0,0,30506
12794,17051951,17051951,17083933,0,0,0,31982
12878,17075804,17075804,17085155,0,0,0,9351
12631,16937669,16937669,17085443,0,0,0,147774
12903,17086983,17086983,17087056,0,0,0,73
12873,17072411,17072411,17087458,0,0,0,15047
12838,17061231,17061231,17087481,0,0,0,26250
12857,17070410,17070410,17087558,0,0,0,17148
12672,16978569,16978569,17087603,0,0,0,109034
12556,16890370,16890370,17087837,0,0,0,197467
12905,17088370,17088370,17088471,0,0,0,101
12545,16888912,16888912,17088554,0,0,0,199642
12858,17070451,17070451,17088663,0,0,0,18212
12906,17088766,17088766,17088881,0,0,0,115
12907,17088923,17088923,17089027,0,0,0,104
12560,16890419,16890419,17089393,0,0,0,198974
12829,17058138,17058138,17089766,0,0,0,31628
12859,17070789,17070789,17090035,0,0,0,19246
12669,16978568,16978568,17090168,0,0,0,111600
12554,16890341,16890341,17090408,0,0,0,200067
12872,17072375,17072375,17091559,0,0,0,19184
12828,17058095,17058095,17091744,0,0,0,33649
12886,17076895,17076895,17091792,0,0,0,14897
12557,16890380,16890380,17092288,0,0,0,201908
12547,16888919,16888919,17092994,0,0,0,204075
12696,16983090,16983090,17093470,0,0,0,110380
12559,16890403,16890403,17095716,0,0,0,205313
12864,17071715,17071715,17097195,0,0,0,25480
12695,16983041,16983041,17098312,0,0,0,115271
12909,17098323,17098323,17098399,0,0,0,76
12908,17098308,17098308,17098406,0,0,0,98
12910,17098503,17098503,17098603,0,0,0,100
12911,17098541,17098541,17098632,0,0,0,91
12816,17055192,17055192,17098645,0,0,0,43453
12818,17055234,17055234,17098714,0,0,0,43480
12819,17055266,17055266,17098716,0,0,0,43450
12884,17076862,17076862,17101145,0,0,0,24283
12901,17085699,17085699,17102494,0,0,0,16795
12897,17081987,17081987,17103822,0,0,0,21835
12899,17081996,17081996,17104166,0,0,0,22170
12898,17081991,17081991,17104285,0,0,0,22294
12562,16890434,16890434,17106434,0,0,0,216000
12863,17071675,17071675,17106826,0,0,0,35151
12846,17063956,17063956,17106832,0,0,0,42876
12881,17076794,17076794,17107268,0,0,0,30474
12893,17079286,17079286,17108402,0,0,0,29116
12775,17018653,17018653,17108533,0,0,0,89880
12845,17063952,17063952,17108622,0,0,0,44670
12918,17108729,17108729,17108802,0,0,0,73
12919,17108764,17108764,17108893,0,0,0,129
12920,17109374,17109374,17109478,0,0,0,104
12921,17109676,17109676,17109811,0,0,0,135
12922,17109912,17109912,17110088,0,0,0,176
12868,17072114,17072114,17111047,0,0,0,38933
12904,17087416,17087416,17113679,0,0,0,26263
12670,16978568,16978568,17114358,0,0,0,135790
12871,17072362,17072362,17115190,0,0,0,42828
12862,17071595,17071595,17116110,0,0,0,44515
12870,17072266,17072266,17116276,0,0,0,44010
12836,17059881,17059881,17125313,0,0,0,65432
12844,17063948,17063948,17125912,0,0,0,61964
12869,17072201,17072201,17127907,0,0,0,55706
12877,17075286,17075286,17130252,0,0,0,54966
12902,17086771,17086771,17130301,0,0,0,43530
12912,17098634,17098634,17132136,0,0,0,33502
12861,17071559,17071559,17132918,0,0,0,61359
12820,17055741,17055741,17132998,0,0,0,77257
12913,17098652,17098652,17133414,0,0,0,34762
12847,17064208,17064208,17134635,0,0,0,70427
12865,17071720,17071720,17136165,0,0,0,64445
12916,17107226,17107226,17137403,0,0,0,30177
12917,17108357,17108357,17137783,0,0,0,29426
12933,17137921,17137921,17138011,0,0,0,90
12934,17138016,17138016,17138087,0,0,0,71
12936,17138172,17138172,17138242,0,0,0,70
12940,17138652,17138652,17138896,0,0,0,244
12632,16937786,16937786,17139332,0,0,0,201546
12941,17138884,17138884,17139485,0,0,0,601
12923,17113615,17113615,17140063,0,0,0,26448
12945,17139499,17139499,17141720,0,0,0,2221
12944,17139473,17139473,17141727,0,0,0,2254
12946,17139527,17139527,17141727,0,0,0,2200
12943,17139449,17139449,17141728,0,0,0,2279
12947,17140020,17140020,17141873,0,0,0,1853
12938,17138302,17138302,17143781,0,0,0,5479
12953,17143605,17143605,17143909,0,0,0,304
12955,17145850,17145850,17146129,0,0,0,279
12939,17138398,17138398,17146197,0,0,0,7799
12542,16887302,16887302,17146502,0,0,0,259200
12952,17142586,17142586,17146764,0,0,0,4178
12949,17142493,17142493,17146768,0,0,0,4275
12950,17142515,17142515,17146768,0,0,0,4253
12951,17142548,17142548,17146769,0,0,0,4221
12959,17146802,17146802,17147093,0,0,0,291
12960,17147022,17147022,17147404,0,0,0,382
12956,17146196,17146196,17147975,0,0,0,1779
12957,17146574,17146574,17148304,0,0,0,1730
12962,17149016,17149016,17149124,0,0,0,108
12958,17146589,17146589,17149239,0,0,0,2650
12961,17147639,17147639,17149391,0,0,0,1752
12900,17085187,17085187,17149731,0,0,0,64544
12965,17149935,17149935,17150008,0,0,0,73
12963,17149737,17149737,17150039,0,0,0,302
12966,17150043,17150043,17150117,0,0,0,74
12967,17150397,17150397,17150569,0,0,0,172
12968,17150643,17150643,17150913,0,0,0,270
12681,16979201,16979201,17151298,0,0,0,172097
12964,17149866,17149866,17151576,0,0,0,1710
12942,17138942,17138942,17151773,0,0,0,12831
12969,17151933,17151933,17152299,0,0,0,366
12971,17152468,17152468,17152682,0,0,0,214
12972,17153416,17153416,17153490,0,0,0,74
12973,17154247,17154247,17154452,0,0,0,205
12974,17154364,17154364,17154712,0,0,0,348
12975,17154632,17154632,17154830,0,0,0,198
12976,17155511,17155511,17155890,0,0,0,379
12977,17155767,17155767,17155966,0,0,0,199
12575,16896812,16896812,17156012,0,0,0,259200
12978,17156421,17156421,17156820,0,0,0,399
12979,17157218,17157218,17157265,0,0,0,47
12980,17157304,17157304,17157963,0,0,0,659
12982,17158642,17158642,17158700,0,0,0,58
12983,17158651,17158651,17158709,0,0,0,58
12981,17158424,17158424,17158802,0,0,0,378
12988,17159062,17159062,17159116,0,0,0,54
12989,17159069,17159069,17159122,0,0,0,53
12984,17158709,17158709,17159507,0,0,0,798
12986,17158731,17158731,17159538,0,0,0,807
12985,17158721,17158721,17159539,0,0,0,818
12987,17158740,17158740,17159898,0,0,0,1158
12992,17160253,17160253,17161045,0,0,0,792
12875,17075173,17075173,17161974,0,0,0,86801
12993,17161855,17161855,17162489,0,0,0,634
12994,17162867,17162867,17163536,0,0,0,669
12851,17065262,17065262,17164201,0,0,0,98939
12853,17065307,17065307,17164450,0,0,0,99143
12854,17065328,17065328,17164736,0,0,0,99408
12852,17065284,17065284,17165784,0,0,0,100500
12932,17137713,17137713,17167722,0,0,0,30009
12931,17137356,17137356,17167868,0,0,0,30512
12997,17167679,17167679,17167873,0,0,0,194
12948,17141827,17141827,17168201,0,0,0,26374
13001,17171406,17171406,17171521,0,0,0,115
12914,17099616,17099616,17171915,0,0,0,72299
13002,17171515,17171515,17172173,0,0,0,658
13003,17172156,17172156,17172418,0,0,0,262
13004,17172399,17172399,17172844,0,0,0,445
13006,17172979,17172979,17173044,0,0,0,65
13007,17173032,17173032,17173147,0,0,0,115
13005,17172908,17172908,17173151,0,0,0,243
12996,17167604,17167604,17173251,0,0,0,5647
13009,17173469,17173469,17173615,0,0,0,146
13010,17173738,17173738,17173859,0,0,0,121
13008,17173431,17173431,17173968,0,0,0,537
13012,17174101,17174101,17174278,0,0,0,177
13011,17173965,17173965,17174392,0,0,0,427
13013,17174368,17174368,17174598,0,0,0,230
13014,17174432,17174432,17174625,0,0,0,193
13016,17174720,17174720,17174905,0,0,0,185
13015,17174619,17174619,17175019,0,0,0,400
12915,17099623,17099623,17175090,0,0,0,75467
13017,17174793,17174793,17175180,0,0,0,387
13019,17175081,17175081,17175265,0,0,0,184
13020,17175173,17175173,17175336,0,0,0,163
12925,17131923,17131923,17175380,0,0,0,43457
12926,17131953,17131953,17175382,0,0,0,43429
13018,17175021,17175021,17175383,0,0,0,362
13021,17175277,17175277,17175433,0,0,0,156
12927,17132003,17132003,17175435,0,0,0,43432
12928,17132034,17132034,17175490,0,0,0,43456
13022,17175454,17175454,17175634,0,0,0,180
13024,17175657,17175657,17175795,0,0,0,138
13026,17176167,17176167,17176314,0,0,0,147
13027,17176361,17176361,17176507,0,0,0,146
13028,17176563,17176563,17176716,0,0,0,153
12995,17163776,17163776,17177109,0,0,0,13333
13030,17176949,17176949,17177157,0,0,0,208
13031,17178229,17178229,17178468,0,0,0,239
13032,17178542,17178542,17178687,0,0,0,145
13023,17175594,17175594,17178807,0,0,0,3213
13029,17176865,17176865,17179154,0,0,0,2289
13025,17175724,17175724,17179346,0,0,0,3622
13033,17179421,17179421,17179682,0,0,0,261
13034,17180209,17180209,17180309,0,0,0,100
13036,17180563,17180563,17180771,0,0,0,208
13037,17181377,17181377,17181512,0,0,0,135
13038,17181565,17181565,17181678,0,0,0,113
13040,17182600,17182600,17183222,0,0,0,622
13041,17183239,17183239,17183634,0,0,0,395
13039,17181655,17181655,17183804,0,0,0,2149
13035,17180295,17180295,17184166,0,0,0,3871
13042,17183516,17183516,17185103,0,0,0,1587
13044,17185828,17185828,17186036,0,0,0,208
13045,17186502,17186502,17186710,0,0,0,208
13046,17186678,17186678,17186866,0,0,0,188
13047,17187721,17187721,17187919,0,0,0,198
13048,17187881,17187881,17188163,0,0,0,282
13049,17188596,17188596,17188748,0,0,0,152
13050,17188847,17188847,17188971,0,0,0,124
13043,17183608,17183608,17189444,0,0,0,5836
12930,17136176,17136176,17190595,0,0,0,54419
12990,17159139,17159139,17190616,0,0,0,31477
13051,17190022,17190022,17190709,0,0,0,687
13054,17190764,17190764,17192331,0,0,0,1567
12778,17019603,17019603,17192357,0,0,0,172754
13056,17190837,17190837,17192476,0,0,0,1639
13057,17190871,17190871,17192677,0,0,0,1806
12779,17020500,17020500,17193254,0,0,0,172754
13058,17193563,17193563,17193749,0,0,0,186
13000,17168162,17168162,17194391,0,0,0,26229
12999,17167800,17167800,17197986,0,0,0,30186
12998,17167779,17167779,17198292,0,0,0,30513
12954,17144049,17144049,17199931,0,0,0,55882
13055,17190798,17190798,17202839,0,0,0,12041
12929,17132281,17132281,17215649,0,0,0,83368
13061,17207426,17207426,17226832,0,0,0,19406
13059,17197941,17197941,17227166,0,0,0,29225
13063,17227187,17227187,17227964,0,0,0,777
13064,17227202,17227202,17227981,0,0,0,779
13065,17227213,17227213,17227993,0,0,0,780
13066,17227226,17227226,17228015,0,0,0,789
13053,17190590,17190590,17228403,0,0,0,37813
13060,17198249,17198249,17228586,0,0,0,30337
13068,17229865,17229865,17230342,0,0,0,477
13067,17228539,17228539,17230441,0,0,0,1902
13070,17230502,17230502,17231277,0,0,0,775
13071,17231953,17231953,17232726,0,0,0,773
13072,17234066,17234066,17234864,0,0,0,798
13073,17240908,17240908,17241446,0,0,0,538
13074,17241618,17241618,17241716,0,0,0,98
13075,17241692,17241692,17241810,0,0,0,118
13076,17242265,17242265,17242444,0,0,0,179
13077,17242530,17242530,17242620,0,0,0,90
13078,17242654,17242654,17242902,0,0,0,248
13079,17243617,17243617,17243737,0,0,0,120
12991,17159309,17159309,17247211,0,0,0,87902
13062,17227124,17227124,17257148,0,0,0,30024
13081,17243949,17243949,17259101,0,0,0,15152
13080,17243853,17243853,17259486,0,0,0,15633
13069,17230403,17230403,17260421,0,0,0,30018
13084,17270653,17270653,17274841,0,0,0,4188
13085,17271220,17271220,17274883,0,0,0,3663
13082,17257079,17257079,17287061,0,0,0,29982
13083,17260379,17260379,17290425,0,0,0,30046
13087,17298194,17298194,17298799,0,0,0,605
13089,17301706,17301706,17301788,0,0,0,82
13090,17301810,17301810,17301899,0,0,0,89
12924,17131778,17131778,17304578,0,0,0,172800
13088,17298810,17298810,17306158,0,0,0,7348
12811,17054306,17054306,17306906,0,0,0,252600
12812,17054323,17054323,17306923,0,0,0,252600
13091,17305346,17305346,17311268,0,0,0,5922
13093,17314219,17314219,17314626,0,0,0,407
13086,17287018,17287018,17317120,0,0,0,30102
13092,17311493,17311493,17319051,0,0,0,7558
12970,17152186,17152186,17324940,0,0,0,172754
13094,17314351,17314351,17333755,0,0,0,19404
13052,17190553,17190553,17336070,0,0,0,145517
13095,17317039,17317039,17347403,0,0,0,30364
13097,17329229,17329229,17372693,0,0,0,43464
13098,17329277,17329277,17372729,0,0,0,43452
13099,17329348,17329348,17372808,0,0,0,43460
13100,17329414,17329414,17372877,0,0,0,43463
13102,17347368,17347368,17377534,0,0,0,30166
13103,17377452,17377452,17386886,0,0,0,9434
12935,17138167,17138167,17390767,0,0,0,252600
12937,17138190,17138190,17390790,0,0,0,252600
13105,17393889,17393889,17394691,0,0,0,802
13109,17394964,17394964,17399311,0,0,0,4347
13113,17400068,17400068,17400327,0,0,0,259
13106,17394912,17394912,17400410,0,0,0,5498
13112,17394984,17394984,17400900,0,0,0,5916
13107,17394952,17394952,17400901,0,0,0,5949
13110,17394974,17394974,17400901,0,0,0,5927
13108,17394957,17394957,17400906,0,0,0,5949
13111,17394979,17394979,17400906,0,0,0,5927
13122,17401010,17401010,17401184,0,0,0,174
13114,17400173,17400173,17401793,0,0,0,1620
13115,17400224,17400224,17401818,0,0,0,1594
13116,17400242,17400242,17401825,0,0,0,1583
13132,17401799,17401799,17401869,0,0,0,70
13124,17401198,17401198,17402099,0,0,0,901
13125,17401222,17401222,17402101,0,0,0,879
13128,17401301,17401301,17402102,0,0,0,801
13123,17401166,17401166,17402103,0,0,0,937
13126,17401255,17401255,17402103,0,0,0,848
13127,17401278,17401278,17402103,0,0,0,825
13134,17402103,17402103,17402497,0,0,0,394
13137,17402114,17402114,17402497,0,0,0,383
13135,17402106,17402106,17402500,0,0,0,394
13138,17402118,17402118,17402501,0,0,0,383
13133,17402099,17402099,17402504,0,0,0,405
13136,17402110,17402110,17402504,0,0,0,394
13139,17403355,17403355,17403402,0,0,0,47
13140,17403479,17403479,17403561,0,0,0,82
13141,17403552,17403552,17403676,0,0,0,124
13142,17403745,17403745,17403843,0,0,0,98
13144,17403785,17403785,17403849,0,0,0,64
13143,17403766,17403766,17403852,0,0,0,86
13096,17329172,17329172,17403911,0,0,0,74739
13147,17403886,17403886,17404151,0,0,0,265
13149,17404085,17404085,17404201,0,0,0,116
13150,17404444,17404444,17404559,0,0,0,115
13151,17404730,17404730,17404851,0,0,0,121
13146,17403877,17403877,17404966,0,0,0,1089
13152,17405261,17405261,17405489,0,0,0,228
13145,17403862,17403862,17405719,0,0,0,1857
13153,17406952,17406952,17407192,0,0,0,240
13155,17413767,17413767,17413887,0,0,0,120
13156,17414218,17414218,17414297,0,0,0,79
13157,17414803,17414803,17414892,0,0,0,89
13131,17401786,17401786,17415753,0,0,0,13967
13130,17401767,17401767,17415756,0,0,0,13989
13117,17400288,17400288,17415770,0,0,0,15482
13129,17401750,17401750,17415773,0,0,0,14023
13158,17415915,17415915,17416106,0,0,0,191
13159,17415918,17415918,17416124,0,0,0,206
13160,17415926,17415926,17416143,0,0,0,217
13161,17415931,17415931,17416154,0,0,0,223
13163,17416084,17416084,17416693,0,0,0,609
13165,17416121,17416121,17416693,0,0,0,572
13164,17416098,17416098,17416697,0,0,0,599
13162,17416057,17416057,17416705,0,0,0,648
13104,17386848,17386848,17417125,0,0,0,30277
13169,17416670,17416670,17417871,0,0,0,1201
13166,17416660,17416660,17417872,0,0,0,1212
13167,17416664,17416664,17417876,0,0,0,1212
13168,17416667,17416667,17417879,0,0,0,1212
13171,17417241,17417241,17417972,0,0,0,731
13176,17418048,17418048,17418344,0,0,0,296
13177,17418683,17418683,17418989,0,0,0,306
13173,17417849,17417849,17419550,0,0,0,1701
13172,17417840,17417840,17419552,0,0,0,1712
13175,17417865,17417865,17419555,0,0,0,1690
13174,17417857,17417857,17419558,0,0,0,1701
13179,17419627,17419627,17419899,0,0,0,272
13180,17419790,17419790,17419940,0,0,0,150
13185,17419853,17419853,17420002,0,0,0,149
13186,17419940,17419940,17420088,0,0,0,148
13184,17419837,17419837,17420183,0,0,0,346
13187,17420065,17420065,17420219,0,0,0,154
13181,17419828,17419828,17420364,0,0,0,536
13182,17419832,17419832,17420379,0,0,0,547
13193,17420541,17420541,17420631,0,0,0,90
13194,17420645,17420645,17420735,0,0,0,90
13195,17420932,17420932,17421036,0,0,0,104
13188,17420128,17420128,17421522,0,0,0,1394
13196,17421438,17421438,17421558,0,0,0,120
13198,17421730,17421730,17421808,0,0,0,78
13183,17419835,17419835,17422620,0,0,0,2785
13190,17420333,17420333,17422662,0,0,0,2329
13192,17420367,17420367,17422663,0,0,0,2296
13191,17420350,17420350,17422668,0,0,0,2318
13189,17420164,17420164,17422669,0,0,0,2505
13199,17422595,17422595,17422711,0,0,0,116
13204,17422721,17422721,17422820,0,0,0,99
13209,17422842,17422842,17422962,0,0,0,120
13210,17423449,17423449,17423550,0,0,0,101
13211,17423697,17423697,17423775,0,0,0,78
13212,17424046,17424046,17424182,0,0,0,136
13213,17424135,17424135,17424244,0,0,0,109
13224,17427038,17427038,17427157,0,0,0,119
13227,17427073,17427073,17427159,0,0,0,86
13225,17427052,17427052,17427160,0,0,0,108
13223,17427033,17427033,17427163,0,0,0,130
13226,17427066,17427066,17427163,0,0,0,97
13219,17426290,17426290,17427831,0,0,0,1541
13234,17427207,17427207,17427831,0,0,0,624
13220,17426303,17426303,17427833,0,0,0,1530
13221,17426317,17426317,17427836,0,0,0,1519
13235,17427223,17427223,17427836,0,0,0,613
13228,17427089,17427089,17427837,0,0,0,748
13230,17427142,17427142,17427837,0,0,0,695
13214,17426121,17426121,17427838,0,0,0,1717
13231,17427154,17427154,17427838,0,0,0,684
13218,17426276,17426276,17427839,0,0,0,1563
13229,17427102,17427102,17427839,0,0,0,737
13232,17427166,17427166,17427839,0,0,0,673
13233,17427193,17427193,17427839,0,0,0,646
13215,17426151,17426151,17427840,0,0,0,1689
13216,17426177,17426177,17427840,0,0,0,1663
13217,17426203,17426203,17427840,0,0,0,1637
13101,17338068,17338068,17428228,0,0,0,90160
13243,17427997,17427997,17429254,0,0,0,1257
13246,17428010,17428010,17429256,0,0,0,1246
13249,17428021,17428021,17429256,0,0,0,1235
13238,17427978,17427978,17429257,0,0,0,1279
13244,17428000,17428000,17429257,0,0,0,1257
13253,17428033,17428033,17429257,0,0,0,1224
13202,17422662,17422662,17429258,0,0,0,6596
13203,17422673,17422673,17429258,0,0,0,6585
13241,17427990,17427990,17429258,0,0,0,1268
13247,17428013,17428013,17429259,0,0,0,1246
13250,17428024,17428024,17429259,0,0,0,1235
13239,17427982,17427982,17429261,0,0,0,1279
13242,17427993,17427993,17429261,0,0,0,1268
13251,17428026,17428026,17429261,0,0,0,1235
13245,17428005,17428005,17429262,0,0,0,1257
13240,17427985,17427985,17429264,0,0,0,1279
13248,17428018,17428018,17429264,0,0,0,1246
13252,17428029,17428029,17429264,0,0,0,1235
13200,17422635,17422635,17429265,0,0,0,6630
13201,17422646,17422646,17429265,0,0,0,6619
13274,17429960,17429960,17430090,0,0,0,130
13272,17429292,17429292,17430491,0,0,0,1199
13258,17429236,17429236,17430578,0,0,0,1342
13271,17429286,17429286,17430594,0,0,0,1308
13270,17429282,17429282,17430601,0,0,0,1319
13259,17429239,17429239,17430603,0,0,0,1364
13260,17429242,17429242,17430617,0,0,0,1375
13261,17429245,17429245,17430620,0,0,0,1375
13275,17430067,17430067,17430667,0,0,0,600
13284,17431032,17431032,17431121,0,0,0,89
13286,17431127,17431127,17431262,0,0,0,135
13287,17431308,17431308,17431401,0,0,0,93
13273,17429297,17429297,17431459,0,0,0,2162
13288,17431581,17431581,17431685,0,0,0,104
13276,17430532,17430532,17431715,0,0,0,1183
13277,17430563,17430563,17431735,0,0,0,1172
13278,17430572,17430572,17431744,0,0,0,1172
13279,17430585,17430585,17431749,0,0,0,1164
13280,17430700,17430700,17431768,0,0,0,1068
13281,17430716,17430716,17431774,0,0,0,1058
13282,17430731,17430731,17431789,0,0,0,1058
13283,17430734,17430734,17431803,0,0,0,1069
13285,17431095,17431095,17431972,0,0,0,877
13254,17429219,17429219,17432056,0,0,0,2837
13255,17429222,17429222,17432070,0,0,0,2848
13256,17429225,17429225,17432084,0,0,0,2859
13257,17429229,17429229,17432099,0,0,0,2870
13262,17429248,17429248,17432107,0,0,0,2859
13263,17429252,17429252,17432122,0,0,0,2870
13264,17429255,17429255,17432125,0,0,0,2870
13265,17429257,17429257,17432127,0,0,0,2870
13289,17431973,17431973,17432305,0,0,0,332
13303,17432288,17432288,17432407,0,0,0,119
13294,17432066,17432066,17432484,0,0,0,418
13295,17432077,17432077,17432495,0,0,0,418
13296,17432086,17432086,17432504,0,0,0,418
13297,17432094,17432094,17432512,0,0,0,418
13299,17432177,17432177,17432564,0,0,0,387
13300,17432180,17432180,17432577,0,0,0,397
13301,17432185,17432185,17432593,0,0,0,408
13302,17432188,17432188,17432596,0,0,0,408
13266,17429268,17429268,17432661,0,0,0,3393
13267,17429272,17429272,17432731,0,0,0,3459
13268,17429275,17429275,17432745,0,0,0,3470
13298,17432147,17432147,17432747,0,0,0,600
13269,17429278,17429278,17432748,0,0,0,3470
13308,17432521,17432521,17432825,0,0,0,304
13309,17432542,17432542,17432846,0,0,0,304
13311,17432556,17432556,17432871,0,0,0,315
13310,17432549,17432549,17432971,0,0,0,422
13315,17432791,17432791,17433477,0,0,0,686
13316,17432811,17432811,17433497,0,0,0,686
13317,17432828,17432828,17433503,0,0,0,675
13318,17432848,17432848,17433512,0,0,0,664
13322,17433566,17433566,17433931,0,0,0,365
13323,17433569,17433569,17433934,0,0,0,365
13320,17433530,17433530,17433937,0,0,0,407
13321,17433563,17433563,17433939,0,0,0,376
13197,17421694,17421694,17435457,0,0,0,13763
13328,17435496,17435496,17435600,0,0,0,104
13329,17435711,17435711,17435832,0,0,0,121
13330,17436129,17436129,17436256,0,0,0,127
13331,17436511,17436511,17436638,0,0,0,127
13332,17436679,17436679,17436824,0,0,0,145
13333,17436829,17436829,17436973,0,0,0,144
13304,17432443,17432443,17437006,0,0,0,4563
13305,17432454,17432454,17437006,0,0,0,4552
13306,17432462,17432462,17437025,0,0,0,4563
13307,17432474,17432474,17437037,0,0,0,4563
13324,17433944,17433944,17437054,0,0,0,3110
13325,17433947,17433947,17437057,0,0,0,3110
13326,17433950,17433950,17437071,0,0,0,3121
13327,17433954,17433954,17437075,0,0,0,3121
13342,17437067,17437067,17437246,0,0,0,179
13343,17437216,17437216,17437342,0,0,0,126
13334,17436961,17436961,17437480,0,0,0,519
13335,17436970,17436970,17437500,0,0,0,530
13336,17436984,17436984,17437504,0,0,0,520
13338,17437011,17437011,17437520,0,0,0,509
13339,17437021,17437021,17437530,0,0,0,509
13340,17437031,17437031,17437540,0,0,0,509
13341,17437040,17437040,17437549,0,0,0,509
13344,17437446,17437446,17437609,0,0,0,163
13353,17437852,17437852,17438072,0,0,0,220
13354,17438328,17438328,17438478,0,0,0,150
13355,17438565,17438565,17438713,0,0,0,148
13356,17438801,17438801,17438952,0,0,0,151
13357,17438867,17438867,17439310,0,0,0,443
13358,17439350,17439350,17439507,0,0,0,157
13359,17439589,17439589,17439996,0,0,0,407
13360,17439706,17439706,17440200,0,0,0,494
13363,17441591,17441591,17441768,0,0,0,177
13362,17441392,17441392,17441801,0,0,0,409
13291,17432030,17432030,17442028,0,0,0,9998
13361,17439914,17439914,17442495,0,0,0,2581
13290,17432015,17432015,17442699,0,0,0,10684
13293,17432052,17432052,17442725,0,0,0,10673
13292,17432043,17432043,17442727,0,0,0,10684
13319,17432880,17432880,17442732,0,0,0,9852
13312,17432691,17432691,17442752,0,0,0,10061
13313,17432699,17432699,17442760,0,0,0,10061
13314,17432709,17432709,17442783,0,0,0,10074
13365,17441779,17441779,17442975,0,0,0,1196
13364,17441742,17441742,17442982,0,0,0,1240
13345,17437454,17437454,17443301,0,0,0,5847
13376,17443261,17443261,17444279,0,0,0,1018
13346,17437748,17437748,17444293,0,0,0,6545
13347,17437753,17437753,17444298,0,0,0,6545
13348,17437757,17437757,17444302,0,0,0,6545
13349,17437768,17437768,17444313,0,0,0,6545
13350,17437777,17437777,17444322,0,0,0,6545
13351,17437782,17437782,17444327,0,0,0,6545
13352,17437787,17437787,17444343,0,0,0,6556
13170,17417048,17417048,17447164,0,0,0,30116
13385,17451212,17451212,17451336,0,0,0,124
13386,17451839,17451839,17451995,0,0,0,156
13387,17451962,17451962,17452091,0,0,0,129
13388,17452389,17452389,17452721,0,0,0,332
13389,17452679,17452679,17452835,0,0,0,156
13390,17453142,17453142,17453742,0,0,0,600
13154,17410744,17410744,17454172,0,0,0,43428
13375,17442948,17442948,17468749,0,0,0,25801
13374,17442938,17442938,17474347,0,0,0,31409
13337,17436994,17436994,17477646,0,0,0,40652
13371,17442714,17442714,17481347,0,0,0,38633
13370,17442701,17442701,17481672,0,0,0,38971
13366,17442663,17442663,17481915,0,0,0,39252
13367,17442671,17442671,17481923,0,0,0,39252
13368,17442681,17442681,17481933,0,0,0,39252
13369,17442690,17442690,17481942,0,0,0,39252
13393,17482168,17482168,17482204,0,0,0,36
13372,17442728,17442728,17482275,0,0,0,39547
13394,17482213,17482213,17482316,0,0,0,103
13395,17482300,17482300,17482459,0,0,0,159
13373,17442748,17442748,17482626,0,0,0,39878
13396,17482939,17482939,17483054,0,0,0,115
13381,17444272,17444272,17483282,0,0,0,39010
13380,17444263,17444263,17483284,0,0,0,39021
13383,17444296,17444296,17483284,0,0,0,38988
13384,17444308,17444308,17483285,0,0,0,38977
13379,17444255,17444255,17483287,0,0,0,39032
13378,17444246,17444246,17483289,0,0,0,39043
13377,17444236,17444236,17483290,0,0,0,39054
13382,17444280,17444280,17483290,0,0,0,39010
13399,17483190,17483190,17483291,0,0,0,101
13402,17483290,17483290,17483405,0,0,0,115
13404,17483583,17483583,17483695,0,0,0,112
13405,17483693,17483693,17483833,0,0,0,140
13406,17484326,17484326,17484466,0,0,0,140
13237,17427472,17427472,17484649,0,0,0,57177
13236,17427449,17427449,17486983,0,0,0,59534
13178,17419054,17419054,17486991,0,0,0,67937
13409,17484654,17484654,17488482,0,0,0,3828
13401,17483274,17483274,17488486,0,0,0,5212
13403,17483566,17483566,17488486,0,0,0,4920
13413,17485021,17485021,17488491,0,0,0,3470
13407,17484488,17484488,17488492,0,0,0,4004
13408,17484518,17484518,17488492,0,0,0,3974
13400,17483214,17483214,17488493,0,0,0,5279
13410,17484682,17484682,17488493,0,0,0,3811
13411,17484706,17484706,17488493,0,0,0,3787
13412,17484732,17484732,17488493,0,0,0,3761
13397,17483142,17483142,17488498,0,0,0,5356
13398,17483158,17483158,17488503,0,0,0,5345
13421,17488661,17488661,17488787,0,0,0,126
13423,17488677,17488677,17488792,0,0,0,115
13420,17488656,17488656,17488793,0,0,0,137
13424,17488680,17488680,17488795,0,0,0,115
13422,17488671,17488671,17488797,0,0,0,126
13419,17488639,17488639,17488798,0,0,0,159
13431,17490560,17490560,17490675,0,0,0,115
13432,17490874,17490874,17491026,0,0,0,152
13434,17491196,17491196,17491254,0,0,0,58
13433,17491169,17491169,17491307,0,0,0,138
13435,17491420,17491420,17491540,0,0,0,120
13436,17491711,17491711,17491831,0,0,0,120
13437,17492014,17492014,17492125,0,0,0,111
13438,17492156,17492156,17492237,0,0,0,81
13439,17492199,17492199,17492321,0,0,0,122
13441,17492331,17492331,17492504,0,0,0,173
13442,17492387,17492387,17492504,0,0,0,117
13443,17492393,17492393,17492505,0,0,0,112
13444,17492426,17492426,17492515,0,0,0,89
13430,17488810,17488810,17492646,0,0,0,3836
13427,17488800,17488800,17492647,0,0,0,3847
13425,17488791,17488791,17492649,0,0,0,3858
13428,17488804,17488804,17492651,0,0,0,3847
13426,17488794,17488794,17492652,0,0,0,3858
13429,17488806,17488806,17492653,0,0,0,3847
13448,17492581,17492581,17492714,0,0,0,133
13440,17492236,17492236,17492719,0,0,0,483
13446,17492512,17492512,17494145,0,0,0,1633
13457,17495465,17495465,17495580,0,0,0,115
13458,17495735,17495735,17495819,0,0,0,84
13456,17495136,17495136,17495861,0,0,0,725
13459,17495849,17495849,17495964,0,0,0,115
13445,17492492,17492492,17496010,0,0,0,3518
13449,17492586,17492586,17496021,0,0,0,3435
13447,17492544,17492544,17496022,0,0,0,3478
13460,17496117,17496117,17496257,0,0,0,140
13461,17496379,17496379,17496489,0,0,0,110
13465,17496431,17496431,17497100,0,0,0,669
13470,17497037,17497037,17497736,0,0,0,699
13474,17498502,17498502,17498618,0,0,0,116
13475,17498710,17498710,17498757,0,0,0,47
13472,17497926,17497926,17498953,0,0,0,1027
13473,17497952,17497952,17498984,0,0,0,1032
13479,17499133,17499133,17499293,0,0,0,160
13483,17499296,17499296,17499370,0,0,0,74
13490,17499981,17499981,17500041,0,0,0,60
13505,17500394,17500394,17500474,0,0,0,80
13503,17500325,17500325,17500491,0,0,0,166
13511,17500748,17500748,17500802,0,0,0,54
13508,17500441,17500441,17501411,0,0,0,970
13507,17500429,17500429,17501466,0,0,0,1037
13509,17500455,17500455,17501469,0,0,0,1014
13510,17500477,17500477,17501485,0,0,0,1008
13506,17500405,17500405,17502166,0,0,0,1761
13504,17500369,17500369,17502312,0,0,0,1943
13520,17501946,17501946,17502362,0,0,0,416
13512,17501382,17501382,17502551,0,0,0,1169
13513,17501411,17501411,17502646,0,0,0,1235
13516,17501443,17501443,17502852,0,0,0,1409
13489,17499767,17499767,17502928,0,0,0,3161
13514,17501418,17501418,17503043,0,0,0,1625
13515,17501432,17501432,17503046,0,0,0,1614
13517,17501466,17501466,17503209,0,0,0,1743
13518,17501513,17501513,17503231,0,0,0,1718
13519,17501518,17501518,17503236,0,0,0,1718
13521,17502730,17502730,17503252,0,0,0,522
13522,17503248,17503248,17503347,0,0,0,99
13523,17503357,17503357,17503464,0,0,0,107
13497,17500213,17500213,17503468,0,0,0,3255
13527,17503391,17503391,17503499,0,0,0,108
13530,17503404,17503404,17503501,0,0,0,97
13533,17503498,17503498,17503589,0,0,0,91
13532,17503497,17503497,17504458,0,0,0,961
13469,17496947,17496947,17505090,0,0,0,8143
13417,17487312,17487312,17505135,0,0,0,17823
13536,17505357,17505357,17505760,0,0,0,403
13464,17496427,17496427,17506154,0,0,0,9727
13529,17503401,17503401,17506689,0,0,0,3288
13535,17505285,17505285,17506738,0,0,0,1453
13528,17503393,17503393,17506801,0,0,0,3408
13531,17503410,17503410,17506840,0,0,0,3430
13541,17506792,17506792,17506906,0,0,0,114
13542,17506801,17506801,17506921,0,0,0,120
13539,17506394,17506394,17507648,0,0,0,1254
13524,17503381,17503381,17508100,0,0,0,4719
13525,17503385,17503385,17508128,0,0,0,4743
13526,17503390,17503390,17508179,0,0,0,4789
13540,17506786,17506786,17508217,0,0,0,1431
13544,17506861,17506861,17508238,0,0,0,1377
13545,17506889,17506889,17508259,0,0,0,1370
13555,17510113,17510113,17510288,0,0,0,175
13560,17510606,17510606,17510721,0,0,0,115
13561,17510835,17510835,17510909,0,0,0,74
13562,17511027,17511027,17511131,0,0,0,104
13543,17506829,17506829,17511633,0,0,0,4804
13567,17517984,17517984,17518089,0,0,0,105
13568,17518080,17518080,17518240,0,0,0,160
13534,17503962,17503962,17518365,0,0,0,14403
13569,17518412,17518412,17518589,0,0,0,177
13570,17521704,17521704,17521777,0,0,0,73
13571,17521794,17521794,17521898,0,0,0,104
13572,17522190,17522190,17522263,0,0,0,73
13573,17522336,17522336,17522549,0,0,0,213
13574,17522639,17522639,17522851,0,0,0,212
13576,17522960,17522960,17523027,0,0,0,67
13391,17480151,17480151,17523616,0,0,0,43465
13392,17480266,17480266,17523824,0,0,0,43558
13577,17523975,17523975,17524087,0,0,0,112
13476,17498920,17498920,17528346,0,0,0,29426
13462,17496420,17496420,17529225,0,0,0,32805
13466,17496433,17496433,17529263,0,0,0,32830
13467,17496876,17496876,17529323,0,0,0,32447
13468,17496905,17496905,17529377,0,0,0,32472
13471,17497059,17497059,17529446,0,0,0,32387
13537,17505753,17505753,17529469,0,0,0,23716
13546,17508076,17508076,17529833,0,0,0,21757
13587,17530458,17530458,17530609,0,0,0,151
13588,17530583,17530583,17530775,0,0,0,192
13484,17499569,17499569,17531087,0,0,0,31518
13453,17492651,17492651,17531221,0,0,0,38570
13579,17527425,17527425,17531313,0,0,0,3888
13589,17531226,17531226,17531528,0,0,0,302
13454,17492655,17492655,17531693,0,0,0,39038
13482,17499221,17499221,17531766,0,0,0,32545
13451,17492619,17492619,17531871,0,0,0,39252
13496,17500212,17500212,17532612,0,0,0,32400
13498,17500220,17500220,17532620,0,0,0,32400
13499,17500225,17500225,17532625,0,0,0,32400
13500,17500231,17500231,17532631,0,0,0,32400
13455,17492659,17492659,17532864,0,0,0,40205
13590,17533201,17533201,17533336,0,0,0,135
13452,17492644,17492644,17533577,0,0,0,40933
13593,17535391,17535391,17535568,0,0,0,177
13594,17535652,17535652,17535821,0,0,0,169
13595,17535797,17535797,17536235,0,0,0,438
13596,17536325,17536325,17536471,0,0,0,146
13597,17536792,17536792,17536938,0,0,0,146
13598,17537127,17537127,17537231,0,0,0,104
13599,17537419,17537419,17537636,0,0,0,217
13600,17538239,17538239,17538375,0,0,0,136
13601,17538529,17538529,17538664,0,0,0,135
13602,17538830,17538830,17538965,0,0,0,135
13603,17539169,17539169,17539293,0,0,0,124
13581,17529227,17529227,17540744,0,0,0,11517
13583,17529310,17529310,17540803,0,0,0,11493
13477,17499044,17499044,17541197,0,0,0,42153
13450,17492616,17492616,17543016,0,0,0,50400
13563,17512359,17512359,17544759,0,0,0,32400
13564,17512375,17512375,17544775,0,0,0,32400
13565,17512396,17512396,17544796,0,0,0,32400
13566,17512403,17512403,17544803,0,0,0,32400
13592,17534944,17534944,17545825,0,0,0,10881
13551,17508201,17508201,17547740,0,0,0,39539
13549,17508150,17508150,17548081,0,0,0,39931
13547,17508093,17508093,17548202,0,0,0,40109
13548,17508111,17508111,17548353,0,0,0,40242
13550,17508176,17508176,17548521,0,0,0,40345
13585,17529619,17529619,17549025,0,0,0,19406
13485,17499598,17499598,17551234,0,0,0,51636
13491,17500064,17500064,17551715,0,0,0,51651
13487,17499670,17499670,17552146,0,0,0,52476
13486,17499630,17499630,17552390,0,0,0,52760
13463,17496423,17496423,17553592,0,0,0,57169
13418,17487414,17487414,17554552,0,0,0,67138
13488,17499703,17499703,17554691,0,0,0,54988
13575,17522894,17522894,17555692,0,0,0,32798
13492,17500100,17500100,17555801,0,0,0,55701
13493,17500135,17500135,17556279,0,0,0,56144
13591,17534863,17534863,17556603,0,0,0,21740
13501,17500235,17500235,17557532,0,0,0,57297
13494,17500163,17500163,17557538,0,0,0,57375
13502,17500265,17500265,17558087,0,0,0,57822
13552,17508220,17508220,17558620,0,0,0,50400
13495,17500192,17500192,17558975,0,0,0,58783
13584,17529334,17529334,17559574,0,0,0,30240
13604,17539357,17539357,17560957,0,0,0,21600
13605,17539426,17539426,17561026,0,0,0,21600
13578,17524048,17524048,17561687,0,0,0,37639
13478,17499082,17499082,17561821,0,0,0,62739
13480,17499141,17499141,17563226,0,0,0,64085
13481,17499191,17499191,17564087,0,0,0,64896
13608,17563881,17563881,17567360,0,0,0,3479
13610,17568891,17568891,17568987,0,0,0,96
13611,17568925,17568925,17569036,0,0,0,111
13612,17569181,17569181,17569255,0,0,0,74
13613,17569334,17569334,17569404,0,0,0,70
13615,17569427,17569427,17569500,0,0,0,73
13616,17569589,17569589,17569693,0,0,0,104
13617,17569756,17569756,17569964,0,0,0,208
13222,17426404,17426404,17575378,0,0,0,148974
13148,17403975,17403975,17576775,0,0,0,172800
13621,17577026,17577026,17580477,0,0,0,3451
13609,17567803,17567803,17581749,0,0,0,13946
13629,17582634,17582634,17582758,0,0,0,124
13586,17529976,17529976,17582807,0,0,0,52831
13632,17583068,17583068,17583223,0,0,0,155
13416,17487022,17487022,17583254,0,0,0,96232
13623,17581135,17581135,17584255,0,0,0,3120
13620,17576996,17576996,17584417,0,0,0,7421
13637,17585968,17585968,17586075,0,0,0,107
13638,17586057,17586057,17586146,0,0,0,89
13633,17583161,17583161,17586263,0,0,0,3102
13645,17586570,17586570,17586636,0,0,0,66
13627,17581369,17581369,17588108,0,0,0,6739
13640,17586112,17586112,17588757,0,0,0,2645
13649,17586645,17586645,17589167,0,0,0,2522
13636,17583802,17583802,17590789,0,0,0,6987
13619,17576901,17576901,17591301,0,0,0,14400
13660,17591330,17591330,17591428,0,0,0,98
13664,17592579,17592579,17592651,0,0,0,72
13582,17529274,17529274,17593021,0,0,0,63747
13670,17593284,17593284,17593358,0,0,0,74
13606,17560717,17560717,17593814,0,0,0,33097
13671,17593857,17593857,17593931,0,0,0,74
13669,17592961,17592961,17594018,0,0,0,1057
13673,17594110,17594110,17594183,0,0,0,73
13635,17583657,17583657,17594340,0,0,0,10683
13674,17594451,17594451,17594556,0,0,0,105
13672,17593945,17593945,17594732,0,0,0,787
13634,17583493,17583493,17594766,0,0,0,11273
13675,17594702,17594702,17594771,0,0,0,69
13631,17583001,17583001,17595029,0,0,0,12028
13676,17594943,17594943,17595055,0,0,0,112
13650,17586697,17586697,17595129,0,0,0,8432
13677,17595230,17595230,17595303,0,0,0,73
13682,17595829,17595829,17595933,0,0,0,104
13580,17529189,17529189,17599488,0,0,0,70299
13715,17600139,17600139,17600279,0,0,0,140
13720,17604640,17604640,17604786,0,0,0,146
13721,17605110,17605110,17605257,0,0,0,147
13722,17605393,17605393,17605498,0,0,0,105
13723,17605819,17605819,17605988,0,0,0,169
13724,17606386,17606386,17606533,0,0,0,147
13725,17606747,17606747,17606887,0,0,0,140
13726,17607056,17607056,17607202,0,0,0,146
13639,17586078,17586078,17608496,0,0,0,22418
13614,17569376,17569376,17609116,0,0,0,39740
13659,17591313,17591313,17609313,0,0,0,18000
13661,17591336,17591336,17609336,0,0,0,18000
13662,17591342,17591342,17609342,0,0,0,18000
13630,17582872,17582872,17609638,0,0,0,26766
13728,17609596,17609596,17609766,0,0,0,170
13663,17591773,17591773,17609773,0,0,0,18000
13729,17609765,17609765,17609920,0,0,0,155
13730,17609945,17609945,17610134,0,0,0,189
13731,17610194,17610194,17610340,0,0,0,146
13607,17562583,17562583,17610435,0,0,0,47852
13732,17610604,17610604,17610717,0,0,0,113
13695,17596831,17596831,17610762,0,0,0,13931
13665,17592805,17592805,17610805,0,0,0,18000
13666,17592817,17592817,17610817,0,0,0,18000
13667,17592822,17592822,17610822,0,0,0,18000
13668,17592827,17592827,17610827,0,0,0,18000
13656,17586997,17586997,17610880,0,0,0,23883
13734,17611148,17611148,17611325,0,0,0,177
13696,17596852,17596852,17611414,0,0,0,14562
13735,17611772,17611772,17612372,0,0,0,600
13678,17595403,17595403,17613403,0,0,0,18000
13679,17595434,17595434,17613434,0,0,0,18000
13680,17595441,17595441,17613441,0,0,0,18000
13681,17595448,17595448,17613448,0,0,0,18000
13727,17608930,17608930,17614507,0,0,0,5577
13657,17587035,17587035,17615052,0,0,0,28017
13709,17597596,17597596,17615560,0,0,0,17964
13736,17612975,17612975,17619876,0,0,0,6901
13628,17581556,17581556,17622189,0,0,0,40633
13740,17623051,17623051,17623651,0,0,0,600
13741,17623708,17623708,17623949,0,0,0,241
13742,17624279,17624279,17624662,0,0,0,383
13538,17506361,17506361,17624940,0,0,0,118579
13743,17624752,17624752,17625352,0,0,0,600
13739,17622582,17622582,17626195,0,0,0,3613
13744,17626723,17626723,17627323,0,0,0,600
13745,17629012,17629012,17629592,0,0,0,580
13746,17629564,17629564,17629803,0,0,0,239
13747,17630003,17630003,17630603,0,0,0,600
13705,17597317,17597317,17633317,0,0,0,36000
13706,17597324,17597324,17633324,0,0,0,36000
13707,17597331,17597331,17633331,0,0,0,36000
13708,17597337,17597337,17633337,0,0,0,36000
13710,17598492,17598492,17634492,0,0,0,36000
13711,17598498,17598498,17634498,0,0,0,36000
13712,17598504,17598504,17634504,0,0,0,36000
13713,17598509,17598509,17634509,0,0,0,36000
13641,17586378,17586378,17634791,0,0,0,48413
13554,17510110,17510110,17638010,0,0,0,127900
13652,17586894,17586894,17638644,0,0,0,51750
13655,17586972,17586972,17638731,0,0,0,51759
13654,17586942,17586942,17638752,0,0,0,51810
13622,17581089,17581089,17638970,0,0,0,57881
13653,17586929,17586929,17639012,0,0,0,52083
13626,17581226,17581226,17639685,0,0,0,58459
13748,17640588,17640588,17640703,0,0,0,115
13749,17640923,17640923,17641131,0,0,0,208
13750,17641497,17641497,17641655,0,0,0,158
13751,17642052,17642052,17642303,0,0,0,251
13752,17642337,17642337,17642509,0,0,0,172
13714,17599543,17599543,17642774,0,0,0,43231
13753,17642753,17642753,17642869,0,0,0,116
13754,17642952,17642952,17643068,0,0,0,116
13755,17643357,17643357,17643472,0,0,0,115
13558,17510127,17510127,17643667,0,0,0,133540
13756,17643611,17643611,17643771,0,0,0,160
13716,17600648,17600648,17644121,0,0,0,43473
13717,17600684,17600684,17644154,0,0,0,43470
13718,17600704,17600704,17644236,0,0,0,43532
13719,17600820,17600820,17644248,0,0,0,43428
13757,17644906,17644906,17645054,0,0,0,148
13758,17645154,17645154,17645300,0,0,0,146
13759,17645437,17645437,17647237,0,0,0,1800
13737,17614558,17614558,17647473,0,0,0,32915
13118,17400317,17400317,17652917,0,0,0,252600
13119,17400330,17400330,17652930,0,0,0,252600
13120,17400438,17400438,17653038,0,0,0,252600
13121,17400475,17400475,17653075,0,0,0,252600
13644,17586542,17586542,17653341,0,0,0,66799
13643,17586501,17586501,17653404,0,0,0,66903
13647,17586579,17586579,17653447,0,0,0,66868
13642,17586456,17586456,17653570,0,0,0,67114
13733,17610765,17610765,17654207,0,0,0,43442
13761,17654110,17654110,17654287,0,0,0,177
13648,17586607,17586607,17654761,0,0,0,68154
13646,17586572,17586572,17655165,0,0,0,68593
13762,17654749,17654749,17655373,0,0,0,624
13763,17655660,17655660,17655868,0,0,0,208
13414,17486994,17486994,17656291,0,0,0,169297
13415,17487007,17487007,17656394,0,0,0,169387
13767,17657726,17657726,17657841,0,0,0,115
13738,17618939,17618939,17659584,0,0,0,40645
13765,17656313,17656313,17660403,0,0,0,4090
13785,17663042,17663042,17663155,0,0,0,113
13768,17657902,17657902,17663721,0,0,0,5819
13556,17510118,17510118,17663746,0,0,0,153628
13786,17663366,17663366,17664008,0,0,0,642
13787,17663366,17663366,17664008,0,0,0,642
13788,17663367,17663367,17664009,0,0,0,642
13789,17663367,17663367,17664009,0,0,0,642
13790,17663367,17663367,17664009,0,0,0,642
13796,17663369,17663369,17664011,0,0,0,642
13791,17663367,17663367,17664020,0,0,0,653
13792,17663368,17663368,17664021,0,0,0,653
13793,17663368,17663368,17664021,0,0,0,653
13794,17663368,17663368,17664021,0,0,0,653
13795,17663368,17663368,17664021,0,0,0,653
13797,17663369,17663369,17664022,0,0,0,653
13798,17663369,17663369,17664022,0,0,0,653
13799,17663370,17663370,17664023,0,0,0,653
13800,17663370,17663370,17664023,0,0,0,653
13801,17663370,17663370,17664023,0,0,0,653
13802,17663370,17663370,17664023,0,0,0,653
13803,17663370,17663370,17664023,0,0,0,653
13804,17663371,17663371,17664024,0,0,0,653
13805,17663371,17663371,17664024,0,0,0,653
13780,17661162,17661162,17664353,0,0,0,3191
13772,17658184,17658184,17664973,0,0,0,6789
13769,17657937,17657937,17665461,0,0,0,7524
13770,17658045,17658045,17665625,0,0,0,7580
13784,17662007,17662007,17666016,0,0,0,4009
13858,17666131,17666131,17666289,0,0,0,158
13771,17658159,17658159,17666685,0,0,0,8526
13782,17661329,17661329,17673093,0,0,0,11764
13205,17422727,17422727,17675327,0,0,0,252600
13206,17422757,17422757,17675357,0,0,0,252600
13207,17422786,17422786,17675386,0,0,0,252600
13208,17422816,17422816,17675416,0,0,0,252600
13760,17648825,17648825,17675888,0,0,0,27063
13863,17676101,17676101,17676175,0,0,0,74
13864,17676178,17676178,17676397,0,0,0,219
13865,17676223,17676223,17676407,0,0,0,184
13866,17676471,17676471,17676657,0,0,0,186
13867,17677407,17677407,17677841,0,0,0,434
13781,17661299,17661299,17678157,0,0,0,16858
13875,17682163,17682163,17682327,0,0,0,164
13876,17682230,17682230,17682332,0,0,0,102
13766,17656982,17656982,17685435,0,0,0,28453
13764,17655771,17655771,17686849,0,0,0,31078
13877,17682320,17682320,17689054,0,0,0,6734
13878,17682351,17682351,17692354,0,0,0,10003
13883,17694356,17694356,17694533,0,0,0,177
13884,17694526,17694526,17694738,0,0,0,212
13887,17695086,17695086,17695324,0,0,0,238
13888,17695368,17695368,17695514,0,0,0,146
13776,17660016,17660016,17696016,0,0,0,36000
13777,17660023,17660023,17696023,0,0,0,36000
13778,17660029,17660029,17696029,0,0,0,36000
13779,17660035,17660035,17696035,0,0,0,36000
13889,17695573,17695573,17696104,0,0,0,531
13890,17696076,17696076,17696357,0,0,0,281
13891,17696372,17696372,17696518,0,0,0,146
13892,17696530,17696530,17696937,0,0,0,407
13893,17696950,17696950,17697302,0,0,0,352
13894,17697314,17697314,17697522,0,0,0,208
13895,17697526,17697526,17698126,0,0,0,600
13896,17698282,17698282,17698653,0,0,0,371
13897,17698706,17698706,17699319,0,0,0,613
13618,17569959,17569959,17699559,0,0,0,129600
13862,17675961,17675961,17702112,0,0,0,26151
13898,17699282,17699282,17702882,0,0,0,3600
13899,17702558,17702558,17705029,0,0,0,2471
13553,17510104,17510104,17705252,0,0,0,195148
13901,17705660,17705660,17706823,0,0,0,1163
13873,17681043,17681043,17707162,0,0,0,26119
13902,17706928,17706928,17707373,0,0,0,445
13874,17681397,17681397,17707459,0,0,0,26062
13903,17707500,17707500,17708040,0,0,0,540
13911,17708481,17708481,17708594,0,0,0,113
13557,17510124,17510124,17708953,0,0,0,198829
13915,17708728,17708728,17709354,0,0,0,626
13908,17708003,17708003,17709370,0,0,0,1367
13921,17709313,17709313,17709374,0,0,0,61
13922,17709336,17709336,17709819,0,0,0,483
13913,17708634,17708634,17710168,0,0,0,1534
13904,17707641,17707641,17710448,0,0,0,2807
13923,17710209,17710209,17710612,0,0,0,403
13924,17710895,17710895,17711030,0,0,0,135
13918,17708913,17708913,17711153,0,0,0,2240
13917,17708859,17708859,17711294,0,0,0,2435
13916,17708797,17708797,17711564,0,0,0,2767
13905,17707712,17707712,17711650,0,0,0,3938
13910,17708090,17708090,17711845,0,0,0,3755
13906,17707902,17707902,17711852,0,0,0,3950
13925,17711278,17711278,17711942,0,0,0,664
13932,17711991,17711991,17712113,0,0,0,122
13936,17712690,17712690,17712794,0,0,0,104
13920,17709033,17709033,17712906,0,0,0,3873
13559,17510249,17510249,17712934,0,0,0,202685
13919,17708974,17708974,17712977,0,0,0,4003
13933,17712511,17712511,17713031,0,0,0,520
13879,17686556,17686556,17713100,0,0,0,26544
13912,17708549,17708549,17713235,0,0,0,4686
13914,17708725,17708725,17713343,0,0,0,4618
13939,17712995,17712995,17713412,0,0,0,417
13941,17713370,17713370,17713490,0,0,0,120
13816,17664086,17664086,17713596,0,0,0,49510
13942,17713447,17713447,17713642,0,0,0,195
13811,17664085,17664085,17713841,0,0,0,49756
13943,17713610,17713610,17713971,0,0,0,361
13944,17713934,17713934,17714082,0,0,0,148
13946,17714794,17714794,17715153,0,0,0,359
13817,17664086,17664086,17715234,0,0,0,51148
13848,17664092,17664092,17715552,0,0,0,51460
13869,17679976,17679976,17715976,0,0,0,36000
13870,17679981,17679981,17715981,0,0,0,36000
13871,17679986,17679986,17715986,0,0,0,36000
13872,17679991,17679991,17715991,0,0,0,36000
13855,17664093,17664093,17716084,0,0,0,51991
13849,17664092,17664092,17716237,0,0,0,52145
13841,17664091,17664091,17716298,0,0,0,52207
13850,17664092,17664092,17716747,0,0,0,52655
13842,17664091,17664091,17716850,0,0,0,52759
13909,17708013,17708013,17717076,0,0,0,9063
13945,17714045,17714045,17717645,0,0,0,3600
13851,17664092,17664092,17718196,0,0,0,54104
13852,17664092,17664092,17718542,0,0,0,54450
13947,17715096,17715096,17718696,0,0,0,3600
13843,17664091,17664091,17720223,0,0,0,56132
13844,17664091,17664091,17720223,0,0,0,56132
13856,17664093,17664093,17720588,0,0,0,56495
13845,17664091,17664091,17720628,0,0,0,56537
13853,17664092,17664092,17721094,0,0,0,57002
13854,17664092,17664092,17721447,0,0,0,57355
13948,17721407,17721407,17721926,0,0,0,519
13827,17664089,17664089,17721991,0,0,0,57902
13907,17707953,17707953,17722123,0,0,0,14170
13949,17721922,17721922,17722251,0,0,0,329
13824,17664088,17664088,17722457,0,0,0,58369
13658,17587074,17587074,17722865,0,0,0,135791
13812,17664085,17664085,17723036,0,0,0,58951
13950,17722489,17722489,17723038,0,0,0,549
13951,17723087,17723087,17723202,0,0,0,115
13952,17723285,17723285,17723579,0,0,0,294
13807,17664078,17664078,17723673,0,0,0,59595
13818,17664086,17664086,17723954,0,0,0,59868
13834,17664090,17664090,17724011,0,0,0,59921
13828,17664089,17664089,17724055,0,0,0,59966
13829,17664089,17664089,17724314,0,0,0,60225
13846,17664091,17664091,17724389,0,0,0,60298
13808,17664084,17664084,17725458,0,0,0,61374
13835,17664090,17664090,17726811,0,0,0,62721
13820,17664087,17664087,17726850,0,0,0,62763
13953,17723536,17723536,17727136,0,0,0,3600
13836,17664090,17664090,17727470,0,0,0,63380
13825,17664088,17664088,17727572,0,0,0,63484
13830,17664089,17664089,17727883,0,0,0,63794
13813,17664085,17664085,17727983,0,0,0,63898
13809,17664084,17664084,17728296,0,0,0,64212
13837,17664090,17664090,17728934,0,0,0,64844
13900,17705075,17705075,17730869,0,0,0,25794
13810,17664084,17664084,17731928,0,0,0,67844
13868,17677718,17677718,17731980,0,0,0,54262
13814,17664085,17664085,17733503,0,0,0,69418
13683,17596045,17596045,17733592,0,0,0,137547
13806,17663522,17663522,17734149,0,0,0,70627
13838,17664090,17664090,17735103,0,0,0,71013
13882,17692207,17692207,17735642,0,0,0,43435
13881,17692176,17692176,17735646,0,0,0,43470
13847,17664091,17664091,17735972,0,0,0,71881
13839,17664090,17664090,17736336,0,0,0,72246
13840,17664090,17664090,17737282,0,0,0,73192
13885,17694921,17694921,17738354,0,0,0,43433
13886,17694934,17694934,17738393,0,0,0,43459
13831,17664089,17664089,17738468,0,0,0,74379
13821,17664087,17664087,17738543,0,0,0,74456
13832,17664089,17664089,17739052,0,0,0,74963
13833,17664089,17664089,17740030,0,0,0,75941
13815,17664085,17664085,17741276,0,0,0,77191
13822,17664087,17664087,17742723,0,0,0,78636
13826,17664088,17664088,17743014,0,0,0,78926
13937,17712746,17712746,17743641,0,0,0,30895
13823,17664087,17664087,17743988,0,0,0,79901
13938,17712797,17712797,17744449,0,0,0,31652
13819,17664086,17664086,17745500,0,0,0,81414
13774,17658743,17658743,17754817,0,0,0,96074
13954,17730923,17730923,17755635,0,0,0,24712
13931,17711763,17711763,17756439,0,0,0,44676
13935,17712596,17712596,17756968,0,0,0,44372
13934,17712554,17712554,17757525,0,0,0,44971
13928,17711647,17711647,17758774,0,0,0,47127
13927,17711638,17711638,17759043,0,0,0,47405
13926,17711592,17711592,17759444,0,0,0,47852
13930,17711727,17711727,17759448,0,0,0,47721
13929,17711694,17711694,17759902,0,0,0,48208
13959,17764322,17764322,17764382,0,0,0,60
13960,17764384,17764384,17764444,0,0,0,60
13956,17742362,17742362,17769022,0,0,0,26660
13957,17742677,17742677,17769170,0,0,0,26493
13958,17755771,17755771,17773853,0,0,0,18082
13965,17779575,17779575,17779649,0,0,0,74
13966,17779625,17779625,17779729,0,0,0,104
13967,17779732,17779732,17779888,0,0,0,156
13968,17779896,17779896,17780042,0,0,0,146
13940,17713105,17713105,17780079,0,0,0,66974
13969,17780632,17780632,17780809,0,0,0,177
13970,17783238,17783238,17783409,0,0,0,171
13971,17783526,17783526,17783704,0,0,0,178
13972,17783751,17783751,17783929,0,0,0,178
13973,17784135,17784135,17784323,0,0,0,188
13974,17784268,17784268,17784478,0,0,0,210
13975,17784426,17784426,17784603,0,0,0,177
13976,17784646,17784646,17784865,0,0,0,219
13977,17784825,17784825,17785026,0,0,0,201
13978,17785069,17785069,17785271,0,0,0,202
13979,17785356,17785356,17785555,0,0,0,199
13980,17785498,17785498,17785582,0,0,0,84
13981,17785581,17785581,17787027,0,0,0,1446
13964,17773905,17773905,17792121,0,0,0,18216
13783,17661459,17661459,17807589,0,0,0,146130
13861,17666882,17666882,17814572,0,0,0,147690
13983,17792118,17792118,17821848,0,0,0,29730
13955,17732456,17732456,17829990,0,0,0,97534
13963,17766895,17766895,17830592,0,0,0,63697
13985,17831118,17831118,17831222,0,0,0,104
13986,17831449,17831449,17831525,0,0,0,76
13987,17831514,17831514,17831587,0,0,0,73
13984,17822016,17822016,17835621,0,0,0,13605
13961,17765876,17765876,17836049,0,0,0,70173
13962,17766626,17766626,17836156,0,0,0,69530
13651,17586854,17586854,17839454,0,0,0,252600
13624,17581167,17581167,17840367,0,0,0,259200
13625,17581199,17581199,17840399,0,0,0,259200
13686,17596219,17596219,17842608,0,0,0,246389
13988,17831621,17831621,17848202,0,0,0,16581
13992,17849142,17849142,17849252,0,0,0,110
13994,17851641,17851641,17851740,0,0,0,99
13995,17851665,17851665,17851764,0,0,0,99
13996,17851665,17851665,17851764,0,0,0,99
13997,17851688,17851688,17851798,0,0,0,110
13998,17851711,17851711,17851821,0,0,0,110
13999,17851731,17851731,17851830,0,0,0,99
14000,17851761,17851761,17851860,0,0,0,99
14001,17851777,17851777,17851876,0,0,0,99
14002,17851792,17851792,17851891,0,0,0,99
14003,17851792,17851792,17851891,0,0,0,99
14004,17851805,17851805,17851904,0,0,0,99
14005,17851817,17851817,17851916,0,0,0,99
14006,17851831,17851831,17851930,0,0,0,99
14007,17851847,17851847,17851951,0,0,0,104
14008,17851861,17851861,17851965,0,0,0,104
14009,17851878,17851878,17851982,0,0,0,104
14010,17851878,17851878,17851982,0,0,0,104
14011,17851880,17851880,17851984,0,0,0,104
14014,17851938,17851938,17852009,0,0,0,71
14012,17851919,17851919,17852023,0,0,0,104
14013,17851931,17851931,17852035,0,0,0,104
14015,17851951,17851951,17852050,0,0,0,99
14016,17852006,17852006,17852097,0,0,0,91
14019,17852050,17852050,17852119,0,0,0,69
14017,17852018,17852018,17852120,0,0,0,102
14018,17852043,17852043,17852152,0,0,0,109
14020,17852064,17852064,17852170,0,0,0,106
14021,17852068,17852068,17852174,0,0,0,106
14022,17852068,17852068,17852174,0,0,0,106
14023,17852107,17852107,17852219,0,0,0,112
14024,17852146,17852146,17852251,0,0,0,105
14025,17852180,17852180,17852281,0,0,0,101
14026,17852217,17852217,17852316,0,0,0,99
14027,17852248,17852248,17852346,0,0,0,98
14028,17852282,17852282,17852382,0,0,0,100
14029,17852294,17852294,17852393,0,0,0,99
14030,17852311,17852311,17852410,0,0,0,99
14031,17852316,17852316,17852415,0,0,0,99
14032,17852330,17852330,17852429,0,0,0,99
14033,17852346,17852346,17852445,0,0,0,99
14034,17852364,17852364,17852463,0,0,0,99
14035,17852382,17852382,17852481,0,0,0,99
14036,17852414,17852414,17852513,0,0,0,99
14037,17852438,17852438,17852537,0,0,0,99
14039,17852510,17852510,17852585,0,0,0,75
14038,17852480,17852480,17852588,0,0,0,108
14040,17852539,17852539,17852654,0,0,0,115
14041,17852591,17852591,17852686,0,0,0,95
14042,17852619,17852619,17852726,0,0,0,107
14076,17853618,17853618,17853717,0,0,0,99
14078,17853638,17853638,17853792,0,0,0,154
14050,17853351,17853351,17853876,0,0,0,525
14095,17853802,17853802,17853911,0,0,0,109
14057,17853423,17853423,17854081,0,0,0,658
14099,17853905,17853905,17854081,0,0,0,176
14100,17854030,17854030,17854204,0,0,0,174
13684,17596072,17596072,17855272,0,0,0,259200
13685,17596143,17596143,17855343,0,0,0,259200
13687,17596414,17596414,17855614,0,0,0,259200
13688,17596475,17596475,17855675,0,0,0,259200
13689,17596489,17596489,17855689,0,0,0,259200
13690,17596520,17596520,17855720,0,0,0,259200
13691,17596655,17596655,17855855,0,0,0,259200
13692,17596697,17596697,17855897,0,0,0,259200
13693,17596703,17596703,17855903,0,0,0,259200
13694,17596734,17596734,17855934,0,0,0,259200
14065,17853505,17853505,17855997,0,0,0,2492
13697,17597008,17597008,17856208,0,0,0,259200
14075,17853608,17853608,17856223,0,0,0,2615
13698,17597039,17597039,17856239,0,0,0,259200
13699,17597045,17597045,17856245,0,0,0,259200
13700,17597079,17597079,17856279,0,0,0,259200
13701,17597238,17597238,17856438,0,0,0,259200
13702,17597272,17597272,17856472,0,0,0,259200
13703,17597279,17597279,17856479,0,0,0,259200
13704,17597309,17597309,17856509,0,0,0,259200
14101,17854147,17854147,17857343,0,0,0,3196
13989,17835611,17835611,17860109,0,0,0,24498
13880,17690216,17690216,17863016,0,0,0,172800
13993,17849252,17849252,17864535,0,0,0,15283
14061,17853464,17853464,17869983,0,0,0,16519
14086,17853710,17853710,17870408,0,0,0,16698
14060,17853454,17853454,17870502,0,0,0,17048
14064,17853495,17853495,17870639,0,0,0,17144
14059,17853443,17853443,17870675,0,0,0,17232
14074,17853597,17853597,17871556,0,0,0,17959
14054,17853392,17853392,17871612,0,0,0,18220
14053,17853382,17853382,17872641,0,0,0,19259
14105,17860122,17860122,17877872,0,0,0,17750
14052,17853372,17853372,17878304,0,0,0,24932
14071,17853567,17853567,17879451,0,0,0,25884
13982,17787011,17787011,17882007,0,0,0,94996
14058,17853433,17853433,17882061,0,0,0,28628
14063,17853485,17853485,17883183,0,0,0,29698
14062,17853474,17853474,17883663,0,0,0,30189
14083,17853679,17853679,17884288,0,0,0,30609
14056,17853413,17853413,17884733,0,0,0,31320
14123,17880737,17880737,17885034,0,0,0,4297
14098,17853822,17853822,17885104,0,0,0,31282
14117,17880584,17880584,17885632,0,0,0,5048
14124,17880752,17880752,17886880,0,0,0,6128
14119,17880627,17880627,17887158,0,0,0,6531
14093,17853781,17853781,17887409,0,0,0,33628
14090,17853751,17853751,17891284,0,0,0,37533
14089,17853740,17853740,17891397,0,0,0,37657
14085,17853700,17853700,17894647,0,0,0,40947
14097,17853812,17853812,17895075,0,0,0,41263
14092,17853771,17853771,17895205,0,0,0,41434
14096,17853802,17853802,17895526,0,0,0,41724
14070,17853556,17853556,17896770,0,0,0,43214
14066,17853515,17853515,17897059,0,0,0,43544
14088,17853730,17853730,17900593,0,0,0,46863
14122,17880688,17880688,17901340,0,0,0,20652
14048,17853331,17853331,17901737,0,0,0,48406
14055,17853402,17853402,17901878,0,0,0,48476
14049,17853341,17853341,17902112,0,0,0,48771
14051,17853362,17853362,17902591,0,0,0,49229
14094,17853792,17853792,17903589,0,0,0,49797
14091,17853761,17853761,17903724,0,0,0,49963
14121,17880676,17880676,17904190,0,0,0,23514
14120,17880657,17880657,17905487,0,0,0,24830
14077,17853628,17853628,17906283,0,0,0,52655
14079,17853638,17853638,17906842,0,0,0,53204
14084,17853689,17853689,17906905,0,0,0,53216
14081,17853659,17853659,17907344,0,0,0,53685
14087,17853720,17853720,17907487,0,0,0,53767
14080,17853648,17853648,17908016,0,0,0,54368
14069,17853546,17853546,17908459,0,0,0,54913
14082,17853669,17853669,17908643,0,0,0,54974
14103,17854442,17854442,17908726,0,0,0,54284
14067,17853526,17853526,17909263,0,0,0,55737
14116,17877877,17877877,17909700,0,0,0,31823
13773,17658729,17658729,17911329,0,0,0,252600
13775,17658754,17658754,17911354,0,0,0,252600
14072,17853577,17853577,17913192,0,0,0,59615
14073,17853587,17853587,17917759,0,0,0,64172
13857,17665968,17665968,17918568,0,0,0,252600
14102,17854343,17854343,17918778,0,0,0,64435
13859,17666220,17666220,17918820,0,0,0,252600
13860,17666250,17666250,17918850,0,0,0,252600
14068,17853536,17853536,17919229,0,0,0,65693
14115,17871356,17871356,17920473,0,0,0,49117
13990,17835819,17835819,17920840,0,0,0,85021
14111,17870779,17870779,17933522,0,0,0,62743
14118,17880613,17880613,17937281,0,0,0,56668
14108,17870637,17870637,17941111,0,0,0,70474
14125,17882407,17882407,17948484,0,0,0,66077
14130,17921904,17921904,17949345,0,0,0,27441
14126,17917634,17917634,17949481,0,0,0,31847
14127,17919719,17919719,17961303,0,0,0,41584
14110,17870684,17870684,17963886,0,0,0,93202
14138,17949365,17949365,17965078,0,0,0,15713
13991,17835958,17835958,17967164,0,0,0,131206
14107,17870631,17870631,17978500,0,0,0,107869
14106,17870628,17870628,17978508,0,0,0,107880
14109,17870640,17870640,17978509,0,0,0,107869
14144,17973715,17973715,17979189,0,0,0,5474
14143,17973495,17973495,17981340,0,0,0,7845
14113,17870909,17870909,17982803,0,0,0,111894
14112,17870831,17870831,17983459,0,0,0,112628
14159,17979372,17979372,17988681,0,0,0,9309
14134,17946003,17946003,17989452,0,0,0,43449
14135,17946024,17946024,17989471,0,0,0,43447
14136,17946048,17946048,17989499,0,0,0,43451
14137,17946072,17946072,17989532,0,0,0,43460
14162,17979727,17979727,17989944,0,0,0,10217
14139,17960287,17960287,17992084,0,0,0,31797
14151,17978366,17978366,18010750,0,0,0,32384
14158,17979239,17979239,18011018,0,0,0,31779
14166,17980794,17980794,18018486,0,0,0,37692
14163,17980381,17980381,18018515,0,0,0,38134
14140,17964110,17964110,18020163,0,0,0,56053
14128,17919786,17919786,18020778,0,0,0,100992
14157,17979125,17979125,18021601,0,0,0,42476
14160,17979425,17979425,18032067,0,0,0,52642
14165,17980671,17980671,18034264,0,0,0,53593
14146,17977693,17977693,18034870,0,0,0,57177
14164,17980477,17980477,18035103,0,0,0,54626
14152,17978523,17978523,18036295,0,0,0,57772
14174,18040202,18040202,18040862,0,0,0,660
14167,18014730,18014730,18041323,0,0,0,26593
14175,18040822,18040822,18044148,0,0,0,3326
14161,17979490,17979490,18044179,0,0,0,64689
14170,18018862,18018862,18044519,0,0,0,25657
14176,18044183,18044183,18045356,0,0,0,1173
14178,18046040,18046040,18046237,0,0,0,197
14179,18046309,18046309,18047268,0,0,0,959
14181,18047971,18047971,18050180,0,0,0,2209
14183,18050138,18050138,18052310,0,0,0,2172
14148,17977924,17977924,18054187,0,0,0,76263
14168,18014767,18014767,18054687,0,0,0,39920
14169,18014782,18014782,18054709,0,0,0,39927
14182,18048127,18048127,18055295,0,0,0,7168
14186,18054650,18054650,18055713,0,0,0,1063
14185,18054631,18054631,18055716,0,0,0,1085
14187,18054671,18054671,18055721,0,0,0,1050
14184,18052464,18052464,18056064,0,0,0,3600
14180,18047618,18047618,18057178,0,0,0,9560
14188,18057991,18057991,18058044,0,0,0,53
14189,18058099,18058099,18058617,0,0,0,518
14191,18058582,18058582,18058786,0,0,0,204
14192,18058916,18058916,18059446,0,0,0,530
14194,18059403,18059403,18059996,0,0,0,593
14156,17979081,17979081,18060910,0,0,0,81829
14195,18060164,18060164,18061139,0,0,0,975
14199,18061676,18061676,18062007,0,0,0,331
14202,18062327,18062327,18063157,0,0,0,830
14201,18061877,18061877,18065989,0,0,0,4112
14196,18060329,18060329,18075901,0,0,0,15572
14177,18044545,18044545,18076323,0,0,0,31778
14114,17870962,17870962,18078245,0,0,0,207283
14147,17977841,17977841,18083685,0,0,0,105844
14149,17977998,17977998,18083939,0,0,0,105941
14200,18061780,18061780,18085486,0,0,0,23706
14197,18061261,18061261,18093082,0,0,0,31821
14141,17965109,17965109,18095887,0,0,0,130778
14131,17925186,17925186,18097986,0,0,0,172800
14210,18099894,18099894,18099954,0,0,0,60
14213,18100224,18100224,18100284,0,0,0,60
14211,18099906,18099906,18101101,0,0,0,1195
14217,18101179,18101179,18102358,0,0,0,1179
14215,18101118,18101118,18102361,0,0,0,1243
14216,18101173,18101173,18102363,0,0,0,1190
14154,17978818,17978818,18102465,0,0,0,123647
14222,18104643,18104643,18104703,0,0,0,60
14173,18022120,18022120,18105172,0,0,0,83052
14043,17852622,17852622,18105222,0,0,0,252600
14044,17852739,17852739,18105339,0,0,0,252600
14045,17852877,17852877,18105477,0,0,0,252600
14046,17852948,17852948,18105548,0,0,0,252600
14047,17853048,17853048,18105648,0,0,0,252600
14223,18105924,18105924,18105984,0,0,0,60
14224,18106043,18106043,18106103,0,0,0,60
14226,18106232,18106232,18106772,0,0,0,540
14104,17857530,17857530,18110130,0,0,0,252600
14153,17978695,17978695,18110538,0,0,0,131843
14198,18061424,18061424,18113595,0,0,0,52171
14155,17978959,17978959,18114118,0,0,0,135159
14229,18115800,18115800,18115853,0,0,0,53
14230,18115859,18115859,18115932,0,0,0,73
14228,18115737,18115737,18115934,0,0,0,197
14232,18116453,18116453,18116503,0,0,0,50
14231,18116024,18116024,18118599,0,0,0,2575
14233,18116480,18116480,18118599,0,0,0,2119
14237,18118861,18118861,18121369,0,0,0,2508
14142,17973461,17973461,18122737,0,0,0,149276
14150,17978111,17978111,18122749,0,0,0,144638
14145,17974014,17974014,18122751,0,0,0,148737
14190,18058415,18058415,18122759,0,0,0,64344
14193,18059145,18059145,18122765,0,0,0,63620
14208,18091320,18091320,18123054,0,0,0,31734
14204,18081790,18081790,18125269,0,0,0,43479
14206,18081848,18081848,18125279,0,0,0,43431
14205,18081825,18081825,18125287,0,0,0,43462
14207,18081887,18081887,18125349,0,0,0,43462
14212,18100093,18100093,18132493,0,0,0,32400
14214,18100367,18100367,18132767,0,0,0,32400
14240,18127783,18127783,18137508,0,0,0,9725
14227,18106910,18106910,18139310,0,0,0,32400
14209,18097921,18097921,18141348,0,0,0,43427
14238,18122490,18122490,18146510,0,0,0,24020
14171,18019030,18019030,18149909,0,0,0,130879
14239,18124895,18124895,18156583,0,0,0,31688
14220,18102339,18102339,18157216,0,0,0,54877
14172,18022053,18022053,18161513,0,0,0,139460
14235,18118633,18118633,18161589,0,0,0,42956
14236,18118841,18118841,18161828,0,0,0,42987
14243,18149204,18149204,18162770,0,0,0,13566
14129,17919787,17919787,18172387,0,0,0,252600
14241,18149116,18149116,18173926,0,0,0,24810
14242,18149138,18149138,18176246,0,0,0,27108
14246,18179050,18179050,18179155,0,0,0,105
14247,18179174,18179174,18179306,0,0,0,132
14244,18149215,18149215,18179566,0,0,0,30351
14132,17933287,17933287,18185887,0,0,0,252600
14133,17933311,17933311,18185911,0,0,0,252600
14253,18186769,18186769,18186844,0,0,0,75
14254,18186833,18186833,18187165,0,0,0,332
14255,18186963,18186963,18187348,0,0,0,385
14256,18187106,18187106,18187534,0,0,0,428
14258,18187646,18187646,18187815,0,0,0,169
14259,18187793,18187793,18188207,0,0,0,414
14270,18205731,18205731,18206207,0,0,0,476
14203,18063116,18063116,18207096,0,0,0,143980
14249,18186089,18186089,18208087,0,0,0,21998
14265,18194996,18208087,18208366,0,0,13091,13370
14266,18195171,18208366,18208667,0,0,13195,13496
14267,18195310,18208667,18208969,0,0,13357,13659
14272,18209872,18209872,18210018,0,0,0,146
14273,18210433,18210433,18210579,0,0,0,146
14245,18149241,18149241,18210659,0,0,0,61418
14274,18210935,18210935,18211095,0,0,0,160
14275,18211102,18211102,18212411,0,0,0,1309
14276,18214908,18214908,18215054,0,0,0,146
14277,18215170,18215170,18215351,0,0,0,181
14269,18199642,18199642,18215776,0,0,0,16134
14278,18215553,18215553,18216226,0,0,0,673
14279,18216385,18216385,18216489,0,0,0,104
14271,18208163,18210659,18225668,0,0,2496,17505
14286,18223902,18225668,18225721,0,0,1766,1819
14287,18224131,18225721,18226795,0,0,1590,2664
14288,18225162,18226795,18227009,0,0,1633,1847
14289,18225462,18227009,18227263,0,0,1547,1801
14290,18225673,18227263,18227595,0,0,1590,1922
14261,18191009,18191009,18234473,0,0,0,43464
14250,18186211,18186211,18235503,0,0,0,49292
14251,18186330,18186330,18236196,0,0,0,49866
14225,18106176,18106176,18239513,0,0,0,133337
14292,18241714,18241714,18241809,0,0,0,95
14293,18241817,18241817,18241964,0,0,0,147
14294,18242005,18242005,18242605,0,0,0,600
14295,18243190,18243190,18243336,0,0,0,146
14296,18243578,18243578,18243724,0,0,0,146
14297,18243738,18243738,18243884,0,0,0,146
14262,18194614,18194614,18245411,0,0,0,50797
14298,18246263,18246263,18246416,0,0,0,153
14263,18194635,18194635,18246525,0,0,0,51890
14299,18246772,18246772,18246905,0,0,0,133
14300,18246993,18246993,18247149,0,0,0,156
14301,18248318,18248318,18248382,0,0,0,64
14302,18248362,18248362,18248507,0,0,0,145
14303,18248463,18248463,18248642,0,0,0,179
14304,18248642,18248642,18252415,0,0,0,3773
14260,18190267,18190267,18253635,0,0,0,63368
14305,18255058,18255058,18255131,0,0,0,73
14306,18255276,18255276,18255380,0,0,0,104
14307,18255501,18255501,18255574,0,0,0,73
14264,18194669,18194669,18258155,0,0,0,63486
14221,18103407,18103407,18263275,0,0,0,159868
14311,18263685,18263685,18263806,0,0,0,121
14252,18186448,18186448,18268740,0,0,0,82292
14257,18187373,18187373,18269892,0,0,0,82519
14218,18102326,18102326,18271207,0,0,0,168881
14219,18102331,18102331,18272307,0,0,0,169976
14322,18287978,18287978,18288440,0,0,0,462
14280,18216734,18216734,18289077,0,0,0,72343
14323,18289885,18289885,18289978,0,0,0,93
14281,18217048,18225668,18293923,0,0,8620,76875
14314,18263851,18263851,18297407,0,0,0,33556
14282,18217190,18235503,18301685,0,0,18313,84495
14325,18302538,18302538,18302642,0,0,0,104
14312,18263808,18263808,18303084,0,0,0,39276
14327,18306572,18306572,18307305,0,0,0,733
14329,18307373,18307373,18307728,0,0,0,355
14330,18307693,18307693,18308257,0,0,0,564
14332,18308227,18308227,18308827,0,0,0,600
14334,18309470,18309470,18309729,0,0,0,259
14335,18311357,18311357,18311957,0,0,0,600
14336,18314354,18314354,18314878,0,0,0,524
14337,18315797,18315797,18316234,0,0,0,437
14338,18316678,18316678,18316836,0,0,0,158
14339,18316976,18316976,18317308,0,0,0,332
14340,18317401,18317401,18317547,0,0,0,146
14341,18318362,18318362,18318508,0,0,0,146
14342,18318675,18318675,18318821,0,0,0,146
14343,18318881,18318881,18319078,0,0,0,197
14308,18255643,18255643,18319543,0,0,0,63900
14344,18319441,18319441,18319598,0,0,0,157
14345,18319827,18319827,18319986,0,0,0,159
14346,18320171,18320171,18320513,0,0,0,342
14347,18321007,18321007,18321150,0,0,0,143
14348,18321143,18321143,18321258,0,0,0,115
14349,18321640,18321640,18322147,0,0,0,507
14350,18323706,18323706,18323852,0,0,0,146
14351,18323970,18323970,18324149,0,0,0,179
14352,18324755,18324755,18325052,0,0,0,297
14353,18325107,18325107,18325366,0,0,0,259
14354,18325370,18325370,18325626,0,0,0,256
14355,18325606,18325606,18325900,0,0,0,294
14356,18326041,18326041,18326190,0,0,0,149
14357,18326224,18326224,18326824,0,0,0,600
14358,18328497,18328497,18329097,0,0,0,600
14321,18281905,18281905,18345412,0,0,0,63507
14309,18263401,18263401,18348646,0,0,0,85245
14310,18263573,18263573,18348838,0,0,0,85265
14313,18263814,18263814,18349029,0,0,0,85215
14315,18263995,18263995,18349248,0,0,0,85253
14316,18264132,18264132,18349386,0,0,0,85254
14317,18264483,18264483,18349723,0,0,0,85240
14318,18264583,18264583,18349865,0,0,0,85282
14319,18264693,18264693,18349944,0,0,0,85251
14320,18264769,18264769,18350020,0,0,0,85251
14248,18180646,18180646,18353446,0,0,0,172800
14285,18219097,18239513,18368229,0,0,20416,149132
14234,18116675,18116675,18369275,0,0,0,252600
14362,18372003,18372003,18372510,0,0,0,507
14363,18374773,18374773,18374866,0,0,0,93
14283,18217937,18235503,18375012,0,0,17566,157075
14364,18376456,18376456,18376516,0,0,0,60
14284,18219043,18236196,18376891,0,0,17153,157848
14366,18377687,18377687,18388487,0,0,0,10800
14367,18377696,18377696,18388496,0,0,0,10800
14368,18378012,18378012,18388812,0,0,0,10800
14372,18393949,18393949,18394177,0,0,0,228
14373,18394254,18394254,18394462,0,0,0,208
14374,18394582,18394582,18395182,0,0,0,600
14375,18399094,18399094,18399693,0,0,0,599
14359,18342693,18342693,18403726,0,0,0,61033
14365,18376727,18376727,18412727,0,0,0,36000
14324,18302407,18302407,18440092,0,0,0,137685
14376,18399688,18399688,18442888,0,0,0,43200
14328,18306967,18306967,18445198,0,0,0,138231
14291,18238999,18238999,18446302,0,0,0,207303
14326,18304627,18304627,18447840,0,0,0,143213
14377,18407883,18407883,18451083,0,0,0,43200
14378,18407891,18407891,18451091,0,0,0,43200
14379,18407897,18407897,18451097,0,0,0,43200
14380,18407904,18407904,18451104,0,0,0,43200
14331,18308029,18308029,18457202,0,0,0,149173
14384,18461212,18461212,18461285,0,0,0,73
14385,18461376,18461376,18461528,0,0,0,152
14381,18410115,18410115,18463791,0,0,0,53676
14387,18462902,18462902,18467233,0,0,0,4331
14268,18195443,18208969,18468169,0,0,13526,272726
14333,18309197,18309197,18469461,0,0,0,160264
14382,18410134,18410134,18474954,0,0,0,64820
14360,18345497,18345497,18483602,0,0,0,138105
14388,18465317,18465317,18486891,0,0,0,21574
14389,18465339,18465339,18486897,0,0,0,21558
14383,18410283,18410283,18493827,0,0,0,83544
14369,18386574,18386574,18519922,0,0,0,133348
14371,18388833,18388833,18521381,0,0,0,132548
14361,18357471,18357471,18530271,0,0,0,172800
14370,18388749,18388749,18548835,0,0,0,160086
14391,18486886,18486886,18551383,0,0,0,64497
14393,18486926,18486926,18552900,0,0,0,65974
14390,18486864,18486864,18553369,0,0,0,66505
14396,18556165,18556165,18556300,0,0,0,135
14392,18486911,18486911,18557727,0,0,0,70816
14409,18562745,18562745,18562819,0,0,0,74
14410,18562822,18562822,18562988,0,0,0,166
14411,18563014,18563014,18563353,0,0,0,339
14412,18563547,18563547,18564054,0,0,0,507
14413,18564913,18564913,18565037,0,0,0,124
14386,18462785,18462785,18565571,0,0,0,102786
14407,18556979,18556979,18600176,0,0,0,43197
14416,18610208,18610208,18610268,0,0,0,60
14418,18610591,18610591,18610651,0,0,0,60
14417,18610399,18610399,18613912,0,0,0,3513
14419,18614945,18614945,18615005,0,0,0,60
14420,18615232,18615232,18615292,0,0,0,60
14421,18615416,18615416,18615725,0,0,0,309
14422,18615698,18615698,18615758,0,0,0,60
14424,18622591,18622591,18622808,0,0,0,217
14425,18624943,18624943,18625003,0,0,0,60
14426,18625185,18625185,18625245,0,0,0,60
14427,18625328,18625328,18625388,0,0,0,60
14428,18625799,18625799,18625859,0,0,0,60
14429,18626172,18626172,18626232,0,0,0,60
14430,18626627,18626627,18626747,0,0,0,120
14431,18627164,18627164,18627284,0,0,0,120
14432,18627732,18627732,18627852,0,0,0,120
14433,18628047,18628047,18628162,0,0,0,115
14434,18628409,18628409,18628529,0,0,0,120
14394,18537235,18537235,18629811,0,0,0,92576
14436,18629470,18629470,18630683,0,0,0,1213
14438,18631009,18631009,18631164,0,0,0,155
14439,18631049,18631049,18631169,0,0,0,120
14440,18631344,18631344,18631464,0,0,0,120
14442,18631955,18631955,18632062,0,0,0,107
14443,18634923,18634923,18635043,0,0,0,120
14444,18635857,18635857,18635977,0,0,0,120
14397,18556383,18556383,18641627,0,0,0,85244
14398,18556417,18556417,18641663,0,0,0,85246
14399,18556454,18556454,18641669,0,0,0,85215
14400,18556485,18556485,18641727,0,0,0,85242
14401,18556522,18556522,18641771,0,0,0,85249
14403,18556554,18556554,18641814,0,0,0,85260
14404,18556664,18556664,18641929,0,0,0,85265
14405,18556721,18556721,18641982,0,0,0,85261
14406,18556762,18556762,18642022,0,0,0,85260
14414,18600237,18600237,18656970,0,0,0,56733
14415,18607430,18607430,18693830,0,0,0,86400
14437,18630383,18630383,18695874,0,0,0,65491
14445,18694234,18694234,18695962,0,0,0,1728
14447,18701043,18701043,18704643,0,0,0,3600
14402,18556548,18556548,18711249,0,0,0,154701
14449,18710202,18710202,18713802,0,0,0,3600
14453,18713603,18713603,18714203,0,0,0,600
14454,18713604,18713604,18714204,0,0,0,600
14455,18713604,18713604,18714204,0,0,0,600
14456,18713604,18713604,18714204,0,0,0,600
14457,18713604,18713604,18714204,0,0,0,600
14458,18713604,18713604,18714204,0,0,0,600
14459,18713635,18713635,18714235,0,0,0,600
14460,18713636,18713636,18714236,0,0,0,600
14461,18713636,18713636,18714236,0,0,0,600
14462,18713636,18713636,18714236,0,0,0,600
14463,18713636,18713636,18714236,0,0,0,600
14464,18713637,18713637,18714237,0,0,0,600
14465,18713637,18713637,18714237,0,0,0,600
14466,18713637,18713637,18714237,0,0,0,600
14467,18713638,18713638,18714238,0,0,0,600
14468,18713638,18713638,18714238,0,0,0,600
14469,18713638,18713638,18714238,0,0,0,600
14470,18713638,18713638,18714238,0,0,0,600
14471,18713639,18713639,18714239,0,0,0,600
14472,18713639,18713639,18714239,0,0,0,600
14473,18713639,18713639,18714239,0,0,0,600
14474,18713639,18713639,18714239,0,0,0,600
14475,18713640,18713640,18714240,0,0,0,600
14476,18713640,18713640,18714240,0,0,0,600
14477,18713640,18713640,18714240,0,0,0,600
14478,18713640,18713640,18714240,0,0,0,600
14479,18713641,18713641,18714241,0,0,0,600
14480,18713641,18713641,18714241,0,0,0,600
14481,18713641,18713641,18714241,0,0,0,600
14482,18713641,18713641,18714241,0,0,0,600
14483,18713641,18713641,18714241,0,0,0,600
14484,18713642,18713642,18714242,0,0,0,600
14485,18715450,18715450,18715480,0,0,0,30
14487,18717262,18717262,18717282,0,0,0,20
14408,18557445,18557445,18717568,0,0,0,160123
14446,18695876,18695876,18717805,0,0,0,21929
14451,18713065,18713065,18720714,0,0,0,7649
14491,18721163,18721163,18721281,0,0,0,118
14492,18721845,18721845,18723840,0,0,0,1995
14395,18555959,18555959,18728759,0,0,0,172800
14452,18713264,18713264,18732595,0,0,0,19331
14486,18715692,18715692,18734474,0,0,0,18782
14488,18717480,18717480,18739398,0,0,0,21918
14490,18718668,18718668,18740238,0,0,0,21570
14489,18718652,18718652,18740350,0,0,0,21698
14499,18741497,18741497,18741736,0,0,0,239
14500,18741713,18741713,18741766,0,0,0,53
14501,18742294,18742294,18742411,0,0,0,117
14502,18742357,18742357,18742462,0,0,0,105
14503,18742474,18742474,18742602,0,0,0,128
14450,18712536,18712536,18748536,0,0,0,36000
14435,18629246,18629246,18762306,0,0,0,133060
14506,18781181,18781181,18783215,0,0,0,2034
14507,18784591,18784591,18784706,0,0,0,115
14525,18784909,18784909,18785098,0,0,0,189
14508,18784902,18784902,18785102,0,0,0,200
14509,18784903,18784903,18785103,0,0,0,200
14510,18784903,18784903,18785103,0,0,0,200
14511,18784903,18784903,18785103,0,0,0,200
14521,18784908,18784908,18785103,0,0,0,195
14522,18784908,18784908,18785125,0,0,0,217
14516,18784907,18784907,18785144,0,0,0,237
14517,18784907,18784907,18785144,0,0,0,237
14518,18784907,18784907,18785144,0,0,0,237
14519,18784907,18784907,18785144,0,0,0,237
14524,18784908,18784908,18785150,0,0,0,242
14526,18784909,18784909,18785151,0,0,0,242
14527,18784909,18784909,18785151,0,0,0,242
14520,18784907,18784907,18785155,0,0,0,248
14523,18784908,18784908,18785156,0,0,0,248
14512,18784903,18784903,18785157,0,0,0,254
14513,18784903,18784903,18785157,0,0,0,254
14514,18784903,18784903,18785157,0,0,0,254
14515,18784903,18784903,18785157,0,0,0,254
14529,18787440,18787440,18787664,0,0,0,224
14534,18787693,18787693,18787869,0,0,0,176
14541,18787904,18787904,18788132,0,0,0,228
14542,18788157,18788157,18789894,0,0,0,1737
14543,18790532,18790532,18790684,0,0,0,152
14448,18707887,18707887,18790732,0,0,0,82845
14547,18792236,18792236,18798892,0,0,0,6656
14548,18792360,18792360,18798892,0,0,0,6532
14539,18787786,18787786,18808464,0,0,0,20678
14540,18787804,18787804,18808532,0,0,0,20728
14537,18787747,18787747,18808812,0,0,0,21065
14538,18787761,18787761,18808879,0,0,0,21118
14535,18787712,18787712,18811941,0,0,0,24229
14536,18787728,18787728,18812041,0,0,0,24313
14533,18787538,18787538,18814138,0,0,0,26600
14532,18787522,18787522,18814315,0,0,0,26793
14530,18787474,18787474,18814357,0,0,0,26883
14531,18787496,18787496,18814357,0,0,0,26861
14496,18730262,18730262,18815587,0,0,0,85325
14528,18787396,18787396,18817530,0,0,0,30134
14545,18790647,18790647,18820980,0,0,0,30333
14549,18808422,18808422,18829016,0,0,0,20594
14550,18808493,18808493,18829078,0,0,0,20585
14551,18808773,18808773,18829707,0,0,0,20934
14553,18811904,18811904,18835997,0,0,0,24093
14554,18811966,18811966,18836099,0,0,0,24133
14555,18814095,18814095,18840384,0,0,0,26289
14556,18814267,18814267,18840740,0,0,0,26473
14557,18814274,18814274,18840908,0,0,0,26634
14558,18814277,18814277,18841139,0,0,0,26862
14559,18817490,18817490,18847583,0,0,0,30093
14561,18820937,18820937,18850932,0,0,0,29995
14552,18808838,18808838,18852038,0,0,0,43200
14493,18722864,18722864,18853682,0,0,0,130818
14504,18776392,18776392,18862792,0,0,0,86400
14495,18726348,18726348,18867472,0,0,0,141124
14546,18790703,18790703,18867511,0,0,0,76808
14497,18730347,18730347,18867996,0,0,0,137649
14544,18790621,18790621,18868871,0,0,0,78250
14562,18868313,18868313,18879113,0,0,0,10800
14423,18621707,18621707,18880907,0,0,0,259200
14566,18881968,18881968,18882117,0,0,0,149
14498,18730518,18730518,18890674,0,0,0,160156
14560,18818631,18818631,18890846,0,0,0,72215
14568,18891418,18891418,18891458,0,0,0,40
14505,18779277,18779277,18917879,0,0,0,138602
14570,18942640,18942640,18942786,0,0,0,146
14563,18871673,18871673,18946774,0,0,0,75101
14564,18871696,18871696,18949880,0,0,0,78184
14567,18883152,18883152,18976140,0,0,0,92988
14441,18631390,18631390,18976990,0,0,0,345600
14572,18944825,18944825,18999875,0,0,0,55050
14575,19000917,19000917,19001370,0,0,0,453
14565,18879533,18879533,19001674,0,0,0,122141
14494,18724201,18724201,19001681,0,0,0,277480
14576,19001896,19001896,19002290,0,0,0,394
14577,19003545,19003545,19003698,0,0,0,153
14578,19003714,19003714,19004148,0,0,0,434
14579,19006528,19006528,19007254,0,0,0,726
14581,19008851,19008851,19008973,0,0,0,122
14582,19009162,19009162,19009534,0,0,0,372
14583,19010036,19010036,19010438,0,0,0,402
14569,18894225,18894225,19053980,0,0,0,159755
14586,19048947,19048947,19056553,0,0,0,7606
14587,19062222,19062222,19064246,0,0,0,2024
14573,18959256,18959256,19111729,0,0,0,152473
14571,18944602,18944602,19117402,0,0,0,172800
14574,18976896,18976896,19146605,0,0,0,169709
14594,19198364,19198364,19201976,0,0,0,3612
14595,19203670,19203670,19207313,0,0,0,3643
14598,19209652,19209652,19209762,0,0,0,110
14600,19209726,19209726,19209799,0,0,0,73
14599,19209700,19209700,19209976,0,0,0,276
14597,19209512,19209512,19209988,0,0,0,476
14593,19155378,19155378,19210373,0,0,0,54995
14589,19140510,19140510,19210627,0,0,0,70117
14590,19141050,19141050,19210787,0,0,0,69737
14588,19139308,19139308,19210848,0,0,0,71540
14596,19207799,19207799,19211346,0,0,0,3547
14611,19213679,19213679,19213743,0,0,0,64
14612,19213772,19213772,19213918,0,0,0,146
14615,19214781,19214781,19214885,0,0,0,104
14605,19211575,19211575,19215109,0,0,0,3534
14616,19215283,19215283,19215449,0,0,0,166
14617,19215897,19215897,19216001,0,0,0,104
14619,19216531,19216531,19216624,0,0,0,93
14620,19216807,19216807,19216927,0,0,0,120
14621,19216933,19216933,19217068,0,0,0,135
14622,19217034,19217034,19217835,0,0,0,801
14623,19217330,19217330,19217861,0,0,0,531
14624,19217670,19217670,19218416,0,0,0,746
14625,19218363,19218363,19218709,0,0,0,346
14628,19218868,19218868,19218941,0,0,0,73
14629,19218991,19218991,19219075,0,0,0,84
14631,19219104,19219104,19219189,0,0,0,85
14618,19215964,19215964,19219425,0,0,0,3461
14634,19219540,19219540,19219763,0,0,0,223
14627,19218836,19218836,19220364,0,0,0,1528
14626,19218462,19218462,19220372,0,0,0,1910
14636,19220314,19220314,19220520,0,0,0,206
14639,19221430,19221430,19224986,0,0,0,3556
14646,19226665,19226665,19226835,0,0,0,170
14650,19227935,19227935,19228012,0,0,0,77
14651,19227936,19227936,19228013,0,0,0,77
14652,19227936,19227936,19228013,0,0,0,77
14653,19227936,19227936,19228013,0,0,0,77
14654,19227936,19227936,19228013,0,0,0,77
14655,19227936,19227936,19228013,0,0,0,77
14656,19227936,19227936,19228013,0,0,0,77
14657,19227936,19227936,19228013,0,0,0,77
14658,19227937,19227937,19228047,0,0,0,110
14659,19227937,19227937,19228047,0,0,0,110
14660,19227937,19227937,19228078,0,0,0,141
14661,19227937,19227937,19228078,0,0,0,141
14662,19227937,19227937,19228078,0,0,0,141
14663,19228147,19228147,19228223,0,0,0,76
14664,19228147,19228147,19228223,0,0,0,76
14665,19228147,19228147,19228223,0,0,0,76
14666,19228147,19228147,19228223,0,0,0,76
14667,19228147,19228147,19228223,0,0,0,76
14668,19228148,19228148,19228224,0,0,0,76
14669,19228148,19228148,19228224,0,0,0,76
14670,19228148,19228148,19228224,0,0,0,76
14671,19228148,19228148,19228257,0,0,0,109
14672,19228148,19228148,19228268,0,0,0,120
14673,19228148,19228148,19228291,0,0,0,143
14674,19228148,19228148,19228291,0,0,0,143
14675,19228149,19228149,19228323,0,0,0,174
14644,19225026,19225026,19228655,0,0,0,3629
14676,19228612,19228612,19228692,0,0,0,80
14647,19226904,19226904,19229312,0,0,0,2408
14677,19229538,19229538,19229614,0,0,0,76
14678,19229539,19229539,19229615,0,0,0,76
14679,19229539,19229539,19229615,0,0,0,76
14680,19229539,19229539,19229615,0,0,0,76
14681,19229539,19229539,19229615,0,0,0,76
14682,19229539,19229539,19229615,0,0,0,76
14683,19229539,19229539,19229615,0,0,0,76
14684,19229539,19229539,19229615,0,0,0,76
14685,19229540,19229540,19229649,0,0,0,109
14686,19229540,19229540,19229660,0,0,0,120
14687,19229540,19229540,19229682,0,0,0,142
14688,19229540,19229540,19229682,0,0,0,142
14689,19229540,19229540,19229714,0,0,0,174
14691,19229768,19229768,19229809,0,0,0,41
14690,19229762,19229762,19229820,0,0,0,58
14692,19229768,19229768,19229842,0,0,0,74
14693,19229768,19229768,19229842,0,0,0,74
14694,19229768,19229768,19229842,0,0,0,74
14695,19229769,19229769,19229874,0,0,0,105
14696,19229769,19229769,19229874,0,0,0,105
14697,19230009,19230009,19230166,0,0,0,157
14698,19230009,19230009,19230166,0,0,0,157
14699,19230009,19230009,19230239,0,0,0,230
14648,19226914,19226914,19230331,0,0,0,3417
14700,19230010,19230010,19230333,0,0,0,323
14637,19220400,19220400,19230353,0,0,0,9953
14649,19226924,19226924,19230353,0,0,0,3429
14704,19230293,19230293,19230392,0,0,0,99
14701,19230010,19230010,19230467,0,0,0,457
14702,19230010,19230010,19230602,0,0,0,592
14703,19230010,19230010,19230610,0,0,0,600
14706,19230750,19230750,19231464,0,0,0,714
14705,19230373,19230373,19231516,0,0,0,1143
14711,19231923,19231923,19232075,0,0,0,152
14591,19147181,19147181,19232366,0,0,0,85185
14715,19232700,19232700,19232773,0,0,0,73
14584,19010892,19010892,19232829,0,0,0,221937
14585,19011569,19011569,19233179,0,0,0,221610
14580,19008123,19008123,19233231,0,0,0,225108
14713,19231943,19231943,19233915,0,0,0,1972
14717,19234294,19234294,19234351,0,0,0,57
14718,19234294,19234294,19234373,0,0,0,79
14720,19234310,19234310,19234394,0,0,0,84
14719,19234294,19234294,19234404,0,0,0,110
14707,19231180,19231180,19234724,0,0,0,3544
14709,19231282,19231282,19236530,0,0,0,5248
14722,19236953,19236953,19237053,0,0,0,100
14714,19232195,19232195,19237089,0,0,0,4894
14724,19237134,19237134,19237249,0,0,0,115
14708,19231217,19231217,19237543,0,0,0,6326
14725,19237574,19237574,19237656,0,0,0,82
14726,19237901,19237901,19238027,0,0,0,126
14721,19234789,19234789,19238425,0,0,0,3636
14723,19236980,19236980,19241081,0,0,0,4101
14730,19241888,19241888,19241960,0,0,0,72
14731,19242035,19242035,19242100,0,0,0,65
14732,19242061,19242061,19242139,0,0,0,78
14733,19242099,19242099,19242171,0,0,0,72
14728,19238512,19238512,19242214,0,0,0,3702
14734,19242187,19242187,19242280,0,0,0,93
14735,19242213,19242213,19242287,0,0,0,74
14635,19220253,19220253,19245022,0,0,0,24769
14638,19220653,19220653,19245979,0,0,0,25326
14736,19242928,19242928,19246707,0,0,0,3779
14633,19219536,19219536,19249663,0,0,0,30127
14738,19247294,19249663,19253362,0,0,2369,6068
14739,19251195,19251195,19255020,0,0,0,3825
14712,19231932,19231932,19255208,0,0,0,23276
14727,19238345,19238345,19255338,0,0,0,16993
14740,19252957,19252957,19256301,0,0,0,3344
14742,19257051,19257051,19257233,0,0,0,182
14741,19255060,19255060,19258903,0,0,0,3843
14743,19259255,19259255,19263072,0,0,0,3817
14645,19226023,19245022,19269192,0,0,18999,43169
14641,19223914,19223914,19277275,0,0,0,53361
14640,19223304,19223304,19278357,0,0,0,55053
14632,19219126,19219126,19282679,0,0,0,63553
14642,19224097,19224097,19284746,0,0,0,60649
14744,19283427,19283427,19287398,0,0,0,3971
14745,19287541,19287541,19291432,0,0,0,3891
14737,19246820,19249663,19292863,0,0,2843,46043
14729,19240715,19240715,19295752,0,0,0,55037
14746,19292814,19292814,19296686,0,0,0,3872
14607,19212002,19212002,19296831,0,0,0,84829
14608,19212097,19212097,19296831,0,0,0,84734
14606,19211913,19211913,19297781,0,0,0,85868
14752,19299459,19299459,19300101,0,0,0,642
14749,19296831,19296831,19300678,0,0,0,3847
14753,19300678,19300678,19300782,0,0,0,104
14754,19301108,19301108,19302126,0,0,0,1018
14758,19302514,19302514,19302642,0,0,0,128
14759,19302873,19302873,19302977,0,0,0,104
14760,19303021,19303021,19303167,0,0,0,146
14761,19303131,19303131,19303277,0,0,0,146
14762,19303663,19303663,19303767,0,0,0,104
14643,19224934,19224934,19303783,0,0,0,78849
14756,19301186,19301186,19304619,0,0,0,3433
14763,19304052,19304052,19304655,0,0,0,603
14764,19304828,19304828,19304974,0,0,0,146
14601,19210039,19210039,19305363,0,0,0,95324
14765,19305383,19305383,19305462,0,0,0,79
14766,19305389,19305389,19305482,0,0,0,93
14767,19305423,19305423,19305493,0,0,0,70
14768,19305429,19305429,19305517,0,0,0,88
14769,19305429,19305429,19305548,0,0,0,119
14770,19305429,19305429,19305548,0,0,0,119
14771,19305429,19305429,19305548,0,0,0,119
14772,19305446,19305446,19305592,0,0,0,146
14773,19305518,19305518,19305619,0,0,0,101
14774,19305628,19305628,19305774,0,0,0,146
14775,19305847,19305847,19305932,0,0,0,85
14776,19305855,19305855,19305961,0,0,0,106
14777,19306015,19306015,19306141,0,0,0,126
14778,19306715,19306715,19306763,0,0,0,48
14780,19306721,19306721,19306795,0,0,0,74
14781,19306721,19306721,19306795,0,0,0,74
14782,19306721,19306721,19306795,0,0,0,74
14783,19306722,19306722,19306796,0,0,0,74
14779,19306720,19306720,19306847,0,0,0,127
14784,19306722,19306722,19306849,0,0,0,127
14785,19306722,19306722,19306849,0,0,0,127
14786,19306899,19306899,19307026,0,0,0,127
14787,19306969,19306969,19307075,0,0,0,106
14755,19301120,19301120,19307885,0,0,0,6765
14788,19307870,19307870,19307987,0,0,0,117
14747,19295292,19295292,19308013,0,0,0,12721
14604,19210080,19210080,19308617,0,0,0,98537
14603,19210061,19210061,19310073,0,0,0,100012
14602,19210049,19210049,19310083,0,0,0,100034
14789,19308024,19308024,19310400,0,0,0,2376
14792,19310073,19310073,19310542,0,0,0,469
14791,19310063,19310063,19310543,0,0,0,480
14793,19310085,19310085,19310543,0,0,0,458
14794,19310094,19310094,19310552,0,0,0,458
14790,19310050,19310050,19310553,0,0,0,503
14795,19310125,19310125,19310553,0,0,0,428
14797,19310446,19310446,19310697,0,0,0,251
14804,19310937,19310937,19312090,0,0,0,1153
14806,19312047,19312047,19312120,0,0,0,73
14808,19312284,19312284,19312368,0,0,0,84
14802,19310815,19310815,19312472,0,0,0,1657
14799,19310794,19310794,19312473,0,0,0,1679
14803,19310818,19310818,19312475,0,0,0,1657
14805,19311276,19311276,19312476,0,0,0,1200
14800,19310798,19310798,19312477,0,0,0,1679
14798,19310788,19310788,19312478,0,0,0,1690
14801,19310802,19310802,19312481,0,0,0,1679
14809,19312715,19312715,19312819,0,0,0,104
14810,19312825,19312825,19312938,0,0,0,113
14811,19312837,19312837,19312939,0,0,0,102
14813,19312990,19312990,19313063,0,0,0,73
14815,19313279,19313279,19313361,0,0,0,82
14816,19313345,19313345,19313412,0,0,0,67
14825,19313359,19313359,19313428,0,0,0,69
14817,19313351,19313351,19313432,0,0,0,81
14818,19313351,19313351,19313432,0,0,0,81
14834,19313390,19313390,19313441,0,0,0,51
14819,19313351,19313351,19313454,0,0,0,103
14820,19313351,19313351,19313454,0,0,0,103
14821,19313352,19313352,19313455,0,0,0,103
14822,19313352,19313352,19313455,0,0,0,103
14823,19313352,19313352,19313455,0,0,0,103
14826,19313359,19313359,19313462,0,0,0,103
14827,19313359,19313359,19313462,0,0,0,103
14828,19313360,19313360,19313463,0,0,0,103
14829,19313360,19313360,19313463,0,0,0,103
14830,19313360,19313360,19313463,0,0,0,103
14824,19313352,19313352,19313465,0,0,0,113
14831,19313360,19313360,19313480,0,0,0,120
14833,19313360,19313463,19313548,0,0,103,188
14832,19313360,19313455,19313575,0,0,95,215
14835,19313462,19313462,19313575,0,0,0,113
14836,19313520,19313520,19313629,0,0,0,109
14837,19313637,19313637,19313744,0,0,0,107
14838,19313784,19313784,19313891,0,0,0,107
14839,19314212,19314212,19314320,0,0,0,108
14840,19314359,19314359,19314558,0,0,0,199
14807,19312137,19312137,19314585,0,0,0,2448
14841,19314532,19314532,19314855,0,0,0,323
14842,19314952,19314952,19315388,0,0,0,436
14843,19315506,19315506,19315579,0,0,0,73
14847,19315513,19315513,19315602,0,0,0,89
14850,19315514,19315514,19315623,0,0,0,109
14844,19315512,19315512,19315632,0,0,0,120
14845,19315512,19315512,19315632,0,0,0,120
14846,19315512,19315512,19315632,0,0,0,120
14848,19315513,19315513,19315633,0,0,0,120
14849,19315513,19315513,19315633,0,0,0,120
14852,19315886,19315886,19315959,0,0,0,73
14630,19219040,19219040,19315977,0,0,0,96937
14851,19315514,19315623,19316046,0,0,109,532
14854,19316691,19316691,19316764,0,0,0,73
14855,19316697,19316697,19316786,0,0,0,89
14856,19316697,19316697,19316786,0,0,0,89
14857,19316698,19316698,19316787,0,0,0,89
14862,19316699,19316699,19316807,0,0,0,108
14858,19316698,19316698,19316818,0,0,0,120
14859,19316698,19316698,19316818,0,0,0,120
14860,19316698,19316698,19316818,0,0,0,120
14861,19316698,19316698,19316818,0,0,0,120
14863,19316851,19316851,19316903,0,0,0,52
14865,19316858,19316858,19316926,0,0,0,68
14864,19316857,19316857,19316970,0,0,0,113
14866,19316858,19316858,19316971,0,0,0,113
14867,19316858,19316858,19316971,0,0,0,113
14868,19316858,19316858,19316971,0,0,0,113
14869,19316859,19316859,19316980,0,0,0,121
14870,19316859,19316859,19316980,0,0,0,121
14872,19316987,19316987,19317093,0,0,0,106
14873,19316992,19316992,19317098,0,0,0,106
14871,19316981,19316981,19317099,0,0,0,118
14874,19317098,19317098,19317171,0,0,0,73
14877,19317105,19317105,19317198,0,0,0,93
14882,19317106,19317106,19317200,0,0,0,94
14875,19317104,19317104,19317228,0,0,0,124
14876,19317104,19317104,19317228,0,0,0,124
14878,19317105,19317105,19317229,0,0,0,124
14879,19317105,19317105,19317229,0,0,0,124
14880,19317105,19317105,19317229,0,0,0,124
14881,19317105,19317105,19317229,0,0,0,124
14796,19310357,19310357,19317440,0,0,0,7083
14812,19312898,19312898,19318805,0,0,0,5907
14814,19313150,19313150,19318816,0,0,0,5666
14886,19318782,19318782,19318873,0,0,0,91
14887,19318784,19318784,19318886,0,0,0,102
14888,19318794,19318794,19318916,0,0,0,122
14889,19318799,19318799,19318921,0,0,0,122
14890,19318803,19318803,19318925,0,0,0,122
14892,19318840,19318840,19319024,0,0,0,184
14899,19319412,19319412,19319471,0,0,0,59
14900,19319435,19319435,19319505,0,0,0,70
14905,19319436,19319436,19319517,0,0,0,81
14917,19319438,19319438,19319519,0,0,0,81
14924,19319439,19319439,19319520,0,0,0,81
14934,19319463,19319463,19319534,0,0,0,71
14901,19319435,19319435,19319538,0,0,0,103
14902,19319435,19319435,19319538,0,0,0,103
14906,19319436,19319436,19319539,0,0,0,103
14918,19319438,19319438,19319541,0,0,0,103
14907,19319436,19319436,19319550,0,0,0,114
14908,19319436,19319436,19319550,0,0,0,114
14911,19319437,19319437,19319551,0,0,0,114
14912,19319437,19319437,19319551,0,0,0,114
14919,19319438,19319438,19319552,0,0,0,114
14920,19319438,19319438,19319552,0,0,0,114
14925,19319439,19319439,19319553,0,0,0,114
14926,19319439,19319439,19319553,0,0,0,114
14904,19319435,19319435,19319555,0,0,0,120
14930,19319462,19319462,19319555,0,0,0,93
14903,19319435,19319435,19319560,0,0,0,125
14909,19319436,19319436,19319561,0,0,0,125
14910,19319436,19319436,19319577,0,0,0,141
14913,19319437,19319437,19319587,0,0,0,150
14937,19319464,19319505,19319623,0,0,41,159
14941,19319465,19319539,19319630,0,0,74,165
14942,19319465,19319551,19319631,0,0,86,166
14935,19319463,19319541,19319643,0,0,78,180
14943,19319465,19319560,19319645,0,0,95,180
14929,19319461,19319538,19319647,0,0,77,186
14931,19319462,19319534,19319652,0,0,72,190
14938,19319464,19319550,19319652,0,0,86,188
14914,19319437,19319555,19319665,0,0,118,228
14922,19319438,19319555,19319668,0,0,117,230
14932,19319462,19319560,19319669,0,0,98,207
14927,19319439,19319560,19319672,0,0,121,233
14928,19319439,19319577,19319677,0,0,138,238
14921,19319438,19319553,19319678,0,0,115,240
14915,19319437,19319555,19319679,0,0,118,242
14936,19319463,19319587,19319710,0,0,124,247
14944,19319465,19319647,19319770,0,0,182,305
14939,19319464,19319668,19319796,0,0,204,332
14916,19319437,19319677,19319833,0,0,240,396
14923,19319438,19319770,19319893,0,0,332,455
14933,19319462,19319833,19319990,0,0,371,528
14940,19319464,19319893,19320018,0,0,429,554
14592,19155213,19155213,19328013,0,0,0,172800
14891,19318819,19318819,19328432,0,0,0,9613
14883,19317964,19317964,19329528,0,0,0,11564
14884,19317989,19317989,19329575,0,0,0,11586
14885,19318016,19318016,19329686,0,0,0,11670
14897,19319248,19319248,19337001,0,0,0,17753
14953,19340795,19340795,19340922,0,0,0,127
14954,19340901,19340901,19341123,0,0,0,222
14955,19345992,19345992,19346468,0,0,0,476
14751,19296979,19296979,19348083,0,0,0,51104
14949,19326338,19326338,19352122,0,0,0,25784
14893,19318863,19318863,19356050,0,0,0,37187
14757,19301295,19301295,19356415,0,0,0,55120
14894,19318887,19318887,19362087,0,0,0,43200
14895,19318985,19318985,19362185,0,0,0,43200
14896,19319027,19319027,19362227,0,0,0,43200
14898,19319265,19319265,19362465,0,0,0,43200
14716,19233686,19246707,19379089,0,0,13021,145403
14950,19326815,19326815,19385111,0,0,0,58296
14958,19384898,19384898,19385432,0,0,0,534
14959,19385483,19385483,19385634,0,0,0,151
14961,19385564,19385564,19387291,0,0,0,1727
14965,19389425,19389425,19389546,0,0,0,121
14963,19387391,19387391,19389704,0,0,0,2313
14967,19391171,19391171,19391286,0,0,0,115
14962,19385605,19385605,19391888,0,0,0,6283
14966,19389709,19389709,19392806,0,0,0,3097
14973,19392784,19392784,19392868,0,0,0,84
14974,19392834,19392834,19392918,0,0,0,84
14976,19393062,19393062,19393170,0,0,0,108
14978,19393215,19393215,19393274,0,0,0,59
14972,19392781,19392781,19393278,0,0,0,497
14977,19393214,19393214,19393360,0,0,0,146
14979,19393278,19393278,19393365,0,0,0,87
14982,19394045,19394045,19394339,0,0,0,294
14981,19393645,19393645,19394714,0,0,0,1069
14983,19394313,19394313,19394833,0,0,0,520
14987,19394962,19394962,19395416,0,0,0,454
14988,19395388,19395388,19395533,0,0,0,145
14989,19395512,19395512,19395683,0,0,0,171
14991,19395968,19395968,19396037,0,0,0,69
14992,19396041,19396041,19396112,0,0,0,71
14993,19396140,19396140,19396210,0,0,0,70
14994,19396255,19396255,19396302,0,0,0,47
14995,19396636,19396636,19397125,0,0,0,489
14997,19397124,19397124,19397239,0,0,0,115
14986,19394818,19394818,19397509,0,0,0,2691
15002,19399133,19399133,19399249,0,0,0,116
15003,19401618,19401618,19402080,0,0,0,462
15004,19402386,19402386,19402632,0,0,0,246
15005,19402940,19402940,19403024,0,0,0,84
15006,19403044,19403044,19403127,0,0,0,83
15007,19403080,19403080,19403307,0,0,0,227
15008,19403254,19403254,19403349,0,0,0,95
15009,19403398,19403398,19403500,0,0,0,102
15010,19403436,19403436,19403684,0,0,0,248
15011,19403570,19403570,19403811,0,0,0,241
15012,19403803,19403803,19403950,0,0,0,147
14748,19295694,19295694,19403994,0,0,0,108300
15015,19404009,19404009,19404407,0,0,0,398
15014,19403975,19403975,19404484,0,0,0,509
14960,19385497,19385497,19405551,0,0,0,20054
15013,19403957,19403957,19405653,0,0,0,1696
14710,19231361,19245979,19405727,0,0,14618,174366
15016,19404111,19404111,19405841,0,0,0,1730
15021,19405871,19405871,19406017,0,0,0,146
15018,19404460,19404460,19406051,0,0,0,1591
15020,19405681,19405681,19406086,0,0,0,405
15017,19404443,19404443,19406109,0,0,0,1666
15022,19406472,19406472,19406971,0,0,0,499
15023,19406748,19406748,19407048,0,0,0,300
15024,19407496,19407496,19407642,0,0,0,146
15025,19407807,19407807,19407911,0,0,0,104
14984,19394687,19394687,19407968,0,0,0,13281
14956,19346487,19346487,19408153,0,0,0,61666
15026,19408190,19408190,19408486,0,0,0,296
15028,19408519,19408519,19408602,0,0,0,83
14985,19394799,19394799,19408636,0,0,0,13837
15027,19408207,19408207,19408665,0,0,0,458
15031,19408572,19408572,19408674,0,0,0,102
15030,19408546,19408546,19408681,0,0,0,135
14996,19396670,19396670,19409366,0,0,0,12696
14999,19397314,19397314,19409367,0,0,0,12053
15033,19408769,19408769,19409831,0,0,0,1062
15042,19409889,19409889,19409936,0,0,0,47
15048,19409890,19409890,19409994,0,0,0,104
15032,19408766,19408766,19409995,0,0,0,1229
15034,19408783,19408783,19410010,0,0,0,1227
15035,19408821,19408821,19410050,0,0,0,1229
15036,19408947,19408947,19410080,0,0,0,1133
15049,19409891,19409994,19410137,0,0,103,246
15043,19409890,19409890,19410490,0,0,0,600
15044,19409890,19409890,19410490,0,0,0,600
15045,19409890,19409890,19410490,0,0,0,600
15046,19409890,19409890,19410490,0,0,0,600
15047,19409890,19409890,19410490,0,0,0,600
15040,19409869,19409869,19410712,0,0,0,843
15039,19409371,19409371,19410771,0,0,0,1400
15050,19409891,19410712,19410834,0,0,821,943
14964,19389153,19389153,19410890,0,0,0,21737
15055,19410064,19410064,19411264,0,0,0,1200
15107,19411583,19411583,19411802,0,0,0,219
15109,19411801,19411801,19411848,0,0,0,47
15057,19410347,19410347,19411898,0,0,0,1551
15108,19411794,19411794,19411898,0,0,0,104
15059,19410348,19410348,19411899,0,0,0,1551
15060,19410348,19410348,19411899,0,0,0,1551
15061,19410348,19410348,19411899,0,0,0,1551
15063,19410349,19410349,19411900,0,0,0,1551
15068,19410350,19410350,19411901,0,0,0,1551
15069,19410350,19410350,19411901,0,0,0,1551
15056,19410341,19410341,19411908,0,0,0,1567
15058,19410347,19410347,19411910,0,0,0,1563
15062,19410348,19410348,19411911,0,0,0,1563
15064,19410349,19410349,19411912,0,0,0,1563
15065,19410349,19410349,19411912,0,0,0,1563
15066,19410349,19410349,19411912,0,0,0,1563
15067,19410349,19410349,19411912,0,0,0,1563
15070,19410350,19410350,19411913,0,0,0,1563
15071,19410350,19410350,19411913,0,0,0,1563
15072,19410351,19410351,19411914,0,0,0,1563
15073,19410351,19410351,19411914,0,0,0,1563
15074,19410351,19410351,19411914,0,0,0,1563
15075,19410352,19410352,19411915,0,0,0,1563
15076,19410352,19410352,19411915,0,0,0,1563
15077,19410352,19410352,19411915,0,0,0,1563
15078,19410352,19410352,19411915,0,0,0,1563
15079,19410352,19410352,19411915,0,0,0,1563
15080,19410352,19410352,19411915,0,0,0,1563
15081,19410352,19410352,19411915,0,0,0,1563
15082,19410353,19410353,19411916,0,0,0,1563
15083,19410353,19410353,19411916,0,0,0,1563
15084,19410353,19410353,19411916,0,0,0,1563
15085,19410353,19410353,19411916,0,0,0,1563
15086,19410353,19410353,19411916,0,0,0,1563
15087,19410353,19410353,19411916,0,0,0,1563
15088,19410353,19410353,19411916,0,0,0,1563
15089,19410354,19410354,19411917,0,0,0,1563
15090,19410354,19410354,19411917,0,0,0,1563
15091,19410354,19410354,19411917,0,0,0,1563
15092,19410354,19410354,19411917,0,0,0,1563
15093,19410354,19410354,19411917,0,0,0,1563
15094,19410354,19410354,19411917,0,0,0,1563
15095,19410354,19410354,19411917,0,0,0,1563
15096,19410355,19410355,19411918,0,0,0,1563
15097,19410355,19410355,19411918,0,0,0,1563
15098,19410355,19410355,19411918,0,0,0,1563
15099,19410355,19410355,19411918,0,0,0,1563
15100,19410355,19410355,19411918,0,0,0,1563
15101,19410355,19410355,19411918,0,0,0,1563
15102,19410355,19410355,19411918,0,0,0,1563
15103,19410356,19410356,19411919,0,0,0,1563
15104,19410356,19410356,19411919,0,0,0,1563
15110,19411886,19411886,19411988,0,0,0,102
15111,19411903,19411903,19412003,0,0,0,100
15114,19411957,19411957,19412032,0,0,0,75
15112,19411929,19411929,19412037,0,0,0,108
15113,19411948,19411948,19412070,0,0,0,122
15115,19411970,19411970,19412121,0,0,0,151
15116,19412372,19412372,19412474,0,0,0,102
15117,19412378,19412378,19412501,0,0,0,123
15118,19412378,19412378,19412512,0,0,0,134
15119,19412379,19412379,19412513,0,0,0,134
15120,19412379,19412379,19412513,0,0,0,134
15123,19412380,19412380,19412546,0,0,0,166
15121,19412379,19412379,19412555,0,0,0,176
15122,19412379,19412379,19412555,0,0,0,176
15124,19412380,19412555,19412726,0,0,175,346
14968,19392405,19392405,19412819,0,0,0,20414
14980,19393454,19393454,19412819,0,0,0,19365
14975,19393058,19393058,19412823,0,0,0,19765
14990,19395652,19395652,19412966,0,0,0,17314
15019,19405647,19405647,19414804,0,0,0,9157
15106,19410796,19410796,19415347,0,0,0,4551
14948,19320086,19320086,19415718,0,0,0,95632
15037,19409017,19409017,19415946,0,0,0,6929
15135,19427166,19427166,19427281,0,0,0,115
15105,19410775,19410775,19437373,0,0,0,26598
15137,19437547,19437547,19437665,0,0,0,118
14750,19296858,19296858,19449327,0,0,0,152469
14969,19392418,19392418,19454036,0,0,0,61618
14970,19392426,19392426,19459196,0,0,0,66770
14609,19212901,19212901,19465501,0,0,0,252600
14610,19212932,19212932,19465532,0,0,0,252600
14613,19214108,19214108,19466708,0,0,0,252600
14614,19214301,19214301,19466901,0,0,0,252600
14971,19392438,19392438,19467511,0,0,0,75073
15054,19410035,19410035,19469126,0,0,0,59091
15052,19409982,19409982,19469216,0,0,0,59234
15053,19410009,19410009,19469221,0,0,0,59212
15192,19470687,19470687,19471201,0,0,0,514
15193,19470801,19470801,19471238,0,0,0,437
15195,19470948,19470948,19471415,0,0,0,467
15196,19471384,19471384,19471872,0,0,0,488
15197,19471390,19471390,19471878,0,0,0,488
15190,19470285,19470285,19471882,0,0,0,1597
15191,19470302,19470302,19471962,0,0,0,1660
15194,19470878,19470878,19472036,0,0,0,1158
15001,19397347,19397347,19472047,0,0,0,74700
15051,19409958,19409958,19472054,0,0,0,62096
14998,19397271,19397271,19472057,0,0,0,74786
15000,19397335,19397335,19472057,0,0,0,74722
15038,19409331,19409331,19472058,0,0,0,62727
15041,19409869,19409869,19472067,0,0,0,62198
15198,19472221,19472221,19473421,0,0,0,1200
15210,19473716,19473716,19473786,0,0,0,70
15213,19474740,19474740,19474830,0,0,0,90
15214,19474740,19474740,19474830,0,0,0,90
15208,19473533,19473533,19474840,0,0,0,1307
15215,19474740,19474740,19474863,0,0,0,123
15216,19474741,19474741,19474864,0,0,0,123
15217,19474741,19474741,19474875,0,0,0,134
15219,19474741,19474741,19474886,0,0,0,145
15218,19474741,19474741,19474906,0,0,0,165
15222,19474872,19474872,19475016,0,0,0,144
15220,19474742,19474906,19475025,0,0,164,283
15225,19475326,19475326,19475445,0,0,0,119
15223,19475218,19475218,19475548,0,0,0,330
15224,19475224,19475224,19475724,0,0,0,500
15227,19476026,19476026,19476145,0,0,0,119
15226,19475775,19475775,19476237,0,0,0,462
15228,19476373,19476373,19476457,0,0,0,84
15230,19476564,19476564,19476705,0,0,0,141
15229,19476457,19476457,19476862,0,0,0,405
15231,19477400,19477400,19477557,0,0,0,157
15233,19477406,19477406,19477586,0,0,0,180
15232,19477405,19477405,19477601,0,0,0,196
15234,19477406,19477406,19477602,0,0,0,196
15235,19477406,19477406,19477634,0,0,0,228
15236,19477406,19477406,19477634,0,0,0,228
15237,19477407,19477407,19477635,0,0,0,228
15238,19477407,19477634,19477746,0,0,227,339
15240,19478281,19478281,19478525,0,0,0,244
15241,19478609,19478609,19478793,0,0,0,184
15242,19478686,19478686,19478938,0,0,0,252
15243,19478686,19478686,19478991,0,0,0,305
15244,19478687,19478687,19478992,0,0,0,305
15245,19478687,19478687,19478992,0,0,0,305
15248,19478687,19478687,19479033,0,0,0,346
15246,19478687,19478687,19479045,0,0,0,358
15247,19478687,19478687,19479045,0,0,0,358
15251,19478777,19478777,19479131,0,0,0,354
15252,19478783,19478783,19479160,0,0,0,377
15253,19478783,19478783,19479160,0,0,0,377
15254,19478783,19478783,19479191,0,0,0,408
15261,19479115,19479115,19479202,0,0,0,87
15255,19478783,19478783,19479234,0,0,0,451
15256,19478784,19478784,19479255,0,0,0,471
15262,19479204,19479204,19479278,0,0,0,74
15260,19479047,19479047,19479368,0,0,0,321
15263,19479267,19479267,19479374,0,0,0,107
15249,19478687,19479255,19479412,0,0,568,725
15257,19478784,19479033,19479478,0,0,249,694
15258,19478784,19479412,19479651,0,0,628,867
15264,19479427,19479427,19479862,0,0,0,435
15189,19469983,19469983,19480783,0,0,0,10800
15128,19417814,19417814,19481398,0,0,0,63584
15266,19482263,19482263,19482476,0,0,0,213
15267,19482330,19482330,19482645,0,0,0,315
15268,19482592,19482592,19482673,0,0,0,81
15270,19482703,19482703,19482773,0,0,0,70
15269,19482645,19482645,19482971,0,0,0,326
15272,19483092,19483092,19483170,0,0,0,78
15271,19483053,19483053,19483227,0,0,0,174
15273,19483278,19483278,19483572,0,0,0,294
15275,19483749,19483749,19483827,0,0,0,78
15281,19483756,19483756,19483845,0,0,0,89
15276,19483755,19483755,19483854,0,0,0,99
15277,19483755,19483755,19483854,0,0,0,99
15278,19483755,19483755,19483868,0,0,0,113
15279,19483755,19483755,19483868,0,0,0,113
15280,19483756,19483756,19483869,0,0,0,113
15291,19483804,19483804,19483872,0,0,0,68
15282,19483794,19483794,19483878,0,0,0,84
15287,19483800,19483800,19483887,0,0,0,87
15283,19483794,19483794,19483911,0,0,0,117
15284,19483794,19483794,19483911,0,0,0,117
15285,19483794,19483794,19483911,0,0,0,117
15286,19483794,19483794,19483911,0,0,0,117
15292,19483816,19483816,19483926,0,0,0,110
15293,19483816,19483816,19483937,0,0,0,121
15288,19483801,19483845,19483953,0,0,44,152
15295,19483817,19483817,19483954,0,0,0,137
15294,19483817,19483817,19483969,0,0,0,152
15299,19483822,19483822,19483980,0,0,0,158
15300,19483822,19483822,19483992,0,0,0,170
15301,19483822,19483822,19484020,0,0,0,198
15296,19483817,19483868,19484026,0,0,51,209
15297,19483817,19483869,19484049,0,0,52,232
15306,19483832,19483832,19484064,0,0,0,232
15302,19483822,19483887,19484085,0,0,65,263
15307,19483832,19483832,19484086,0,0,0,254
15303,19483822,19483868,19484100,0,0,46,278
15298,19483818,19483953,19484134,0,0,135,316
15308,19483833,19483854,19484139,0,0,21,306
15309,19483833,19483887,19484139,0,0,54,306
15304,19483822,19483937,19484158,0,0,115,336
15310,19483833,19483911,19484217,0,0,78,384
15313,19484285,19484285,19484366,0,0,0,81
15305,19483823,19484134,19484370,0,0,311,547
15312,19483834,19484139,19484372,0,0,305,538
15311,19483833,19484026,19484373,0,0,193,540
15289,19483801,19484372,19484481,0,0,571,680
15133,19422298,19422298,19484543,0,0,0,62245
15132,19422261,19422261,19484608,0,0,0,62347
15134,19422345,19422345,19484743,0,0,0,62398
15314,19484697,19484697,19484786,0,0,0,89
14946,19320072,19320072,19484840,0,0,0,164768
15315,19484787,19484787,19484992,0,0,0,205
15316,19485015,19485015,19485128,0,0,0,113
15317,19485069,19485069,19485148,0,0,0,79
15140,19440132,19440132,19485387,0,0,0,45255
15139,19440126,19440126,19485766,0,0,0,45640
15141,19440132,19440132,19485903,0,0,0,45771
15142,19440132,19440132,19486110,0,0,0,45978
15221,19474742,19484743,19486543,0,0,10001,11801
15239,19477407,19486543,19486731,0,0,9136,9324
15250,19478687,19486731,19486999,0,0,8044,8312
15209,19473617,19473617,19487177,0,0,0,13560
15259,19478784,19486999,19487437,0,0,8215,8653
15143,19440133,19440133,19487961,0,0,0,47828
14947,19320077,19320077,19488087,0,0,0,168010
15318,19485489,19488087,19488200,0,0,2598,2711
15319,19485710,19488200,19488308,0,0,2490,2598
15320,19486063,19488308,19488652,0,0,2245,2589
15321,19487596,19488652,19488849,0,0,1056,1253
15290,19483801,19487437,19489237,0,0,3636,5436
15265,19479809,19479809,19490609,0,0,0,10800
15125,19413342,19413342,19491438,0,0,0,78096
14945,19320059,19320059,19492791,0,0,0,172732
15131,19421331,19421331,19492955,0,0,0,71624
15326,19493866,19493866,19493993,0,0,0,127
15173,19440139,19440139,19494449,0,0,0,54310
15029,19408540,19408540,19494940,0,0,0,86400
15174,19440139,19440139,19495747,0,0,0,55608
15175,19440139,19440139,19495747,0,0,0,55608
15166,19440138,19440138,19495934,0,0,0,55796
15180,19440140,19440140,19496009,0,0,0,55869
15176,19440139,19440139,19496112,0,0,0,55973
15333,19495980,19495980,19496130,0,0,0,150
15167,19440138,19440138,19496196,0,0,0,56058
15334,19496078,19496130,19496285,0,0,52,207
15322,19492747,19492747,19496382,0,0,0,3635
15330,19495076,19495076,19496394,0,0,0,1318
15323,19492877,19492877,19496416,0,0,0,3539
15177,19440139,19440139,19496418,0,0,0,56279
15324,19492923,19492923,19496455,0,0,0,3532
15325,19492977,19492977,19496461,0,0,0,3484
15338,19496388,19496388,19496544,0,0,0,156
15186,19440141,19440141,19496924,0,0,0,56783
15342,19496761,19496761,19496969,0,0,0,208
15181,19440140,19440140,19496983,0,0,0,56843
15182,19440140,19440140,19496983,0,0,0,56843
15183,19440140,19440140,19497118,0,0,0,56978
15343,19496979,19496979,19497138,0,0,0,159
15187,19440141,19440141,19497551,0,0,0,57410
15184,19440140,19440140,19497612,0,0,0,57472
14951,19326846,19326846,19497752,0,0,0,170906
15188,19440141,19440141,19497858,0,0,0,57717
15127,19417005,19417005,19498159,0,0,0,81154
15344,19497637,19497637,19498181,0,0,0,544
15345,19498192,19498192,19498318,0,0,0,126
15346,19498207,19498207,19498343,0,0,0,136
15347,19498218,19498218,19498397,0,0,0,179
15349,19498228,19498397,19498515,0,0,169,287
15348,19498222,19498343,19498795,0,0,121,573
14952,19328542,19328542,19501342,0,0,0,172800
15147,19440134,19440134,19502734,0,0,0,62600
15159,19440137,19440137,19502885,0,0,0,62748
15160,19440137,19440137,19503237,0,0,0,63100
15148,19440134,19440134,19503400,0,0,0,63266
15151,19440135,19440135,19503463,0,0,0,63328
15152,19440135,19440135,19503580,0,0,0,63445
15178,19440139,19440139,19503847,0,0,0,63708
15161,19440137,19440137,19503887,0,0,0,63750
15153,19440135,19440135,19503958,0,0,0,63823
15156,19440136,19440136,19503990,0,0,0,63854
15129,19417852,19417852,19504252,0,0,0,86400
15352,19504101,19504101,19504380,0,0,0,279
15355,19504262,19504262,19504400,0,0,0,138
15185,19440140,19440140,19504442,0,0,0,64302
15356,19504288,19504380,19504475,0,0,92,187
15168,19440138,19440138,19504922,0,0,0,64784
15149,19440134,19440134,19505104,0,0,0,64970
15358,19505354,19505354,19505485,0,0,0,131
15359,19505378,19505378,19505630,0,0,0,252
15179,19440139,19440139,19505751,0,0,0,65612
15360,19505841,19505841,19506012,0,0,0,171
15353,19504167,19504252,19506052,0,0,85,1885
15361,19506056,19506056,19506151,0,0,0,95
15362,19506301,19506301,19506374,0,0,0,73
15363,19506447,19506447,19506517,0,0,0,70
15364,19506512,19506512,19506570,0,0,0,58
15354,19504230,19506052,19507852,0,0,1822,3622
14957,19348104,19348104,19508041,0,0,0,159937
15365,19506575,19506575,19508243,0,0,0,1668
15369,19508200,19508200,19508283,0,0,0,83
15370,19508281,19508281,19508354,0,0,0,73
15357,19504304,19507852,19508452,0,0,3548,4148
15274,19483513,19483513,19508546,0,0,0,25033
15366,19507774,19507774,19509574,0,0,0,1800
15367,19507787,19507787,19509587,0,0,0,1800
15371,19509776,19509776,19509882,0,0,0,106
15372,19509828,19509828,19509989,0,0,0,161
15373,19509937,19509937,19510136,0,0,0,199
15374,19510133,19510133,19510366,0,0,0,233
15375,19510551,19510551,19510604,0,0,0,53
15376,19510603,19510603,19511002,0,0,0,399
15377,19510993,19510993,19512611,0,0,0,1618
15212,19473850,19473850,19513337,0,0,0,39487
15211,19473743,19473743,19513750,0,0,0,40007
15379,19514648,19514648,19517247,0,0,0,2599
15380,19517191,19517191,19517762,0,0,0,571
15378,19514468,19514468,19519077,0,0,0,4609
15154,19440135,19440135,19519138,0,0,0,79003
15331,19495098,19495098,19519395,0,0,0,24297
15144,19440133,19440133,19519612,0,0,0,79479
15157,19440136,19440136,19519863,0,0,0,79727
15162,19440137,19440137,19519980,0,0,0,79843
15145,19440133,19440133,19520122,0,0,0,79989
15146,19440133,19440133,19520122,0,0,0,79989
15155,19440135,19440135,19520238,0,0,0,80103
15350,19499426,19499426,19520514,0,0,0,21088
15163,19440137,19440137,19520740,0,0,0,80603
15150,19440134,19440134,19520790,0,0,0,80656
15158,19440136,19440136,19520823,0,0,0,80687
15169,19440138,19440138,19520974,0,0,0,80836
15164,19440137,19440137,19521051,0,0,0,80914
15170,19440138,19440138,19521177,0,0,0,81039
15171,19440138,19440138,19521726,0,0,0,81588
15165,19440137,19440137,19521798,0,0,0,81661
15172,19440138,19440138,19523227,0,0,0,83089
14853,19316022,19316022,19527010,0,0,0,210988
15382,19528537,19528537,19528716,0,0,0,179
15383,19528645,19528645,19528835,0,0,0,190
15384,19528714,19528714,19539657,0,0,0,10943
15385,19554378,19554378,19555274,0,0,0,896
15386,19555733,19555733,19555893,0,0,0,160
15387,19555754,19555754,19555922,0,0,0,168
15391,19556594,19556594,19556794,0,0,0,200
15392,19556794,19556794,19556952,0,0,0,158
15393,19556871,19556871,19557151,0,0,0,280
15388,19556182,19556182,19557200,0,0,0,1018
15394,19557235,19557235,19557370,0,0,0,135
15397,19557463,19557463,19557661,0,0,0,198
15405,19557740,19557740,19557845,0,0,0,105
15398,19557463,19557661,19558004,0,0,198,541
15399,19557463,19558004,19558205,0,0,541,742
15407,19558122,19558122,19558234,0,0,0,112
15408,19558223,19558223,19558338,0,0,0,115
15409,19558370,19558370,19558474,0,0,0,104
15396,19557461,19557461,19558683,0,0,0,1222
15400,19557463,19558205,19559075,0,0,742,1612
15410,19558541,19558541,19559168,0,0,0,627
15402,19557497,19559075,19559306,0,0,1578,1809
15412,19559312,19559312,19559379,0,0,0,67
15401,19557464,19558683,19559380,0,0,1219,1916
15403,19557509,19559075,19559422,0,0,1566,1913
15413,19559481,19559481,19559568,0,0,0,87
15414,19559579,19559579,19559815,0,0,0,236
15416,19559901,19559901,19560111,0,0,0,210
15411,19558631,19559380,19560211,0,0,749,1580
15404,19557522,19560211,19562011,0,0,2689,4489
15419,19562148,19562148,19562279,0,0,0,131
15389,19556398,19556398,19564024,0,0,0,7626
15390,19556406,19556406,19564194,0,0,0,7788
15422,19564570,19564570,19564654,0,0,0,84
15423,19564721,19564721,19564797,0,0,0,76
15428,19564930,19564930,19565049,0,0,0,119
15429,19565017,19565017,19565101,0,0,0,84
15432,19565519,19565519,19565675,0,0,0,156
15415,19559695,19559695,19565772,0,0,0,6077
15433,19565805,19565805,19565911,0,0,0,106
15434,19565867,19565867,19565983,0,0,0,116
15435,19566051,19566051,19566167,0,0,0,116
15436,19566833,19566833,19566958,0,0,0,125
15437,19567021,19567021,19567109,0,0,0,88
15439,19567297,19567297,19567386,0,0,0,89
15440,19567408,19567408,19567766,0,0,0,358
15417,19560661,19562011,19568211,0,0,1350,7550
15442,19570668,19570668,19571067,0,0,0,399
15418,19561198,19561198,19571998,0,0,0,10800
15441,19570592,19570592,19572146,0,0,0,1554
15444,19571638,19571638,19572254,0,0,0,616
15199,19473071,19473071,19572365,0,0,0,99294
15443,19571397,19571397,19572420,0,0,0,1023
15445,19572516,19572516,19572625,0,0,0,109
15446,19572723,19572723,19572818,0,0,0,95
15448,19572838,19572838,19572948,0,0,0,110
15447,19572769,19572769,19573037,0,0,0,268
15449,19572953,19572953,19573062,0,0,0,109
15451,19573041,19573041,19573150,0,0,0,109
15452,19573154,19573154,19573263,0,0,0,109
15453,19573348,19573348,19573418,0,0,0,70
15454,19573440,19573440,19573510,0,0,0,70
15455,19573542,19573542,19573611,0,0,0,69
15456,19573621,19573621,19573733,0,0,0,112
15450,19572965,19572965,19573930,0,0,0,965
15457,19573685,19573685,19573946,0,0,0,261
15460,19573988,19573988,19574609,0,0,0,621
15459,19573957,19573957,19574672,0,0,0,715
15461,19574419,19574419,19574701,0,0,0,282
15462,19574634,19574634,19574712,0,0,0,78
15464,19574792,19574792,19574897,0,0,0,105
15465,19574880,19574880,19575063,0,0,0,183
15463,19574747,19574747,19576110,0,0,0,1363
15467,19575773,19575773,19576492,0,0,0,719
15468,19575920,19575920,19576545,0,0,0,625
15340,19496417,19496417,19578142,0,0,0,81725
15341,19496431,19496431,19578167,0,0,0,81736
15332,19495099,19495099,19578725,0,0,0,83626
15470,19578722,19578722,19578853,0,0,0,131
15471,19579065,19579065,19579285,0,0,0,220
15336,19496351,19496351,19579763,0,0,0,83412
15335,19496339,19496339,19579773,0,0,0,83434
15337,19496369,19496369,19579781,0,0,0,83412
15339,19496406,19496406,19579818,0,0,0,83412
15472,19579351,19579351,19579941,0,0,0,590
15473,19579666,19579666,19580194,0,0,0,528
15424,19564847,19564847,19580341,0,0,0,15494
15426,19564887,19564887,19580366,0,0,0,15479
15427,19564913,19564913,19580371,0,0,0,15458
15430,19565056,19565056,19580389,0,0,0,15333
15431,19565111,19565111,19580402,0,0,0,15291
15487,19580640,19580640,19580843,0,0,0,203
15486,19580370,19580370,19580876,0,0,0,506
15491,19581726,19581726,19581855,0,0,0,129
15492,19581726,19581855,19582228,0,0,129,502
15488,19580866,19580866,19583282,0,0,0,2416
15207,19473292,19473292,19583323,0,0,0,110031
15493,19581726,19582228,19584028,0,0,502,2302
15498,19583158,19583158,19584057,0,0,0,899
15458,19573912,19573912,19584712,0,0,0,10800
15425,19564859,19564859,19585529,0,0,0,20670
15494,19581727,19584028,19585828,0,0,2301,4101
15503,19586526,19586526,19586631,0,0,0,105
15495,19581727,19585828,19587628,0,0,4101,5901
15496,19581727,19587628,19587746,0,0,5901,6019
15395,19557257,19557257,19588445,0,0,0,31188
15466,19575291,19575291,19596614,0,0,0,21323
15505,19592628,19592628,19599571,0,0,0,6943
15483,19580332,19580332,19600424,0,0,0,20092
15484,19580348,19580348,19600480,0,0,0,20132
15485,19580355,19580355,19600685,0,0,0,20330
15508,19599362,19599362,19600800,0,0,0,1438
15481,19580307,19580307,19600914,0,0,0,20607
15480,19580297,19580297,19601015,0,0,0,20718
15482,19580321,19580321,19601332,0,0,0,21011
15205,19473285,19473285,19601770,0,0,0,128485
15490,19581331,19581331,19602126,0,0,0,20795
15420,19562237,19562237,19603286,0,0,0,41049
15499,19583359,19583359,19604806,0,0,0,21447
15201,19473140,19473140,19615793,0,0,0,142653
15489,19581009,19581009,19617009,0,0,0,36000
15381,19517642,19517642,19625942,0,0,0,108300
15203,19473201,19473201,19637040,0,0,0,163839
15438,19567075,19567075,19644028,0,0,0,76953
15512,19600973,19600973,19644345,0,0,0,43372
15516,19601604,19601604,19644993,0,0,0,43389
15517,19601908,19601908,19645275,0,0,0,43367
15518,19601916,19602126,19645504,0,0,210,43588
15136,19437371,19437371,19667131,0,0,0,229760
15204,19473283,19473283,19671287,0,0,0,198004
15202,19473173,19473173,19671332,0,0,0,198159
15206,19473289,19473289,19671605,0,0,0,198316
15200,19473102,19473102,19672418,0,0,0,199316
15351,19501529,19501529,19672752,0,0,0,171223
15509,19600874,19672752,19672884,0,0,71878,72010
15510,19600956,19672884,19673145,0,0,71928,72189
15511,19600968,19673145,19674945,0,0,72177,73977
15126,19416808,19416808,19676008,0,0,0,259200
15513,19601009,19674945,19676745,0,0,73936,75736
15514,19601031,19676745,19677006,0,0,75714,75975
15130,19417883,19417883,19677083,0,0,0,259200
15515,19601043,19677006,19677606,0,0,75963,76563
15507,19592852,19600800,19680219,0,0,7948,87367
15519,19677964,19677964,19681342,0,0,0,3378
15138,19437961,19437961,19697161,0,0,0,259200
15501,19583958,19587746,19720399,0,0,3788,136441
15478,19579845,19579845,19727063,0,0,0,147218
15500,19583936,19583936,19727781,0,0,0,143845
15523,19734669,19734669,19734901,0,0,0,232
15421,19562503,19562503,19735303,0,0,0,172800
15479,19579862,19579862,19737980,0,0,0,158118
15522,19734578,19734578,19746287,0,0,0,11709
15521,19734545,19734545,19746607,0,0,0,12062
15327,19494609,19494609,19747209,0,0,0,252600
15328,19494629,19494629,19747229,0,0,0,252600
15329,19494643,19494643,19747243,0,0,0,252600
15475,19579812,19579812,19747874,0,0,0,168062
15502,19583972,19587746,19747944,0,0,3774,163972
15477,19579833,19579833,19750338,0,0,0,170505
15497,19582392,19582392,19755125,0,0,0,172733
15504,19586682,19586682,19759440,0,0,0,172758
15368,19507850,19507850,19767050,0,0,0,259200
15406,19557945,19557945,19768632,0,0,0,210687
15469,19576511,19576511,19770726,0,0,0,194215
15520,19693669,19693669,19770806,0,0,0,77137
15476,19579822,19579822,19774982,0,0,0,195160
15529,19775898,19775898,19799280,0,0,0,23382
15531,19785770,19785770,19802802,0,0,0,17032
15528,19775623,19775623,19811711,0,0,0,36088
15474,19579803,19579803,19813373,0,0,0,233570
15539,19813391,19813391,19815151,0,0,0,1760
15543,19816418,19816418,19816524,0,0,0,106
15544,19816435,19816435,19816549,0,0,0,114
15546,19816738,19816738,19817048,0,0,0,310
15545,19816731,19816731,19817053,0,0,0,322
15547,19816766,19816766,19817130,0,0,0,364
15548,19817533,19817533,19817593,0,0,0,60
15526,19774408,19774408,19817773,0,0,0,43365
15549,19817791,19817791,19817892,0,0,0,101
15550,19817816,19817816,19817925,0,0,0,109
15551,19817841,19817841,19817983,0,0,0,142
15553,19818040,19818040,19818218,0,0,0,178
15552,19817940,19817940,19818265,0,0,0,325
15554,19818359,19818359,19818526,0,0,0,167
15527,19775183,19775183,19818531,0,0,0,43348
15556,19818442,19818442,19818535,0,0,0,93
15555,19818395,19818531,19820272,0,0,136,1877
15564,19820828,19820828,19820949,0,0,0,121
15574,19823695,19823695,19823789,0,0,0,94
15571,19822762,19822762,19826362,0,0,0,3600
15586,19830626,19830626,19831119,0,0,0,493
15558,19818691,19818691,19833142,0,0,0,14451
15587,19833330,19833330,19833408,0,0,0,78
15588,19833443,19833443,19833552,0,0,0,109
15557,19818535,19818535,19833866,0,0,0,15331
15591,19833884,19833884,19834100,0,0,0,216
15590,19833725,19833725,19834786,0,0,0,1061
15592,19834177,19834177,19835159,0,0,0,982
15589,19833637,19833637,19835182,0,0,0,1545
15593,19835277,19835277,19835499,0,0,0,222
15594,19835578,19835578,19835895,0,0,0,317
15595,19835944,19835944,19836146,0,0,0,202
15596,19836239,19836239,19836578,0,0,0,339
15597,19836888,19836888,19837112,0,0,0,224
15598,19837173,19837173,19837243,0,0,0,70
15530,19776168,19776168,19837338,0,0,0,61170
15599,19837322,19837322,19837662,0,0,0,340
15600,19837604,19837604,19837711,0,0,0,107
15602,19838503,19838503,19838652,0,0,0,149
15581,19825008,19825008,19838929,0,0,0,13921
15605,19840920,19840920,19840967,0,0,0,47
15606,19840992,19840992,19842242,0,0,0,1250
15541,19815264,19815264,19842349,0,0,0,27085
15609,19842555,19842555,19842675,0,0,0,120
15610,19842777,19842777,19842866,0,0,0,89
15603,19838635,19838635,19842910,0,0,0,4275
15604,19839621,19839621,19842979,0,0,0,3358
15612,19842958,19842958,19843043,0,0,0,85
15540,19815228,19815228,19843332,0,0,0,28104
15538,19813352,19813352,19843355,0,0,0,30003
15608,19842470,19842470,19843758,0,0,0,1288
15584,19829980,19843355,19843945,0,0,13375,13965
15621,19844046,19844046,19844178,0,0,0,132
15585,19830602,19843945,19844534,0,0,13343,13932
15559,19818790,19818790,19854790,0,0,0,36000
15623,19844910,19854790,19854874,0,0,9880,9964
15506,19592741,19599571,19858771,0,0,6830,266030
15569,19821734,19821734,19858826,0,0,0,37092
15570,19821745,19821745,19859455,0,0,0,37710
15579,19824706,19858771,19862337,0,0,34065,37631
15580,19824763,19862337,19862511,0,0,37574,37748
15611,19842935,19842935,19864555,0,0,0,21620
15613,19842984,19842984,19864592,0,0,0,21608
15620,19843563,19843563,19865222,0,0,0,21659
15607,19841775,19862511,19866029,0,0,20736,24254
15625,19845261,19866029,19866426,0,0,20768,21165
15572,19823539,19823539,19866889,0,0,0,43350
15573,19823581,19823581,19866962,0,0,0,43381
15576,19824487,19824487,19877759,0,0,0,53272
15575,19824348,19824348,19877955,0,0,0,53607
15619,19843324,19844534,19881607,0,0,1210,38283
15578,19824568,19826362,19888339,0,0,1794,63771
15525,19773438,19773438,19889529,0,0,0,116091
15601,19837765,19837765,19892773,0,0,0,55008
15631,19901658,19901658,19902695,0,0,0,1037
15634,19904364,19904364,19904464,0,0,0,100
15635,19904818,19904818,19904890,0,0,0,72
15637,19905211,19905211,19905307,0,0,0,96
15617,19843314,19843314,19905520,0,0,0,62206
15628,19899791,19899791,19905525,0,0,0,5734
15638,19905464,19905525,19905950,0,0,61,486
15636,19905124,19905124,19906174,0,0,0,1050
15618,19843320,19844534,19906718,0,0,1214,63398
15614,19843283,19844534,19906762,0,0,1251,63479
15645,19905955,19906718,19906784,0,0,763,829
15650,19906681,19906718,19906837,0,0,37,156
15647,19906112,19906718,19906918,0,0,606,806
15649,19906518,19906718,19906929,0,0,200,411
15651,19906783,19906783,19906986,0,0,0,203
15648,19906254,19906254,19907276,0,0,0,1022
15652,19907100,19907100,19907307,0,0,0,207
15653,19907513,19907513,19907839,0,0,0,326
15654,19907919,19907919,19908278,0,0,0,359
15632,19902478,19905520,19908393,0,0,3042,5915
15615,19843292,19854790,19909812,0,0,11498,66520
15642,19905508,19909812,19910321,0,0,4304,4813
15655,19908164,19908164,19910781,0,0,0,2617
15624,19844978,19854874,19911913,0,0,9896,66935
15658,19911305,19911305,19912351,0,0,0,1046
15577,19824530,19826362,19912762,0,0,1832,88232
15662,19914333,19914333,19914646,0,0,0,313
15663,19915297,19915297,19915659,0,0,0,362
15664,19915975,19915975,19916292,0,0,0,317
15665,19916373,19916373,19916465,0,0,0,92
15666,19916703,19916703,19916792,0,0,0,89
15560,19819617,19820272,19918242,0,0,655,98625
15669,19919960,19919960,19920097,0,0,0,137
15670,19920101,19920101,19920278,0,0,0,177
15616,19843306,19858771,19920977,0,0,15465,77671
15672,19920933,19920933,19921981,0,0,0,1048
15674,19922188,19922188,19922296,0,0,0,108
15673,19921215,19921215,19922778,0,0,0,1563
15678,19922750,19922778,19922852,0,0,28,102
15677,19922619,19922778,19922869,0,0,159,250
15679,19922856,19922856,19922929,0,0,0,73
15680,19922982,19922982,19923088,0,0,0,106
15681,19923089,19923089,19923186,0,0,0,97
15683,19923206,19923206,19923306,0,0,0,100
15682,19923196,19923196,19923307,0,0,0,111
15684,19924005,19924005,19924137,0,0,0,132
15685,19924089,19924089,19924162,0,0,0,73
15686,19924239,19924239,19924333,0,0,0,94
15687,19924245,19924245,19924359,0,0,0,114
15689,19924318,19924318,19924399,0,0,0,81
15690,19924366,19924366,19924436,0,0,0,70
15691,19924550,19924550,19924639,0,0,0,89
15692,19924764,19924764,19924829,0,0,0,65
15693,19924771,19924771,19924847,0,0,0,76
15695,19924914,19924914,19924994,0,0,0,80
15698,19925680,19925680,19925753,0,0,0,73
15699,19925758,19925758,19925832,0,0,0,74
15671,19920777,19920777,19925963,0,0,0,5186
15676,19922507,19922507,19925979,0,0,0,3472
15700,19925905,19925905,19926013,0,0,0,108
15675,19922253,19922253,19926240,0,0,0,3987
15701,19926145,19926145,19926805,0,0,0,660
15703,19926857,19926857,19927716,0,0,0,859
15715,19928069,19928069,19928164,0,0,0,95
15707,19927929,19927929,19928165,0,0,0,236
15716,19928222,19928222,19928368,0,0,0,146
15566,19821341,19821341,19932786,0,0,0,111445
15747,19934288,19934288,19934366,0,0,0,78
15748,19934405,19934405,19934452,0,0,0,47
15667,19917547,19918242,19936242,0,0,695,18695
15719,19930910,19930910,19936659,0,0,0,5749
15720,19930929,19936242,19938195,0,0,5313,7266
15535,19786262,19786262,19942768,0,0,0,156506
15721,19930934,19936659,19943514,0,0,5725,12580
15722,19930948,19938195,19943665,0,0,7247,12717
15702,19926838,19926838,19944838,0,0,0,18000
15524,19773415,19773415,19946215,0,0,0,172800
15723,19930955,19943514,19949336,0,0,12559,18381
15717,19928355,19928355,19949913,0,0,0,21558
15728,19931574,19946215,19949968,0,0,14641,18394
15726,19931016,19944838,19950416,0,0,13822,19400
15724,19930962,19943665,19950427,0,0,12703,19465
15727,19931023,19946215,19950567,0,0,15192,19544
15567,19821689,19821689,19951289,0,0,0,129600
15568,19821701,19821701,19951301,0,0,0,129600
15725,19930968,19944838,19951371,0,0,13870,20403
15729,19931591,19946215,19951953,0,0,14624,20362
15733,19931616,19950416,19952032,0,0,18800,20416
15743,19932005,19952032,19952955,0,0,20027,20950
15744,19932010,19952955,19953593,0,0,20945,21583
15738,19931964,19951301,19953753,0,0,19337,21789
15742,19932001,19951953,19953830,0,0,19952,21829
15740,19931981,19951301,19954668,0,0,19320,22687
15731,19931603,19949913,19954726,0,0,18310,23123
15730,19931598,19949336,19954806,0,0,17738,23208
15737,19931944,19951289,19955213,0,0,19345,23269
15732,19931610,19949968,19955578,0,0,18358,23968
15734,19931624,19950427,19955932,0,0,18803,24308
15745,19932017,19953593,19956490,0,0,21576,24473
15735,19931649,19950567,19956742,0,0,18918,25093
15536,19786422,19786422,19956805,0,0,0,170383
15714,19927968,19956805,19956916,0,0,28837,28948
15736,19931656,19951289,19956982,0,0,19633,25326
15741,19931992,19951371,19960176,0,0,19379,28184
15739,19931975,19951301,19960194,0,0,19326,28219
15706,19927921,19960176,19960311,0,0,32255,32390
15713,19927963,19960311,19960424,0,0,32348,32461
15656,19910762,19932786,19961084,0,0,22024,50322
15705,19927916,19961084,19961212,0,0,33168,33296
15708,19927934,19961212,19961586,0,0,33278,33652
15709,19927940,19961586,19961741,0,0,33646,33801
15712,19927958,19961741,19961862,0,0,33783,33904
15542,19815399,19815399,19964289,0,0,0,148890
15643,19905526,19905950,19971443,0,0,424,65917
15646,19906021,19912762,19978485,0,0,6741,72464
15630,19900671,19900671,19982587,0,0,0,81916
15752,19985383,19985383,19985466,0,0,0,83
15668,19919690,19920977,19985621,0,0,1287,65931
15753,19985669,19985669,19985777,0,0,0,108
15754,19986166,19986166,19986245,0,0,0,79
15757,19990377,19990377,19990491,0,0,0,114
15758,19990422,19990422,19990509,0,0,0,87
15764,19990437,19990437,19990519,0,0,0,82
15759,19990423,19990423,19990537,0,0,0,114
15760,19990423,19990423,19990537,0,0,0,114
15761,19990423,19990423,19990537,0,0,0,114
15765,19990437,19990437,19990546,0,0,0,109
15762,19990424,19990424,19990549,0,0,0,125
15769,19990463,19990463,19990588,0,0,0,125
15766,19990438,19990491,19990600,0,0,53,162
15770,19990469,19990519,19990627,0,0,50,158
15771,19990469,19990537,19990645,0,0,68,176
15767,19990438,19990537,19990646,0,0,99,208
15768,19990438,19990549,19990658,0,0,111,220
15784,19990521,19990546,19990699,0,0,25,178
15776,19990488,19990491,19990717,0,0,3,229
15785,19990521,19990588,19990776,0,0,67,255
15777,19990488,19990537,19990785,0,0,49,297
15772,19990469,19990646,19990799,0,0,177,330
15774,19990470,19990658,19990811,0,0,188,341
15786,19990522,19990645,19990833,0,0,123,311
15778,19990488,19990600,19990871,0,0,112,383
15787,19990522,19990799,19990982,0,0,277,460
15779,19990488,19990785,19991056,0,0,297,568
15780,19990488,19990811,19991113,0,0,323,625
15788,19990522,19990982,19991188,0,0,460,666
15793,19990817,19991113,19991200,0,0,296,383
15622,19844187,19844187,19991314,0,0,0,147127
15763,19990424,19991200,19991325,0,0,776,901
15773,19990470,19991325,19991433,0,0,855,963
15781,19990489,19991433,19991749,0,0,944,1260
15789,19990522,19991749,19991967,0,0,1227,1445
15795,19991470,19991967,19992040,0,0,497,570
15794,19991256,19991967,19992073,0,0,711,817
15796,19991677,19992040,19992113,0,0,363,436
15797,19992133,19992133,19992181,0,0,0,48
15798,19992139,19992139,19992213,0,0,0,74
15799,19992139,19992139,19992213,0,0,0,74
15800,19992140,19992140,19992256,0,0,0,116
15801,19992140,19992140,19992256,0,0,0,116
15802,19992140,19992256,19992372,0,0,116,232
15806,19992440,19992440,19992555,0,0,0,115
15807,19992601,19992601,19992706,0,0,0,105
15812,19992719,19992719,19992853,0,0,0,134
15816,19992730,19992730,19992853,0,0,0,123
15808,19992707,19992707,19992984,0,0,0,277
15815,19992725,19992853,19992987,0,0,128,262
15756,19986916,19986916,19994552,0,0,0,7636
15830,19995112,19995112,19995258,0,0,0,146
15627,19845673,19877759,19996115,0,0,32086,150442
15775,19990470,19996115,19996209,0,0,5645,5739
15811,19992719,19996115,19996218,0,0,3396,3499
15819,19992742,19996218,19996420,0,0,3476,3678
15782,19990489,19996209,19996528,0,0,5720,6039
15821,19992753,19996420,19996541,0,0,3667,3788
15790,19990523,19996528,19996639,0,0,6005,6116
15831,19996476,19996541,19996645,0,0,65,169
15803,19992140,19996639,19996755,0,0,4499,4615
15832,19996643,19996645,19996761,0,0,2,118
15823,19992900,19992984,19996805,0,0,84,3905
15833,19996732,19996732,19996842,0,0,0,110
15809,19992707,19996755,19997052,0,0,4048,4345
15834,19997005,19997005,19997140,0,0,0,135
15813,19992719,19997052,19997166,0,0,4333,4447
15817,19992730,19997166,19997249,0,0,4436,4519
15835,19997173,19997173,19997280,0,0,0,107
15837,19997284,19997284,19997388,0,0,0,104
15838,19997408,19997408,19997562,0,0,0,154
15839,19997613,19997613,19997728,0,0,0,115
15749,19934568,19954668,19997792,0,0,20100,63224
15746,19933054,19953830,19998953,0,0,20776,65899
15841,19999687,19999687,19999760,0,0,0,73
15842,19999829,19999829,19999902,0,0,0,73
15843,19999955,19999955,20000056,0,0,0,101
15845,20001610,20001610,20001757,0,0,0,147
15824,19993014,19993014,20002139,0,0,0,9125
15847,20002163,20002163,20002270,0,0,0,107
15849,20002494,20002494,20002565,0,0,0,71
15829,19994519,19994519,20002910,0,0,0,8391
15840,19999216,19999216,20003038,0,0,0,3822
15852,20004316,20004316,20004474,0,0,0,158
15853,20004562,20004562,20004678,0,0,0,116
15854,20004757,20004757,20004892,0,0,0,135
15836,19997187,19997187,20005251,0,0,0,8064
15641,19905493,19905950,20005839,0,0,457,100346
15639,19905474,19905950,20005850,0,0,476,100376
15856,20006333,20006333,20006433,0,0,0,100
15857,20006799,20006799,20006895,0,0,0,96
15858,20007912,20007912,20007982,0,0,0,70
15859,20008132,20008132,20008243,0,0,0,111
15860,20008247,20008247,20008318,0,0,0,71
15862,20008382,20008382,20008471,0,0,0,89
15861,20008366,20008366,20008477,0,0,0,111
15863,20008568,20008568,20008668,0,0,0,100
15864,20008577,20008577,20008750,0,0,0,173
15865,20008677,20008677,20008828,0,0,0,151
15866,20008870,20008870,20008981,0,0,0,111
15867,20008943,20008943,20009103,0,0,0,160
15851,20003276,20003276,20009180,0,0,0,5904
15791,19990523,20009180,20009413,0,0,18657,18890
15868,20009345,20009345,20009413,0,0,0,68
15804,19992141,20009413,20009518,0,0,17272,17377
15869,20009438,20009438,20009552,0,0,0,114
15850,20003254,20003254,20009634,0,0,0,6380
15870,20009475,20009475,20009657,0,0,0,182
15810,19992708,20009518,20009665,0,0,16810,16957
15871,20009535,20009535,20009741,0,0,0,206
15814,19992720,20009665,20009758,0,0,16945,17038
15872,20009622,20009634,20009798,0,0,12,176
15818,19992730,20009758,20009873,0,0,17028,17143
15820,19992743,20009873,20009966,0,0,17130,17223
15822,19992753,20009966,20010129,0,0,17213,17376
15873,20009784,20009784,20010188,0,0,0,404
15874,20010038,20010038,20010203,0,0,0,165
15875,20010066,20010066,20010234,0,0,0,168
15825,19993938,20010129,20010264,0,0,16191,16326
15826,19994006,20010264,20010590,0,0,16258,16584
15827,19994394,20010590,20010816,0,0,16196,16422
15828,19994403,20010816,20011044,0,0,16413,16641
15846,20002132,20011044,20011185,0,0,8912,9053
15877,20011274,20011274,20011427,0,0,0,153
15878,20011289,20011289,20011470,0,0,0,181
15882,20011592,20011592,20011723,0,0,0,131
15883,20011684,20011684,20011800,0,0,0,116
15885,20011709,20011709,20011847,0,0,0,138
15884,20011693,20011693,20011884,0,0,0,191
15718,19928436,19928436,20011959,0,0,0,83523
15886,20011711,20011711,20012044,0,0,0,333
15887,20011774,20011774,20012083,0,0,0,309
15876,20010187,20010187,20012256,0,0,0,2069
15894,20012265,20012265,20012400,0,0,0,135
15895,20012277,20012277,20012454,0,0,0,177
15892,20012058,20012058,20012898,0,0,0,840
15889,20011947,20011947,20013140,0,0,0,1193
15888,20011816,20011816,20013206,0,0,0,1390
15640,19905483,19906762,20013253,0,0,1279,107770
15890,20011970,20012898,20013792,0,0,928,1822
15899,20013166,20013792,20013895,0,0,626,729
15903,20013412,20013895,20014007,0,0,483,595
15902,20013398,20013895,20014061,0,0,497,663
15904,20013752,20014007,20014122,0,0,255,370
15905,20013768,20014061,20014238,0,0,293,470
15907,20014291,20014291,20014450,0,0,0,159
15898,20013104,20013792,20014903,0,0,688,1799
15848,20002194,20002194,20015897,0,0,0,13703
15909,20014811,20014903,20016053,0,0,92,1242
15893,20012081,20012081,20016137,0,0,0,4056
15911,20015177,20016137,20016190,0,0,960,1013
15644,19905849,19910321,20016292,0,0,4472,110443
15910,20015175,20016137,20016305,0,0,962,1130
15917,20016104,20016104,20016320,0,0,0,216
15912,20015441,20016190,20016365,0,0,749,924
15913,20015456,20016305,20016469,0,0,849,1013
15914,20015886,20016320,20016471,0,0,434,585
15915,20015903,20016365,20016505,0,0,462,602
15921,20016300,20016471,20016609,0,0,171,309
15920,20016288,20016469,20016629,0,0,181,341
15922,20016392,20016505,20016871,0,0,113,479
15891,20012019,20013140,20017236,0,0,1121,5217
15923,20016734,20016871,20017613,0,0,137,879
15925,20017584,20017613,20018410,0,0,29,826
15926,20017609,20018410,20018702,0,0,801,1093
15928,20017651,20018702,20019530,0,0,1051,1879
15949,20018595,20019530,20020238,0,0,935,1643
15633,19903701,19942768,20025576,0,0,39067,121875
15855,20005297,20005297,20026134,0,0,0,20837
15939,20017795,20026134,20026251,0,0,8339,8456
15940,20017796,20026251,20026368,0,0,8455,8572
15941,20017797,20026368,20026485,0,0,8571,8688
15942,20017798,20026485,20026602,0,0,8687,8804
15943,20017798,20026602,20026719,0,0,8804,8921
15951,20019262,20026719,20026852,0,0,7457,7590
15952,20019263,20026852,20026985,0,0,7589,7722
15953,20019264,20026985,20027118,0,0,7721,7854
15954,20019264,20027118,20027251,0,0,7854,7987
15955,20019265,20027251,20027384,0,0,7986,8119
15956,20019266,20027384,20027517,0,0,8118,8251
15626,19845648,19866426,20032187,0,0,20778,186539
15958,20036133,20036133,20036259,0,0,0,126
15959,20036379,20036379,20036486,0,0,0,107
15960,20036488,20036488,20036620,0,0,0,132
15961,20036488,20036620,20036752,0,0,132,264
15962,20036489,20036752,20036884,0,0,263,395
15963,20036489,20036884,20037016,0,0,395,527
15964,20036489,20037016,20037148,0,0,527,659
15965,20036489,20037148,20037280,0,0,659,791
15966,20036489,20037280,20037412,0,0,791,923
15967,20036489,20037412,20037506,0,0,923,1017
15968,20036489,20037506,20037653,0,0,1017,1164
15969,20036491,20037653,20037747,0,0,1162,1256
15970,20037117,20037747,20037879,0,0,630,762
15971,20037117,20037879,20038011,0,0,762,894
15972,20037117,20038011,20038143,0,0,894,1026
15973,20037117,20038143,20038275,0,0,1026,1158
15974,20037117,20038275,20038407,0,0,1158,1290
15975,20037117,20038407,20038539,0,0,1290,1422
15976,20037118,20038539,20038671,0,0,1421,1553
15977,20037118,20038671,20038765,0,0,1553,1647
15978,20037118,20038765,20038859,0,0,1647,1741
15979,20037118,20038859,20038953,0,0,1741,1835
15980,20037118,20038953,20039047,0,0,1835,1929
15981,20037118,20039047,20039141,0,0,1929,2023
15982,20037118,20039141,20039277,0,0,2023,2159
15983,20037119,20039277,20039371,0,0,2158,2252
15984,20037119,20039371,20039504,0,0,2252,2385
15985,20037119,20039504,20039637,0,0,2385,2518
15986,20037119,20039637,20039770,0,0,2518,2651
15987,20037119,20039770,20039903,0,0,2651,2784
15988,20037119,20039903,20040036,0,0,2784,2917
15989,20037119,20040036,20040169,0,0,2917,3050
15532,19785907,19785907,20045107,0,0,0,259200
15533,19785956,19785956,20045156,0,0,0,259200
15534,19785993,19785993,20045193,0,0,0,259200
15924,20017534,20045107,20045205,0,0,27573,27671
15927,20017618,20045107,20045213,0,0,27489,27595
15929,20017665,20045107,20045226,0,0,27442,27561
15930,20017666,20045156,20045263,0,0,27490,27597
15932,20017667,20045156,20045274,0,0,27489,27607
15931,20017666,20045156,20045278,0,0,27490,27612
15934,20017695,20045193,20045299,0,0,27498,27604
15933,20017668,20045193,20045311,0,0,27525,27643
15935,20017696,20045213,20045319,0,0,27517,27623
15937,20017698,20045278,20045356,0,0,27580,27658
15936,20017697,20045263,20045370,0,0,27566,27673
15938,20017699,20045299,20045406,0,0,27600,27707
15944,20018429,20045319,20045434,0,0,26890,27005
15945,20018431,20045356,20045493,0,0,26925,27062
15947,20018436,20045406,20045499,0,0,26970,27063
15946,20018434,20045370,20045504,0,0,26936,27070
15948,20018439,20045434,20045557,0,0,26995,27118
15537,19786585,19786585,20045785,0,0,0,259200
15561,19820116,20045557,20045890,0,0,225441,225774
15562,19820430,20045890,20046141,0,0,225460,225711
15563,19820679,20046141,20046261,0,0,225462,225582
15565,19821180,20046261,20046861,0,0,225081,225681
15916,20016038,20016038,20047545,0,0,0,31507
15704,19927679,20046861,20048661,0,0,119182,120982
15710,19927946,20048661,20050461,0,0,120715,122515
15711,19927953,20050461,20052261,0,0,122508,124308
15783,19990489,20052261,20052397,0,0,61772,61908
15792,19990523,20052397,20052997,0,0,61874,62474
15805,19992141,20052997,20053597,0,0,60856,61456
15844,20001483,20053597,20053716,0,0,52114,52233
15950,20018721,20026134,20062088,0,0,7413,43367
15957,20019887,20026134,20062088,0,0,6247,42201
15990,20074534,20074534,20074678,0,0,0,144
15991,20074877,20074877,20074913,0,0,0,36
15992,20074921,20074921,20074994,0,0,0,73
15993,20075129,20075129,20075274,0,0,0,145
15994,20075223,20075223,20075341,0,0,0,118
16007,20075227,20075227,20075343,0,0,0,116
15995,20075224,20075224,20075352,0,0,0,128
16000,20075225,20075225,20075353,0,0,0,128
16008,20075227,20075227,20075358,0,0,0,131
16009,20075227,20075227,20075367,0,0,0,140
16010,20075227,20075227,20075367,0,0,0,140
15996,20075224,20075224,20075383,0,0,0,159
15997,20075224,20075224,20075383,0,0,0,159
15998,20075224,20075224,20075383,0,0,0,159
15999,20075224,20075224,20075383,0,0,0,159
16001,20075225,20075225,20075384,0,0,0,159
16002,20075225,20075225,20075384,0,0,0,159
16003,20075226,20075226,20075385,0,0,0,159
16004,20075226,20075226,20075385,0,0,0,159
16005,20075226,20075226,20075385,0,0,0,159
16006,20075226,20075226,20075385,0,0,0,159
16011,20075228,20075228,20075390,0,0,0,162
16012,20075228,20075228,20075390,0,0,0,162
16013,20075228,20075228,20075390,0,0,0,162
16014,20076801,20076801,20076891,0,0,0,90
16015,20077139,20077139,20077234,0,0,0,95
16017,20077250,20077250,20077354,0,0,0,104
16016,20077244,20077244,20077606,0,0,0,362
16021,20079085,20079085,20079246,0,0,0,161
16020,20079068,20079068,20079251,0,0,0,183
16022,20079297,20079297,20079447,0,0,0,150
16023,20079311,20079311,20079471,0,0,0,160
16025,20079716,20079716,20079864,0,0,0,148
16024,20079550,20079550,20079874,0,0,0,324
16026,20079731,20079731,20079900,0,0,0,169
16027,20080323,20080323,20080416,0,0,0,93
16028,20080772,20080772,20080875,0,0,0,103
16029,20080794,20080794,20080906,0,0,0,112
16030,20081071,20081071,20081208,0,0,0,137
16031,20081083,20081083,20081209,0,0,0,126
16033,20081364,20081364,20081506,0,0,0,142
16034,20081380,20081380,20081507,0,0,0,127
16036,20081797,20081797,20081906,0,0,0,109
16037,20081814,20081814,20081931,0,0,0,117
16039,20082083,20082083,20082198,0,0,0,115
16040,20082098,20082098,20082210,0,0,0,112
16041,20082155,20082155,20082259,0,0,0,104
16042,20082274,20082274,20082400,0,0,0,126
16043,20082342,20082342,20082478,0,0,0,136
16044,20082356,20082356,20082481,0,0,0,125
16045,20082789,20082789,20082913,0,0,0,124
16046,20082803,20082803,20082915,0,0,0,112
16019,20078070,20078070,20082931,0,0,0,4861
16018,20077928,20077928,20082962,0,0,0,5034
16049,20082962,20082962,20083074,0,0,0,112
16048,20082939,20082939,20083124,0,0,0,185
16050,20083094,20083094,20083201,0,0,0,107
16047,20082912,20082912,20083214,0,0,0,302
16051,20083119,20083119,20083288,0,0,0,169
16052,20083203,20083203,20083374,0,0,0,171
16054,20083310,20083310,20083427,0,0,0,117
16053,20083304,20083304,20083451,0,0,0,147
16055,20083327,20083327,20083463,0,0,0,136
15657,19910778,19910778,20083526,0,0,0,172748
16038,20082046,20082046,20083563,0,0,0,1517
16059,20083605,20083605,20083771,0,0,0,166
16058,20083593,20083593,20083781,0,0,0,188
16060,20087425,20087425,20087758,0,0,0,333
16061,20088079,20088079,20088138,0,0,0,59
16063,20088515,20088515,20088852,0,0,0,337
16065,20089040,20089040,20089179,0,0,0,139
16064,20089027,20089027,20089188,0,0,0,161
16066,20089528,20089528,20089675,0,0,0,147
16067,20089544,20089544,20089707,0,0,0,163
16068,20089854,20089854,20090181,0,0,0,327
16069,20090104,20090104,20090254,0,0,0,150
16070,20090118,20090118,20090277,0,0,0,159
16057,20083523,20083523,20090846,0,0,0,7323
16056,20083504,20083504,20090882,0,0,0,7378
16073,20090856,20090856,20090955,0,0,0,99
16071,20090533,20090533,20091206,0,0,0,673
16075,20092794,20092794,20092929,0,0,0,135
15879,20011310,20011310,20093767,0,0,0,82457
16078,20093823,20093823,20093958,0,0,0,135
16079,20094044,20094044,20094204,0,0,0,160
16080,20094063,20094063,20094233,0,0,0,170
16082,20094343,20094343,20094394,0,0,0,51
16081,20094286,20094286,20094426,0,0,0,140
16083,20094363,20094363,20094542,0,0,0,179
16084,20094423,20094423,20094595,0,0,0,172
16085,20094491,20094491,20094668,0,0,0,177
16086,20094551,20094551,20094728,0,0,0,177
16087,20094615,20094615,20094786,0,0,0,171
16088,20094675,20094675,20094846,0,0,0,171
16089,20094739,20094739,20094906,0,0,0,167
16091,20094853,20094853,20094938,0,0,0,85
15582,19828326,19842349,20094949,0,0,14023,266623
16090,20094798,20094798,20094978,0,0,0,180
16092,20094919,20094919,20095059,0,0,0,140
16093,20094986,20094986,20095152,0,0,0,166
16077,20093501,20093501,20095540,0,0,0,2039
16094,20095593,20095593,20095931,0,0,0,338
15583,19828337,19843332,20095932,0,0,14995,267595
16062,20088159,20088159,20096593,0,0,0,8434
16095,20096767,20096767,20096830,0,0,0,63
16097,20097843,20097843,20097987,0,0,0,144
16098,20097902,20097902,20098069,0,0,0,167
16099,20097946,20097946,20098094,0,0,0,148
16101,20098057,20098057,20098198,0,0,0,141
16100,20098013,20098013,20098199,0,0,0,186
16102,20098109,20098109,20098246,0,0,0,137
16103,20098160,20098160,20098297,0,0,0,137
16104,20098213,20098213,20098374,0,0,0,161
16105,20098264,20098264,20098427,0,0,0,163
16106,20098320,20098320,20098475,0,0,0,155
16107,20098365,20098365,20098530,0,0,0,165
16108,20098417,20098417,20098567,0,0,0,150
16109,20098431,20098431,20098601,0,0,0,170
16113,20098887,20098887,20099036,0,0,0,149
16114,20098902,20098902,20099059,0,0,0,157
16115,20098959,20098959,20099116,0,0,0,157
16116,20099080,20099080,20099236,0,0,0,156
16118,20099128,20099128,20099280,0,0,0,152
16119,20099344,20099344,20099441,0,0,0,97
16120,20099381,20099381,20099469,0,0,0,88
16121,20099551,20099551,20099677,0,0,0,126
16122,20099563,20099563,20099678,0,0,0,115
16125,20099635,20099635,20099745,0,0,0,110
16124,20099633,20099633,20099754,0,0,0,121
16126,20099636,20099636,20099757,0,0,0,121
16123,20099598,20099598,20099778,0,0,0,180
16127,20099768,20099768,20099925,0,0,0,157
15880,20011337,20025576,20100024,0,0,14239,88687
16128,20099880,20099880,20100039,0,0,0,159
16129,20099986,20099986,20100136,0,0,0,150
16130,20100034,20100034,20100193,0,0,0,159
16132,20100120,20100120,20100225,0,0,0,105
16131,20100102,20100102,20100271,0,0,0,169
16133,20100153,20100153,20100278,0,0,0,125
16134,20100154,20100154,20100279,0,0,0,125
16135,20100160,20100160,20100327,0,0,0,167
15897,20012905,20013206,20100376,0,0,301,87471
15919,20016139,20016629,20100587,0,0,490,84448
15901,20013195,20013792,20100700,0,0,597,87505
16137,20101391,20101391,20101740,0,0,0,349
16138,20101830,20101830,20102168,0,0,0,338
16111,20098465,20098465,20102393,0,0,0,3928
15906,20014027,20014027,20102519,0,0,0,88492
16140,20102554,20102554,20102645,0,0,0,91
16139,20102507,20102507,20102663,0,0,0,156
16141,20102578,20102578,20102830,0,0,0,252
16142,20102653,20102653,20103022,0,0,0,369
16143,20102710,20102710,20103085,0,0,0,375
16144,20102777,20102777,20103145,0,0,0,368
16145,20103039,20103039,20103421,0,0,0,382
16146,20103084,20103084,20103424,0,0,0,340
16147,20103162,20103162,20103528,0,0,0,366
16150,20103356,20103356,20103531,0,0,0,175
16148,20103198,20103198,20103558,0,0,0,360
16110,20098456,20098456,20103584,0,0,0,5128
16149,20103223,20103223,20103597,0,0,0,374
16154,20103607,20103607,20103706,0,0,0,99
16151,20103380,20103380,20103742,0,0,0,362
16152,20103480,20103480,20103842,0,0,0,362
16155,20103743,20103743,20103842,0,0,0,99
16158,20103829,20103829,20103917,0,0,0,88
16153,20103565,20103565,20103923,0,0,0,358
15908,20014486,20014486,20104038,0,0,0,89552
16156,20103774,20103774,20104149,0,0,0,375
16157,20103820,20103820,20104188,0,0,0,368
16160,20103929,20103929,20104197,0,0,0,268
16159,20103838,20103838,20104228,0,0,0,390
16162,20104219,20104219,20104312,0,0,0,93
16167,20105484,20105484,20105643,0,0,0,159
15881,20011442,20032187,20106606,0,0,20745,95164
16164,20104337,20104337,20111722,0,0,0,7385
16072,20090832,20090832,20112057,0,0,0,21225
15629,19900593,19900593,20112385,0,0,0,211792
16074,20091028,20091028,20112780,0,0,0,21752
16175,20113492,20113492,20113596,0,0,0,104
16176,20114427,20114427,20114562,0,0,0,135
16177,20114755,20114755,20114885,0,0,0,130
16178,20114894,20114894,20115020,0,0,0,126
16179,20115056,20115056,20115181,0,0,0,125
16180,20115142,20115142,20115292,0,0,0,150
16181,20115528,20115528,20115675,0,0,0,147
16182,20115796,20115796,20115942,0,0,0,146
16183,20116230,20116230,20116357,0,0,0,127
16184,20117447,20117447,20117585,0,0,0,138
16186,20117631,20117631,20117756,0,0,0,125
16187,20118207,20118207,20118353,0,0,0,146
16188,20118437,20118437,20118584,0,0,0,147
16189,20121575,20121575,20121650,0,0,0,75
16190,20121628,20121628,20121743,0,0,0,115
16191,20121776,20121776,20121922,0,0,0,146
16192,20122017,20122017,20122617,0,0,0,600
16096,20096993,20096993,20123260,0,0,0,26267
16193,20123509,20123509,20124109,0,0,0,600
16032,20081215,20081215,20125885,0,0,0,44670
15751,19936913,19954806,20127606,0,0,17893,190693
15918,20016128,20017236,20127704,0,0,1108,111576
15750,19936803,19971443,20132972,0,0,34640,196169
16169,20108227,20108227,20150692,0,0,0,42465
16170,20108331,20108331,20150765,0,0,0,42434
16197,20156570,20156570,20156920,0,0,0,350
16198,20156985,20156985,20157125,0,0,0,140
16199,20157231,20157231,20157340,0,0,0,109
16201,20157488,20157488,20157623,0,0,0,135
16203,20157660,20157660,20157769,0,0,0,109
15755,19986482,19986482,20159282,0,0,0,172800
16204,20159393,20159393,20159955,0,0,0,562
16206,20160559,20160559,20160710,0,0,0,151
16209,20162949,20162949,20163079,0,0,0,130
16210,20163272,20163272,20163350,0,0,0,78
16205,20159971,20159971,20163589,0,0,0,3618
16211,20163584,20163584,20163699,0,0,0,115
15659,19911864,19911864,20163864,0,0,0,252000
15660,19911897,19911897,20163897,0,0,0,252000
15661,19911906,19911906,20163906,0,0,0,252000
16213,20163795,20163795,20163919,0,0,0,124
16214,20163981,20163981,20164087,0,0,0,106
16215,20164216,20164216,20164326,0,0,0,110
16216,20164293,20164293,20164433,0,0,0,140
16217,20164462,20164462,20164540,0,0,0,78
16218,20164907,20164907,20164985,0,0,0,78
16220,20165355,20165355,20165458,0,0,0,103
16221,20165845,20165845,20165934,0,0,0,89
16222,20165992,20165992,20166065,0,0,0,73
16223,20166098,20166098,20166177,0,0,0,79
16224,20166216,20166216,20166296,0,0,0,80
16225,20166248,20166248,20166331,0,0,0,83
16163,20104333,20104333,20166602,0,0,0,62269
16166,20104370,20104370,20166603,0,0,0,62233
16165,20104349,20104349,20166607,0,0,0,62258
16228,20166806,20166806,20167045,0,0,0,239
16227,20166360,20166360,20168040,0,0,0,1680
16226,20166352,20166352,20168044,0,0,0,1692
16232,20170431,20170431,20170526,0,0,0,95
16233,20170483,20170483,20170536,0,0,0,53
16234,20170696,20170696,20170935,0,0,0,239
16235,20171595,20171595,20171833,0,0,0,238
16236,20171991,20171991,20172226,0,0,0,235
16112,20098631,20098631,20172249,0,0,0,73618
16240,20172433,20172433,20172499,0,0,0,66
15900,20013170,20016292,20172543,0,0,3122,159373
16244,20172514,20172514,20172592,0,0,0,78
15896,20012885,20013253,20172763,0,0,368,159878
16245,20172694,20172694,20172783,0,0,0,89
16117,20099122,20099122,20172828,0,0,0,73706
16241,20172464,20172464,20173029,0,0,0,565
16242,20172478,20172478,20173054,0,0,0,576
16247,20172830,20172830,20173055,0,0,0,225
16246,20172821,20172821,20173057,0,0,0,236
16243,20172501,20172501,20173099,0,0,0,598
16248,20172855,20172855,20173102,0,0,0,247
16249,20172939,20173029,20173261,0,0,90,322
16237,20172375,20172375,20173379,0,0,0,1004
16238,20172390,20172390,20173394,0,0,0,1004
16239,20172404,20172404,20173419,0,0,0,1015
16230,20170024,20170024,20173966,0,0,0,3942
16229,20168973,20168973,20174031,0,0,0,5058
16231,20170232,20170232,20174032,0,0,0,3800
16251,20173020,20173029,20174394,0,0,9,1374
16266,20173827,20174394,20174480,0,0,567,653
16208,20162458,20162458,20174723,0,0,0,12265
16279,20174712,20174723,20174842,0,0,11,130
16282,20174910,20174910,20175020,0,0,0,110
16219,20165254,20165254,20175040,0,0,0,9786
16284,20175245,20175245,20175358,0,0,0,113
16285,20175310,20175310,20175369,0,0,0,59
16286,20175369,20175369,20175467,0,0,0,98
16287,20175409,20175409,20175513,0,0,0,104
16289,20175851,20175851,20175929,0,0,0,78
16291,20175981,20175981,20176082,0,0,0,101
16288,20175607,20175607,20176207,0,0,0,600
16292,20176265,20176265,20176381,0,0,0,116
16293,20176344,20176344,20176392,0,0,0,48
16262,20173632,20173632,20176607,0,0,0,2975
16263,20173708,20173708,20176672,0,0,0,2964
16261,20173547,20173547,20176849,0,0,0,3302
16264,20173758,20174032,20177006,0,0,274,3248
16267,20173900,20174394,20177377,0,0,494,3477
16268,20173986,20174480,20177460,0,0,494,3474
16076,20093223,20093223,20177752,0,0,0,84529
16276,20174470,20177752,20178004,0,0,3282,3534
16269,20174063,20175040,20178015,0,0,977,3952
16273,20174186,20174186,20178018,0,0,0,3832
16271,20174113,20176672,20179645,0,0,2559,5532
16272,20174169,20176849,20179822,0,0,2680,5653
16274,20174296,20177006,20179976,0,0,2710,5680
16290,20175942,20179822,20180042,0,0,3880,4100
16294,20176397,20180042,20180283,0,0,3645,3886
16270,20174096,20176607,20180300,0,0,2511,6204
16295,20177260,20180283,20180387,0,0,3023,3127
16275,20174341,20177377,20180404,0,0,3036,6063
16296,20177586,20180300,20180427,0,0,2714,2841
16297,20177702,20180387,20180505,0,0,2685,2803
16298,20177848,20180427,20180543,0,0,2579,2695
16300,20178387,20180543,20180594,0,0,2156,2207
16299,20178170,20180505,20180621,0,0,2335,2451
16280,20174794,20177752,20180775,0,0,2958,5981
16212,20163732,20163732,20180948,0,0,0,17216
16281,20174909,20178004,20181030,0,0,3095,6121
16305,20182037,20182037,20182084,0,0,0,47
16304,20181995,20181995,20182090,0,0,0,95
16306,20182086,20182086,20182252,0,0,0,166
16307,20182260,20182260,20182349,0,0,0,89
16303,20181887,20181887,20182487,0,0,0,600
16308,20182570,20182570,20182759,0,0,0,189
16310,20182939,20182939,20183539,0,0,0,600
16312,20183736,20183736,20183814,0,0,0,78
16313,20183928,20183928,20183974,0,0,0,46
16314,20184056,20184056,20184151,0,0,0,95
16316,20184180,20184180,20184275,0,0,0,95
16317,20184408,20184408,20184519,0,0,0,111
16315,20184151,20184151,20184647,0,0,0,496
16319,20184574,20184574,20184736,0,0,0,162
16320,20184580,20184580,20184753,0,0,0,173
16321,20184580,20184580,20184769,0,0,0,189
16322,20184580,20184580,20184769,0,0,0,189
16323,20184581,20184581,20184770,0,0,0,189
16324,20184581,20184647,20184862,0,0,66,281
16325,20184581,20184736,20184951,0,0,155,370
16326,20184582,20184753,20184968,0,0,171,386
16327,20184582,20184769,20184984,0,0,187,402
16328,20184582,20184769,20185005,0,0,187,423
16329,20184582,20184770,20185006,0,0,188,424
16330,20184583,20184862,20185098,0,0,279,515
16332,20184583,20184968,20185113,0,0,385,530
16331,20184583,20184951,20185120,0,0,368,537
16333,20184583,20184984,20185133,0,0,401,550
16334,20184584,20185005,20185201,0,0,421,617
16335,20184585,20185006,20185202,0,0,421,617
16338,20184928,20185098,20185629,0,0,170,701
16339,20184928,20185113,20185655,0,0,185,727
16341,20184929,20185133,20185675,0,0,204,746
16340,20184928,20185120,20185684,0,0,192,756
16352,20185255,20185255,20185720,0,0,0,465
16342,20184929,20185201,20185754,0,0,272,825
16343,20184929,20185202,20185755,0,0,273,826
16353,20185261,20185720,20186181,0,0,459,920
16344,20184929,20185629,20186182,0,0,700,1253
16345,20184929,20185655,20186208,0,0,726,1279
16347,20184930,20185684,20186237,0,0,754,1307
16346,20184929,20185675,20186239,0,0,746,1310
16349,20184930,20185755,20186283,0,0,825,1353
16348,20184930,20185754,20186318,0,0,824,1388
16359,20186322,20186322,20186401,0,0,0,79
16360,20186504,20186504,20186551,0,0,0,47
16355,20185262,20186208,20186691,0,0,946,1429
16354,20185261,20186181,20186695,0,0,920,1434
16350,20184930,20186182,20186710,0,0,1252,1780
16356,20185262,20186208,20186722,0,0,946,1460
16361,20186610,20186610,20186730,0,0,0,120
16357,20185262,20186237,20186751,0,0,975,1489
16358,20185262,20186237,20186793,0,0,975,1531
16362,20186684,20186684,20187010,0,0,0,326
16363,20187242,20187242,20187355,0,0,0,113
16365,20187553,20187553,20187631,0,0,0,78
16367,20187886,20187886,20187995,0,0,0,109
16207,20162261,20162261,20188283,0,0,0,26022
16161,20104030,20104030,20188915,0,0,0,84885
16370,20189473,20189473,20189551,0,0,0,78
16371,20189591,20189591,20189638,0,0,0,47
16372,20189691,20189691,20189886,0,0,0,195
16373,20190685,20190685,20190764,0,0,0,79
16374,20190968,20190968,20191046,0,0,0,78
16376,20191644,20191644,20191722,0,0,0,78
16369,20188693,20188693,20191778,0,0,0,3085
16377,20191830,20191830,20191907,0,0,0,77
16381,20191921,20191921,20192068,0,0,0,147
16382,20192031,20192031,20192116,0,0,0,85
16383,20192068,20192068,20192170,0,0,0,102
16384,20192126,20192126,20192200,0,0,0,74
16385,20192148,20192148,20192226,0,0,0,78
16283,20174977,20178015,20192389,0,0,3038,17412
16393,20192450,20192450,20192497,0,0,0,47
16388,20192285,20192389,20192519,0,0,104,234
16394,20192525,20192525,20192679,0,0,0,154
16387,20192271,20192271,20192737,0,0,0,466
16400,20192632,20192632,20192865,0,0,0,233
15688,19924291,19942768,20195368,0,0,18477,271077
16318,20184503,20195368,20195515,0,0,10865,11012
16336,20184654,20195515,20195663,0,0,10861,11009
16337,20184776,20195663,20195859,0,0,10887,11083
16278,20174706,20177460,20195890,0,0,2754,21184
16351,20185012,20195859,20196013,0,0,10847,11001
16364,20187313,20195890,20196071,0,0,8577,8758
16309,20182674,20192737,20196539,0,0,10063,13865
16368,20188060,20196013,20196613,0,0,7953,8553
16406,20194843,20196071,20197391,0,0,1228,2548
16195,20156497,20156497,20198896,0,0,0,42399
16196,20156512,20156512,20199008,0,0,0,42496
16375,20191543,20199008,20199367,0,0,7465,7824
16378,20191836,20199367,20199495,0,0,7531,7659
16379,20191837,20199495,20199619,0,0,7658,7782
16380,20191839,20199619,20199760,0,0,7780,7921
16194,20156456,20156456,20199836,0,0,0,43380
16386,20192256,20199760,20199858,0,0,7504,7602
16200,20157467,20157467,20199906,0,0,0,42439
16202,20157509,20157509,20199948,0,0,0,42439
16389,20192310,20199858,20199955,0,0,7548,7645
16390,20192312,20199906,20200045,0,0,7594,7733
16391,20192314,20199948,20200072,0,0,7634,7758
16392,20192316,20199955,20200106,0,0,7639,7790
16395,20192535,20200045,20200165,0,0,7510,7630
16396,20192538,20200072,20200198,0,0,7534,7660
16397,20192539,20200106,20200232,0,0,7567,7693
16398,20192540,20200165,20200261,0,0,7625,7721
16399,20192541,20200198,20200294,0,0,7657,7753
16401,20193268,20200232,20200338,0,0,6964,7070
16302,20181331,20196613,20200373,0,0,15282,19042
16402,20193269,20200261,20200398,0,0,6992,7129
16403,20193270,20200294,20200424,0,0,7024,7154
16404,20193271,20200338,20200437,0,0,7067,7166
16405,20193272,20200373,20200502,0,0,7101,7230
16407,20196007,20200398,20200517,0,0,4391,4510
16408,20196059,20200424,20200547,0,0,4365,4488
16409,20196060,20200437,20200560,0,0,4377,4500
16410,20196061,20200502,20200612,0,0,4441,4551
16411,20196063,20200517,20200636,0,0,4454,4573
16412,20196343,20200547,20200860,0,0,4204,4517
16413,20196344,20200560,20200864,0,0,4216,4520
16414,20196346,20200612,20200927,0,0,4266,4581
16415,20196347,20200636,20200951,0,0,4289,4604
16416,20196348,20200860,20201130,0,0,4512,4782
16417,20197545,20200864,20201218,0,0,3319,3673
16418,20197546,20200927,20201239,0,0,3381,3693
16419,20197547,20200951,20201272,0,0,3404,3725
16420,20197563,20201130,20201451,0,0,3567,3888
16424,20201183,20201272,20201459,0,0,89,276
16421,20197564,20201218,20201561,0,0,3654,3997
16422,20197566,20201239,20201613,0,0,3673,4047
16426,20201711,20201711,20201771,0,0,0,60
16425,20201491,20201491,20201782,0,0,0,291
16428,20202179,20202179,20202323,0,0,0,144
16429,20202180,20202323,20202467,0,0,143,287
16423,20199675,20201272,20202553,0,0,1597,2878
16430,20202181,20202467,20202611,0,0,286,430
16311,20183627,20198896,20202677,0,0,15269,19050
16431,20202182,20202553,20202697,0,0,371,515
16432,20202182,20202611,20202755,0,0,429,573
16433,20202329,20202677,20202814,0,0,348,485
16434,20202330,20202677,20202834,0,0,347,504
16435,20202331,20202677,20202834,0,0,346,503
16436,20202332,20202697,20202854,0,0,365,522
16437,20202333,20202755,20202912,0,0,422,579
16438,20203211,20203211,20203270,0,0,0,59
16427,20201802,20201802,20203271,0,0,0,1469
16439,20203282,20203282,20205142,0,0,0,1860
16366,20187684,20187684,20208715,0,0,0,21031
15694,19924900,19956490,20209090,0,0,31590,284190
15696,19924933,19956805,20209405,0,0,31872,284472
15697,19924958,19956805,20209405,0,0,31847,284447
16440,20205822,20205822,20210461,0,0,0,4639
16035,20081712,20081712,20211356,0,0,0,129644
16441,20211177,20211177,20213454,0,0,0,2277
16442,20249488,20249488,20252209,0,0,0,2721
16443,20252946,20252946,20253144,0,0,0,198
16444,20253280,20253280,20255942,0,0,0,2662
16445,20256078,20256078,20258097,0,0,0,2019
16451,20258076,20258076,20259578,0,0,0,1502
16453,20269402,20269402,20269519,0,0,0,117
16454,20269874,20269874,20269989,0,0,0,115
16455,20270034,20270034,20270165,0,0,0,131
16456,20270133,20270133,20270282,0,0,0,149
16457,20270371,20270371,20271812,0,0,0,1441
16458,20271756,20271756,20271889,0,0,0,133
16460,20272129,20272129,20272261,0,0,0,132
16461,20272329,20272329,20272418,0,0,0,89
16459,20272114,20272114,20272813,0,0,0,699
16462,20272795,20272795,20272884,0,0,0,89
16463,20272909,20272909,20273009,0,0,0,100
16136,20100292,20100292,20273092,0,0,0,172800
16466,20273609,20273609,20273699,0,0,0,90
16465,20273100,20273100,20273753,0,0,0,653
16464,20272961,20272961,20273765,0,0,0,804
16467,20273737,20273737,20273798,0,0,0,61
16468,20273805,20273805,20273872,0,0,0,67
16470,20274042,20274042,20274135,0,0,0,93
16469,20274004,20274004,20274202,0,0,0,198
16471,20274214,20274214,20274281,0,0,0,67
16473,20274754,20274754,20274843,0,0,0,89
16474,20274841,20274841,20274930,0,0,0,89
16475,20274998,20274998,20275074,0,0,0,76
16476,20275067,20275067,20275157,0,0,0,90
16477,20275298,20275298,20275394,0,0,0,96
16478,20275512,20275512,20275607,0,0,0,95
16479,20275689,20275689,20275778,0,0,0,89
16480,20275781,20275781,20275890,0,0,0,109
16481,20276477,20276477,20276566,0,0,0,89
16482,20276688,20276688,20276782,0,0,0,94
16483,20276930,20276930,20277025,0,0,0,95
16484,20277254,20277254,20277348,0,0,0,94
16485,20277346,20277346,20277436,0,0,0,90
16486,20277735,20277735,20277829,0,0,0,94
16487,20278103,20278103,20278192,0,0,0,89
16488,20278364,20278364,20278459,0,0,0,95
16489,20278505,20278505,20278600,0,0,0,95
16490,20278689,20278689,20278783,0,0,0,94
16491,20278789,20278789,20278856,0,0,0,67
16492,20278995,20278995,20279089,0,0,0,94
16493,20279462,20279462,20279556,0,0,0,94
16494,20279511,20279511,20279605,0,0,0,94
16495,20279620,20279620,20279715,0,0,0,95
16496,20279749,20279749,20279816,0,0,0,67
16452,20261951,20261951,20287832,0,0,0,25881
16446,20256963,20256963,20299392,0,0,0,42429
16447,20256974,20256974,20299392,0,0,0,42418
16448,20256987,20256987,20299426,0,0,0,42439
16449,20257002,20257002,20299441,0,0,0,42439
16450,20257571,20257571,20300010,0,0,0,42439
16258,20173411,20173411,20308998,0,0,0,135587
16174,20111583,20111583,20309011,0,0,0,197428
16173,20111444,20111444,20327541,0,0,0,216097
16185,20117527,20117527,20328709,0,0,0,211182
16256,20173387,20173387,20330492,0,0,0,157105
16472,20274350,20274350,20336682,0,0,0,62332
16265,20173811,20173811,20341583,0,0,0,167772
16500,20341679,20341679,20341797,0,0,0,118
16501,20341811,20341811,20342580,0,0,0,769
16260,20173431,20180948,20342811,0,0,7517,169380
16502,20342569,20342569,20343270,0,0,0,701
16503,20342670,20342670,20343278,0,0,0,608
16504,20343278,20343278,20344111,0,0,0,833
16505,20343328,20343328,20344120,0,0,0,792
16507,20344262,20344262,20345071,0,0,0,809
16506,20344191,20344191,20345084,0,0,0,893
16508,20346375,20346375,20346446,0,0,0,71
16497,20333273,20333273,20347633,0,0,0,14360
16498,20333357,20333357,20348046,0,0,0,14689
16509,20346447,20346447,20348247,0,0,0,1800
16510,20346457,20346457,20348257,0,0,0,1800
16499,20333512,20333512,20348492,0,0,0,14980
16171,20110792,20110792,20352609,0,0,0,241817
16514,20351883,20351883,20352734,0,0,0,851
16515,20352746,20352746,20353493,0,0,0,747
16516,20353491,20353491,20354339,0,0,0,848
16517,20354376,20354376,20355100,0,0,0,724
16518,20355135,20355135,20355945,0,0,0,810
16520,20356044,20356044,20356803,0,0,0,759
16519,20355950,20355950,20356824,0,0,0,874
16521,20356797,20356797,20357808,0,0,0,1011
16522,20361156,20361156,20361273,0,0,0,117
16523,20361223,20361223,20361338,0,0,0,115
16524,20361293,20361293,20361400,0,0,0,107
16525,20361362,20361362,20361457,0,0,0,95
16526,20361572,20361572,20361700,0,0,0,128
16527,20361636,20361636,20361773,0,0,0,137
16168,20106401,20106401,20365601,0,0,0,259200
16172,20111249,20111249,20370449,0,0,0,259200
16528,20371859,20371859,20371932,0,0,0,73
16254,20173213,20173213,20380598,0,0,0,207385
16252,20173195,20173195,20387017,0,0,0,213822
16513,20349378,20349378,20387928,0,0,0,38550
16253,20173204,20173204,20392924,0,0,0,219720
16532,20417353,20417353,20417453,0,0,0,100
16534,20417484,20417484,20417652,0,0,0,168
16535,20417607,20417607,20417687,0,0,0,80
16533,20417408,20417408,20417839,0,0,0,431
16536,20417890,20417890,20418014,0,0,0,124
16537,20418180,20418180,20418228,0,0,0,48
16511,20349194,20349194,20419171,0,0,0,69977
16540,20419145,20419145,20419212,0,0,0,67
16512,20349324,20349324,20419271,0,0,0,69947
16539,20419134,20419134,20419352,0,0,0,218
16541,20419154,20419154,20419366,0,0,0,212
16542,20419216,20419216,20419377,0,0,0,161
16543,20419312,20419312,20420799,0,0,0,1487
16544,20419332,20419332,20420822,0,0,0,1490
16545,20419357,20419357,20420846,0,0,0,1489
16277,20174661,20201613,20421782,0,0,26952,247121
16551,20422351,20422351,20422702,0,0,0,351
16553,20427140,20427140,20427244,0,0,0,104
16554,20427246,20427246,20427364,0,0,0,118
16550,20421966,20421966,20427982,0,0,0,6016
16556,20429333,20429333,20429468,0,0,0,135
16529,20373858,20373858,20429854,0,0,0,55996
16552,20423318,20423318,20429966,0,0,0,6648
16548,20420778,20420778,20430885,0,0,0,10107
16547,20420757,20420757,20431051,0,0,0,10294
16562,20431006,20431006,20431066,0,0,0,60
16549,20420800,20420800,20431071,0,0,0,10271
16250,20172950,20172950,20432083,0,0,0,259133
16255,20173376,20173376,20432576,0,0,0,259200
16257,20173396,20173396,20432596,0,0,0,259200
16259,20173420,20173420,20432620,0,0,0,259200
16565,20434120,20434120,20434240,0,0,0,120
16555,20427418,20427418,20436168,0,0,0,8750
16563,20431221,20431221,20437001,0,0,0,5780
16569,20436995,20436995,20437237,0,0,0,242
16557,20430018,20430018,20438067,0,0,0,8049
16572,20438925,20438925,20438989,0,0,0,64
16573,20439122,20439122,20439200,0,0,0,78
16574,20439217,20439217,20439287,0,0,0,70
16575,20439249,20439249,20439300,0,0,0,51
16576,20439299,20439299,20439366,0,0,0,67
16577,20439367,20439367,20439425,0,0,0,58
16578,20439424,20439424,20439486,0,0,0,62
16579,20439456,20439456,20439536,0,0,0,80
16580,20439463,20439463,20439543,0,0,0,80
16581,20439689,20439689,20439744,0,0,0,55
16301,20178410,20180594,20439748,0,0,2184,261338
16582,20439698,20439698,20439767,0,0,0,69
16571,20438023,20438023,20439872,0,0,0,1849
16583,20439782,20439782,20439901,0,0,0,119
16546,20420338,20420338,20440015,0,0,0,19677
16585,20439904,20439904,20440016,0,0,0,112
16592,20439907,20439907,20440025,0,0,0,118
16593,20439907,20439907,20440025,0,0,0,118
16594,20439907,20439907,20440025,0,0,0,118
16596,20439908,20439908,20440026,0,0,0,118
16597,20439908,20439908,20440026,0,0,0,118
16587,20439906,20439906,20440030,0,0,0,124
16588,20439906,20439906,20440030,0,0,0,124
16589,20439906,20439906,20440030,0,0,0,124
16591,20439907,20439907,20440031,0,0,0,124
16595,20439907,20439907,20440036,0,0,0,129
16604,20439910,20439910,20440038,0,0,0,128
16598,20439908,20439908,20440045,0,0,0,137
16599,20439908,20439908,20440045,0,0,0,137
16600,20439909,20439909,20440046,0,0,0,137
16601,20439909,20439909,20440046,0,0,0,137
16602,20439909,20439909,20440048,0,0,0,139
16603,20439909,20439909,20440048,0,0,0,139
16586,20439905,20439905,20440060,0,0,0,155
16590,20439906,20439906,20440061,0,0,0,155
16608,20441290,20441290,20441406,0,0,0,116
16609,20441538,20441538,20441611,0,0,0,73
16610,20441696,20441696,20441836,0,0,0,140
16584,20439868,20439868,20442119,0,0,0,2251
16612,20442374,20442374,20442513,0,0,0,139
16618,20442637,20442637,20442730,0,0,0,93
16617,20442636,20442636,20442751,0,0,0,115
16615,20442634,20442634,20442757,0,0,0,123
16616,20442635,20442635,20442761,0,0,0,126
16619,20442638,20442638,20442768,0,0,0,130
16605,20439975,20439975,20443150,0,0,0,3175
16561,20430865,20430865,20443353,0,0,0,12488
16621,20443329,20443329,20444006,0,0,0,677
16620,20442829,20442829,20444060,0,0,0,1231
16570,20437279,20437279,20447934,0,0,0,10655
16613,20442406,20442406,20450450,0,0,0,8044
16614,20442501,20442501,20450546,0,0,0,8045
16611,20442347,20442347,20451314,0,0,0,8967
16661,20451374,20451374,20452243,0,0,0,869
16667,20452267,20452267,20452349,0,0,0,82
16664,20451505,20451505,20452444,0,0,0,939
16665,20451509,20451509,20452490,0,0,0,981
16666,20451513,20451513,20452556,0,0,0,1043
16662,20451387,20451387,20452565,0,0,0,1178
16663,20451399,20451399,20452630,0,0,0,1231
16558,20430116,20430116,20453220,0,0,0,23104
16560,20430770,20430770,20453220,0,0,0,22450
16530,20414457,20414457,20456877,0,0,0,42420
16531,20415895,20415895,20459278,0,0,0,43383
16623,20444155,20444155,20460991,0,0,0,16836
16606,20440204,20440204,20461177,0,0,0,20973
16559,20430367,20430367,20461748,0,0,0,31381
16566,20434373,20434373,20461786,0,0,0,27413
16564,20433252,20433252,20461791,0,0,0,28539
16668,20452331,20452331,20476153,0,0,0,23822
16625,20449213,20449213,20501285,0,0,0,52072
16626,20449213,20449213,20502208,0,0,0,52995
16627,20449213,20449213,20502332,0,0,0,53119
16628,20449213,20449213,20502456,0,0,0,53243
16629,20449214,20449214,20502457,0,0,0,53243
16645,20451104,20451104,20502835,0,0,0,51731
16643,20451102,20451102,20502895,0,0,0,51793
16630,20449214,20449214,20503232,0,0,0,54018
16631,20449214,20449214,20503232,0,0,0,54018
16646,20451104,20451104,20503269,0,0,0,52165
16649,20451105,20451105,20503449,0,0,0,52344
16650,20451105,20451105,20503480,0,0,0,52375
16632,20449214,20449214,20503491,0,0,0,54277
16651,20451105,20451105,20503511,0,0,0,52406
16644,20451103,20451103,20503788,0,0,0,52685
16647,20451104,20451104,20504440,0,0,0,53336
16633,20449214,20449214,20504638,0,0,0,55424
16634,20451077,20451077,20506959,0,0,0,55882
16635,20451078,20451078,20506960,0,0,0,55882
16642,20451080,20451080,20507086,0,0,0,56006
16636,20451078,20451078,20507766,0,0,0,56688
16672,20507882,20507882,20507995,0,0,0,113
16638,20451079,20451079,20508232,0,0,0,57153
16622,20443677,20443677,20508369,0,0,0,64692
16669,20453144,20453144,20508444,0,0,0,55300
16637,20451078,20451078,20508510,0,0,0,57432
16567,20434881,20434881,20508683,0,0,0,73802
16607,20440302,20440302,20508683,0,0,0,68381
16538,20418342,20418342,20508697,0,0,0,90355
16568,20436198,20436198,20508697,0,0,0,72499
16624,20444959,20444959,20508698,0,0,0,63739
16639,20451079,20451079,20508728,0,0,0,57649
16640,20451079,20451079,20508770,0,0,0,57691
16652,20451148,20451148,20509304,0,0,0,58156
16658,20451150,20451150,20509399,0,0,0,58249
16654,20451149,20451149,20509646,0,0,0,58497
16659,20451150,20451150,20509709,0,0,0,58559
16655,20451149,20451149,20510576,0,0,0,59427
16660,20451150,20451150,20510942,0,0,0,59792
16656,20451149,20451149,20511654,0,0,0,60505
16641,20451079,20451079,20513314,0,0,0,62235
16657,20451149,20451149,20513817,0,0,0,62668
16653,20451148,20451148,20513847,0,0,0,62699
16670,20453162,20453162,20516244,0,0,0,63082
16671,20453385,20453385,20516564,0,0,0,63179
16687,20532926,20532926,20534509,0,0,0,1583
16688,20532961,20532961,20534589,0,0,0,1628
16683,20532613,20532613,20534659,0,0,0,2046
16684,20532677,20532677,20534759,0,0,0,2082
16685,20532723,20532723,20534794,0,0,0,2071
16686,20532762,20532762,20534802,0,0,0,2040
16700,20535826,20535826,20535920,0,0,0,94
16701,20535846,20535846,20535924,0,0,0,78
16689,20532969,20534509,20536224,0,0,1540,3255
16702,20536100,20536100,20536426,0,0,0,326
16704,20536538,20536538,20536590,0,0,0,52
16705,20536545,20536545,20536597,0,0,0,52
16648,20451104,20451104,20537504,0,0,0,86400
16723,20554674,20554674,20554721,0,0,0,47
16690,20533554,20533554,20554832,0,0,0,21278
16703,20536230,20554832,20554936,0,0,18602,18706
16724,20554765,20554765,20555111,0,0,0,346
16699,20535196,20535196,20555607,0,0,0,20411
16725,20563148,20563148,20563314,0,0,0,166
16726,20563530,20563530,20563654,0,0,0,124
16727,20563655,20563655,20564235,0,0,0,580
16736,20595796,20595796,20595968,0,0,0,172
16691,20534470,20534589,20598071,0,0,119,63601
16692,20534601,20534659,20598085,0,0,58,63484
16694,20534668,20534794,20598146,0,0,126,63478
16718,20544140,20598146,20598250,0,0,54006,54110
16740,20598215,20598215,20598293,0,0,0,78
16719,20544212,20598250,20598405,0,0,54038,54193
16720,20544432,20598405,20598529,0,0,53973,54097
16698,20534804,20598071,20598692,0,0,63267,63888
16721,20544629,20598529,20598808,0,0,53900,54179
16722,20544999,20598692,20599127,0,0,53693,54128
16730,20593418,20599127,20599247,0,0,5709,5829
16758,20599501,20599501,20599579,0,0,0,78
16759,20599613,20599613,20599680,0,0,0,67
16697,20534795,20536224,20600072,0,0,1429,65277
16761,20600096,20600096,20600179,0,0,0,83
16760,20600085,20600085,20600184,0,0,0,99
16763,20600182,20600182,20600229,0,0,0,47
16764,20600226,20600226,20600521,0,0,0,295
16762,20600107,20600107,20600919,0,0,0,812
16780,20602915,20602915,20603174,0,0,0,259
16693,20534633,20534759,20603364,0,0,126,68731
16783,20603890,20603890,20603957,0,0,0,67
16782,20603874,20603874,20603988,0,0,0,114
16787,20605092,20605092,20605283,0,0,0,191
16788,20605510,20605510,20605608,0,0,0,98
16789,20605901,20605901,20605968,0,0,0,67
16790,20606061,20606061,20606263,0,0,0,202
16792,20607017,20607017,20607250,0,0,0,233
16793,20607250,20607250,20607349,0,0,0,99
16794,20607354,20607354,20607547,0,0,0,193
16791,20606313,20606313,20607820,0,0,0,1507
16799,20607874,20607874,20607976,0,0,0,102
16781,20602981,20602981,20608197,0,0,0,5216
16784,20604696,20608197,20608625,0,0,3501,3929
16786,20605007,20608625,20608932,0,0,3618,3925
16796,20607555,20608932,20609274,0,0,1377,1719
16797,20607645,20609274,20609449,0,0,1629,1804
16800,20607945,20607976,20609502,0,0,31,1557
16802,20608900,20608900,20610436,0,0,0,1536
16807,20611314,20611314,20611413,0,0,0,99
16808,20611416,20611416,20611488,0,0,0,72
16809,20611472,20611472,20611559,0,0,0,87
16811,20611605,20611605,20611672,0,0,0,67
16805,20609939,20609939,20611751,0,0,0,1812
16814,20612184,20612184,20612282,0,0,0,98
16813,20612171,20612171,20612286,0,0,0,115
16815,20612850,20612850,20612922,0,0,0,72
16801,20608627,20609449,20613027,0,0,822,4400
16695,20534766,20534802,20614326,0,0,36,79560
16743,20599230,20614326,20614433,0,0,15096,15203
16744,20599231,20614433,20614537,0,0,15202,15306
16745,20599231,20614537,20614677,0,0,15306,15446
16785,20604921,20614326,20614747,0,0,9405,9826
16746,20599232,20614677,20614817,0,0,15445,15585
16747,20599233,20614817,20614910,0,0,15584,15677
16748,20599325,20614910,20615003,0,0,15585,15678
16749,20599326,20615003,20615112,0,0,15677,15786
16810,20611496,20614747,20615188,0,0,3251,3692
16750,20599327,20615112,20615221,0,0,15785,15894
16751,20599328,20615221,20615330,0,0,15893,16002
16752,20599329,20615330,20615439,0,0,16001,16110
16753,20599366,20615439,20615548,0,0,16073,16182
16812,20611719,20615188,20615592,0,0,3469,3873
16754,20599367,20615548,20615657,0,0,16181,16290
16755,20599368,20615657,20615766,0,0,16289,16398
16756,20599369,20615766,20615875,0,0,16397,16506
16757,20599369,20615875,20615999,0,0,16506,16630
16822,20616001,20616001,20616328,0,0,0,327
16765,20600310,20615999,20616371,0,0,15689,16061
16823,20616034,20616034,20616371,0,0,0,337
16766,20600311,20616371,20616743,0,0,16060,16432
16767,20600312,20616743,20617115,0,0,16431,16803
16816,20613501,20615592,20617129,0,0,2091,3628
16732,20594204,20599247,20617247,0,0,5043,23043
16768,20600312,20617115,20617487,0,0,16803,17175
16769,20600313,20617487,20617849,0,0,17174,17536
16770,20600338,20617849,20618221,0,0,17511,17883
16771,20600339,20618221,20618585,0,0,17882,18246
16826,20618604,20618604,20618697,0,0,0,93
16827,20618765,20618765,20618812,0,0,0,47
16829,20618765,20618765,20618843,0,0,0,78
16832,20618766,20618766,20618859,0,0,0,93
16833,20618766,20618843,20618936,0,0,77,170
16772,20600340,20618585,20618963,0,0,18245,18623
16773,20600340,20618963,20619366,0,0,18623,19026
16774,20600341,20619366,20619738,0,0,19025,19397
16775,20600356,20619738,20620141,0,0,19382,19785
16729,20593164,20598808,20620540,0,0,5644,27376
16776,20600358,20620141,20620544,0,0,19783,20186
16777,20600359,20620540,20620943,0,0,20181,20584
16779,20600361,20620544,20620947,0,0,20183,20586
16778,20600360,20620540,20620974,0,0,20180,20614
16828,20618765,20620947,20621025,0,0,2182,2260
16798,20607695,20620943,20621543,0,0,13248,13848
16821,20614389,20617129,20623355,0,0,2740,8966
16825,20617057,20617057,20623695,0,0,0,6638
16731,20594131,20603364,20625782,0,0,9233,31651
16834,20618766,20625782,20625875,0,0,7016,7109
16733,20594822,20600072,20625885,0,0,5250,31063
16843,20626698,20626698,20626766,0,0,0,68
16844,20627171,20627171,20627260,0,0,0,89
16845,20627179,20627179,20627268,0,0,0,89
16846,20627190,20627190,20627289,0,0,0,99
16848,20627211,20627211,20627289,0,0,0,78
16847,20627199,20627199,20627298,0,0,0,99
16851,20627342,20627342,20627415,0,0,0,73
16850,20627329,20627329,20627418,0,0,0,89
16853,20627366,20627366,20627418,0,0,0,52
16852,20627349,20627349,20627422,0,0,0,73
16849,20627320,20627320,20627425,0,0,0,105
16854,20627379,20627379,20627446,0,0,0,67
16855,20627658,20627658,20627716,0,0,0,58
16856,20627685,20627685,20627750,0,0,0,65
16857,20627705,20627705,20627931,0,0,0,226
16858,20627714,20627931,20628146,0,0,217,432
16859,20627722,20628146,20628443,0,0,424,721
16860,20627729,20628443,20628636,0,0,714,907
16861,20627748,20628636,20629035,0,0,888,1287
16870,20629672,20629672,20629776,0,0,0,104
16872,20629693,20629693,20629776,0,0,0,83
16871,20629678,20629678,20629782,0,0,0,104
16873,20629700,20629700,20629783,0,0,0,83
16869,20629659,20629659,20629810,0,0,0,151
16874,20629855,20629855,20630093,0,0,0,238
16875,20629869,20629869,20630195,0,0,0,326
16862,20627765,20629035,20630584,0,0,1270,2819
16881,20630614,20630614,20630666,0,0,0,52
16880,20630601,20630601,20630669,0,0,0,68
16879,20630587,20630587,20630672,0,0,0,85
16882,20630625,20630625,20630692,0,0,0,67
16890,20631204,20631204,20631251,0,0,0,47
16892,20631506,20631506,20631573,0,0,0,67
16863,20627824,20630584,20632668,0,0,2760,4844
16864,20627864,20632668,20634772,0,0,4804,6908
16734,20594909,20614326,20636679,0,0,19417,41770
16867,20628964,20636679,20636759,0,0,7715,7795
16735,20594932,20614326,20636817,0,0,19394,41885
16868,20628973,20636759,20636839,0,0,7786,7866
16865,20627901,20634772,20636876,0,0,6871,8975
16883,20630829,20636817,20637244,0,0,5988,6415
16885,20630850,20636817,20637253,0,0,5967,6403
16884,20630839,20636817,20637264,0,0,5978,6425
16886,20630858,20636839,20637264,0,0,5981,6406
16893,20631715,20636876,20637372,0,0,5161,5657
16682,20532394,20532394,20640605,0,0,0,108211
16824,20616873,20623355,20644611,0,0,6482,27738
16900,20642770,20644611,20644715,0,0,1841,1945
16899,20642464,20644611,20644736,0,0,2147,2272
16901,20642887,20644715,20644839,0,0,1828,1952
16902,20643010,20644736,20644851,0,0,1726,1841
16904,20644589,20644851,20644975,0,0,262,386
16903,20643066,20644839,20644994,0,0,1773,1928
16907,20646687,20646687,20646822,0,0,0,135
16909,20647281,20647281,20647405,0,0,0,124
16910,20647506,20647506,20647639,0,0,0,133
16681,20532339,20532339,20649409,0,0,0,117070
16738,20598077,20649409,20650072,0,0,51332,51995
16739,20598086,20650072,20653718,0,0,51986,55632
16795,20607460,20649409,20654287,0,0,41949,46827
16737,20598066,20640605,20656250,0,0,42539,58184
16819,20614318,20654287,20657064,0,0,39969,42746
16877,20630346,20657064,20657138,0,0,26718,26792
16741,20598673,20653718,20659493,0,0,55045,60820
16896,20633683,20657138,20660687,0,0,23455,27004
16803,20609366,20659493,20661330,0,0,50127,51964
16742,20598684,20656250,20661994,0,0,57566,63310
16804,20609420,20661330,20664371,0,0,51910,54951
16897,20637462,20660687,20664462,0,0,23225,27000
16898,20641360,20664462,20667785,0,0,23102,26425
16905,20645246,20667785,20668188,0,0,22539,22942
16906,20645697,20668188,20670074,0,0,22491,24377
16911,20647543,20670074,20673260,0,0,22531,25717
16837,20620563,20620974,20674235,0,0,411,53672
16835,20618766,20674235,20674328,0,0,55469,55562
16914,20677594,20677594,20677889,0,0,0,295
16806,20611300,20661994,20678622,0,0,50694,67322
16916,20678845,20678845,20678912,0,0,0,67
16915,20677897,20677897,20679065,0,0,0,1168
16817,20614292,20664371,20679201,0,0,50079,64909
16923,20680796,20680796,20681070,0,0,0,274
16924,20680810,20680810,20681148,0,0,0,338
16925,20680845,20681070,20681439,0,0,225,594
16927,20681070,20681070,20681771,0,0,0,701
16937,20682297,20682297,20682369,0,0,0,72
16935,20682297,20682297,20682379,0,0,0,82
16936,20682297,20682297,20682379,0,0,0,82
16934,20682291,20682291,20682386,0,0,0,95
16940,20682322,20682322,20682394,0,0,0,72
16941,20682323,20682323,20682405,0,0,0,82
16942,20682323,20682323,20682405,0,0,0,82
16943,20682323,20682323,20682421,0,0,0,98
16938,20682322,20682322,20682425,0,0,0,103
16939,20682322,20682322,20682425,0,0,0,103
16945,20682907,20682907,20683442,0,0,0,535
16818,20614305,20678622,20684082,0,0,64317,69777
16950,20684709,20684709,20684861,0,0,0,152
16952,20685332,20685332,20685430,0,0,0,98
16954,20686105,20686105,20686172,0,0,0,67
16955,20686335,20686335,20686402,0,0,0,67
16956,20686493,20686493,20686577,0,0,0,84
16957,20686535,20686535,20686631,0,0,0,96
16959,20686576,20686576,20686685,0,0,0,109
16960,20686617,20686617,20686686,0,0,0,69
16961,20686649,20686649,20686717,0,0,0,68
16964,20687616,20687616,20688317,0,0,0,701
16895,20633161,20674328,20688810,0,0,41167,55649
16965,20688710,20688810,20688903,0,0,100,193
16931,20681569,20688810,20688945,0,0,7241,7376
16932,20682052,20688945,20689100,0,0,6893,7048
16930,20681507,20688810,20689348,0,0,7303,7841
16908,20647105,20647105,20689463,0,0,0,42358
16944,20682597,20689348,20689472,0,0,6751,6875
16967,20689425,20689425,20689518,0,0,0,93
16946,20683140,20689472,20689577,0,0,6332,6437
16947,20683306,20689577,20689712,0,0,6271,6406
16948,20683871,20689712,20689765,0,0,5841,5894
16949,20683883,20689765,20689900,0,0,5882,6017
16974,20690216,20690216,20690328,0,0,0,112
16976,20690760,20690760,20690817,0,0,0,57
16951,20685180,20689900,20690892,0,0,4720,5712
16958,20686551,20690892,20691053,0,0,4341,4502
16977,20690781,20690781,20691100,0,0,0,319
16962,20686910,20691053,20691226,0,0,4143,4316
16963,20687123,20691226,20691967,0,0,4103,4844
16966,20688957,20691967,20692567,0,0,3010,3610
16978,20690861,20692567,20692661,0,0,1706,1800
16820,20614329,20679201,20693021,0,0,64872,78692
16987,20692942,20692942,20693041,0,0,0,99
16891,20631291,20636839,20693134,0,0,5548,61843
16836,20619632,20684082,20693155,0,0,64450,73523
16988,20693269,20693269,20693367,0,0,0,98
16991,20693871,20693871,20693954,0,0,0,83
16992,20694053,20694053,20694100,0,0,0,47
16917,20679092,20688810,20694531,0,0,9718,15439
16842,20623496,20693021,20695161,0,0,69525,71665
16866,20628948,20693155,20695184,0,0,64207,66236
16840,20621100,20621100,20695206,0,0,0,74106
16876,20630170,20695161,20695215,0,0,64991,65045
17004,20696605,20696605,20696745,0,0,0,140
16878,20630383,20695184,20696799,0,0,64801,66416
17002,20695145,20695206,20697084,0,0,61,1939
17005,20697213,20697213,20697306,0,0,0,93
17006,20697328,20697328,20697421,0,0,0,93
17007,20697420,20697420,20697546,0,0,0,126
17008,20697502,20697502,20697637,0,0,0,135
17009,20697635,20697637,20697772,0,0,2,137
16918,20679542,20688810,20698189,0,0,9268,18647
17010,20698063,20698063,20698218,0,0,0,155
17012,20699610,20699610,20699724,0,0,0,114
17013,20699680,20699680,20699727,0,0,0,47
17016,20699886,20699886,20699933,0,0,0,47
16680,20532335,20532335,20700326,0,0,0,167991
16933,20682055,20689100,20701448,0,0,7045,19393
17028,20704204,20704204,20704260,0,0,0,56
17029,20704358,20704358,20704441,0,0,0,83
17030,20705167,20705167,20705637,0,0,0,470
17033,20708633,20708633,20708804,0,0,0,171
17034,20708804,20708804,20708955,0,0,0,151
17035,20708961,20708961,20709029,0,0,0,68
16894,20633048,20695215,20709839,0,0,62167,76791
16953,20685481,20700326,20714360,0,0,14845,28879
16676,20532303,20532303,20715171,0,0,0,182868
16995,20694491,20715171,20715264,0,0,20680,20773
16994,20694480,20715171,20715280,0,0,20691,20800
16997,20694694,20715171,20715288,0,0,20477,20594
17001,20694920,20715171,20715295,0,0,20251,20375
16996,20694632,20715171,20715297,0,0,20539,20665
17036,20709031,20709031,20715358,0,0,0,6327
17003,20696326,20715280,20715373,0,0,18954,19047
17014,20699751,20715295,20715402,0,0,15544,15651
17018,20699997,20715297,20715433,0,0,15300,15436
17040,20715440,20715440,20715507,0,0,0,67
17015,20699826,20715288,20715521,0,0,15462,15695
17000,20694768,20715171,20715538,0,0,20403,20770
17041,20715713,20715713,20715780,0,0,0,67
17046,20716125,20716125,20716376,0,0,0,251
17047,20716355,20716376,20717219,0,0,21,864
17042,20715794,20715794,20717244,0,0,0,1450
17052,20717018,20717244,20717306,0,0,226,288
17050,20716946,20717219,20717315,0,0,273,369
17053,20717019,20717306,20717368,0,0,287,349
17054,20717020,20717315,20717377,0,0,295,357
17055,20717037,20717368,20717435,0,0,331,398
17057,20717275,20717435,20717488,0,0,160,213
17058,20717302,20717488,20717556,0,0,186,254
17059,20717416,20717556,20717809,0,0,140,393
17060,20717428,20717809,20718082,0,0,381,654
16970,20689876,20692567,20719132,0,0,2691,29256
16982,20692044,20698218,20719138,0,0,6174,27094
16973,20689904,20693134,20719165,0,0,3230,29261
16971,20689885,20692567,20719256,0,0,2682,29371
16980,20692020,20695206,20719264,0,0,3186,27244
16972,20689894,20693134,20719400,0,0,3240,29506
16969,20689867,20689867,20719820,0,0,0,29953
16968,20689857,20689857,20720422,0,0,0,30565
17021,20700656,20715402,20721491,0,0,14746,20835
16975,20690335,20714360,20721560,0,0,24025,31225
17022,20702868,20721560,20721653,0,0,18692,18785
16984,20692079,20701448,20721953,0,0,9369,29874
16981,20692031,20698189,20722232,0,0,6158,30201
16919,20679608,20709839,20724999,0,0,30231,45391
17066,20724936,20724936,20725446,0,0,0,510
17067,20725349,20725349,20725695,0,0,0,346
17062,20717646,20718082,20728159,0,0,436,10513
16979,20690975,20694531,20731001,0,0,3556,40026
17024,20703103,20722232,20732212,0,0,19129,29109
16913,20647611,20700326,20732336,0,0,52715,84725
16985,20692199,20714360,20735322,0,0,22161,43123
17037,20713500,20715521,20736060,0,0,2021,22560
17032,20707316,20715402,20736437,0,0,8086,29121
17038,20713898,20715538,20736474,0,0,1640,22576
17023,20702979,20721653,20736624,0,0,18674,33645
16921,20680247,20724999,20739565,0,0,44752,59318
16989,20693785,20739565,20739669,0,0,45780,45884
16990,20693786,20739669,20739762,0,0,45883,45976
17039,20713955,20719132,20740078,0,0,5177,26123
16922,20680317,20732336,20741484,0,0,52019,61167
16912,20647590,20696799,20742197,0,0,49209,94607
17044,20716014,20719165,20743426,0,0,3151,27412
17051,20717010,20719820,20743896,0,0,2810,26886
16983,20692071,20701448,20744648,0,0,9377,52577
17043,20715881,20719138,20745422,0,0,3257,29541
17048,20716382,20719264,20745649,0,0,2882,29267
17045,20716109,20719256,20745686,0,0,3147,29577
17049,20716509,20719400,20745799,0,0,2891,29290
17020,20700639,20732212,20746472,0,0,31573,45833
17056,20717227,20717377,20747528,0,0,150,30301
16998,20694707,20739762,20748891,0,0,45055,54184
17063,20717670,20720422,20751208,0,0,2752,33538
17065,20720360,20721560,20751701,0,0,1200,31341
17068,20733980,20735322,20755952,0,0,1342,21972
17069,20734771,20736060,20757122,0,0,1289,22351
17070,20734840,20736474,20757389,0,0,1634,22549
16993,20694354,20715171,20758371,0,0,20817,64017
17081,20760257,20760257,20760368,0,0,0,111
17082,20760302,20760368,20760484,0,0,66,182
17085,20760368,20760368,20760581,0,0,0,213
17083,20760349,20760349,20760682,0,0,0,333
17087,20762621,20762621,20762688,0,0,0,67
17088,20762718,20762718,20762834,0,0,0,116
17091,20762797,20762797,20762875,0,0,0,78
17071,20740206,20740206,20764383,0,0,0,24177
17064,20719774,20721491,20764691,0,0,1717,44917
17072,20741023,20741023,20765210,0,0,0,24187
16675,20532295,20532295,20767186,0,0,0,234891
16920,20679949,20679949,20768444,0,0,0,88495
17073,20742102,20742102,20768674,0,0,0,26572
17074,20742496,20742496,20769469,0,0,0,26973
17075,20742723,20743426,20770398,0,0,703,27675
17076,20742854,20743896,20771308,0,0,1042,28454
17084,20760350,20760484,20771527,0,0,134,11177
16674,20532290,20532290,20771940,0,0,0,239650
17093,20762936,20767186,20773039,0,0,4250,10103
17017,20699946,20715373,20773285,0,0,15427,73339
17011,20698942,20715264,20775646,0,0,16322,76704
17078,20754570,20754570,20775669,0,0,0,21099
17115,20776051,20776051,20777255,0,0,0,1204
17079,20755715,20755952,20777523,0,0,237,21808
17120,20777539,20777539,20777601,0,0,0,62
17086,20760376,20767186,20778466,0,0,6810,18090
17080,20755770,20757122,20778609,0,0,1352,22839
17077,20750438,20751208,20781640,0,0,770,31202
17126,20782068,20782068,20782173,0,0,0,105
17125,20781971,20781971,20782235,0,0,0,264
17128,20782742,20782742,20782991,0,0,0,249
17089,20762747,20764383,20784243,0,0,1636,21496
17101,20769496,20769496,20784939,0,0,0,15443
17092,20762837,20767186,20787144,0,0,4349,24307
17094,20764323,20764691,20789226,0,0,368,24903
17095,20765145,20765210,20789786,0,0,65,24641
16673,20531893,20531893,20791093,0,0,0,259200
16677,20532306,20532306,20791506,0,0,0,259200
16678,20532326,20532326,20791526,0,0,0,259200
16679,20532332,20532332,20791532,0,0,0,259200
17139,20788131,20791532,20791605,0,0,3401,3474
17135,20787646,20791532,20791658,0,0,3886,4012
17134,20787573,20791526,20791692,0,0,3953,4119
17136,20787670,20791692,20791835,0,0,4022,4165
17152,20792163,20792163,20792270,0,0,0,107
16696,20534772,20534772,20792522,0,0,0,257750
16839,20620932,20621025,20792609,0,0,93,171677
17019,20700086,20715297,20792650,0,0,15211,92564
17155,20792554,20792609,20792702,0,0,55,148
17129,20784789,20787144,20793672,0,0,2355,8883
17157,20792763,20793672,20793770,0,0,909,1007
16887,20631118,20637253,20793851,0,0,6135,162733
17158,20792950,20793770,20793858,0,0,820,908
17147,20791617,20793851,20793926,0,0,2234,2309
17160,20793434,20793851,20793944,0,0,417,510
17025,20703986,20742197,20793949,0,0,38211,89963
16888,20631123,20637372,20793970,0,0,6249,162847
17162,20793951,20793951,20794024,0,0,0,73
17161,20793755,20793755,20794030,0,0,0,275
17163,20793959,20793959,20794052,0,0,0,93
17159,20793012,20794024,20794117,0,0,1012,1105
17026,20704023,20748891,20794136,0,0,44868,90113
17107,20775142,20793949,20794199,0,0,18807,19057
17164,20794110,20794110,20794203,0,0,0,93
17166,20794220,20794220,20794313,0,0,0,93
17112,20775752,20794199,20794314,0,0,18447,18562
17165,20794210,20794210,20794314,0,0,0,104
17167,20794345,20794345,20794418,0,0,0,73
17169,20794463,20794463,20794536,0,0,0,73
17170,20794604,20794604,20794708,0,0,0,104
17099,20768611,20768611,20794745,0,0,0,26134
17172,20794869,20794869,20794962,0,0,0,93
17140,20788234,20791605,20795205,0,0,3371,6971
17173,20795205,20795205,20795298,0,0,0,93
17174,20795423,20795423,20795516,0,0,0,93
17100,20769413,20769413,20795578,0,0,0,26165
17176,20795551,20795551,20795644,0,0,0,93
17109,20775367,20775367,20795855,0,0,0,20488
17178,20795823,20795823,20795916,0,0,0,93
17179,20795956,20795956,20796018,0,0,0,62
17180,20796069,20796069,20796166,0,0,0,97
17111,20775616,20775616,20796215,0,0,0,20599
17182,20796166,20796166,20796246,0,0,0,80
17102,20769636,20769636,20796247,0,0,0,26611
17184,20796292,20796292,20796385,0,0,0,93
17185,20796625,20796625,20796718,0,0,0,93
17186,20796721,20796721,20796794,0,0,0,73
17187,20796813,20796813,20796906,0,0,0,93
17188,20796907,20796907,20796980,0,0,0,73
17190,20797007,20797007,20797088,0,0,0,81
17191,20797057,20797057,20797134,0,0,0,77
17106,20770224,20770398,20797153,0,0,174,26929
17192,20797107,20797107,20797166,0,0,0,59
16889,20631133,20640605,20797203,0,0,9472,166070
17193,20797134,20797134,20797238,0,0,0,104
17194,20797231,20797231,20797336,0,0,0,105
17118,20777202,20777202,20798163,0,0,0,20961
17197,20797375,20798163,20798227,0,0,788,852
17200,20797460,20798163,20798256,0,0,703,796
17119,20777224,20777224,20798264,0,0,0,21040
17201,20797571,20798227,20798320,0,0,656,749
17202,20797678,20798256,20798349,0,0,578,671
17203,20797806,20798264,20798357,0,0,458,551
17205,20798162,20798349,20798450,0,0,187,288
17207,20798341,20798357,20798451,0,0,16,110
16841,20623125,20625875,20798675,0,0,2750,175550
17105,20770009,20770009,20799525,0,0,0,29516
17096,20765692,20791532,20801342,0,0,25840,35650
17103,20769745,20769745,20802020,0,0,0,32275
17104,20769799,20769799,20803136,0,0,0,33337
16999,20694715,20741484,20803204,0,0,46769,108489
17150,20792085,20792085,20803979,0,0,0,11894
17110,20775499,20794136,20804156,0,0,18637,28657
17209,20798711,20804156,20804249,0,0,5445,5538
17208,20798543,20804156,20804250,0,0,5613,5707
17210,20798826,20804156,20804250,0,0,5330,5424
17211,20798937,20804249,20804342,0,0,5312,5405
17228,20804602,20804602,20804649,0,0,0,47
17229,20804731,20804731,20804799,0,0,0,68
17108,20775311,20775311,20805317,0,0,0,30006
17117,20776663,20776663,20805463,0,0,0,28800
17138,20787857,20787857,20805958,0,0,0,18101
17027,20704028,20791526,20806946,0,0,87498,102918
16706,20537045,20554936,20807536,0,0,17891,270491
17154,20792262,20792262,20807637,0,0,0,15375
17145,20791255,20792522,20810522,0,0,1267,19267
17124,20780802,20780802,20811058,0,0,0,30256
17090,20762780,20767186,20811620,0,0,4406,48840
17141,20788818,20788818,20812870,0,0,0,24052
17144,20789658,20791658,20815744,0,0,2000,26086
17177,20795813,20795813,20816350,0,0,0,20537
17181,20796145,20796145,20816734,0,0,0,20589
17204,20798098,20798320,20819664,0,0,222,21566
17171,20794682,20794682,20820698,0,0,0,26016
17175,20795540,20795540,20821992,0,0,0,26452
17183,20796184,20796184,20822605,0,0,0,26421
16728,20564231,20564231,20823431,0,0,0,259200
17198,20797381,20798451,20823437,0,0,1070,26056
17189,20796924,20796924,20823451,0,0,0,26527
17206,20798179,20803979,20824985,0,0,5800,26806
17137,20787729,20791835,20825830,0,0,4106,38101
17156,20792704,20792704,20828704,0,0,0,36000
17199,20797407,20804156,20829192,0,0,6749,31785
17148,20791639,20793926,20831513,0,0,2287,39874
17151,20792159,20797203,20832085,0,0,5044,39926
17195,20797332,20797332,20833226,0,0,0,35894
17196,20797359,20797359,20833504,0,0,0,36145
17235,20816289,20816350,20837001,0,0,61,20712
17233,20812813,20812870,20837069,0,0,57,24256
17236,20816665,20816734,20837272,0,0,69,20607
17234,20813684,20815744,20839999,0,0,2060,26315
17237,20819549,20819664,20840573,0,0,115,21024
17232,20810998,20811620,20841521,0,0,622,30523
17238,20820487,20820698,20841633,0,0,211,21146
17230,20805254,20811620,20841710,0,0,6366,36456
17153,20792201,20798675,20843776,0,0,6474,51575
17239,20820656,20821992,20848296,0,0,1336,27640
17240,20821930,20822605,20848975,0,0,675,27045
17241,20823348,20823437,20850010,0,0,89,26662
16707,20537138,20598085,20850685,0,0,60947,313547
16708,20537174,20598085,20850685,0,0,60911,313511
16709,20537205,20598085,20850685,0,0,60880,313480
16710,20537333,20598146,20850746,0,0,60813,313413
16711,20537368,20598146,20850746,0,0,60778,313378
16712,20537406,20598692,20851292,0,0,61286,313886
16713,20537431,20598692,20851292,0,0,61261,313861
17242,20824626,20824626,20851466,0,0,0,26840
16714,20538748,20600072,20852672,0,0,61324,313924
16715,20538767,20600072,20852672,0,0,61305,313905
16830,20618765,20852672,20852765,0,0,233907,234000
17097,20766357,20771527,20854327,0,0,5170,87970
16716,20538785,20603364,20855964,0,0,64579,317179
16717,20538804,20603364,20855964,0,0,64560,317160
17031,20706865,20706865,20856832,0,0,0,149967
17244,20836939,20837001,20857636,0,0,62,20697
17246,20837206,20837272,20857957,0,0,66,20751
17098,20766386,20771940,20858340,0,0,5554,91954
17218,20799626,20805463,20859755,0,0,5837,60129
17220,20800000,20807536,20859879,0,0,7536,59879
16831,20618765,20859879,20859973,0,0,241114,241208
17219,20799922,20807536,20860622,0,0,7614,60700
17245,20837008,20837069,20861178,0,0,61,24170
17221,20800040,20807536,20861574,0,0,7496,61534
17248,20840455,20840573,20861590,0,0,118,21135
17222,20800073,20807536,20862549,0,0,7463,62476
17250,20841382,20841633,20862559,0,0,251,21177
17223,20800098,20807536,20863479,0,0,7438,63381
17247,20837947,20839999,20864064,0,0,2052,26117
17225,20800173,20810522,20864109,0,0,10349,63936
17226,20800198,20810522,20864361,0,0,10324,64163
17227,20800295,20811058,20865269,0,0,10763,64974
17243,20835344,20835344,20865568,0,0,0,30224
17263,20866604,20866604,20866698,0,0,0,94
17264,20866936,20866936,20867030,0,0,0,94
17265,20867721,20867721,20867814,0,0,0,93
17266,20867863,20867863,20867957,0,0,0,94
17267,20868234,20868234,20868307,0,0,0,73
17127,20782132,20782132,20868532,0,0,0,86400
17268,20868468,20868468,20868553,0,0,0,85
17269,20868492,20868492,20868598,0,0,0,106
17270,20868589,20868589,20868664,0,0,0,75
17271,20868729,20868729,20868844,0,0,0,115
17272,20868804,20868804,20868877,0,0,0,73
17273,20868891,20868891,20869015,0,0,0,124
17274,20869019,20869019,20869143,0,0,0,124
17275,20869802,20869802,20869884,0,0,0,82
17276,20869864,20869864,20869957,0,0,0,93
17224,20800155,20807637,20871526,0,0,7482,71371
17249,20840893,20841521,20871609,0,0,628,30716
17251,20846959,20846959,20873610,0,0,0,26651
17252,20848293,20848293,20874307,0,0,0,26014
17142,20789051,20789226,20875626,0,0,175,86575
17143,20789507,20789786,20876186,0,0,279,86679
17253,20849921,20849921,20876618,0,0,0,26697
17284,20877049,20877049,20877153,0,0,0,104
17285,20877483,20877483,20877700,0,0,0,217
17286,20877787,20877787,20877894,0,0,0,107
17287,20877832,20877832,20877926,0,0,0,94
17116,20776480,20803204,20877958,0,0,26724,101478
17255,20857512,20857512,20878006,0,0,0,20494
17289,20878069,20878069,20878162,0,0,0,93
17254,20851408,20851408,20878275,0,0,0,26867
17291,20878406,20878406,20878499,0,0,0,93
17256,20857825,20857825,20878549,0,0,0,20724
17293,20878510,20878510,20878614,0,0,0,104
17294,20878744,20878744,20879299,0,0,0,555
16838,20620583,20620583,20879783,0,0,0,259200
17295,20879235,20879235,20879784,0,0,0,549
17297,20880013,20880013,20880086,0,0,0,73
17296,20879738,20879738,20880087,0,0,0,349
17298,20880028,20880028,20880152,0,0,0,124
17299,20880634,20880634,20880711,0,0,0,77
17301,20880711,20880711,20880835,0,0,0,124
17300,20880657,20880657,20880866,0,0,0,209
17282,20875908,20875908,20882196,0,0,0,6288
17259,20861410,20861410,20882525,0,0,0,21115
17261,20862246,20862246,20883281,0,0,0,21035
17306,20883450,20883450,20883543,0,0,0,93
17257,20861076,20861076,20885079,0,0,0,24003
17307,20884617,20884617,20885217,0,0,0,600
17260,20861970,20861970,20885990,0,0,0,24020
17212,20799625,20804250,20890650,0,0,4625,91025
17213,20799625,20804250,20890650,0,0,4625,91025
17214,20799625,20804342,20890742,0,0,4717,91117
17215,20799625,20805317,20891717,0,0,5692,92092
17216,20799625,20805463,20891863,0,0,5838,92238
17217,20799625,20805463,20891863,0,0,5838,92238
17262,20865500,20865500,20895533,0,0,0,30033
17288,20877943,20877943,20898524,0,0,0,20581
17292,20878504,20878504,20899056,0,0,0,20552
17278,20873548,20873548,20899909,0,0,0,26361
17279,20874245,20874245,20900450,0,0,0,26205
17277,20870923,20870923,20901218,0,0,0,30295
17122,20780559,20791506,20902649,0,0,10947,122090
17283,20876556,20876556,20903236,0,0,0,26680
17304,20882480,20882480,20903461,0,0,0,20981
17305,20883217,20883217,20904313,0,0,0,21096
17290,20878231,20878231,20905003,0,0,0,26772
17308,20885019,20885019,20908841,0,0,0,23822
17309,20885928,20885928,20909789,0,0,0,23861
17123,20780579,20804156,20910252,0,0,23577,129673
17146,20791516,20828704,20918578,0,0,37188,127062
17311,20898462,20898462,20919024,0,0,0,20562
17312,20899021,20899021,20919501,0,0,0,20480
17133,20787515,20850746,20920131,0,0,63231,132616
17149,20791650,20793970,20923570,0,0,2320,131920
17317,20903404,20903404,20924215,0,0,0,20811
17318,20904271,20904271,20925299,0,0,0,21028
17310,20895470,20895470,20925428,0,0,0,29958
17313,20899846,20899846,20926109,0,0,0,26263
17314,20900395,20900395,20927456,0,0,0,27061
17328,20927393,20927393,20929245,0,0,0,1852
17316,20903170,20903170,20929930,0,0,0,26760
17315,20901153,20901153,20931331,0,0,0,30178
17319,20904939,20904939,20931587,0,0,0,26648
17320,20908778,20908778,20932846,0,0,0,24068
17321,20909727,20909727,20933743,0,0,0,24016
16986,20692650,20692650,20936151,0,0,0,243501
17322,20918962,20918962,20939608,0,0,0,20646
17113,20775929,20794314,20939725,0,0,18385,163796
17338,20939866,20939866,20939959,0,0,0,93
17323,20919438,20919438,20940035,0,0,0,20597
16926,20681014,20681148,20940348,0,0,134,259334
16928,20681077,20681439,20940639,0,0,362,259562
17340,20940281,20940281,20940808,0,0,0,527
17341,20940755,20940755,20940932,0,0,0,177
17342,20940900,20940900,20941500,0,0,0,600
17343,20943261,20943261,20943354,0,0,0,93
17344,20943376,20943376,20943501,0,0,0,125
17345,20944041,20944041,20944165,0,0,0,124
17346,20944386,20944386,20944521,0,0,0,135
17324,20924170,20924170,20945185,0,0,0,21015
17348,20945268,20945268,20945362,0,0,0,94
17349,20945422,20945422,20945526,0,0,0,104
17325,20925237,20925237,20946067,0,0,0,20830
17351,20946655,20946655,20946759,0,0,0,104
16929,20681144,20688810,20948010,0,0,7666,266866
17352,20948357,20948357,20948450,0,0,0,93
17353,20949033,20949033,20949633,0,0,0,600
17354,20949260,20949260,20950530,0,0,0,1270
17361,20950752,20950752,20950845,0,0,0,93
17362,20950925,20950925,20951029,0,0,0,104
17363,20950992,20950992,20951085,0,0,0,93
17302,20882122,20882122,20951505,0,0,0,69383
17280,20874954,20874954,20952165,0,0,0,77211
17327,20926045,20926045,20952237,0,0,0,26192
17281,20875024,20875024,20952514,0,0,0,77490
17329,20929200,20929200,20955349,0,0,0,26149
17326,20925388,20925388,20955662,0,0,0,30274
17367,20956376,20956376,20956480,0,0,0,104
17330,20929872,20929872,20956621,0,0,0,26749
17333,20932784,20932784,20956674,0,0,0,23890
17370,20956895,20956895,20957495,0,0,0,600
17334,20933700,20933700,20957612,0,0,0,23912
17332,20931529,20931529,20958157,0,0,0,26628
17357,20949522,20949522,20959708,0,0,0,10186
17356,20949480,20949480,20959887,0,0,0,10407
17337,20939541,20939541,20960262,0,0,0,20721
17339,20939973,20939973,20960495,0,0,0,20522
17331,20931268,20931268,20961122,0,0,0,29854
17114,20776048,20801342,20965605,0,0,25294,189557
17347,20945116,20945116,20966085,0,0,0,20969
17168,20794417,20794417,20967166,0,0,0,172749
17131,20787457,20833504,20967358,0,0,46047,179901
17350,20946007,20946007,20967371,0,0,0,21364
17377,20966895,20966895,20967495,0,0,0,600
17303,20882144,20882144,20968544,0,0,0,86400
17364,20952172,20952172,20978490,0,0,0,26318
17130,20785788,20806946,20979264,0,0,21158,193476
17369,20956615,20956615,20980351,0,0,0,23736
17373,20960193,20960193,20980803,0,0,0,20610
17374,20960423,20960423,20980983,0,0,0,20560
17365,20955305,20955305,20981216,0,0,0,25911
17371,20957549,20957549,20981328,0,0,0,23779
17368,20956558,20956558,20983218,0,0,0,26660
17372,20958094,20958094,20984390,0,0,0,26296
17366,20955588,20955588,20985473,0,0,0,29885
17132,20787474,20850685,20985680,0,0,63211,198206
17376,20966032,20966032,20987034,0,0,0,21002
17378,20967308,20967308,20988207,0,0,0,20899
17375,20961069,20961069,20991239,0,0,0,30170
17258,20861386,20861386,20995592,0,0,0,134206
17383,20980815,20980815,21001297,0,0,0,20482
17384,20980992,20980992,21001685,0,0,0,20693
17382,20980292,20980292,21003208,0,0,0,22916
17386,20981274,20981274,21003846,0,0,0,22572
17381,20978450,20978450,21004882,0,0,0,26432
17061,20717567,20746472,21005672,0,0,28905,288105
17385,20981155,20981155,21007342,0,0,0,26187
17360,20949880,20949880,21007508,0,0,0,57628
17390,20986972,20986972,21008131,0,0,0,21159
17391,20988228,20988228,21009204,0,0,0,20976
17387,20983153,20983153,21009853,0,0,0,26700
17388,20984346,20984346,21011253,0,0,0,26907
17389,20985399,20985399,21015093,0,0,0,29694
17359,20949857,20949857,21015885,0,0,0,66028
17396,21007701,21007701,21018294,0,0,0,10593
17392,20991239,20991239,21020743,0,0,0,29504
17358,20949834,20949834,21022104,0,0,0,72270
17402,21023714,21023714,21023774,0,0,0,60
17403,21024222,21024222,21024476,0,0,0,254
17409,21024945,21024945,21024992,0,0,0,47
17406,21024742,21024742,21024995,0,0,0,253
17408,21024932,21024932,21024995,0,0,0,63
17410,21024996,21024996,21025268,0,0,0,272
17393,21004805,21004805,21025451,0,0,0,20646
17405,21024731,21024731,21025652,0,0,0,921
17404,21024724,21024724,21026099,0,0,0,1375
17411,21025536,21025536,21026136,0,0,0,600
17395,21006100,21006100,21026733,0,0,0,20633
17418,21026312,21026312,21027284,0,0,0,972
17416,21026049,21026049,21027375,0,0,0,1326
17422,21027497,21027497,21027564,0,0,0,67
17415,21025988,21025988,21027723,0,0,0,1735
17417,21026294,21026294,21027748,0,0,0,1454
17423,21027669,21027669,21027790,0,0,0,121
17424,21027827,21027827,21027900,0,0,0,73
17414,21025856,21025856,21027969,0,0,0,2113
17430,21027971,21027971,21028050,0,0,0,79
17425,21027925,21027925,21028061,0,0,0,136
17426,21027931,21027931,21028067,0,0,0,136
17428,21027945,21027945,21028112,0,0,0,167
17431,21028019,21028019,21028129,0,0,0,110
17433,21028226,21028226,21028311,0,0,0,85
17412,21025834,21025834,21028405,0,0,0,2571
17413,21025847,21025847,21028418,0,0,0,2571
17434,21028374,21028374,21028447,0,0,0,73
17394,21006092,21006092,21028586,0,0,0,22494
17435,21028503,21028503,21028596,0,0,0,93
17436,21028667,21028667,21028743,0,0,0,76
17438,21028710,21028710,21028816,0,0,0,106
17444,21028922,21028922,21028995,0,0,0,73
17443,21028886,21028886,21029021,0,0,0,135
17446,21029198,21029198,21029513,0,0,0,315
17442,21028778,21028778,21030419,0,0,0,1641
17441,21028773,21028773,21030706,0,0,0,1933
17440,21028763,21028763,21030707,0,0,0,1944
17455,21030921,21030921,21030988,0,0,0,67
17400,21020838,21020838,21031298,0,0,0,10460
17432,21028067,21028067,21031563,0,0,0,3496
17401,21021475,21021475,21032115,0,0,0,10640
17454,21030767,21030767,21032298,0,0,0,1531
17397,21010770,21010770,21033222,0,0,0,22452
17458,21033986,21033986,21034070,0,0,0,84
17460,21034261,21034261,21034348,0,0,0,87
17461,21034317,21034317,21034410,0,0,0,93
17462,21034468,21034468,21034572,0,0,0,104
17463,21034595,21034595,21034733,0,0,0,138
17464,21034703,21034703,21035159,0,0,0,456
17466,21035127,21035127,21035313,0,0,0,186
17467,21035450,21035450,21035606,0,0,0,156
17459,21033987,21033987,21035756,0,0,0,1769
17469,21035797,21035797,21036119,0,0,0,322
17470,21036077,21036077,21036502,0,0,0,425
17472,21036464,21036464,21036753,0,0,0,289
17477,21036761,21036761,21036958,0,0,0,197
17478,21036936,21036936,21037102,0,0,0,166
17476,21036717,21036717,21037133,0,0,0,416
17480,21037153,21037153,21037496,0,0,0,343
17483,21037443,21037443,21037508,0,0,0,65
17468,21035783,21035783,21037716,0,0,0,1933
17485,21037482,21037482,21038082,0,0,0,600
17473,21036503,21036503,21038341,0,0,0,1838
17421,21027293,21027293,21038873,0,0,0,11580
17398,21013174,21013174,21039492,0,0,0,26318
17487,21037669,21037716,21039664,0,0,47,1995
17493,21040340,21040340,21040475,0,0,0,135
17488,21038743,21038743,21040627,0,0,0,1884
17448,21030421,21030421,21041091,0,0,0,10670
17447,21030320,21030320,21041139,0,0,0,10819
17450,21030492,21030492,21041173,0,0,0,10681
17449,21030477,21030477,21041189,0,0,0,10712
17498,21041148,21041173,21041302,0,0,25,154
17501,21041242,21041242,21041320,0,0,0,78
17452,21030670,21030670,21041380,0,0,0,10710
17451,21030637,21030637,21041390,0,0,0,10753
17505,21041344,21041380,21041442,0,0,36,98
17491,21039559,21039559,21041515,0,0,0,1956
17508,21041470,21041470,21041566,0,0,0,96
17509,21041569,21041569,21041688,0,0,0,119
17502,21041325,21041325,21041809,0,0,0,484
17506,21041416,21041416,21041843,0,0,0,427
17453,21030737,21030737,21041869,0,0,0,11132
17510,21041687,21041687,21041968,0,0,0,281
17511,21041943,21041943,21042006,0,0,0,63
17499,21041172,21041809,21042014,0,0,637,842
17512,21041950,21042006,21042069,0,0,56,119
17513,21041955,21042069,21042132,0,0,114,177
17514,21042760,21042760,21043191,0,0,0,431
17518,21043007,21043007,21043280,0,0,0,273
17507,21041441,21041441,21043356,0,0,0,1915
17121,20780555,20784243,21043443,0,0,3688,262888
17520,21043496,21043496,21043563,0,0,0,67
17521,21043613,21043613,21044027,0,0,0,414
17399,21017932,21017932,21044859,0,0,0,26927
17527,21044865,21044865,21044974,0,0,0,109
17525,21044779,21044859,21045582,0,0,80,803
17503,21041329,21041329,21046615,0,0,0,5286
17445,21029031,21029031,21046659,0,0,0,17628
17529,21045857,21046615,21046708,0,0,758,851
17528,21045760,21046615,21046750,0,0,855,990
17231,20806013,20806013,21047594,0,0,0,241581
17471,21036079,21036079,21047740,0,0,0,11661
17500,21041182,21042014,21047790,0,0,832,6608
17534,21046551,21047790,21047874,0,0,1239,1323
17538,21047124,21047790,21047967,0,0,666,843
17542,21047790,21047790,21047995,0,0,0,205
17543,21047966,21047966,21048121,0,0,0,155
17380,20974066,20974066,21048122,0,0,0,74056
17496,21041103,21041103,21048197,0,0,0,7094
17497,21041145,21041145,21048218,0,0,0,7073
17523,21044169,21047790,21048224,0,0,3621,4055
17420,21027241,21027241,21048308,0,0,0,21067
17481,21037200,21037200,21048308,0,0,0,11108
17479,21037071,21037071,21048370,0,0,0,11299
17549,21048391,21048391,21048510,0,0,0,119
17530,21046348,21046615,21048764,0,0,267,2416
17551,21048692,21048692,21048790,0,0,0,98
17379,20974035,20974035,21049162,0,0,0,75127
17553,21049152,21049152,21049307,0,0,0,155
17552,21048899,21048899,21049314,0,0,0,415
17554,21049323,21049323,21049525,0,0,0,202
17555,21049451,21049451,21049768,0,0,0,317
17556,21049649,21049649,21049835,0,0,0,186
17557,21049918,21049918,21049985,0,0,0,67
17437,21028702,21028702,21050268,0,0,0,21566
17559,21050040,21050040,21050485,0,0,0,445
17489,21039120,21041189,21051224,0,0,2069,12104
17407,21024792,21024792,21051295,0,0,0,26503
17531,21046549,21046659,21052146,0,0,110,5597
17562,21052649,21052649,21052804,0,0,0,155
17495,21040590,21040590,21052877,0,0,0,12287
17536,21046551,21047790,21053074,0,0,1239,6523
17537,21046551,21047790,21053136,0,0,1239,6585
17532,21046550,21047594,21053143,0,0,1044,6593
17565,21053162,21053162,21053251,0,0,0,89
17563,21052820,21052820,21053283,0,0,0,463
17533,21046550,21047740,21053320,0,0,1190,6770
17535,21046551,21047790,21053401,0,0,1239,6850
17567,21053218,21053218,21053459,0,0,0,241
17558,21049991,21049991,21053486,0,0,0,3495
17569,21053557,21053557,21053617,0,0,0,60
17570,21053589,21053589,21053656,0,0,0,67
17568,21053492,21053492,21053906,0,0,0,414
17572,21053855,21053855,21054110,0,0,0,255
17564,21053055,21053055,21054183,0,0,0,1128
17457,21033805,21033805,21054335,0,0,0,20530
17579,21054662,21054662,21054755,0,0,0,93
17575,21054118,21054118,21054922,0,0,0,804
17578,21054547,21054547,21055081,0,0,0,534
17583,21055143,21055143,21055221,0,0,0,78
17580,21054925,21054925,21055276,0,0,0,351
17465,21034857,21034857,21055318,0,0,0,20461
17548,21048386,21048386,21055437,0,0,0,7051
17581,21055043,21055043,21055906,0,0,0,863
17593,21056633,21056633,21057084,0,0,0,451
17598,21057983,21057983,21058056,0,0,0,73
17596,21057859,21057859,21058087,0,0,0,228
17586,21055330,21055330,21058228,0,0,0,2898
17456,21031717,21031717,21058243,0,0,0,26526
17524,21044630,21044630,21058301,0,0,0,13671
17594,21056641,21056641,21058327,0,0,0,1686
17576,21054249,21054249,21058328,0,0,0,4079
17589,21055662,21055662,21058331,0,0,0,2669
17597,21057880,21058228,21058364,0,0,348,484
17566,21053204,21053204,21058392,0,0,0,5188
17571,21053797,21053797,21058429,0,0,0,4632
17574,21054018,21054018,21058429,0,0,0,4411
17522,21043837,21044027,21058490,0,0,190,14653
17595,21057495,21058327,21058772,0,0,832,1277
17603,21058804,21058804,21058902,0,0,0,98
17605,21059043,21059043,21059214,0,0,0,171
17604,21058950,21058950,21059393,0,0,0,443
17591,21055999,21055999,21059504,0,0,0,3505
17474,21036667,21036667,21059709,0,0,0,23042
17475,21036687,21036687,21059710,0,0,0,23023
17606,21059563,21059563,21060051,0,0,0,488
17610,21060107,21060107,21060174,0,0,0,67
17609,21060069,21060069,21060230,0,0,0,161
17612,21060278,21060278,21060345,0,0,0,67
17611,21060238,21060238,21060398,0,0,0,160
17492,21040277,21040277,21061629,0,0,0,21352
17588,21055452,21055452,21064354,0,0,0,8902
17613,21060572,21060572,21064800,0,0,0,4228
17615,21065402,21065402,21065589,0,0,0,187
17617,21065694,21065694,21065787,0,0,0,93
17616,21065625,21065625,21065816,0,0,0,191
17618,21066257,21066257,21066519,0,0,0,262
17619,21066594,21066594,21066865,0,0,0,271
17494,21040515,21040515,21066938,0,0,0,26423
17592,21056477,21056477,21067309,0,0,0,10832
17573,21053905,21053905,21067700,0,0,0,13795
17621,21066903,21066903,21067731,0,0,0,828
17622,21067664,21067664,21067834,0,0,0,170
17620,21066841,21066841,21068641,0,0,0,1800
17544,21048240,21048308,21069090,0,0,68,20850
17626,21070950,21070950,21071023,0,0,0,73
17625,21068989,21068989,21071051,0,0,0,2062
17599,21058015,21058243,21071150,0,0,228,13135
17628,21071152,21071152,21071245,0,0,0,93
17629,21071317,21071317,21071472,0,0,0,155
17560,21050226,21050226,21071567,0,0,0,21341
17631,21071518,21071518,21071662,0,0,0,144
17335,20937881,20937881,21071976,0,0,0,134095
17336,20938012,20938012,21072238,0,0,0,134226
17526,21044810,21045582,21072287,0,0,772,27477
17519,21043315,21043315,21073146,0,0,0,29831
17627,21071141,21071141,21073188,0,0,0,2047
17633,21071852,21071852,21073529,0,0,0,1677
17577,21054272,21054272,21074774,0,0,0,20502
17584,21055245,21055276,21075887,0,0,31,20642
17561,21051235,21051235,21077553,0,0,0,26318
17429,21027952,21027952,21077860,0,0,0,49908
17637,21075006,21075006,21078192,0,0,0,3186
17640,21078160,21078160,21081760,0,0,0,3600
17614,21061570,21061570,21082922,0,0,0,21352
17607,21059654,21059654,21083182,0,0,0,23528
17608,21059662,21059662,21083264,0,0,0,23602
17427,21027938,21027938,21083482,0,0,0,55544
17601,21058194,21058331,21084986,0,0,137,26792
17634,21072003,21072003,21086110,0,0,0,14107
17624,21068953,21068953,21089867,0,0,0,20914
17632,21071546,21071546,21092313,0,0,0,20767
17623,21067777,21067777,21094102,0,0,0,26325
17636,21074706,21074706,21095372,0,0,0,20666
17638,21075794,21075794,21096226,0,0,0,20432
17504,21041334,21043443,21098324,0,0,2109,56990
17630,21071472,21071472,21098614,0,0,0,27142
17539,21047192,21048197,21099569,0,0,1005,52377
17541,21047501,21048224,21102005,0,0,723,54504
17635,21073094,21073094,21103034,0,0,0,29940
17641,21082862,21082862,21104141,0,0,0,21279
17639,21077486,21077486,21104164,0,0,0,26678
17642,21083138,21083138,21105703,0,0,0,22565
17643,21083207,21083207,21105886,0,0,0,22679
17657,21109148,21109148,21109245,0,0,0,97
17658,21110032,21110032,21110126,0,0,0,94
17659,21110150,21110150,21110254,0,0,0,104
17660,21110210,21110210,21110325,0,0,0,115
17661,21110283,21110283,21110387,0,0,0,104
17645,21089823,21089823,21110659,0,0,0,20836
17666,21111341,21111341,21111461,0,0,0,120
17665,21111140,21111140,21111462,0,0,0,322
17667,21111471,21111471,21111587,0,0,0,116
17669,21111540,21111540,21111625,0,0,0,85
17644,21084804,21084804,21111911,0,0,0,27107
17670,21111562,21111562,21111983,0,0,0,421
17672,21111924,21111924,21112002,0,0,0,78
17673,21111960,21111960,21112168,0,0,0,208
17675,21112237,21112237,21112319,0,0,0,82
17646,21092250,21092250,21113218,0,0,0,20968
17668,21111508,21111508,21113959,0,0,0,2451
17677,21113917,21113917,21113979,0,0,0,62
17540,21047281,21048218,21114211,0,0,937,66930
17585,21055281,21072238,21114246,0,0,16957,58965
17678,21114191,21114191,21114302,0,0,0,111
17674,21112011,21112011,21114412,0,0,0,2401
17682,21114740,21114740,21114811,0,0,0,71
17515,21042976,21042976,21114851,0,0,0,71875
17683,21114806,21114806,21114884,0,0,0,78
17516,21042991,21042991,21114935,0,0,0,71944
17517,21043006,21043006,21114970,0,0,0,71964
17685,21114880,21114880,21114985,0,0,0,105
17684,21114813,21114813,21115131,0,0,0,318
17686,21114888,21114888,21115199,0,0,0,311
17687,21114913,21114913,21115217,0,0,0,304
17690,21115174,21115174,21115326,0,0,0,152
17689,21115140,21115140,21115346,0,0,0,206
17688,21115095,21115095,21115385,0,0,0,290
17695,21115468,21115468,21115572,0,0,0,104
17692,21115284,21115284,21115584,0,0,0,300
17648,21095316,21095316,21116000,0,0,0,20684
17649,21096178,21096178,21116637,0,0,0,20459
17694,21115325,21115325,21116686,0,0,0,1361
17693,21115308,21115308,21116700,0,0,0,1392
17691,21115215,21115215,21117334,0,0,0,2119
17707,21117444,21117444,21117704,0,0,0,260
17647,21094031,21094031,21120377,0,0,0,26346
17355,20949272,20949272,21122072,0,0,0,172800
17651,21102966,21102966,21123824,0,0,0,20858
17545,21048254,21051224,21125130,0,0,2970,76876
17713,21123371,21123371,21125328,0,0,0,1957
17650,21098553,21098553,21125432,0,0,0,26879
17679,21114271,21114271,21125776,0,0,0,11505
17701,21115843,21115843,21125778,0,0,0,9935
17702,21115911,21115911,21125785,0,0,0,9874
17704,21115960,21115960,21125785,0,0,0,9825
17699,21115769,21115769,21125819,0,0,0,10050
17700,21115809,21115809,21125859,0,0,0,10050
17546,21048258,21071976,21125877,0,0,23718,77619
17490,21039542,21039542,21125942,0,0,0,86400
17723,21126045,21126045,21126387,0,0,0,342
17725,21126317,21126317,21126402,0,0,0,85
17712,21123223,21123223,21126411,0,0,0,3188
17726,21126375,21126375,21126454,0,0,0,79
17697,21115567,21115567,21126467,0,0,0,10900
17727,21126406,21126406,21126467,0,0,0,61
17696,21115540,21115540,21126502,0,0,0,10962
17719,21125788,21125788,21126549,0,0,0,761
17728,21126438,21126438,21126556,0,0,0,118
17730,21126473,21126473,21126557,0,0,0,84
17731,21126504,21126504,21126613,0,0,0,109
17722,21125885,21125885,21126718,0,0,0,833
17733,21127003,21127003,21127070,0,0,0,67
17732,21126750,21126750,21127239,0,0,0,489
17734,21127206,21127206,21127276,0,0,0,70
17735,21127302,21127302,21127437,0,0,0,135
17729,21126438,21126438,21127818,0,0,0,1380
17654,21105646,21105646,21128963,0,0,0,23317
17655,21105825,21105825,21129163,0,0,0,23338
17737,21128078,21128078,21129377,0,0,0,1299
17740,21129485,21129485,21130055,0,0,0,570
17587,21055406,21098324,21130538,0,0,42918,75132
17653,21104110,21104110,21131012,0,0,0,26902
17736,21127495,21127495,21131095,0,0,0,3600
17747,21130814,21131012,21131515,0,0,198,701
17662,21110597,21110597,21131517,0,0,0,20920
17748,21130951,21131515,21132018,0,0,564,1067
17652,21104068,21104068,21133584,0,0,0,29516
17709,21117973,21125130,21133977,0,0,7157,16004
17676,21113156,21113156,21134014,0,0,0,20858
17751,21131741,21133584,21134452,0,0,1843,2711
17759,21134659,21134659,21134758,0,0,0,99
17754,21133617,21134452,21134880,0,0,835,1263
17744,21129901,21130055,21134966,0,0,154,5065
17743,21129893,21129893,21135017,0,0,0,5124
17741,21129873,21129873,21135021,0,0,0,5148
17742,21129887,21129887,21135022,0,0,0,5135
17755,21133761,21134880,21135035,0,0,1119,1274
17752,21133043,21133977,21135544,0,0,934,2501
17760,21135802,21135802,21135873,0,0,0,71
17762,21135878,21135878,21136126,0,0,0,248
17703,21115920,21115920,21136369,0,0,0,20449
17758,21134039,21135017,21136428,0,0,978,2389
17756,21133940,21134966,21136544,0,0,1026,2604
17773,21136708,21136708,21136807,0,0,0,99
17774,21136776,21136776,21136881,0,0,0,105
17775,21136807,21136807,21136885,0,0,0,78
17766,21136033,21136033,21136979,0,0,0,946
17777,21137090,21137090,21137174,0,0,0,84
17778,21137131,21137131,21137198,0,0,0,67
17768,21136344,21136369,21137340,0,0,25,996
17779,21137284,21137284,21137453,0,0,0,169
17706,21116597,21116597,21137615,0,0,0,21018
17746,21129914,21133977,21137628,0,0,4063,7714
17671,21111849,21111849,21138919,0,0,0,27070
17745,21129908,21133977,21138944,0,0,4069,9036
17796,21140931,21140931,21141029,0,0,0,98
17714,21123768,21123768,21144692,0,0,0,20924
17710,21120323,21120323,21146677,0,0,0,26354
17763,21135884,21135884,21148050,0,0,0,12166
17761,21135859,21135859,21148056,0,0,0,12197
17800,21145089,21148050,21148143,0,0,2961,3054
17764,21135906,21135906,21148149,0,0,0,12243
17765,21135923,21135923,21148212,0,0,0,12289
17772,21136633,21136633,21148860,0,0,0,12227
17770,21136595,21136595,21148906,0,0,0,12311
17769,21136581,21136581,21148939,0,0,0,12358
17771,21136619,21137628,21149948,0,0,1009,13329
17780,21137390,21137390,21151733,0,0,0,14343
17801,21146630,21151733,21151903,0,0,5103,5273
17717,21125369,21125369,21152055,0,0,0,26686
17738,21128900,21128900,21152400,0,0,0,23500
17749,21131446,21131517,21152497,0,0,71,21051
17739,21129100,21129100,21152535,0,0,0,23435
17788,21139079,21144692,21152674,0,0,5613,13595
17757,21133945,21134966,21155816,0,0,1021,21871
17797,21142498,21148906,21156106,0,0,6408,13608
17767,21136297,21136297,21156886,0,0,0,20589
17781,21137575,21137575,21158350,0,0,0,20775
17750,21131485,21132018,21158391,0,0,533,26906
17790,21139338,21144692,21159035,0,0,5354,19697
17789,21139145,21144692,21159043,0,0,5547,19898
17809,21157791,21158350,21159586,0,0,559,1795
17724,21126098,21130538,21160547,0,0,4440,34449
17791,21139404,21146677,21161020,0,0,7273,21616
17792,21139470,21146677,21161020,0,0,7207,21550
17793,21139555,21146677,21161020,0,0,7122,21465
17794,21139627,21148149,21162492,0,0,8522,22865
17753,21133523,21134014,21162564,0,0,491,29041
17815,21164558,21164558,21165426,0,0,0,868
17787,21138877,21138919,21165578,0,0,42,26701
17812,21163586,21163586,21165815,0,0,0,2229
17818,21165106,21165426,21166294,0,0,320,1188
17819,21165279,21165578,21166477,0,0,299,1198
17798,21143569,21160547,21166952,0,0,16978,23383
17821,21165552,21166294,21167218,0,0,742,1666
17799,21144646,21149948,21171032,0,0,5302,26386
17419,21027145,21027145,21171145,0,0,0,144000
17804,21152368,21152400,21173497,0,0,32,21129
17785,21137720,21149948,21175251,0,0,12228,37531
17708,21117688,21122072,21175409,0,0,4384,57721
17803,21152307,21152307,21176181,0,0,0,23874
17805,21152487,21152497,21176369,0,0,10,23882
17807,21154734,21155816,21176669,0,0,1082,21935
17813,21163740,21163740,21176982,0,0,0,13242
17814,21164247,21164247,21177110,0,0,0,12863
17808,21156817,21156886,21177416,0,0,69,20599
17816,21164705,21164705,21177817,0,0,0,13112
17802,21151994,21151994,21178900,0,0,0,26906
17820,21165367,21165578,21178907,0,0,211,13540
17806,21152642,21152642,21179169,0,0,0,26527
17817,21164941,21164941,21179286,0,0,0,14345
17822,21165607,21166477,21180230,0,0,870,14623
17810,21159635,21159635,21180301,0,0,0,20666
17718,21125781,21125781,21180837,0,0,0,55056
17782,21137695,21138944,21181467,0,0,1249,43772
17823,21165723,21166952,21181573,0,0,1229,15850
17795,21140558,21159035,21184235,0,0,18477,43677
17784,21137711,21148212,21185653,0,0,10501,47942
17681,21114491,21114491,21185907,0,0,0,71416
17783,21137703,21148212,21187074,0,0,10509,49371
17824,21165861,21165861,21187404,0,0,0,21543
17664,21111071,21111071,21189766,0,0,0,78695
17663,21111046,21111046,21190045,0,0,0,78999
17811,21162030,21162030,21190344,0,0,0,28314
17825,21173449,21173449,21194477,0,0,0,21028
17656,21109124,21109124,21195524,0,0,0,86400
17776,21136847,21136847,21196763,0,0,0,59916
17843,21197953,21197953,21198340,0,0,0,387
17845,21197963,21197963,21198350,0,0,0,387
17841,21197934,21197934,21198404,0,0,0,470
17832,21191256,21191256,21198583,0,0,0,7327
17842,21197941,21197941,21198690,0,0,0,749
17826,21178892,21178892,21200014,0,0,0,21122
17847,21199644,21199644,21200032,0,0,0,388
17846,21198314,21198314,21200114,0,0,0,1800
17849,21200110,21200110,21201047,0,0,0,937
17850,21200649,21200649,21201560,0,0,0,911
17852,21201583,21201583,21201651,0,0,0,68
17838,21197041,21197041,21202389,0,0,0,5348
17856,21202425,21202425,21202688,0,0,0,263
17830,21180696,21180696,21203217,0,0,0,22521
17859,21202761,21202761,21203419,0,0,0,658
17860,21203310,21203310,21203419,0,0,0,109
17863,21203822,21203822,21203952,0,0,0,130
17869,21204813,21204813,21205176,0,0,0,363
17870,21205135,21205135,21205233,0,0,0,98
17871,21205542,21205542,21205589,0,0,0,47
17827,21179015,21179015,21205703,0,0,0,26688
17872,21205889,21205889,21205925,0,0,0,36
17828,21179548,21179548,21206070,0,0,0,26522
17873,21206194,21206194,21206241,0,0,0,47
17829,21180143,21180143,21206634,0,0,0,26491
17874,21206810,21206810,21206865,0,0,0,55
17875,21207217,21207217,21207284,0,0,0,67
17876,21207392,21207392,21207568,0,0,0,176
17711,21122375,21122375,21208287,0,0,0,85912
17831,21185878,21185878,21208433,0,0,0,22555
17882,21208811,21208811,21208909,0,0,0,98
17883,21209045,21209045,21209422,0,0,0,377
17698,21115569,21115569,21209744,0,0,0,94175
17858,21202600,21202600,21210577,0,0,0,7977
17887,21211905,21211905,21212193,0,0,0,288
17888,21212132,21212132,21212210,0,0,0,78
17880,21208194,21208194,21212460,0,0,0,4266
17857,21202521,21202521,21212753,0,0,0,10232
17889,21212721,21212721,21212914,0,0,0,193
17890,21213037,21213037,21213104,0,0,0,67
17885,21209644,21209644,21213290,0,0,0,3646
17705,21116408,21116700,21213642,0,0,292,97234
17892,21213716,21213716,21213763,0,0,0,47
17786,21138687,21160547,21213784,0,0,21860,75097
17884,21209432,21209432,21213940,0,0,0,4508
17893,21213874,21213874,21214169,0,0,0,295
17896,21214170,21214170,21214600,0,0,0,430
17897,21214387,21214387,21214688,0,0,0,301
17898,21214640,21214640,21214886,0,0,0,246
17901,21214886,21214886,21214933,0,0,0,47
17902,21214924,21214924,21214982,0,0,0,58
17900,21214884,21214884,21214997,0,0,0,113
17899,21214854,21214854,21215027,0,0,0,173
17903,21214951,21214951,21215280,0,0,0,329
17906,21215462,21215462,21215786,0,0,0,324
17907,21215499,21215499,21215885,0,0,0,386
17908,21215519,21215519,21215936,0,0,0,417
17905,21215435,21215435,21216015,0,0,0,580
17867,21204169,21204169,21216028,0,0,0,11859
17868,21204180,21204180,21216068,0,0,0,11888
17909,21216222,21216222,21216290,0,0,0,68
17866,21204149,21204149,21216693,0,0,0,12544
17910,21216544,21216544,21216882,0,0,0,338
17836,21196410,21196410,21216920,0,0,0,20510
17911,21216561,21216561,21216925,0,0,0,364
17912,21216802,21216802,21216957,0,0,0,155
17891,21213346,21213346,21216959,0,0,0,3613
17916,21217036,21217036,21217207,0,0,0,171
17715,21124536,21124536,21217449,0,0,0,92913
17895,21214075,21214075,21217465,0,0,0,3390
17919,21217470,21217470,21217590,0,0,0,120
17920,21217497,21217497,21217591,0,0,0,94
17918,21217342,21217342,21217868,0,0,0,526
17837,21196741,21196741,21217916,0,0,0,21175
17921,21217761,21217761,21217987,0,0,0,226
17716,21124546,21125130,21218043,0,0,584,93497
17924,21218003,21218003,21218245,0,0,0,242
17926,21218140,21218140,21218408,0,0,0,268
17894,21214053,21214053,21218478,0,0,0,4425
17917,21217037,21217037,21218749,0,0,0,1712
17939,21218685,21218685,21218751,0,0,0,66
17913,21216836,21216836,21218826,0,0,0,1990
17942,21219008,21219008,21219051,0,0,0,43
17941,21218809,21218809,21219117,0,0,0,308
17943,21219074,21219074,21219168,0,0,0,94
17927,21218172,21218172,21219292,0,0,0,1120
17944,21219393,21219393,21219464,0,0,0,71
17929,21218346,21218346,21219528,0,0,0,1182
17945,21219525,21219525,21219603,0,0,0,78
17946,21219618,21219618,21219960,0,0,0,342
17848,21199681,21199681,21220333,0,0,0,20652
17886,21210542,21210542,21220462,0,0,0,9920
17915,21216898,21216898,21220510,0,0,0,3612
17949,21220080,21220080,21220691,0,0,0,611
17954,21221892,21221892,21221947,0,0,0,55
17933,21218407,21218407,21222872,0,0,0,4465
17853,21201819,21201819,21222904,0,0,0,21085
17955,21221916,21222904,21222998,0,0,988,1082
17960,21223160,21223160,21223233,0,0,0,73
17961,21223635,21223635,21223708,0,0,0,73
17952,21220509,21220509,21224165,0,0,0,3656
17968,21225338,21225338,21225461,0,0,0,123
17970,21225515,21225515,21225800,0,0,0,285
17971,21225851,21225851,21226722,0,0,0,871
17962,21223744,21223744,21226748,0,0,0,3004
17861,21203387,21203387,21227161,0,0,0,23774
17958,21222788,21222788,21227241,0,0,0,4453
17934,21218445,21218445,21227445,0,0,0,9000
17964,21224391,21227445,21227538,0,0,3054,3147
17965,21224685,21227538,21227631,0,0,2853,2946
17963,21224093,21224093,21227696,0,0,0,3603
17956,21222283,21222998,21227700,0,0,715,5417
17966,21225014,21227631,21227724,0,0,2617,2710
17967,21225209,21227700,21227793,0,0,2491,2584
17969,21225407,21227724,21227818,0,0,2317,2411
17582,21055051,21055081,21227824,0,0,30,172773
17855,21202390,21202390,21228720,0,0,0,26330
17977,21227458,21228720,21228828,0,0,1262,1370
17979,21228017,21228828,21228921,0,0,811,904
17851,21201150,21201150,21230780,0,0,0,29630
17978,21227643,21227696,21231356,0,0,53,3713
17976,21227194,21227194,21231629,0,0,0,4435
17953,21221454,21221454,21232166,0,0,0,10712
17881,21208374,21208374,21232192,0,0,0,23818
17680,21114446,21114446,21233881,0,0,0,119435
17877,21207405,21207405,21233944,0,0,0,26539
17981,21228998,21233944,21234038,0,0,4946,5040
17878,21207586,21207586,21234405,0,0,0,26819
17984,21231241,21231356,21235090,0,0,115,3849
17844,21197953,21197953,21235276,0,0,0,37323
17985,21231571,21231629,21236109,0,0,58,4538
17879,21207862,21207862,21236765,0,0,0,28903
17914,21216851,21216851,21237379,0,0,0,20528
17982,21230554,21230554,21237754,0,0,0,7200
17721,21125884,21125884,21238637,0,0,0,112753
17987,21234912,21234912,21238663,0,0,0,3751
17950,21220279,21238637,21238762,0,0,18358,18483
17922,21217854,21217854,21239040,0,0,0,21186
17992,21239009,21239040,21239147,0,0,31,138
17991,21238718,21238718,21239273,0,0,0,555
17835,21196013,21196013,21240023,0,0,0,44010
17988,21235980,21236109,21240673,0,0,129,4693
17951,21220289,21220289,21241030,0,0,0,20741
17973,21226721,21226721,21241033,0,0,0,14312
17974,21226752,21226752,21241070,0,0,0,14318
17990,21238595,21238595,21242373,0,0,0,3778
17925,21218025,21218025,21244419,0,0,0,26394
17983,21230725,21230780,21244599,0,0,55,13874
17999,21240484,21240673,21245226,0,0,189,4742
17972,21226667,21238762,21245470,0,0,12095,18803
18006,21244941,21245470,21245568,0,0,529,627
18009,21245239,21245568,21245724,0,0,329,485
17995,21239227,21245470,21246070,0,0,6243,6843
17998,21240127,21245470,21246070,0,0,5343,5943
18010,21245429,21245724,21246324,0,0,295,895
17840,21197921,21197921,21246433,0,0,0,48512
17935,21218615,21233881,21247412,0,0,15266,28797
17720,21125825,21125825,21247586,0,0,0,121761
17947,21219699,21247586,21248186,0,0,27887,28487
17959,21222842,21227161,21248201,0,0,4319,25359
18002,21242317,21244599,21248393,0,0,2282,6076
17948,21219712,21248186,21248403,0,0,28474,28691
18013,21248337,21248337,21248492,0,0,0,155
18007,21244981,21244981,21249574,0,0,0,4593
18012,21246044,21246044,21249835,0,0,0,3791
17904,21215402,21215402,21250473,0,0,0,35071
17839,21197889,21197889,21250646,0,0,0,52757
17975,21227105,21227793,21251939,0,0,688,24834
17957,21222368,21227824,21253024,0,0,5456,30656
18018,21250917,21250917,21253275,0,0,0,2358
18016,21249777,21249777,21253552,0,0,0,3775
17854,21202351,21202351,21254046,0,0,0,51695
18015,21249506,21249506,21254119,0,0,0,4613
17980,21228664,21228921,21255412,0,0,257,26748
18020,21253488,21253488,21257265,0,0,0,3777
18017,21250900,21250900,21257457,0,0,0,6557
17989,21237549,21237549,21258270,0,0,0,20721
18021,21254062,21254062,21258653,0,0,0,4591
18023,21257176,21257176,21260964,0,0,0,3788
17994,21239210,21240023,21261172,0,0,813,21962
18025,21258610,21258610,21263235,0,0,0,4625
18027,21260905,21260905,21264703,0,0,0,3798
18000,21240950,21244419,21264801,0,0,3469,23851
17997,21240093,21241030,21265401,0,0,937,25308
17993,21239085,21239147,21265741,0,0,62,26656
18004,21243881,21245470,21266202,0,0,1589,22321
17996,21239540,21240023,21266773,0,0,483,27233
18029,21263188,21263188,21267742,0,0,0,4554
18032,21264636,21264636,21268450,0,0,0,3814
18037,21271707,21271707,21271879,0,0,0,172
18008,21245214,21245470,21271948,0,0,256,26734
18038,21271827,21271827,21271995,0,0,0,168
18036,21268396,21268396,21272227,0,0,0,3831
18035,21267686,21267686,21272300,0,0,0,4614
18014,21248694,21248694,21272393,0,0,0,23699
17833,21194712,21194712,21273912,0,0,0,79200
17834,21194726,21194726,21273926,0,0,0,79200
18005,21244475,21245470,21274469,0,0,995,29994
18044,21273480,21273480,21274824,0,0,0,1344
18003,21243698,21245470,21274914,0,0,1772,31216
18019,21251189,21251189,21275373,0,0,0,24184
18040,21272164,21272164,21275957,0,0,0,3793
18045,21274753,21274753,21276085,0,0,0,1332
18041,21272257,21272257,21276911,0,0,0,4654
17865,21204073,21204073,21276930,0,0,0,72857
17862,21203435,21203435,21277272,0,0,0,73837
18001,21242262,21242373,21278373,0,0,111,36111
18024,21258199,21258199,21278909,0,0,0,20710
18047,21275890,21275890,21279681,0,0,0,3791
17439,21028754,21028754,21280885,0,0,0,252131
18022,21255091,21255091,21281354,0,0,0,26263
18054,21281293,21281293,21281443,0,0,0,150
18049,21276844,21276844,21281573,0,0,0,4729
18026,21260684,21260684,21281739,0,0,0,21055
18028,21261344,21261344,21281935,0,0,0,20591
18051,21279624,21279624,21283408,0,0,0,3784
18031,21264629,21264629,21285593,0,0,0,20964
18062,21285789,21285789,21285980,0,0,0,191
18056,21281535,21281535,21286217,0,0,0,4682
18063,21286057,21286057,21286684,0,0,0,627
18059,21283361,21283361,21287152,0,0,0,3791
18066,21286971,21286971,21287216,0,0,0,245
18068,21287224,21287224,21287601,0,0,0,377
18069,21287733,21287733,21288019,0,0,0,286
18073,21288280,21288280,21288431,0,0,0,151
18071,21288227,21288227,21288437,0,0,0,210
18076,21288442,21288442,21288588,0,0,0,146
18030,21264479,21264479,21288663,0,0,0,24184
18077,21288562,21288562,21288704,0,0,0,142
17482,21037400,21037400,21289506,0,0,0,252106
17486,21037494,21037508,21289622,0,0,14,252128
18080,21288678,21288678,21290762,0,0,0,2084
18065,21286156,21286156,21290793,0,0,0,4637
18067,21287094,21287094,21290877,0,0,0,3783
18082,21290792,21290792,21290907,0,0,0,115
18085,21290933,21290933,21291079,0,0,0,146
18086,21291038,21291038,21291173,0,0,0,135
18087,21291045,21291045,21291377,0,0,0,332
18084,21290930,21290930,21291409,0,0,0,479
18033,21265673,21265673,21292486,0,0,0,26813
18092,21292639,21292639,21292732,0,0,0,93
18088,21291178,21291178,21292905,0,0,0,1727
18093,21293021,21293021,21293131,0,0,0,110
18094,21293101,21293101,21293206,0,0,0,105
18034,21266706,21266706,21293230,0,0,0,26524
18096,21293255,21293255,21293348,0,0,0,93
18075,21288423,21288423,21293648,0,0,0,5225
18097,21293603,21293603,21293696,0,0,0,93
18098,21294039,21294039,21294174,0,0,0,135
18099,21294195,21294195,21294319,0,0,0,124
17986,21231801,21234038,21294439,0,0,2237,62638
18090,21292071,21292071,21294461,0,0,0,2390
18089,21292034,21292034,21294497,0,0,0,2463
18083,21290813,21290813,21294644,0,0,0,3831
18081,21290725,21290725,21295422,0,0,0,4697
18064,21286131,21286131,21295544,0,0,0,9413
17484,21037449,21037449,21296649,0,0,0,259200
18132,21297549,21297549,21297674,0,0,0,125
18133,21297837,21297837,21297884,0,0,0,47
18134,21298255,21298255,21298404,0,0,0,149
18119,21294577,21294577,21298419,0,0,0,3842
18136,21298386,21298386,21298480,0,0,0,94
18039,21271933,21271933,21298529,0,0,0,26596
18138,21298463,21298463,21298639,0,0,0,176
18046,21275307,21275307,21298704,0,0,0,23397
18050,21278875,21278875,21299577,0,0,0,20702
18151,21299876,21299876,21299960,0,0,0,84
18152,21299894,21299894,21300037,0,0,0,143
18128,21295366,21295366,21300076,0,0,0,4710
18154,21300038,21300038,21300097,0,0,0,59
18156,21300481,21300481,21300610,0,0,0,129
18043,21273147,21273147,21301466,0,0,0,28319
18159,21301385,21301385,21301525,0,0,0,140
18158,21300788,21300788,21301597,0,0,0,809
18135,21298382,21298382,21302266,0,0,0,3884
18057,21281676,21281676,21302444,0,0,0,20768
18058,21281883,21281883,21302561,0,0,0,20678
18072,21288234,21288234,21303193,0,0,0,14959
18074,21288351,21288351,21303246,0,0,0,14895
18070,21288218,21288218,21303463,0,0,0,15245
18048,21276032,21276032,21304642,0,0,0,28610
18155,21300076,21300076,21304723,0,0,0,4647
18178,21304533,21304533,21304816,0,0,0,283
18182,21304969,21304969,21305062,0,0,0,93
18176,21303918,21303918,21305157,0,0,0,1239
18177,21304394,21304394,21305189,0,0,0,795
18183,21305231,21305231,21305525,0,0,0,294
18185,21305432,21305432,21305525,0,0,0,93
18186,21305488,21305488,21305582,0,0,0,94
18189,21305625,21305625,21305692,0,0,0,67
18187,21305526,21305526,21305807,0,0,0,281
18190,21305949,21305949,21306017,0,0,0,68
18192,21306122,21306122,21306169,0,0,0,47
18167,21302240,21302240,21306172,0,0,0,3932
18184,21305380,21305380,21306178,0,0,0,798
18061,21285535,21285535,21306625,0,0,0,21090
18201,21306490,21306625,21306683,0,0,135,193
18206,21306660,21306683,21306750,0,0,23,90
18209,21306775,21306775,21306831,0,0,0,56
18194,21306422,21306422,21307217,0,0,0,795
18223,21307393,21307393,21307465,0,0,0,72
18224,21307439,21307439,21307506,0,0,0,67
17547,21048268,21048308,21307508,0,0,40,259240
18055,21281398,21281398,21307916,0,0,0,26518
18238,21308231,21308231,21308325,0,0,0,94
18226,21307640,21307640,21308380,0,0,0,740
18239,21308312,21308312,21308390,0,0,0,78
18240,21308541,21308541,21308604,0,0,0,63
18250,21308797,21308797,21309270,0,0,0,473
18180,21304660,21304660,21309336,0,0,0,4676
18175,21303452,21303452,21309774,0,0,0,6322
18207,21306732,21309774,21309867,0,0,3042,3135
18227,21307858,21309867,21309965,0,0,2009,2107
18191,21306119,21306119,21309987,0,0,0,3868
18181,21304929,21304929,21310146,0,0,0,5217
18219,21307035,21310146,21310239,0,0,3111,3204
18220,21307045,21310239,21310333,0,0,3194,3288
17550,21048391,21051224,21310424,0,0,2833,262033
18173,21303440,21303440,21310678,0,0,0,7238
18174,21303446,21303446,21310727,0,0,0,7281
18262,21310050,21310050,21311022,0,0,0,972
18079,21288597,21288597,21312000,0,0,0,23403
18137,21298455,21298455,21312031,0,0,0,13576
18261,21309926,21309987,21313892,0,0,61,3966
18251,21309265,21309265,21314023,0,0,0,4758
18225,21307566,21307566,21315328,0,0,0,7762
18331,21314741,21315328,21315528,0,0,587,787
17602,21058211,21058243,21317443,0,0,32,259232
18042,21272823,21272823,21317584,0,0,0,44761
18328,21313832,21313832,21317629,0,0,0,3797
18330,21314503,21314503,21319196,0,0,0,4693
18091,21292447,21292447,21319430,0,0,0,26983
18141,21299511,21299511,21320304,0,0,0,20793
18095,21293190,21293190,21320444,0,0,0,27254
18333,21317622,21317622,21321381,0,0,0,3759
18139,21298638,21298638,21321511,0,0,0,22873
18169,21302498,21302498,21323366,0,0,0,20868
18168,21302389,21302389,21323485,0,0,0,21096
18334,21319197,21319430,21324142,0,0,233,4945
18339,21321321,21321321,21325136,0,0,0,3815
18140,21299380,21299380,21326253,0,0,0,26873
18346,21327136,21327136,21327203,0,0,0,67
18347,21327199,21327199,21327246,0,0,0,47
18349,21327645,21327645,21327712,0,0,0,67
18351,21328044,21328044,21328128,0,0,0,84
18205,21306582,21307508,21328408,0,0,926,21826
18352,21328571,21328571,21328655,0,0,0,84
18344,21325073,21325136,21328917,0,0,63,3844
18341,21323846,21324142,21328952,0,0,296,5106
18357,21329625,21329625,21329692,0,0,0,67
18359,21330113,21330113,21330196,0,0,0,83
18360,21330155,21330155,21330222,0,0,0,67
18363,21330426,21330426,21330556,0,0,0,130
18369,21331041,21331041,21331108,0,0,0,67
18368,21331030,21331030,21331113,0,0,0,83
18160,21301394,21301394,21331128,0,0,0,29734
18371,21331201,21331201,21331264,0,0,0,63
18348,21327458,21331128,21331315,0,0,3670,3857
18372,21331213,21331213,21331318,0,0,0,105
18373,21331268,21331268,21331326,0,0,0,58
18350,21327802,21331315,21331439,0,0,3513,3637
18374,21331425,21331425,21331492,0,0,0,67
18354,21328626,21331439,21331532,0,0,2813,2906
18355,21328787,21328917,21332688,0,0,130,3901
18353,21328571,21328571,21333228,0,0,0,4657
18179,21304576,21304576,21333626,0,0,0,29050
18358,21329811,21331532,21334087,0,0,1721,4276
18381,21332519,21332688,21336426,0,0,169,3907
18228,21307872,21309867,21336736,0,0,1995,28864
18382,21333184,21333228,21337826,0,0,44,4642
18388,21336236,21336236,21339952,0,0,0,3716
18390,21337763,21337763,21342318,0,0,0,4555
18394,21341502,21342318,21346047,0,0,816,4545
18112,21294521,21294521,21346869,0,0,0,52348
18111,21294516,21294516,21346957,0,0,0,52441
18106,21294390,21294390,21347078,0,0,0,52688
18115,21294532,21294532,21347128,0,0,0,52596
18100,21294356,21294356,21347212,0,0,0,52856
18117,21294540,21294540,21347457,0,0,0,52917
18127,21294605,21294605,21347600,0,0,0,52995
18108,21294399,21294399,21347675,0,0,0,53276
18118,21294571,21294571,21347705,0,0,0,53134
18116,21294536,21294536,21347719,0,0,0,53183
18110,21294513,21294513,21347758,0,0,0,53245
18103,21294380,21294380,21347763,0,0,0,53383
18126,21294602,21294602,21347949,0,0,0,53347
18124,21294595,21294595,21347962,0,0,0,53367
18121,21294584,21294584,21348170,0,0,0,53586
18122,21294587,21294587,21348452,0,0,0,53865
18125,21294598,21294598,21348649,0,0,0,54051
18104,21294383,21294383,21348820,0,0,0,54437
18120,21294579,21294579,21348940,0,0,0,54361
18109,21294504,21294504,21349330,0,0,0,54826
18107,21294394,21294394,21349345,0,0,0,54951
18105,21294387,21294387,21349486,0,0,0,55099
18113,21294526,21294526,21349778,0,0,0,55252
18329,21314453,21314453,21350453,0,0,0,36000
18396,21344355,21346047,21350583,0,0,1692,6228
18102,21294375,21294375,21350716,0,0,0,56341
18161,21301698,21301698,21351402,0,0,0,49704
18143,21299656,21299656,21351655,0,0,0,51999
18163,21301909,21301909,21351861,0,0,0,49952
18162,21301812,21301812,21351936,0,0,0,50124
18171,21303100,21303100,21351990,0,0,0,48890
18123,21294592,21294592,21352150,0,0,0,57558
18327,21313648,21351655,21352167,0,0,38007,38519
18146,21299669,21299669,21352226,0,0,0,52557
18164,21301995,21301995,21352393,0,0,0,50398
18142,21299647,21299647,21352415,0,0,0,52768
18165,21302076,21302076,21352536,0,0,0,50460
18144,21299660,21299660,21352590,0,0,0,52930
18149,21299681,21299681,21352764,0,0,0,53083
18150,21299685,21299685,21352985,0,0,0,53300
18172,21303121,21303121,21353042,0,0,0,49921
18145,21299666,21299666,21353372,0,0,0,53706
18148,21299677,21299677,21353569,0,0,0,53892
18398,21345179,21350453,21354179,0,0,5274,9000
18147,21299673,21299673,21354185,0,0,0,54512
18403,21348846,21350583,21354230,0,0,1737,5384
18383,21333196,21354185,21354358,0,0,20989,21162
18170,21303076,21303076,21354667,0,0,0,51591
18166,21302178,21302178,21354731,0,0,0,52553
18385,21333562,21354667,21354839,0,0,21105,21277
18391,21339783,21354839,21355009,0,0,15056,15226
18406,21352508,21352508,21356223,0,0,0,3715
18404,21348867,21351936,21356558,0,0,3069,7691
18052,21280351,21280351,21356670,0,0,0,76319
18053,21280376,21280376,21357326,0,0,0,76950
18364,21330639,21357326,21357420,0,0,26687,26781
18365,21330734,21357420,21357523,0,0,26686,26789
18366,21330741,21357523,21357607,0,0,26782,26866
18367,21330773,21357607,21357700,0,0,26834,26927
18409,21353495,21353495,21358088,0,0,0,4593
18370,21331162,21357700,21358151,0,0,26538,26989
18412,21356202,21356223,21359990,0,0,21,3788
18101,21294368,21294368,21362319,0,0,0,67951
18195,21306448,21306448,21362411,0,0,0,55963
18395,21341651,21362319,21362490,0,0,20668,20839
18413,21358088,21358088,21362693,0,0,0,4605
18196,21306461,21306461,21362991,0,0,0,56530
18210,21306868,21307508,21363056,0,0,640,56188
18414,21359906,21359906,21363660,0,0,0,3754
18216,21306895,21307916,21363774,0,0,1021,56879
18197,21306467,21306467,21363873,0,0,0,57406
18212,21306881,21307508,21364143,0,0,627,57262
18204,21306506,21307508,21364174,0,0,1002,57668
18202,21306490,21307508,21364188,0,0,1018,57698
18199,21306474,21307217,21364437,0,0,743,57963
18200,21306479,21307217,21364549,0,0,738,58070
18203,21306500,21307508,21364763,0,0,1008,58263
18211,21306876,21307508,21364825,0,0,632,57949
18237,21308189,21310424,21365077,0,0,2235,56888
18229,21308147,21309867,21365273,0,0,1720,57126
18218,21306903,21309867,21365428,0,0,2964,58525
18214,21306888,21307508,21365620,0,0,620,58732
18213,21306885,21307508,21365682,0,0,623,58797
18157,21300722,21300722,21365753,0,0,0,65031
18249,21308617,21310678,21365768,0,0,2061,57151
18230,21308160,21309867,21365791,0,0,1707,57631
18408,21353013,21365753,21365924,0,0,12740,12911
18410,21355412,21365753,21365924,0,0,10341,10512
18416,21362768,21365768,21365939,0,0,3000,3171
18215,21306892,21307508,21366015,0,0,616,59123
18217,21306899,21309867,21366181,0,0,2968,59282
18421,21366621,21366621,21366714,0,0,0,93
18232,21308168,21309867,21366816,0,0,1699,58648
18233,21308172,21309867,21366837,0,0,1695,58665
18234,21308176,21309867,21366988,0,0,1691,58812
18241,21308571,21310424,21367069,0,0,1853,58498
18246,21308595,21310424,21367165,0,0,1829,58570
18236,21308183,21310424,21367204,0,0,2241,59021
18415,21362626,21362693,21367218,0,0,67,4592
18231,21308164,21309867,21367390,0,0,1703,59226
18235,21308179,21309965,21367396,0,0,1786,59217
18418,21363618,21363618,21367434,0,0,0,3816
18193,21306126,21306126,21367679,0,0,0,61553
18260,21309639,21310678,21367807,0,0,1039,58168
18271,21310116,21310727,21367955,0,0,611,57839
18252,21309588,21310678,21368043,0,0,1090,58455
18244,21308588,21310424,21368266,0,0,1836,59678
18272,21310422,21310727,21368328,0,0,305,57906
18264,21310083,21310727,21368332,0,0,644,58249
18245,21308592,21310424,21368390,0,0,1832,59798
18242,21308578,21310424,21368489,0,0,1846,59911
18248,21308610,21310424,21368566,0,0,1814,59956
18425,21367401,21367401,21368596,0,0,0,1195
18426,21368785,21368785,21368893,0,0,0,108
18263,21310073,21310727,21368901,0,0,654,58828
18427,21368796,21368893,21368970,0,0,97,174
18428,21368809,21368970,21369047,0,0,161,238
18243,21308582,21310424,21369305,0,0,1842,60723
18257,21309627,21310678,21369338,0,0,1051,59711
18269,21310108,21310727,21369618,0,0,619,59510
18265,21310086,21310727,21369786,0,0,641,59700
18266,21310096,21310727,21369822,0,0,631,59726
18268,21310104,21310727,21370024,0,0,623,59920
18255,21309619,21310678,21370125,0,0,1059,60506
18273,21310436,21312000,21370213,0,0,1564,59777
18277,21310463,21312031,21370349,0,0,1568,59886
18270,21310111,21310727,21370393,0,0,616,60282
18256,21309623,21310678,21370434,0,0,1055,60811
18278,21310473,21312031,21370439,0,0,1558,59966
18258,21309630,21310678,21370451,0,0,1048,60821
18279,21310481,21312031,21370563,0,0,1550,60082
18429,21368825,21369047,21371059,0,0,222,2234
18254,21309615,21310678,21371179,0,0,1063,61564
18247,21308602,21310424,21371183,0,0,1822,62581
18424,21367362,21367362,21371186,0,0,0,3824
18267,21310100,21310727,21371192,0,0,627,61092
18433,21370060,21371192,21371266,0,0,1132,1206
18282,21311001,21312031,21371343,0,0,1030,60342
18434,21370072,21371266,21371359,0,0,1194,1287
18060,21285039,21285039,21371439,0,0,0,86400
18274,21310441,21312031,21371605,0,0,1590,61164
18422,21367093,21367093,21371629,0,0,0,4536
18275,21310451,21312031,21371721,0,0,1580,61270
18290,21311680,21320444,21371764,0,0,8764,60084
18281,21310990,21312031,21371777,0,0,1041,60787
18435,21370449,21371359,21371920,0,0,910,1471
18280,21310491,21312031,21371954,0,0,1540,61463
18283,21311005,21312031,21372315,0,0,1026,61310
18276,21310457,21312031,21372326,0,0,1574,61869
18198,21306470,21306625,21372335,0,0,155,65865
18336,21320308,21352167,21372554,0,0,31859,52246
18432,21369018,21370024,21372821,0,0,1006,3803
18291,21311690,21321511,21373132,0,0,9821,61442
18431,21368836,21371059,21373144,0,0,2223,4308
18446,21372992,21372992,21373220,0,0,0,228
18342,21324332,21352764,21373345,0,0,28432,49013
18259,21309634,21310678,21373926,0,0,1044,64292
18343,21324577,21353042,21374128,0,0,28465,49551
18356,21329472,21353569,21374450,0,0,24097,44978
18308,21311937,21351990,21374764,0,0,40053,62827
18442,21371103,21371103,21374943,0,0,0,3840
18292,21311693,21323366,21375018,0,0,11673,63325
18294,21311698,21323485,21375579,0,0,11787,63881
18293,21311695,21323485,21375672,0,0,11790,63977
18453,21375803,21375803,21375871,0,0,0,68
18454,21375943,21375943,21376119,0,0,0,176
18444,21371584,21371584,21376171,0,0,0,4587
18455,21375984,21375984,21376171,0,0,0,187
18456,21376029,21376029,21376200,0,0,0,171
18457,21376089,21376089,21376264,0,0,0,175
18459,21376091,21376091,21376266,0,0,0,175
18253,21309610,21310678,21376284,0,0,1068,66674
18460,21376092,21376092,21376309,0,0,0,217
18458,21376090,21376090,21376369,0,0,0,279
18461,21376117,21376117,21376392,0,0,0,275
18463,21376118,21376118,21376393,0,0,0,275
18464,21376119,21376119,21376394,0,0,0,275
18340,21322077,21352590,21376573,0,0,30513,54496
18285,21311011,21317584,21376679,0,0,6573,65668
18286,21311016,21317584,21377022,0,0,6568,66006
18284,21311009,21317584,21377144,0,0,6575,66135
18393,21340634,21357326,21377886,0,0,16692,37252
18295,21311701,21326253,21378409,0,0,14552,66708
18452,21374881,21374881,21378770,0,0,0,3889
18392,21340454,21355009,21379014,0,0,14555,38560
18335,21319370,21352150,21379192,0,0,32780,59822
18288,21311023,21319430,21379238,0,0,8407,68215
18337,21320386,21352536,21379421,0,0,32150,59035
18470,21379845,21379845,21379959,0,0,0,114
18469,21379839,21379839,21380001,0,0,0,162
18473,21379871,21379959,21380016,0,0,88,145
18345,21326253,21353372,21380024,0,0,27119,53771
18471,21379850,21379850,21380026,0,0,0,176
18472,21379855,21379855,21380031,0,0,0,176
18296,21311704,21328408,21380099,0,0,16704,68395
18474,21379874,21380001,21380275,0,0,127,401
18289,21311033,21320304,21380277,0,0,9271,69244
18475,21379877,21380016,21380290,0,0,139,413
18478,21380445,21380445,21380616,0,0,0,171
18479,21380449,21380449,21380620,0,0,0,171
18476,21380429,21380429,21380621,0,0,0,192
18462,21376117,21376117,21380698,0,0,0,4581
18480,21380453,21380453,21380706,0,0,0,253
18477,21380433,21380433,21380707,0,0,0,274
18481,21380471,21380471,21380729,0,0,0,258
18482,21380477,21380477,21380771,0,0,0,294
18114,21294529,21294529,21380929,0,0,0,86400
18486,21380768,21380768,21380944,0,0,0,176
18487,21380771,21380771,21380947,0,0,0,176
18484,21380759,21380759,21380952,0,0,0,193
18488,21380791,21380791,21381034,0,0,0,243
18485,21380765,21380765,21381065,0,0,0,300
18489,21380795,21380795,21381069,0,0,0,274
18490,21380801,21380801,21381075,0,0,0,274
18287,21311019,21319196,21382001,0,0,8177,70982
18492,21381988,21381988,21382154,0,0,0,166
18493,21382092,21382092,21382258,0,0,0,166
18494,21382193,21382193,21382361,0,0,0,168
18498,21382487,21382487,21382569,0,0,0,82
18445,21371810,21371810,21382610,0,0,0,10800
18468,21378708,21378708,21382615,0,0,0,3907
18297,21311708,21331128,21382633,0,0,19420,70925
18500,21382572,21382572,21382800,0,0,0,228
18501,21382980,21382980,21383033,0,0,0,53
18397,21344852,21362411,21383055,0,0,17559,38203
18503,21383111,21383111,21383168,0,0,0,57
18504,21383132,21383132,21383169,0,0,0,37
18399,21345620,21362490,21383248,0,0,16870,37628
18502,21382990,21382990,21383264,0,0,0,274
18505,21383223,21383223,21383423,0,0,0,200
18506,21383418,21383418,21383683,0,0,0,265
18507,21383528,21383528,21383728,0,0,0,200
18384,21333371,21354358,21383755,0,0,20987,50384
18508,21384008,21384008,21384208,0,0,0,200
18510,21384239,21384239,21384321,0,0,0,82
18511,21384306,21384306,21384438,0,0,0,132
18386,21333740,21354731,21384622,0,0,20991,50882
18512,21384581,21384581,21384705,0,0,0,124
18078,21288583,21288583,21384709,0,0,0,96126
18513,21384790,21384790,21384889,0,0,0,99
18509,21384078,21384078,21384944,0,0,0,866
18483,21380645,21380645,21385134,0,0,0,4489
18514,21385036,21385036,21385168,0,0,0,132
18298,21311711,21333626,21386017,0,0,21915,74306
18466,21376803,21376803,21386031,0,0,0,9228
18400,21345997,21362991,21386249,0,0,16994,40252
18499,21382537,21382537,21386364,0,0,0,3827
18153,21299967,21299967,21386367,0,0,0,86400
18405,21350305,21365620,21386657,0,0,15315,36352
18441,21371060,21384709,21387188,0,0,13649,16128
18131,21296096,21296096,21388088,0,0,0,91992
18129,21296082,21296082,21388137,0,0,0,92055
18130,21296092,21296092,21388147,0,0,0,92055
18517,21386103,21386367,21388167,0,0,264,2064
18299,21311821,21336736,21388431,0,0,24915,76610
18443,21371156,21384944,21388905,0,0,13788,17749
18375,21331581,21358151,21389065,0,0,26570,57484
18420,21365656,21365924,21389210,0,0,268,23554
18515,21385061,21385134,21389681,0,0,73,4620
18518,21386300,21386300,21390182,0,0,0,3882
18377,21331627,21364143,21390842,0,0,32516,59215
18379,21331663,21364549,21391007,0,0,32886,59344
18300,21311830,21339952,21391036,0,0,28122,79206
18380,21331684,21364825,21391081,0,0,33141,59397
18437,21370847,21370847,21391562,0,0,0,20715
18523,21391483,21391483,21392022,0,0,0,539
18411,21355521,21365753,21392282,0,0,10232,36761
18407,21352842,21365682,21392286,0,0,12840,39444
18376,21331610,21363774,21392402,0,0,32164,60792
18401,21346365,21365273,21392409,0,0,18908,46044
18525,21391862,21391862,21392427,0,0,0,565
18402,21347226,21365428,21392458,0,0,18202,45232
18527,21392561,21392561,21392744,0,0,0,183
18529,21392685,21392685,21392866,0,0,0,181
18378,21331643,21364188,21393558,0,0,32545,61915
18528,21392662,21392662,21393736,0,0,0,1074
18532,21393922,21393922,21393990,0,0,0,68
18533,21393949,21393949,21394036,0,0,0,87
18534,21393961,21393961,21394047,0,0,0,86
18521,21390141,21390141,21394068,0,0,0,3927
18535,21393984,21393984,21394069,0,0,0,85
18536,21393998,21393998,21394093,0,0,0,95
18539,21394031,21394031,21394102,0,0,0,71
18538,21394010,21394010,21394133,0,0,0,123
18520,21389552,21389552,21394150,0,0,0,4598
18540,21394068,21394068,21394161,0,0,0,93
18550,21394234,21394234,21394270,0,0,0,36
18551,21394276,21394276,21394349,0,0,0,73
18552,21394298,21394298,21394378,0,0,0,80
18553,21394310,21394310,21394391,0,0,0,81
18419,21363623,21365924,21394398,0,0,2301,30775
18554,21394360,21394360,21394444,0,0,0,84
18450,21373657,21373926,21394474,0,0,269,20817
18555,21394383,21394383,21394475,0,0,0,92
18562,21394574,21394574,21394642,0,0,0,68
18516,21385387,21386031,21394719,0,0,644,9332
18522,21391377,21391562,21394863,0,0,185,3486
18338,21320960,21351861,21395061,0,0,30901,74101
18564,21395010,21395061,21395155,0,0,51,145
18451,21374557,21374557,21395412,0,0,0,20855
18417,21362876,21365791,21395522,0,0,2915,32646
18567,21396551,21396551,21396680,0,0,0,129
18465,21376270,21376270,21397234,0,0,0,20964
18301,21311833,21346869,21397619,0,0,35036,85786
18537,21394007,21394007,21397954,0,0,0,3947
18304,21311843,21347128,21398475,0,0,35285,86632
18311,21312066,21347719,21398668,0,0,35653,86602
18541,21394085,21394085,21398671,0,0,0,4586
18307,21311854,21347600,21398817,0,0,35746,86963
18309,21312057,21347675,21398830,0,0,35618,86773
18305,21311846,21347212,21398843,0,0,35366,86997
18526,21392043,21392286,21399002,0,0,243,6959
18570,21397340,21397340,21399153,0,0,0,1813
18310,21312063,21347705,21399181,0,0,35642,87118
18303,21311840,21347078,21399219,0,0,35238,87379
18312,21312069,21347758,21399276,0,0,35689,87207
18314,21312076,21347949,21399430,0,0,35873,87354
18306,21311850,21347457,21399440,0,0,35607,87590
18316,21312081,21348170,21399471,0,0,36089,87390
18315,21312078,21347962,21399551,0,0,35884,87473
18317,21312085,21348452,21399609,0,0,36367,87524
18319,21312259,21348820,21400279,0,0,36561,88020
18302,21311836,21346957,21400317,0,0,35121,88481
18320,21312262,21348940,21400461,0,0,36678,88199
18436,21370699,21371920,21400463,0,0,1221,29764
18569,21397201,21397201,21400888,0,0,0,3687
18313,21312072,21347763,21400946,0,0,35691,88874
18440,21370954,21379421,21401068,0,0,8467,30114
18324,21312276,21349778,21401208,0,0,37502,88932
17590,21055836,21055836,21401436,0,0,0,345600
18322,21312269,21349345,21401452,0,0,37076,89183
18438,21370852,21372821,21401457,0,0,1969,30605
18323,21312273,21349486,21401495,0,0,37213,89222
18439,21370876,21373144,21401662,0,0,2268,30786
18571,21397901,21397954,21401877,0,0,53,3976
18467,21378493,21378493,21401984,0,0,0,23491
18325,21312280,21350716,21402031,0,0,38436,89751
18321,21312266,21349330,21402837,0,0,37064,90571
18572,21398635,21398635,21403212,0,0,0,4577
18326,21312284,21351402,21403368,0,0,39118,91084
17600,21058173,21058173,21403773,0,0,0,345600
18556,21394391,21398671,21404205,0,0,4280,9814
18531,21393372,21400463,21404331,0,0,7091,10959
18574,21398753,21401068,21404936,0,0,2315,6183
18549,21394228,21397619,21405093,0,0,3391,10865
18575,21398770,21401457,21405325,0,0,2687,6555
18449,21373364,21373364,21405421,0,0,0,32057
18577,21401763,21401763,21405684,0,0,0,3921
18563,21394675,21400279,21406019,0,0,5604,11344
18579,21403152,21403152,21407766,0,0,0,4614
18448,21373362,21373362,21408032,0,0,0,34670
18447,21373358,21373358,21408111,0,0,0,34753
18491,21381844,21381844,21408569,0,0,0,26725
18597,21408523,21408523,21408695,0,0,0,172
18496,21382302,21382302,21408824,0,0,0,26522
18497,21382377,21382377,21408897,0,0,0,26520
18599,21408761,21408761,21408952,0,0,0,191
18601,21408952,21408952,21409103,0,0,0,151
18495,21382281,21382281,21409197,0,0,0,26916
18602,21409123,21409123,21409293,0,0,0,170
18548,21394173,21394863,21409543,0,0,690,15370
18592,21405639,21405639,21409597,0,0,0,3958
18318,21312249,21348649,21411351,0,0,36400,99102
18519,21388880,21388905,21412376,0,0,25,23496
18593,21407703,21407703,21412382,0,0,0,4679
18524,21391499,21392282,21412677,0,0,783,21178
18530,21392803,21392803,21413013,0,0,0,20210
18605,21409537,21409537,21413457,0,0,0,3920
18557,21394408,21398843,21413532,0,0,4435,19124
18559,21394422,21399276,21413768,0,0,4854,19346
18558,21394415,21399181,21413793,0,0,4766,19378
18561,21394436,21399551,21413997,0,0,5115,19561
18560,21394429,21399440,21414021,0,0,5011,19592
18543,21394115,21394115,21414376,0,0,0,20261
18544,21394125,21394150,21416170,0,0,25,22045
18546,21394150,21394719,21416241,0,0,569,22091
18565,21395369,21395369,21416360,0,0,0,20991
18608,21412317,21412317,21416988,0,0,0,4671
18547,21394161,21394719,21417027,0,0,558,22866
18610,21413414,21413414,21417341,0,0,0,3927
18542,21394100,21394100,21417584,0,0,0,23484
18568,21397160,21397160,21417721,0,0,0,20561
17864,21204029,21204029,21418314,0,0,0,214285
18362,21330256,21356670,21418547,0,0,26414,88291
18011,21245531,21246324,21419124,0,0,793,173593
18361,21330248,21356670,21419138,0,0,26422,88890
18614,21417301,21417301,21421253,0,0,0,3952
18613,21416920,21416920,21421669,0,0,0,4749
18587,21403369,21419124,21422110,0,0,15755,18741
18616,21421199,21421199,21425108,0,0,0,3909
18578,21401921,21401921,21425365,0,0,0,23444
18617,21421607,21421607,21426274,0,0,0,4667
18621,21428083,21428083,21428267,0,0,0,184
18573,21398694,21398817,21428275,0,0,123,29581
18618,21425063,21425063,21428930,0,0,0,3867
18566,21395372,21395412,21430191,0,0,40,34819
18620,21426218,21426218,21431129,0,0,0,4911
18606,21411832,21411832,21432350,0,0,0,20518
18623,21428891,21428891,21432801,0,0,0,3910
18611,21414315,21414315,21434575,0,0,0,20260
18598,21408681,21408681,21434871,0,0,0,26190
18604,21409273,21409273,21435482,0,0,0,26209
18607,21412277,21412277,21435706,0,0,0,23429
18600,21408853,21408853,21435820,0,0,0,26967
18624,21431063,21431063,21435826,0,0,0,4763
18603,21409131,21409131,21435946,0,0,0,26815
18626,21432741,21432741,21436611,0,0,0,3870
18612,21416313,21416313,21437221,0,0,0,20908
18615,21417655,21417655,21438293,0,0,0,20638
18634,21436567,21436567,21440408,0,0,0,3841
18545,21394132,21394474,21440627,0,0,342,46495
18631,21435775,21435775,21440634,0,0,0,4859
18609,21412969,21412969,21441392,0,0,0,28423
18423,21367346,21367346,21442251,0,0,0,74905
18639,21441394,21442251,21442422,0,0,857,1028
18589,21403380,21441392,21442749,0,0,38012,39369
18637,21440347,21440347,21444208,0,0,0,3861
18638,21440570,21440570,21445403,0,0,0,4833
18430,21368830,21369338,21445652,0,0,508,76822
18641,21444147,21444147,21448014,0,0,0,3867
18619,21425310,21425310,21449535,0,0,0,24225
18642,21445362,21445362,21450154,0,0,0,4792
18643,21447971,21447971,21451801,0,0,0,3830
18625,21432351,21432351,21453033,0,0,0,20682
18627,21434575,21434575,21454882,0,0,0,20307
18645,21450097,21450097,21454884,0,0,0,4787
18646,21451730,21451730,21455555,0,0,0,3825
18635,21437163,21437163,21457739,0,0,0,20576
18622,21428200,21428200,21457818,0,0,0,29618
18652,21457755,21457755,21457926,0,0,0,171
18636,21438237,21438237,21458981,0,0,0,20744
18650,21455502,21455502,21459338,0,0,0,3836
18648,21454804,21454804,21459590,0,0,0,4786
18630,21435718,21435718,21459901,0,0,0,24183
18628,21434870,21434870,21461122,0,0,0,26252
18658,21461059,21461059,21461229,0,0,0,170
18629,21435437,21435437,21461993,0,0,0,26556
18660,21461933,21461933,21462101,0,0,0,168
18632,21435798,21435798,21462702,0,0,0,26904
18633,21435918,21435918,21462706,0,0,0,26788
18655,21459275,21459275,21463030,0,0,0,3755
18656,21459531,21459531,21464429,0,0,0,4898
18664,21462967,21462967,21466765,0,0,0,3798
18665,21464362,21464362,21469225,0,0,0,4863
18666,21466693,21466693,21470423,0,0,0,3730
17923,21217965,21217965,21470565,0,0,0,252600
18667,21467596,21470565,21470669,0,0,2969,3073
18674,21470848,21470848,21470916,0,0,0,68
17928,21218332,21218332,21470932,0,0,0,252600
17930,21218353,21218353,21470953,0,0,0,252600
17931,21218372,21218372,21470972,0,0,0,252600
18675,21470956,21470956,21471023,0,0,0,67
18677,21471311,21471311,21471436,0,0,0,125
18669,21467995,21470953,21471552,0,0,2958,3557
18640,21441513,21442251,21472173,0,0,738,30660
18668,21467969,21470669,21472268,0,0,2700,4299
18678,21471374,21471374,21472385,0,0,0,1011
18676,21471036,21471036,21472576,0,0,0,1540
18644,21449465,21449465,21473215,0,0,0,23750
17932,21218394,21220691,21473291,0,0,2297,254897
18647,21452970,21452970,21473498,0,0,0,20528
18682,21471667,21471667,21473559,0,0,0,1892
18670,21469171,21469171,21473974,0,0,0,4803
18680,21471399,21471399,21474103,0,0,0,2704
18673,21470368,21470368,21474107,0,0,0,3739
18672,21470105,21472268,21474464,0,0,2163,4359
18681,21471621,21471621,21475066,0,0,0,3445
18649,21454839,21454839,21475144,0,0,0,20305
18584,21403226,21405325,21475890,0,0,2099,72664
18671,21470101,21471552,21476445,0,0,1451,6344
18685,21472857,21472857,21477378,0,0,0,4521
18689,21474039,21474039,21477761,0,0,0,3722
18651,21457676,21457676,21478276,0,0,0,20600
18583,21403217,21404936,21478647,0,0,1719,75430
18688,21473933,21473933,21478660,0,0,0,4727
18691,21477159,21477159,21478764,0,0,0,1605
18692,21477184,21477184,21479008,0,0,0,1824
18693,21477200,21477200,21479024,0,0,0,1824
18654,21458921,21458921,21479648,0,0,0,20727
18699,21479005,21479008,21479964,0,0,3,959
18700,21479040,21479040,21479965,0,0,0,925
18694,21477725,21477725,21481653,0,0,0,3928
18585,21403355,21413532,21482116,0,0,10177,78761
18696,21478594,21478594,21483421,0,0,0,4827
18657,21459838,21459838,21483594,0,0,0,23756
18705,21481593,21481593,21485289,0,0,0,3696
17936,21218650,21233881,21486481,0,0,15231,267831
18653,21457863,21457863,21487810,0,0,0,29947
17937,21218665,21235276,21487876,0,0,16611,269211
17938,21218682,21235276,21487876,0,0,16594,269194
18709,21487768,21487768,21487928,0,0,0,160
18659,21461166,21461166,21487959,0,0,0,26793
18710,21487875,21487875,21488046,0,0,0,171
18711,21487897,21487897,21488055,0,0,0,158
18706,21483357,21483357,21488080,0,0,0,4723
18661,21462039,21462039,21488933,0,0,0,26894
18708,21485247,21485247,21489012,0,0,0,3765
18663,21462663,21462663,21489271,0,0,0,26608
18662,21462648,21462648,21489692,0,0,0,27044
17940,21218699,21238637,21491237,0,0,19938,272538
18714,21488014,21488014,21492643,0,0,0,4629
18716,21488950,21488950,21492653,0,0,0,3703
18687,21473436,21473436,21493619,0,0,0,20183
18690,21475084,21475084,21495497,0,0,0,20413
18686,21473154,21473215,21496093,0,0,61,22939
18719,21492600,21492600,21496318,0,0,0,3718
18720,21492606,21492606,21497293,0,0,0,4687
18695,21478234,21478234,21498942,0,0,0,20708
18724,21496262,21496262,21499972,0,0,0,3710
18702,21479585,21479585,21500327,0,0,0,20742
18679,21471384,21471384,21501644,0,0,0,30260
18725,21497235,21497235,21501921,0,0,0,4686
18727,21499930,21499930,21503689,0,0,0,3759
18707,21483531,21483531,21506445,0,0,0,22914
18730,21501859,21501859,21506475,0,0,0,4616
18731,21503631,21503631,21507355,0,0,0,3724
18733,21506413,21506413,21511023,0,0,0,4610
18734,21507308,21507308,21511140,0,0,0,3832
18721,21493556,21493556,21513776,0,0,0,20220
18713,21488005,21488005,21514276,0,0,0,26271
18736,21511082,21511082,21514909,0,0,0,3827
18715,21488889,21488889,21515382,0,0,0,26493
18735,21510955,21510955,21515606,0,0,0,4651
18722,21495426,21495426,21515777,0,0,0,20351
18717,21489229,21489229,21515983,0,0,0,26754
18718,21489650,21489650,21516331,0,0,0,26681
18712,21487991,21487991,21516398,0,0,0,28407
18739,21514846,21514846,21518689,0,0,0,3843
18723,21495976,21495976,21518770,0,0,0,22794
18726,21498898,21498898,21519584,0,0,0,20686
18741,21515550,21515550,21520108,0,0,0,4558
18750,21520838,21520838,21520973,0,0,0,135
18728,21500262,21500262,21521310,0,0,0,21048
18746,21518646,21518646,21522496,0,0,0,3850
18591,21404230,21442749,21523224,0,0,38519,118994
18749,21520037,21520037,21524665,0,0,0,4628
18704,21479964,21482116,21525870,0,0,2152,45906
18752,21522454,21522454,21526375,0,0,0,3921
18753,21524612,21524612,21529118,0,0,0,4506
18732,21506371,21506371,21529226,0,0,0,22855
18754,21526307,21526307,21530205,0,0,0,3898
18703,21479938,21479965,21531866,0,0,27,51928
18729,21501589,21501589,21531909,0,0,0,30320
18755,21529056,21529056,21533616,0,0,0,4560
18737,21513729,21513729,21534038,0,0,0,20309
18757,21530150,21530150,21534117,0,0,0,3967
18742,21515724,21515724,21536266,0,0,0,20542
18761,21534048,21534048,21537976,0,0,0,3928
18759,21533553,21533553,21538109,0,0,0,4556
18748,21519540,21519540,21540318,0,0,0,20778
18738,21514216,21514216,21540583,0,0,0,26367
18588,21403374,21422110,21540629,0,0,18736,137255
18740,21515337,21515337,21541499,0,0,0,26162
18763,21537938,21537938,21541865,0,0,0,3927
18747,21518707,21518707,21542034,0,0,0,23327
18751,21521244,21521244,21542169,0,0,0,20925
18743,21515921,21515921,21542697,0,0,0,26776
18764,21538040,21538040,21542796,0,0,0,4756
18744,21516266,21516266,21543085,0,0,0,26819
18684,21472296,21472296,21545608,0,0,0,73312
18768,21541805,21541805,21545742,0,0,0,3937
18745,21516344,21516344,21546296,0,0,0,29952
18772,21542740,21542740,21547264,0,0,0,4524
18777,21546267,21546267,21549250,0,0,0,2983
18778,21546582,21546582,21549451,0,0,0,2869
18775,21545977,21545977,21549458,0,0,0,3481
18774,21545681,21545681,21549633,0,0,0,3952
18576,21398775,21401662,21550010,0,0,2887,151235
18781,21549396,21549396,21550024,0,0,0,628
18683,21472281,21472281,21550175,0,0,0,77894
18780,21549179,21549179,21550464,0,0,0,1285
18779,21547193,21547193,21551765,0,0,0,4572
18581,21403175,21403773,21552121,0,0,598,148946
18701,21479243,21479964,21552133,0,0,721,72890
18697,21478774,21478774,21552149,0,0,0,73375
18698,21478991,21478991,21552149,0,0,0,73158
18595,21408062,21408062,21552416,0,0,0,144354
18756,21529164,21529164,21552467,0,0,0,23303
18582,21403197,21404331,21552648,0,0,1134,149451
18782,21549570,21549570,21553470,0,0,0,3900
18760,21533981,21533981,21554315,0,0,0,20334
18596,21408112,21408112,21554807,0,0,0,146695
18785,21551711,21551711,21556201,0,0,0,4490
18783,21550023,21550023,21556357,0,0,0,6334
18762,21536188,21536188,21556647,0,0,0,20459
18784,21550472,21550472,21557235,0,0,0,6763
18793,21553404,21553404,21557274,0,0,0,3870
18786,21551779,21551779,21558062,0,0,0,6283
18790,21552100,21552100,21558091,0,0,0,5991
18787,21551788,21551788,21558206,0,0,0,6418
18788,21551801,21551801,21558250,0,0,0,6449
18791,21552115,21552115,21558283,0,0,0,6168
18789,21552082,21552082,21558464,0,0,0,6382
18795,21556160,21556160,21560704,0,0,0,4544
18594,21408043,21408043,21560832,0,0,0,152789
18765,21540260,21540260,21561005,0,0,0,20745
18758,21531850,21531850,21561078,0,0,0,29228
18797,21557232,21557232,21561172,0,0,0,3940
18809,21561033,21561033,21561204,0,0,0,171
18811,21561144,21561144,21561312,0,0,0,168
18812,21561250,21561250,21561419,0,0,0,169
18813,21561357,21561357,21561540,0,0,0,183
18770,21542115,21542115,21562948,0,0,0,20833
18798,21557803,21557803,21563267,0,0,0,5464
18799,21557908,21557908,21563793,0,0,0,5885
18817,21563708,21563708,21564260,0,0,0,552
18804,21558254,21558254,21564293,0,0,0,6039
18821,21564221,21564221,21564450,0,0,0,229
18818,21563731,21563731,21564533,0,0,0,802
18816,21563192,21563192,21564560,0,0,0,1368
18188,21305533,21305533,21564733,0,0,0,259200
18810,21561079,21561079,21565008,0,0,0,3929
18769,21541969,21541969,21565064,0,0,0,23095
18822,21564252,21564252,21565086,0,0,0,834
18807,21560652,21560652,21565203,0,0,0,4551
18801,21558036,21558036,21565380,0,0,0,7344
18766,21540526,21540526,21567075,0,0,0,26549
18767,21541442,21541442,21567895,0,0,0,26453
18826,21564945,21564945,21568864,0,0,0,3919
18771,21542635,21542635,21569318,0,0,0,26683
18222,21307222,21310333,21569533,0,0,3111,262311
18828,21565141,21565141,21569702,0,0,0,4561
18773,21543045,21543045,21569831,0,0,0,26786
18823,21564510,21564510,21572295,0,0,0,7785
18837,21568799,21568799,21572714,0,0,0,3915
18824,21564521,21564521,21573170,0,0,0,8649
18800,21558011,21558011,21574182,0,0,0,16171
18839,21569638,21569638,21574224,0,0,0,4586
18802,21558167,21558167,21574410,0,0,0,16243
18803,21558208,21558208,21574440,0,0,0,16232
18805,21558394,21558394,21574445,0,0,0,16051
18794,21554252,21554252,21574580,0,0,0,20328
18846,21574353,21574440,21574657,0,0,87,304
18847,21574356,21574657,21574750,0,0,301,394
18830,21565335,21565335,21575002,0,0,0,9667
18829,21565239,21565239,21575072,0,0,0,9833
18792,21552413,21552413,21575472,0,0,0,23059
18776,21546247,21546247,21576448,0,0,0,30201
18841,21572654,21572654,21576520,0,0,0,3866
18796,21556600,21556600,21577215,0,0,0,20615
18845,21574184,21574184,21578819,0,0,0,4635
18855,21576474,21576474,21580372,0,0,0,3898
18844,21574121,21574410,21581829,0,0,289,7708
18808,21560960,21560960,21581895,0,0,0,20935
18857,21578767,21578767,21583395,0,0,0,4628
18815,21562886,21562886,21583897,0,0,0,21011
18858,21580306,21580306,21584176,0,0,0,3870
18864,21584122,21584122,21587949,0,0,0,3827
18860,21583334,21583334,21588022,0,0,0,4688
18827,21564984,21564984,21588506,0,0,0,23522
18871,21588155,21588155,21589995,0,0,0,1840
18814,21561471,21561471,21590032,0,0,0,28561
18869,21587904,21587904,21591758,0,0,0,3854
18870,21587977,21587977,21592727,0,0,0,4750
18832,21567031,21567031,21593397,0,0,0,26366
18877,21593337,21593397,21593570,0,0,60,233
18836,21567833,21567833,21594219,0,0,0,26386
18879,21594153,21594219,21594391,0,0,66,238
18849,21574533,21574533,21594892,0,0,0,20359
18875,21591698,21591758,21595538,0,0,60,3840
18838,21569256,21569256,21595667,0,0,0,26411
18852,21575015,21575015,21596203,0,0,0,21188
18840,21569773,21569773,21596519,0,0,0,26746
18876,21592667,21592727,21597465,0,0,60,4798
18856,21577157,21577157,21597574,0,0,0,20417
18853,21575402,21575402,21598941,0,0,0,23539
18883,21595408,21595667,21599472,0,0,259,4064
18886,21597342,21597342,21602079,0,0,0,4737
18859,21581854,21581854,21602721,0,0,0,20867
18889,21599159,21599159,21602916,0,0,0,3757
18831,21566878,21566878,21603468,0,0,0,36590
18862,21583834,21583834,21604667,0,0,0,20833
18854,21576385,21576385,21606467,0,0,0,30082
18894,21606411,21606411,21606582,0,0,0,171
18892,21602853,21602853,21606627,0,0,0,3774
18890,21602016,21602016,21607076,0,0,0,5060
18896,21606579,21606579,21610381,0,0,0,3802
18332,21315484,21352393,21611536,0,0,36909,296052
18897,21607014,21607014,21611867,0,0,0,4853
18872,21588437,21588506,21612402,0,0,69,23965
18898,21610320,21610320,21614107,0,0,0,3787
18881,21594834,21594892,21615419,0,0,58,20585
18899,21611820,21611820,21616631,0,0,0,4811
18901,21614044,21614044,21617768,0,0,0,3724
18887,21597513,21597513,21618129,0,0,0,20616
18906,21619358,21619358,21619528,0,0,0,170
18878,21593448,21593570,21619543,0,0,122,26095
18907,21619468,21619468,21619638,0,0,0,170
18908,21619575,21619575,21619743,0,0,0,168
18873,21589991,21590032,21619989,0,0,41,29998
18910,21619891,21619891,21620060,0,0,0,169
18880,21594266,21594391,21620918,0,0,125,26652
18904,21617711,21617711,21621435,0,0,0,3724
18903,21616572,21616572,21621467,0,0,0,4895
18848,21574383,21574445,21621920,0,0,62,47537
18888,21598904,21598904,21622449,0,0,0,23545
18884,21595593,21596203,21622462,0,0,610,26869
18885,21596458,21596458,21622927,0,0,0,26469
18891,21602661,21602661,21623683,0,0,0,21022
18913,21621389,21621389,21625072,0,0,0,3683
18586,21403362,21416170,21625497,0,0,12808,222135
18893,21604614,21604614,21625614,0,0,0,21000
18914,21621398,21621398,21626260,0,0,0,4862
18928,21626996,21626996,21627047,0,0,0,51
18389,21336576,21367955,21627155,0,0,31379,290579
18922,21626923,21626923,21627302,0,0,0,379
18929,21627009,21627009,21627391,0,0,0,382
18931,21627053,21627053,21627400,0,0,0,347
18930,21627025,21627025,21627422,0,0,0,397
18933,21627092,21627092,21627454,0,0,0,362
18924,21626940,21626940,21627458,0,0,0,518
18932,21627084,21627084,21627462,0,0,0,378
18923,21626934,21626934,21627483,0,0,0,549
18925,21626955,21626955,21627483,0,0,0,528
18934,21627106,21627106,21627483,0,0,0,377
18927,21626976,21626976,21627514,0,0,0,538
18926,21626962,21626962,21627521,0,0,0,559
18919,21625014,21625014,21628728,0,0,0,3714
18843,21573499,21574182,21630135,0,0,683,56636
18938,21630142,21630142,21630460,0,0,0,318
18921,21626178,21626178,21630967,0,0,0,4789
18939,21630402,21630402,21631417,0,0,0,1015
18935,21628665,21628665,21632413,0,0,0,3748
18942,21632339,21632339,21633096,0,0,0,757
18945,21633685,21633685,21634101,0,0,0,416
18946,21634069,21634069,21634194,0,0,0,125
18947,21634076,21634076,21634216,0,0,0,140
18949,21634097,21634097,21634216,0,0,0,119
18948,21634082,21634082,21634222,0,0,0,140
18951,21634118,21634118,21634247,0,0,0,129
18950,21634104,21634104,21634254,0,0,0,150
18953,21634305,21634305,21634383,0,0,0,78
18955,21634326,21634326,21634383,0,0,0,57
18954,21634312,21634312,21634390,0,0,0,78
18952,21634297,21634297,21634391,0,0,0,94
18842,21573078,21573170,21634392,0,0,92,61314
18956,21634335,21634335,21634392,0,0,0,57
18957,21634347,21634347,21634414,0,0,0,67
18959,21634428,21634428,21634968,0,0,0,540
18958,21634421,21634421,21635003,0,0,0,582
18961,21634440,21634440,21635021,0,0,0,581
18963,21634455,21634455,21635036,0,0,0,581
18960,21634434,21634434,21635046,0,0,0,612
18962,21634449,21634449,21635061,0,0,0,612
18964,21634897,21634897,21635216,0,0,0,319
18940,21630906,21630906,21635627,0,0,0,4721
18902,21615317,21615317,21635768,0,0,0,20451
18895,21606522,21606522,21635875,0,0,0,29353
18970,21635876,21635876,21636005,0,0,0,129
18943,21632350,21632350,21636090,0,0,0,3740
18900,21612271,21612271,21636253,0,0,0,23982
18905,21618066,21618066,21638448,0,0,0,20382
18820,21564169,21564169,21639211,0,0,0,75042
18977,21639199,21639199,21639329,0,0,0,130
18975,21637454,21639211,21639711,0,0,1757,2257
18971,21636028,21636028,21639773,0,0,0,3745
18967,21635569,21635569,21640343,0,0,0,4774
18819,21564153,21564153,21641432,0,0,0,77279
18978,21639710,21639710,21643610,0,0,0,3900
18918,21623616,21623616,21644529,0,0,0,20913
18979,21640275,21640275,21645097,0,0,0,4822
18983,21645377,21645377,21645455,0,0,0,78
18909,21619681,21619681,21645599,0,0,0,25918
18985,21645501,21645501,21646229,0,0,0,728
18920,21625548,21625548,21646321,0,0,0,20773
18984,21645488,21645488,21646323,0,0,0,835
18987,21645604,21645604,21646337,0,0,0,733
18916,21622390,21622390,21646422,0,0,0,24032
18912,21620730,21620730,21646495,0,0,0,25765
18990,21646381,21646381,21646521,0,0,0,140
18980,21643550,21643550,21647344,0,0,0,3794
18208,21306754,21388167,21647367,0,0,81413,340613
18993,21647621,21647621,21647699,0,0,0,78
18994,21647713,21647713,21647892,0,0,0,179
18997,21647806,21647806,21647927,0,0,0,121
18998,21647824,21647824,21647929,0,0,0,105
18999,21647849,21647849,21648046,0,0,0,197
19000,21647862,21647862,21648089,0,0,0,227
18915,21621789,21621789,21648090,0,0,0,26301
19001,21648015,21648015,21648090,0,0,0,75
19003,21648042,21648042,21648121,0,0,0,79
19004,21648054,21648054,21648122,0,0,0,68
18995,21647741,21647741,21648125,0,0,0,384
19005,21648125,21648125,21648194,0,0,0,69
19006,21648129,21648129,21648237,0,0,0,108
19009,21648222,21648222,21648275,0,0,0,53
19007,21648166,21648166,21648277,0,0,0,111
19008,21648202,21648202,21648300,0,0,0,98
19010,21648240,21648240,21648307,0,0,0,67
19011,21648359,21648359,21648442,0,0,0,83
19012,21648394,21648394,21648476,0,0,0,82
19013,21648457,21648457,21648515,0,0,0,58
19014,21648478,21648478,21648545,0,0,0,67
19015,21648588,21648588,21648819,0,0,0,231
19025,21648775,21648775,21648879,0,0,0,104
18917,21622865,21622865,21649150,0,0,0,26285
19027,21648891,21648891,21649278,0,0,0,387
19016,21648639,21648639,21649356,0,0,0,717
19017,21648654,21648654,21649386,0,0,0,732
19018,21648670,21648670,21649388,0,0,0,718
19019,21648687,21648687,21649405,0,0,0,718
19020,21648703,21648703,21649425,0,0,0,722
18911,21619998,21619998,21649428,0,0,0,29430
19022,21648735,21648735,21649443,0,0,0,708
19021,21648717,21648717,21649452,0,0,0,735
19024,21648766,21648766,21649499,0,0,0,733
19026,21648787,21648787,21649500,0,0,0,713
18982,21645057,21645057,21649884,0,0,0,4827
19030,21649213,21649213,21649949,0,0,0,736
19031,21649219,21649356,21650111,0,0,137,892
19033,21649232,21649388,21650137,0,0,156,905
19023,21648751,21648751,21650173,0,0,0,1422
19038,21650128,21650128,21650252,0,0,0,124
18221,21307158,21391081,21650281,0,0,83923,343123
18944,21633149,21633149,21650376,0,0,0,17227
19029,21649203,21649203,21650652,0,0,0,1449
19039,21650602,21650602,21650731,0,0,0,129
19032,21649226,21649386,21650859,0,0,160,1633
19040,21650817,21650817,21650876,0,0,0,59
19041,21650840,21650840,21650970,0,0,0,130
18992,21647280,21647280,21651072,0,0,0,3792
19043,21651071,21651071,21651211,0,0,0,140
19044,21651678,21651678,21652050,0,0,0,372
19046,21653264,21653264,21653404,0,0,0,140
19045,21653115,21653115,21653437,0,0,0,322
19036,21649632,21649632,21654328,0,0,0,4696
19047,21654037,21654037,21654378,0,0,0,341
19037,21649825,21649825,21654669,0,0,0,4844
19042,21651029,21651029,21654877,0,0,0,3848
19051,21655579,21655579,21655692,0,0,0,113
19052,21655635,21655635,21655697,0,0,0,62
19053,21655660,21655660,21655728,0,0,0,68
19054,21655729,21655729,21655796,0,0,0,67
19034,21649324,21649405,21655855,0,0,81,6531
19055,21655804,21655804,21655882,0,0,0,78
19056,21655991,21655991,21656059,0,0,0,68
19057,21656066,21656066,21656133,0,0,0,67
19058,21656139,21656139,21656200,0,0,0,61
19059,21656173,21656173,21656252,0,0,0,79
19060,21656209,21656209,21656283,0,0,0,74
18968,21635709,21635709,21656327,0,0,0,20618
19062,21656232,21656232,21656365,0,0,0,133
19050,21655437,21655437,21656368,0,0,0,931
19061,21656230,21656230,21656938,0,0,0,708
19063,21656241,21656241,21656977,0,0,0,736
19066,21656306,21656306,21657021,0,0,0,715
19065,21656297,21656297,21657041,0,0,0,744
19069,21656694,21656694,21657053,0,0,0,359
19067,21656319,21656319,21657054,0,0,0,735
19068,21656325,21656325,21657058,0,0,0,733
19070,21657271,21657271,21657404,0,0,0,133
19072,21657377,21657377,21657444,0,0,0,67
19077,21657602,21657602,21658378,0,0,0,776
18965,21635051,21635051,21658407,0,0,0,23356
19049,21654817,21654817,21658668,0,0,0,3851
18976,21638378,21638378,21658918,0,0,0,20540
19071,21657320,21657320,21658981,0,0,0,1661
19048,21654600,21654600,21659345,0,0,0,4745
19080,21659022,21659022,21659374,0,0,0,352
18972,21636201,21636201,21660127,0,0,0,23926
18941,21631348,21631348,21660130,0,0,0,28782
19082,21660022,21660022,21660324,0,0,0,302
19084,21660437,21660437,21660685,0,0,0,248
18937,21630013,21630013,21660759,0,0,0,30746
18825,21564587,21564587,21660883,0,0,0,96296
19085,21660694,21660694,21661202,0,0,0,508
19087,21661534,21661534,21662092,0,0,0,558
19078,21658627,21658627,21662488,0,0,0,3861
19089,21662807,21662807,21663128,0,0,0,321
19081,21659285,21659285,21663960,0,0,0,4675
19090,21663791,21663791,21664253,0,0,0,462
18969,21635832,21635832,21664448,0,0,0,28616
19092,21664603,21664603,21664904,0,0,0,301
18981,21644471,21644471,21665479,0,0,0,21008
19095,21665709,21665709,21665969,0,0,0,260
19088,21662435,21662435,21666271,0,0,0,3836
19096,21665981,21665981,21666395,0,0,0,414
18988,21646254,21646254,21667205,0,0,0,20951
19093,21664830,21664830,21669520,0,0,0,4690
19098,21666448,21666448,21670048,0,0,0,3600
19097,21666229,21666229,21670168,0,0,0,3939
18989,21646375,21646375,21670507,0,0,0,24132
18986,21645536,21645536,21671556,0,0,0,26020
18861,21583655,21583655,21671836,0,0,0,88181
18865,21584326,21584326,21671836,0,0,0,87510
18867,21584868,21584868,21671836,0,0,0,86968
18866,21584636,21584636,21671856,0,0,0,87220
18850,21574931,21574931,21671865,0,0,0,96934
18868,21585100,21585100,21671866,0,0,0,86766
18863,21583974,21583974,21671897,0,0,0,87923
18874,21590406,21590406,21672115,0,0,0,81709
18882,21595171,21595538,21672166,0,0,367,76995
18991,21646429,21646429,21672555,0,0,0,26126
19105,21672558,21672558,21672729,0,0,0,171
19106,21672668,21672668,21672835,0,0,0,167
19114,21672767,21672767,21672937,0,0,0,170
19102,21670100,21670100,21673980,0,0,0,3880
19101,21669460,21669460,21674126,0,0,0,4666
19002,21648031,21648031,21674418,0,0,0,26387
19116,21673293,21673293,21674896,0,0,0,1603
19119,21673536,21673536,21675021,0,0,0,1485
19118,21673418,21673418,21675083,0,0,0,1665
19028,21649085,21649085,21675264,0,0,0,26179
19064,21656253,21656253,21676657,0,0,0,20404
19117,21673329,21673329,21677817,0,0,0,4488
19120,21673922,21673922,21677824,0,0,0,3902
19121,21674063,21674063,21678664,0,0,0,4601
19035,21649383,21649405,21679209,0,0,22,29826
19079,21658882,21658882,21679435,0,0,0,20553
18387,21335504,21335504,21681104,0,0,0,345600
19126,21677779,21677779,21681731,0,0,0,3952
19127,21678620,21678620,21683207,0,0,0,4587
19083,21660082,21660082,21684164,0,0,0,24082
19133,21683564,21683564,21684758,0,0,0,1194
19123,21675163,21675163,21684849,0,0,0,9686
19137,21685501,21685501,21685616,0,0,0,115
19130,21681665,21681665,21685619,0,0,0,3954
19094,21665418,21665418,21686188,0,0,0,20770
19135,21684765,21684765,21686342,0,0,0,1577
19139,21685596,21685596,21686746,0,0,0,1150
19073,21657512,21657512,21687328,0,0,0,29816
19076,21657570,21657570,21687344,0,0,0,29774
19131,21683146,21683146,21687757,0,0,0,4611
19100,21667209,21667209,21688165,0,0,0,20956
19075,21657527,21657527,21688800,0,0,0,31273
19138,21685577,21685577,21689532,0,0,0,3955
19074,21657520,21657520,21690066,0,0,0,32546
19142,21687690,21687690,21692285,0,0,0,4595
19144,21689477,21689477,21693383,0,0,0,3906
19091,21664383,21664383,21694319,0,0,0,29936
19103,21670492,21670492,21694530,0,0,0,24038
19145,21692221,21692221,21696790,0,0,0,4569
19125,21676619,21676619,21697229,0,0,0,20610
19146,21693320,21693320,21697260,0,0,0,3940
19104,21671556,21671556,21697364,0,0,0,25808
19115,21672880,21672880,21698720,0,0,0,25840
19129,21679375,21679375,21699722,0,0,0,20347
19122,21674432,21674432,21700840,0,0,0,26408
19151,21697198,21697198,21701167,0,0,0,3969
19149,21696750,21696750,21701341,0,0,0,4591
19124,21675284,21675284,21701373,0,0,0,26089
18834,21567557,21572295,21703316,0,0,4738,135759
19156,21701104,21701104,21705050,0,0,0,3946
18590,21404167,21404205,21705243,0,0,38,301076
19157,21701303,21701303,21705883,0,0,0,4580
18851,21574932,21574932,21706754,0,0,0,131822
19140,21686125,21686125,21707072,0,0,0,20947
19134,21684219,21684219,21708148,0,0,0,23929
19128,21679161,21679161,21708646,0,0,0,29485
19143,21688102,21688102,21708822,0,0,0,20720
19159,21704978,21704978,21708894,0,0,0,3916
19168,21709896,21709896,21709963,0,0,0,67
19160,21705820,21705820,21710378,0,0,0,4558
19170,21710726,21710726,21711142,0,0,0,416
19165,21708842,21708842,21712717,0,0,0,3875
19173,21713134,21713134,21713352,0,0,0,218
19169,21710333,21710333,21714902,0,0,0,4569
19176,21714710,21714710,21715460,0,0,0,750
19182,21715314,21715314,21715460,0,0,0,146
19177,21714725,21714725,21715464,0,0,0,739
19178,21714745,21714745,21715493,0,0,0,748
19183,21715366,21715366,21715495,0,0,0,129
19179,21714756,21714756,21715562,0,0,0,806
19180,21714768,21714768,21715574,0,0,0,806
19185,21715531,21715531,21715621,0,0,0,90
19184,21715498,21715498,21715644,0,0,0,146
19186,21715585,21715585,21715653,0,0,0,68
19187,21715684,21715684,21715751,0,0,0,67
19192,21715847,21715847,21715940,0,0,0,93
19172,21712653,21712653,21716540,0,0,0,3887
19199,21716665,21716665,21717259,0,0,0,594
19198,21716659,21716659,21717456,0,0,0,797
19193,21715854,21715854,21717490,0,0,0,1636
19150,21697142,21697142,21717522,0,0,0,20380
19148,21694467,21694467,21718398,0,0,0,23931
19181,21714861,21714861,21719360,0,0,0,4499
19194,21715995,21715995,21719560,0,0,0,3565
19166,21709036,21709036,21719836,0,0,0,10800
19205,21719876,21719876,21719978,0,0,0,102
19190,21715833,21715833,21719980,0,0,0,4147
19191,21715841,21715841,21719988,0,0,0,4147
19207,21719945,21719945,21720013,0,0,0,68
19208,21720035,21720035,21720101,0,0,0,66
19210,21720060,21720060,21720143,0,0,0,83
19211,21720109,21720109,21720187,0,0,0,78
19154,21699651,21699651,21720211,0,0,0,20560
19197,21716480,21716480,21720356,0,0,0,3876
19214,21720816,21720816,21720894,0,0,0,78
19189,21715827,21715827,21721325,0,0,0,5498
19216,21721473,21721473,21721554,0,0,0,81
19215,21721138,21721138,21721667,0,0,0,529
19217,21721492,21721492,21721859,0,0,0,367
19230,21722746,21722746,21722783,0,0,0,37
18973,21636515,21636515,21722915,0,0,0,86400
19232,21723012,21723012,21723059,0,0,0,47
18974,21636741,21636741,21723141,0,0,0,86400
19233,21723408,21723408,21723492,0,0,0,84
19152,21697295,21697295,21723515,0,0,0,26220
19235,21723554,21723554,21723680,0,0,0,126
19234,21723460,21723460,21723684,0,0,0,224
19147,21694257,21694257,21723686,0,0,0,29429
19236,21723637,21723637,21723809,0,0,0,172
19204,21719320,21719320,21723879,0,0,0,4559
19188,21715800,21715800,21724072,0,0,0,8272
19213,21720290,21720290,21724145,0,0,0,3855
19153,21698656,21698656,21724764,0,0,0,26108
19221,21722343,21722343,21725607,0,0,0,3264
19202,21718409,21718409,21725663,0,0,0,7254
19238,21723710,21723710,21726468,0,0,0,2758
19209,21720053,21720053,21726799,0,0,0,6746
19155,21700781,21700781,21727067,0,0,0,26286
19243,21726321,21726321,21727137,0,0,0,816
19228,21722711,21722711,21727556,0,0,0,4845
19229,21722720,21722720,21727565,0,0,0,4845
19158,21701308,21701308,21727571,0,0,0,26263
19227,21722704,21722704,21727580,0,0,0,4876
19240,21724078,21724078,21727828,0,0,0,3750
19161,21707026,21707026,21727970,0,0,0,20944
19239,21723827,21723827,21728418,0,0,0,4591
19244,21726588,21726588,21728756,0,0,0,2168
19164,21708766,21708766,21729682,0,0,0,20916
19220,21721991,21721991,21730761,0,0,0,8770
19167,21709271,21709271,21730871,0,0,0,21600
18806,21558430,21558430,21731230,0,0,0,172800
19252,21731182,21731182,21731306,0,0,0,124
19203,21719092,21719092,21731424,0,0,0,12332
19247,21727792,21727792,21731624,0,0,0,3832
19226,21722630,21722630,21731656,0,0,0,9026
19219,21721972,21721972,21731885,0,0,0,9913
19162,21708106,21708106,21731964,0,0,0,23858
19218,21721941,21721941,21732247,0,0,0,10306
19223,21722365,21722365,21732359,0,0,0,9994
19224,21722378,21722378,21732394,0,0,0,10016
19249,21728356,21728356,21732891,0,0,0,4535
19258,21733380,21733380,21734514,0,0,0,1134
19222,21722347,21722347,21734527,0,0,0,12180
19253,21731625,21731625,21735399,0,0,0,3774
19260,21735795,21735795,21736395,0,0,0,600
19261,21735795,21735795,21736395,0,0,0,600
19262,21735796,21735796,21736396,0,0,0,600
19263,21735796,21735796,21736396,0,0,0,600
19264,21735796,21735796,21736396,0,0,0,600
19265,21735797,21735797,21736397,0,0,0,600
19266,21735799,21735799,21736399,0,0,0,600
19267,21735799,21735799,21736399,0,0,0,600
19268,21735799,21735799,21736399,0,0,0,600
19269,21735800,21735800,21736400,0,0,0,600
19270,21735800,21735800,21736400,0,0,0,600
19271,21735800,21735800,21736400,0,0,0,600
19272,21735800,21735800,21736400,0,0,0,600
19273,21735800,21735800,21736400,0,0,0,600
19274,21735801,21735801,21736401,0,0,0,600
19275,21735801,21735801,21736401,0,0,0,600
19276,21735801,21735801,21736401,0,0,0,600
19277,21735801,21735801,21736401,0,0,0,600
19278,21735801,21735801,21736401,0,0,0,600
19279,21735802,21735802,21736402,0,0,0,600
19280,21735802,21735802,21736402,0,0,0,600
19281,21735802,21735802,21736402,0,0,0,600
19282,21735802,21735802,21736402,0,0,0,600
19283,21735803,21735803,21736403,0,0,0,600
19196,21716154,21716154,21736709,0,0,0,20555
19286,21736974,21736974,21737093,0,0,0,119
19195,21716044,21716044,21737143,0,0,0,21099
19257,21732891,21732891,21737427,0,0,0,4536
18996,21647802,21647802,21737961,0,0,0,90159
19200,21717462,21717462,21738030,0,0,0,20568
19206,21719890,21719890,21738658,0,0,0,18768
19163,21708593,21708593,21738686,0,0,0,30093
19259,21735338,21735338,21739119,0,0,0,3781
19284,21735988,21735988,21740677,0,0,0,4689
19212,21720156,21720156,21740732,0,0,0,20576
19291,21740271,21740271,21741432,0,0,0,1161
19256,21732154,21732154,21742126,0,0,0,9972
19287,21737427,21737427,21742202,0,0,0,4775
19201,21718351,21718351,21742266,0,0,0,23915
19086,21660742,21660742,21742724,0,0,0,81982
19290,21739108,21739108,21742840,0,0,0,3732
19297,21742763,21742763,21743363,0,0,0,600
19298,21742769,21742769,21743369,0,0,0,600
19299,21742769,21742769,21743369,0,0,0,600
19300,21742769,21742769,21743369,0,0,0,600
19301,21742770,21742770,21743370,0,0,0,600
19302,21742770,21742770,21743370,0,0,0,600
19303,21742770,21742770,21743370,0,0,0,600
19304,21742770,21742770,21743370,0,0,0,600
19305,21742771,21742771,21743371,0,0,0,600
19306,21742771,21742771,21743371,0,0,0,600
19307,21742771,21742771,21743371,0,0,0,600
19308,21742771,21742771,21743371,0,0,0,600
19309,21742772,21742772,21743372,0,0,0,600
19310,21742772,21742772,21743372,0,0,0,600
19311,21742772,21742772,21743372,0,0,0,600
19312,21742772,21742772,21743372,0,0,0,600
19313,21742773,21742773,21743373,0,0,0,600
19314,21742773,21742773,21743373,0,0,0,600
19315,21742773,21742773,21743373,0,0,0,600
19316,21742774,21742774,21743374,0,0,0,600
19317,21742774,21742774,21743374,0,0,0,600
19318,21742774,21742774,21743374,0,0,0,600
19319,21742774,21742774,21743374,0,0,0,600
19320,21742774,21742774,21743374,0,0,0,600
19321,21742775,21742775,21743375,0,0,0,600
19322,21742775,21742775,21743375,0,0,0,600
19323,21742775,21742775,21743375,0,0,0,600
19324,21742775,21742775,21743375,0,0,0,600
19325,21742775,21742775,21743375,0,0,0,600
19326,21742776,21742776,21743376,0,0,0,600
19327,21742776,21742776,21743376,0,0,0,600
19328,21742776,21742776,21743376,0,0,0,600
19330,21743643,21743643,21743768,0,0,0,125
19331,21743794,21743794,21743919,0,0,0,125
19332,21743803,21743803,21744217,0,0,0,414
19333,21743962,21743962,21744228,0,0,0,266
19295,21742567,21742567,21744643,0,0,0,2076
19334,21745517,21745517,21745584,0,0,0,67
19336,21745611,21745611,21745714,0,0,0,103
19338,21745677,21745677,21745776,0,0,0,99
19337,21745659,21745659,21745777,0,0,0,118
19339,21745720,21745720,21745803,0,0,0,83
19340,21745741,21745741,21745808,0,0,0,67
19341,21745819,21745819,21745918,0,0,0,99
19342,21745851,21745851,21745936,0,0,0,85
19343,21745897,21745897,21745976,0,0,0,79
19344,21745918,21745918,21745976,0,0,0,58
19345,21745940,21745940,21746007,0,0,0,67
19356,21746175,21746175,21746330,0,0,0,155
19329,21742871,21742871,21746553,0,0,0,3682
19285,21736031,21736031,21746864,0,0,0,10833
19296,21742751,21742751,21747367,0,0,0,4616
19364,21747551,21747551,21747644,0,0,0,93
19365,21747764,21747764,21747857,0,0,0,93
19352,21746147,21746147,21748474,0,0,0,2327
19248,21727911,21727911,21748602,0,0,0,20691
18580,21403157,21403157,21748757,0,0,0,345600
19237,21723659,21723659,21749413,0,0,0,25754
19370,21750012,21750012,21750207,0,0,0,195
19360,21746488,21746488,21750210,0,0,0,3722
19372,21750182,21750182,21750379,0,0,0,197
19374,21750375,21750375,21750543,0,0,0,168
19242,21724697,21724697,21750549,0,0,0,25852
19293,21741797,21741797,21750557,0,0,0,8760
19251,21729636,21729636,21750576,0,0,0,20940
19375,21750572,21750572,21750751,0,0,0,179
19377,21750776,21750776,21750900,0,0,0,124
19376,21750740,21750740,21750908,0,0,0,168
19367,21749057,21749057,21751812,0,0,0,2755
19383,21753069,21753069,21753277,0,0,0,208
19380,21752014,21752014,21753311,0,0,0,1297
19384,21753219,21753219,21753386,0,0,0,167
19385,21753324,21753324,21753500,0,0,0,176
19245,21726980,21726980,21753511,0,0,0,26531
19371,21750126,21750126,21753878,0,0,0,3752
19171,21710735,21710735,21753935,0,0,0,43200
19241,21724257,21724257,21753994,0,0,0,29737
19246,21727515,21727515,21754013,0,0,0,26498
19361,21747305,21747305,21754505,0,0,0,7200
19368,21749710,21749710,21755659,0,0,0,5949
19255,21731907,21731907,21755693,0,0,0,23786
19335,21745585,21745585,21755991,0,0,0,10406
19388,21753815,21753815,21757553,0,0,0,3738
19392,21755076,21755659,21757735,0,0,583,2659
19288,21738034,21738034,21758587,0,0,0,20553
18936,21629873,21629873,21759875,0,0,0,130002
19394,21755171,21759875,21760198,0,0,4704,5027
19395,21755176,21760198,21760417,0,0,5022,5241
19292,21740734,21740734,21761204,0,0,0,20470
19398,21757512,21757512,21761225,0,0,0,3713
19351,21746139,21746139,21761365,0,0,0,15226
19346,21746099,21746099,21761730,0,0,0,15631
19348,21746117,21746117,21761809,0,0,0,15692
19357,21746183,21746183,21761827,0,0,0,15644
19349,21746125,21746125,21761888,0,0,0,15763
19347,21746110,21746110,21762030,0,0,0,15920
19350,21746132,21746132,21762050,0,0,0,15918
19355,21746169,21746169,21762124,0,0,0,15955
19353,21746155,21746155,21762172,0,0,0,16017
19359,21746375,21746375,21762237,0,0,0,15862
19358,21746345,21746345,21762238,0,0,0,15893
19354,21746162,21746162,21762427,0,0,0,16265
19400,21759421,21761809,21763029,0,0,2388,3608
19412,21763087,21763087,21763191,0,0,0,104
19410,21762845,21762845,21764165,0,0,0,1320
19407,21761171,21761171,21764918,0,0,0,3747
19415,21763328,21763328,21765282,0,0,0,1954
19294,21742248,21742248,21766074,0,0,0,23826
19289,21738639,21738639,21768433,0,0,0,29794
19418,21764857,21764857,21768589,0,0,0,3732
19419,21765654,21765654,21769332,0,0,0,3678
19423,21770440,21770440,21770612,0,0,0,172
19424,21770549,21770549,21770717,0,0,0,168
19373,21750330,21750330,21771273,0,0,0,20943
19421,21768526,21768526,21772300,0,0,0,3774
19382,21752380,21752380,21773277,0,0,0,20897
19427,21772257,21772257,21776182,0,0,0,3925
19378,21750919,21750919,21777309,0,0,0,26390
19430,21777302,21777302,21777459,0,0,0,157
19431,21777412,21777412,21777569,0,0,0,157
19432,21777523,21777523,21777700,0,0,0,177
19399,21759191,21759191,21779520,0,0,0,20329
19429,21776119,21776119,21779907,0,0,0,3788
19386,21753432,21753432,21780022,0,0,0,26590
19436,21779959,21779959,21780132,0,0,0,173
19437,21780069,21780069,21780238,0,0,0,169
19438,21780176,21780176,21780343,0,0,0,167
19439,21780282,21780282,21780457,0,0,0,175
19440,21780394,21780394,21780563,0,0,0,169
19389,21754043,21754043,21780702,0,0,0,26659
19390,21754388,21754388,21781335,0,0,0,26947
19408,21761219,21761219,21781647,0,0,0,20428
19435,21779863,21779863,21783630,0,0,0,3767
19391,21754437,21754437,21783920,0,0,0,29483
19446,21783942,21783942,21784119,0,0,0,177
19445,21783571,21783571,21787355,0,0,0,3784
18966,21635517,21635517,21789431,0,0,0,153914
19401,21759483,21762237,21790146,0,0,2754,30663
19420,21766077,21766077,21790273,0,0,0,24196
19448,21787313,21787313,21791126,0,0,0,3813
19426,21771244,21771244,21792191,0,0,0,20947
19402,21759494,21763029,21792791,0,0,3535,33297
19404,21759811,21790146,21793505,0,0,30335,33694
19428,21773215,21773215,21794052,0,0,0,20837
19175,21713227,21713227,21794159,0,0,0,80932
19174,21713196,21713196,21794196,0,0,0,81000
19450,21791072,21791072,21794851,0,0,0,3779
19405,21759832,21792791,21796167,0,0,32959,36335
19409,21761783,21796167,21798288,0,0,34384,36505
19453,21794788,21794788,21798681,0,0,0,3893
19396,21755894,21755894,21799094,0,0,0,43200
19425,21770654,21770654,21799407,0,0,0,28753
19393,21755118,21757735,21799503,0,0,2617,44385
19455,21799345,21799345,21799532,0,0,0,187
19457,21799490,21799490,21799836,0,0,0,346
19434,21779458,21779458,21800006,0,0,0,20548
19458,21799953,21799953,21800011,0,0,0,58
19231,21722936,21722936,21800581,0,0,0,77645
19464,21800853,21800853,21800921,0,0,0,68
19465,21801182,21801182,21801260,0,0,0,78
19469,21801359,21801359,21801441,0,0,0,82
19470,21801410,21801410,21801503,0,0,0,93
19471,21801553,21801553,21801642,0,0,0,89
19472,21801590,21801590,21801674,0,0,0,84
19444,21781576,21781576,21802195,0,0,0,20619
19454,21798640,21798640,21802563,0,0,0,3923
19476,21802500,21802500,21802604,0,0,0,104
19479,21802627,21802627,21802700,0,0,0,73
19480,21802785,21802785,21802879,0,0,0,94
19481,21802977,21802977,21803064,0,0,0,87
19433,21777635,21777635,21803745,0,0,0,26110
19483,21803090,21803090,21804115,0,0,0,1025
19486,21804116,21804116,21804215,0,0,0,99
19487,21804236,21804236,21804296,0,0,0,60
19488,21804264,21804264,21804358,0,0,0,94
19489,21804360,21804360,21804520,0,0,0,160
19490,21804367,21804367,21804802,0,0,0,435
19492,21804708,21804708,21804803,0,0,0,95
19494,21804770,21804803,21804896,0,0,33,126
19495,21804895,21804896,21805011,0,0,1,116
19496,21804977,21805011,21805135,0,0,34,158
19397,21757142,21760417,21805372,0,0,3275,48230
19477,21802528,21802528,21806440,0,0,0,3912
19441,21780500,21780500,21806610,0,0,0,26110
19501,21807067,21807067,21807145,0,0,0,78
19442,21780705,21780705,21807292,0,0,0,26587
19504,21807325,21807325,21807392,0,0,0,67
19443,21781349,21781349,21808059,0,0,0,26710
19493,21804708,21805372,21808744,0,0,664,4036
19508,21808730,21808744,21808804,0,0,14,74
19369,21749734,21749734,21809042,0,0,0,59308
19509,21809236,21809236,21809296,0,0,0,60
19510,21809465,21809465,21809525,0,0,0,60
19511,21809611,21809611,21809671,0,0,0,60
19499,21806381,21806381,21810330,0,0,0,3949
19514,21810362,21810362,21810422,0,0,0,60
19482,21803002,21803002,21812038,0,0,0,9036
19451,21792139,21792139,21812979,0,0,0,20840
19478,21802605,21802605,21813380,0,0,0,10775
19497,21805193,21805193,21813803,0,0,0,8610
19513,21810265,21810265,21814193,0,0,0,3928
19447,21784052,21784052,21814221,0,0,0,30169
19449,21790201,21790201,21814601,0,0,0,24400
19507,21808477,21813803,21814849,0,0,5326,6372
19452,21794005,21794005,21814946,0,0,0,20941
19516,21813848,21814849,21815190,0,0,1001,1342
19524,21815156,21815156,21815223,0,0,0,67
19460,21799980,21799980,21815733,0,0,0,15753
19525,21815294,21815294,21815795,0,0,0,501
19463,21800084,21800084,21815827,0,0,0,15743
19461,21800009,21800009,21815959,0,0,0,15950
19462,21800041,21800041,21816101,0,0,0,16060
19526,21815832,21815832,21816362,0,0,0,530
19468,21801325,21801325,21816919,0,0,0,15594
19528,21816898,21816898,21816972,0,0,0,74
19467,21801317,21801317,21817090,0,0,0,15773
19498,21805471,21808744,21817246,0,0,3273,11775
19473,21801611,21801611,21817249,0,0,0,15638
19475,21802170,21802170,21817893,0,0,0,15723
19517,21814128,21814128,21818059,0,0,0,3931
19535,21818519,21818519,21818579,0,0,0,60
19530,21816990,21816990,21818907,0,0,0,1917
19536,21818829,21818829,21818995,0,0,0,166
19537,21819042,21819042,21819166,0,0,0,124
19539,21819170,21819170,21819274,0,0,0,104
19538,21819167,21819167,21819313,0,0,0,146
19541,21819281,21819281,21819416,0,0,0,135
19542,21819337,21819337,21819417,0,0,0,80
19543,21819380,21819380,21819458,0,0,0,78
19544,21819444,21819444,21819599,0,0,0,155
19545,21819602,21819602,21819662,0,0,0,60
19546,21819608,21819608,21819955,0,0,0,347
19547,21819929,21819929,21820054,0,0,0,125
19548,21820153,21820153,21820268,0,0,0,115
19549,21820165,21820165,21820290,0,0,0,125
19550,21820240,21820240,21820300,0,0,0,60
19459,21799959,21799959,21820487,0,0,0,20528
19553,21820460,21820460,21820553,0,0,0,93
19554,21820737,21820737,21820830,0,0,0,93
19555,21820913,21820913,21821069,0,0,0,156
19529,21816924,21816924,21821717,0,0,0,4793
19557,21821349,21821349,21821721,0,0,0,372
19532,21817990,21817990,21821929,0,0,0,3939
19533,21818069,21821717,21822262,0,0,3648,4193
19531,21817769,21817769,21822520,0,0,0,4751
19474,21802120,21802120,21822586,0,0,0,20466
19561,21822169,21822520,21822646,0,0,351,477
19560,21822062,21822520,21822691,0,0,458,629
19534,21818079,21822262,21822761,0,0,4183,4682
19564,21822802,21822802,21822849,0,0,0,47
19559,21821952,21821952,21822999,0,0,0,1047
19502,21807111,21807111,21823107,0,0,0,15996
19568,21823017,21823017,21823328,0,0,0,311
19569,21823371,21823371,21823467,0,0,0,96
19573,21823482,21823482,21823584,0,0,0,102
19574,21823546,21823546,21823619,0,0,0,73
19576,21823652,21823652,21823767,0,0,0,115
19577,21823759,21823759,21823894,0,0,0,135
19556,21821092,21822520,21824395,0,0,1428,3303
19583,21825591,21825591,21825776,0,0,0,185
19558,21821882,21821882,21825837,0,0,0,3955
19570,21823406,21823406,21826059,0,0,0,2653
19584,21825759,21825776,21826108,0,0,17,349
19586,21826103,21826108,21826248,0,0,5,145
19587,21826271,21826271,21826338,0,0,0,67
19588,21826365,21826365,21826459,0,0,0,94
19589,21826480,21826480,21826604,0,0,0,124
19581,21824408,21824408,21826666,0,0,0,2258
18833,21567551,21567551,21826751,0,0,0,259200
19590,21826714,21826714,21826807,0,0,0,93
19591,21826821,21826821,21826925,0,0,0,104
19592,21826892,21826892,21827001,0,0,0,109
19593,21826973,21826973,21827385,0,0,0,412
19596,21827331,21827331,21827424,0,0,0,93
19595,21827120,21827120,21827480,0,0,0,360
19540,21819246,21819274,21827656,0,0,28,8410
19580,21824190,21824190,21827790,0,0,0,3600
19456,21799453,21799453,21828131,0,0,0,28678
19600,21828552,21828552,21828807,0,0,0,255
19578,21824027,21824027,21829434,0,0,0,5407
19604,21829108,21829108,21829570,0,0,0,462
19582,21825236,21826059,21829659,0,0,823,4423
19585,21825776,21825837,21829787,0,0,61,4011
19485,21803691,21803691,21830066,0,0,0,26375
19606,21829887,21829887,21830501,0,0,0,614
19579,21824111,21824111,21830506,0,0,0,6395
19518,21814135,21815190,21830947,0,0,1055,16812
19611,21831763,21831763,21832400,0,0,0,637
19491,21804553,21804553,21832551,0,0,0,27998
19610,21831269,21831269,21832865,0,0,0,1596
19500,21806537,21806537,21832989,0,0,0,26452
19614,21833479,21833479,21833568,0,0,0,89
19605,21829660,21829660,21833573,0,0,0,3913
19515,21812934,21812934,21833796,0,0,0,20862
19503,21807229,21807292,21833910,0,0,63,26681
19618,21833801,21833801,21833930,0,0,0,129
19619,21833944,21833944,21834011,0,0,0,67
19594,21827048,21827048,21834338,0,0,0,7290
19505,21807983,21808059,21834784,0,0,76,26801
19622,21834990,21834990,21835130,0,0,0,140
19551,21820293,21820293,21835575,0,0,0,15282
19521,21814870,21814870,21835726,0,0,0,20856
19598,21828091,21828091,21836527,0,0,0,8436
19599,21828247,21828247,21836802,0,0,0,8555
19466,21801309,21801309,21836868,0,0,0,35559
19563,21822536,21822536,21836869,0,0,0,14333
19506,21808435,21809042,21836990,0,0,607,28555
19623,21835385,21835385,21836992,0,0,0,1607
19615,21833529,21833529,21837471,0,0,0,3942
19520,21814567,21814567,21838527,0,0,0,23960
19552,21820455,21820455,21840945,0,0,0,20490
18835,21567563,21581829,21841029,0,0,14266,273466
19625,21837411,21837411,21841328,0,0,0,3917
19562,21822534,21822534,21842677,0,0,0,20143
19519,21814165,21814165,21843886,0,0,0,29721
19630,21843823,21843823,21843997,0,0,0,174
19631,21843935,21843935,21844113,0,0,0,178
19632,21844042,21844042,21844211,0,0,0,169
19633,21844157,21844157,21844336,0,0,0,179
19575,21823609,21841029,21844705,0,0,17420,21096
19628,21841257,21841257,21845175,0,0,0,3918
19636,21845470,21845470,21847103,0,0,0,1633
19403,21759596,21789431,21848221,0,0,29835,88625
19572,21823427,21836990,21848856,0,0,13563,25429
19635,21845141,21845141,21849050,0,0,0,3909
19512,21810072,21810072,21851741,0,0,0,41669
19608,21831170,21831170,21852770,0,0,0,21600
19637,21848979,21848979,21852827,0,0,0,3848
19639,21854097,21854097,21854697,0,0,0,600
19616,21833710,21833796,21854720,0,0,86,21010
19641,21854148,21854148,21854748,0,0,0,600
19643,21854212,21854212,21854812,0,0,0,600
19644,21854560,21854560,21855316,0,0,0,756
19624,21835746,21835746,21856362,0,0,0,20616
19645,21854575,21855316,21856403,0,0,741,1828
19607,21830004,21830066,21856515,0,0,62,26511
19648,21856389,21856389,21856594,0,0,0,205
19638,21852794,21852794,21856686,0,0,0,3892
19597,21828068,21828068,21857042,0,0,0,28974
19609,21831217,21836802,21858402,0,0,5585,27185
19613,21832958,21832989,21859346,0,0,31,26388
19655,21858709,21858709,21860292,0,0,0,1583
19651,21856643,21856643,21860462,0,0,0,3819
19617,21833764,21833910,21860927,0,0,146,27163
19484,21803436,21803436,21861032,0,0,0,57596
19621,21834638,21834638,21861064,0,0,0,26426
19627,21840882,21840882,21861333,0,0,0,20451
19571,21823411,21832551,21862032,0,0,9140,38621
19626,21838508,21838508,21862306,0,0,0,23798
19629,21842638,21842638,21862966,0,0,0,20328
19657,21860401,21860401,21864218,0,0,0,3817
19660,21861650,21861650,21866593,0,0,0,4943
19664,21864172,21864172,21868009,0,0,0,3837
19665,21867973,21867973,21871790,0,0,0,3817
19634,21844273,21844273,21872939,0,0,0,28666
19667,21872896,21872896,21873073,0,0,0,177
19666,21871757,21871757,21875494,0,0,0,3737
19646,21854629,21854629,21875526,0,0,0,20897
19406,21759844,21793505,21876737,0,0,33661,116893
19642,21854154,21854154,21877803,0,0,0,23649
19654,21857223,21857223,21878021,0,0,0,20798
19653,21857049,21876737,21878627,0,0,19688,21578
19669,21875450,21875450,21879273,0,0,0,3823
19659,21861270,21861270,21881826,0,0,0,20556
19650,21856540,21856540,21882841,0,0,0,26301
19674,21882799,21882799,21882950,0,0,0,151
19672,21879214,21879214,21882992,0,0,0,3778
19663,21862906,21862906,21883542,0,0,0,20636
19652,21856990,21856990,21885549,0,0,0,28559
19656,21859292,21859292,21885656,0,0,0,26364
19679,21885597,21885597,21885767,0,0,0,170
19680,21885705,21885705,21885873,0,0,0,168
19662,21862237,21862237,21886186,0,0,0,23949
19676,21882924,21882924,21886636,0,0,0,3712
19612,21832358,21832400,21887019,0,0,42,54661
19620,21834050,21834338,21887106,0,0,288,53056
19658,21860717,21860717,21887207,0,0,0,26490
19565,21822849,21822849,21887451,0,0,0,64602
19685,21887593,21887593,21887661,0,0,0,68
19686,21887773,21887773,21887903,0,0,0,130
19687,21888560,21888560,21888689,0,0,0,129
19661,21862165,21862165,21889018,0,0,0,26853
19689,21888946,21888946,21889066,0,0,0,120
19691,21889084,21889084,21889214,0,0,0,130
19688,21888858,21888858,21889458,0,0,0,600
19692,21890032,21890032,21890343,0,0,0,311
19683,21886579,21886579,21890376,0,0,0,3797
19695,21890458,21890458,21890525,0,0,0,67
19601,21828724,21828724,21891110,0,0,0,62386
19566,21822883,21822883,21891223,0,0,0,68340
19698,21892320,21892320,21892398,0,0,0,78
19700,21892733,21892733,21892848,0,0,0,115
19647,21856370,21856403,21893057,0,0,33,36687
19697,21892222,21892222,21893097,0,0,0,875
19704,21892995,21892995,21893104,0,0,0,109
19699,21892667,21892667,21893267,0,0,0,600
19705,21893072,21893072,21893368,0,0,0,296
19702,21892935,21892935,21893535,0,0,0,600
19708,21893689,21893689,21893749,0,0,0,60
19706,21893263,21893263,21893863,0,0,0,600
19709,21893721,21893721,21893867,0,0,0,146
19707,21893447,21893447,21894047,0,0,0,600
19693,21890314,21890314,21894059,0,0,0,3745
19712,21894097,21894097,21894188,0,0,0,91
19713,21894275,21894275,21894342,0,0,0,67
19715,21894834,21894834,21895140,0,0,0,306
19717,21895098,21895098,21895238,0,0,0,140
19718,21895102,21895102,21895282,0,0,0,180
19719,21895257,21895257,21895373,0,0,0,116
19720,21895342,21895342,21895436,0,0,0,94
19721,21895435,21895435,21895557,0,0,0,122
19722,21895526,21895526,21895620,0,0,0,94
19710,21893867,21893867,21895667,0,0,0,1800
19723,21895669,21895669,21895949,0,0,0,280
19670,21875455,21875455,21895998,0,0,0,20543
19726,21895966,21895966,21896033,0,0,0,67
19714,21894393,21894393,21896193,0,0,0,1800
19727,21896172,21896172,21896266,0,0,0,94
19728,21896272,21896272,21896339,0,0,0,67
19724,21895737,21895737,21896471,0,0,0,734
19729,21896401,21896401,21896536,0,0,0,135
19716,21895075,21895075,21896875,0,0,0,1800
19730,21896786,21896786,21896891,0,0,0,105
19711,21893998,21893998,21897709,0,0,0,3711
19733,21898477,21898477,21898607,0,0,0,130
19671,21877955,21877955,21898902,0,0,0,20947
19737,21899162,21899162,21899447,0,0,0,285
19736,21898910,21898910,21899851,0,0,0,941
19649,21856422,21862032,21899958,0,0,5610,43536
19734,21898622,21898622,21900422,0,0,0,1800
19738,21900784,21900784,21900852,0,0,0,68
19739,21901012,21901012,21901110,0,0,0,98
19740,21901196,21901196,21901294,0,0,0,98
19731,21897638,21897638,21901363,0,0,0,3725
19668,21873006,21873006,21901396,0,0,0,28390
19741,21901340,21901340,21901512,0,0,0,172
19742,21901450,21901450,21901622,0,0,0,172
19743,21901560,21901560,21901729,0,0,0,169
19746,21901822,21901822,21901900,0,0,0,78
19673,21881764,21881764,21902304,0,0,0,20540
19747,21902229,21902229,21902398,0,0,0,169
19749,21902247,21902247,21902425,0,0,0,178
19750,21902261,21902261,21902427,0,0,0,166
19752,21902477,21902477,21902545,0,0,0,68
19753,21902657,21902657,21902725,0,0,0,68
19754,21903092,21903092,21903170,0,0,0,78
19694,21890374,21890374,21903327,0,0,0,12953
19703,21892942,21892942,21903742,0,0,0,10800
19757,21903789,21903789,21903871,0,0,0,82
19677,21883480,21883480,21904176,0,0,0,20696
19756,21903562,21903562,21904338,0,0,0,776
19759,21904401,21904401,21904468,0,0,0,67
19760,21904652,21904652,21904730,0,0,0,78
19761,21904662,21904662,21904767,0,0,0,105
19762,21904746,21904746,21904820,0,0,0,74
19763,21904779,21904779,21904858,0,0,0,79
19764,21904836,21904836,21904948,0,0,0,112
19765,21904916,21904916,21905010,0,0,0,94
19567,21822892,21826751,21905060,0,0,3859,82168
19766,21905100,21905100,21905189,0,0,0,89
19767,21905151,21905151,21905244,0,0,0,93
19768,21905200,21905200,21905282,0,0,0,82
19769,21905209,21905209,21905306,0,0,0,97
19770,21905253,21905253,21905315,0,0,0,62
19751,21902261,21902261,21905613,0,0,0,3352
19772,21905618,21905618,21905685,0,0,0,67
19773,21905838,21905838,21905906,0,0,0,68
19776,21906863,21906863,21906930,0,0,0,67
19701,21892749,21892749,21907149,0,0,0,14400
19603,21828752,21829659,21907416,0,0,907,78664
19778,21907359,21907359,21907426,0,0,0,67
19779,21907504,21907504,21907571,0,0,0,67
19774,21906063,21906063,21907656,0,0,0,1593
19777,21906998,21906998,21907969,0,0,0,971
19781,21908218,21908218,21908285,0,0,0,67
19780,21908197,21908197,21908350,0,0,0,153
19782,21908344,21908344,21908396,0,0,0,52
19783,21908354,21908354,21908421,0,0,0,67
19784,21908645,21908645,21908769,0,0,0,124
19799,21908779,21908779,21908873,0,0,0,94
19675,21882918,21882918,21909036,0,0,0,26118
19812,21908974,21908974,21909154,0,0,0,180
19846,21909358,21909358,21909490,0,0,0,132
19847,21909371,21909371,21909518,0,0,0,147
19848,21909435,21909435,21909569,0,0,0,134
19850,21909535,21909535,21909607,0,0,0,72
19696,21891973,21891973,21909611,0,0,0,17638
19851,21909544,21909544,21909616,0,0,0,72
19849,21909533,21909533,21909677,0,0,0,144
19813,21909285,21909285,21910029,0,0,0,744
19682,21886125,21886125,21910200,0,0,0,24075
19602,21828740,21829434,21910434,0,0,694,81694
19930,21910088,21910434,21910580,0,0,346,492
19932,21910439,21910439,21910594,0,0,0,155
19941,21910914,21910914,21911018,0,0,0,104
19362,21747367,21747367,21911198,0,0,0,163831
19942,21911253,21911253,21911357,0,0,0,104
19681,21885811,21885811,21911841,0,0,0,26030
19684,21887150,21887150,21914058,0,0,0,26908
19678,21885477,21885477,21914841,0,0,0,29364
19972,21912053,21914841,21915441,0,0,2788,3388
19690,21888978,21888978,21915470,0,0,0,26492
19975,21913908,21915441,21916117,0,0,1533,2209
19982,21916318,21916318,21916396,0,0,0,78
19725,21895950,21895950,21916745,0,0,0,20795
19985,21916716,21916716,21916858,0,0,0,142
19984,21916702,21916702,21916860,0,0,0,158
19986,21916808,21916808,21916861,0,0,0,53
19987,21916817,21916817,21916884,0,0,0,67
19755,21903555,21903555,21917242,0,0,0,13687
19893,21909765,21917242,21917533,0,0,7477,7768
19977,21914395,21916117,21917698,0,0,1722,3303
19979,21914941,21917698,21917791,0,0,2757,2850
19980,21915295,21917698,21918180,0,0,2403,2885
19991,21918433,21918433,21918527,0,0,0,94
19993,21918485,21918485,21918614,0,0,0,129
19892,21909754,21917242,21918859,0,0,7488,9105
19996,21919163,21919163,21919230,0,0,0,67
19775,21906733,21906733,21919697,0,0,0,12964
19997,21919308,21919308,21919697,0,0,0,389
19732,21898179,21898179,21919779,0,0,0,21600
19998,21919739,21919739,21919922,0,0,0,183
19735,21898868,21898868,21919925,0,0,0,21057
19992,21918443,21918443,21920024,0,0,0,1581
20000,21919970,21920024,21920211,0,0,54,241
20001,21920441,21920441,21921599,0,0,0,1158
19748,21902229,21902229,21922423,0,0,0,20194
20004,21922961,21922961,21923090,0,0,0,129
20005,21922981,21922981,21923129,0,0,0,148
20007,21923123,21923123,21923190,0,0,0,67
20006,21923112,21923112,21923195,0,0,0,83
20002,21922419,21922419,21923898,0,0,0,1479
19758,21904113,21904113,21924532,0,0,0,20419
19099,21667066,21667066,21926266,0,0,0,259200
20011,21923915,21924532,21926332,0,0,617,2417
19387,21753763,21753763,21926563,0,0,0,172800
19771,21905585,21905585,21927185,0,0,0,21600
19745,21901666,21901666,21930695,0,0,0,29029
20016,21925069,21930695,21931441,0,0,5626,6372
19107,21672688,21672688,21931888,0,0,0,259200
19108,21672688,21672688,21931888,0,0,0,259200
19109,21672689,21672689,21931889,0,0,0,259200
19110,21672689,21672689,21931889,0,0,0,259200
19111,21672689,21672689,21931889,0,0,0,259200
19112,21672690,21672690,21931890,0,0,0,259200
19113,21672690,21672690,21931890,0,0,0,259200
19744,21901621,21901621,21932097,0,0,0,30476
20017,21926004,21931441,21932165,0,0,5437,6161
19949,21911440,21932097,21932190,0,0,20657,20750
19363,21747395,21747395,21932280,0,0,0,184885
20014,21924589,21931888,21933482,0,0,7299,8893
19136,21684849,21684849,21944049,0,0,0,259200
20026,21938390,21944049,21944903,0,0,5659,6513
20027,21938391,21944903,21945777,0,0,6512,7386
19141,21686979,21686979,21946179,0,0,0,259200
20028,21938392,21945777,21946273,0,0,7385,7881
20029,21938392,21946179,21946675,0,0,7787,8283
20030,21938392,21946273,21946769,0,0,7881,8377
20031,21938392,21946675,21947171,0,0,8283,8779
20032,21938393,21946769,21947296,0,0,8376,8903
19931,21910136,21926563,21950270,0,0,16427,40134
19800,21908779,21908779,21956780,0,0,0,48001
19794,21908778,21908778,21957314,0,0,0,48536
19796,21908778,21908778,21957349,0,0,0,48571
19795,21908778,21908778,21957376,0,0,0,48598
19804,21908780,21908780,21957385,0,0,0,48605
19807,21908781,21908781,21957551,0,0,0,48770
19806,21908781,21908781,21957687,0,0,0,48906
19792,21908777,21908777,21957724,0,0,0,48947
19785,21908776,21908776,21957742,0,0,0,48966
19797,21908778,21908778,21957752,0,0,0,48974
19805,21908781,21908781,21957779,0,0,0,48998
19798,21908778,21908778,21957783,0,0,0,49005
20018,21930631,21957724,21957871,0,0,27093,27240
20019,21932147,21957752,21957899,0,0,25605,25752
19801,21908779,21908779,21957938,0,0,0,49159
20020,21932368,21957783,21957971,0,0,25415,25603
19810,21908782,21908782,21958011,0,0,0,49229
19788,21908777,21908777,21958013,0,0,0,49236
20021,21932369,21957871,21958048,0,0,25502,25679
19811,21908782,21908782,21958073,0,0,0,49291
19808,21908781,21908781,21958189,0,0,0,49408
19809,21908782,21908782,21958276,0,0,0,49494
19802,21908779,21908779,21958280,0,0,0,49501
19789,21908777,21908777,21958429,0,0,0,49652
19829,21909342,21909342,21958500,0,0,0,49158
19838,21909343,21909343,21958504,0,0,0,49161
19790,21908777,21908777,21958527,0,0,0,49750
19971,21911778,21932280,21958671,0,0,20502,46893
19818,21909340,21909340,21958712,0,0,0,49372
19853,21909570,21909570,21958791,0,0,0,49221
19989,21917090,21958504,21958793,0,0,41414,41703
19814,21909339,21909339,21958804,0,0,0,49465
19835,21909343,21909343,21958831,0,0,0,49488
20008,21923250,21958671,21958972,0,0,35421,35722
19988,21917041,21958429,21959059,0,0,41388,42018
20009,21923260,21958793,21959069,0,0,35533,35809
19793,21908777,21908777,21959075,0,0,0,50298
19815,21909339,21909339,21959094,0,0,0,49755
19862,21909731,21909731,21959361,0,0,0,49630
20023,21932520,21957938,21959407,0,0,25418,26887
19863,21909731,21909731,21959640,0,0,0,49909
19852,21909569,21909569,21959670,0,0,0,50101
19819,21909340,21909340,21959972,0,0,0,50632
19823,21909341,21909341,21959973,0,0,0,50632
19834,21909342,21909342,21960062,0,0,0,50720
19856,21909728,21909728,21960067,0,0,0,50339
19840,21909344,21909344,21960198,0,0,0,50854
19816,21909339,21909339,21960219,0,0,0,50880
19803,21908779,21908779,21960220,0,0,0,51441
19855,21909571,21909571,21960313,0,0,0,50742
19820,21909340,21909340,21960344,0,0,0,51004
19976,21914013,21933482,21960354,0,0,19469,46341
19830,21909342,21909342,21960532,0,0,0,51190
19842,21909345,21909345,21960787,0,0,0,51442
19832,21909342,21909342,21960859,0,0,0,51517
19833,21909342,21909342,21961011,0,0,0,51669
19973,21912321,21960344,21961244,0,0,48023,48923
19843,21909345,21909345,21961451,0,0,0,52106
19824,21909341,21909341,21961487,0,0,0,52146
20052,21961325,21961325,21961497,0,0,0,172
19825,21909341,21909341,21961957,0,0,0,52616
19839,21909343,21909343,21961962,0,0,0,52619
19791,21908777,21908777,21961965,0,0,0,53188
19836,21909343,21909343,21962079,0,0,0,52736
19821,21909340,21909340,21962416,0,0,0,53076
20056,21962629,21962629,21962800,0,0,0,171
19874,21909734,21911198,21962873,0,0,1464,53139
20040,21943611,21958013,21962877,0,0,14402,19266
19870,21909733,21911198,21962961,0,0,1465,53228
20057,21962737,21962800,21962978,0,0,63,241
20058,21962848,21962873,21963043,0,0,25,195
19866,21909732,21910434,21963070,0,0,702,53338
19854,21909570,21909570,21963119,0,0,0,53549
19822,21909340,21909340,21963247,0,0,0,53907
19826,21909341,21909341,21963279,0,0,0,53938
19841,21909344,21909344,21963621,0,0,0,54277
19831,21909342,21909342,21964262,0,0,0,54920
19894,21909791,21917242,21964599,0,0,7451,54808
19896,21909792,21917533,21965048,0,0,7741,55256
19844,21909345,21909345,21965632,0,0,0,56287
19875,21909734,21911198,21965873,0,0,1464,56139
19878,21909735,21911841,21965952,0,0,2106,56217
19858,21909730,21909730,21966173,0,0,0,56443
19895,21909791,21917533,21966285,0,0,7742,56494
19827,21909341,21909341,21966561,0,0,0,57220
19974,21912335,21965873,21966773,0,0,53538,54438
19871,21909733,21911198,21966896,0,0,1465,57163
19897,21909792,21918859,21967007,0,0,9067,57215
20024,21932868,21966773,21967606,0,0,33905,34738
19898,21909792,21918859,21967635,0,0,9067,57843
19904,21909794,21919779,21967642,0,0,9985,57848
19903,21909794,21919779,21967766,0,0,9985,57972
19859,21909730,21909730,21967907,0,0,0,58177
19905,21909794,21919922,21967940,0,0,10128,58146
19864,21909731,21910200,21967942,0,0,469,58211
19872,21909733,21911198,21968150,0,0,1465,58417
19901,21909793,21919779,21968275,0,0,9986,58482
19867,21909732,21910434,21968285,0,0,702,58553
20012,21924458,21959972,21968345,0,0,35514,43887
19860,21909730,21909730,21968458,0,0,0,58728
19900,21909793,21919779,21968481,0,0,9986,58688
20015,21924599,21960067,21968528,0,0,35468,43929
19786,21908776,21908776,21968686,0,0,0,59910
19899,21909792,21919697,21968917,0,0,9905,59125
19902,21909793,21919779,21968965,0,0,9986,59172
19906,21909794,21919925,21969342,0,0,10131,59548
19861,21909730,21909730,21969451,0,0,0,59721
19879,21909735,21911841,21969757,0,0,2106,60022
20054,21962156,21962156,21970650,0,0,0,8494
19873,21909733,21911198,21970731,0,0,1465,60998
19907,21909795,21922423,21970972,0,0,12628,61177
19884,21909736,21917242,21971381,0,0,7506,61645
20055,21962314,21963043,21971422,0,0,729,9108
19876,21909734,21911198,21971707,0,0,1464,61973
19877,21909734,21911198,21971738,0,0,1464,62004
19908,21909795,21923898,21972339,0,0,14103,62544
19868,21909732,21911198,21972837,0,0,1466,63105
19880,21909735,21914058,21972929,0,0,4323,63194
19909,21909795,21924532,21973521,0,0,14737,63726
19934,21910491,21926563,21974194,0,0,16072,63703
19913,21909796,21926266,21974228,0,0,16470,64432
19922,21909798,21926266,21974252,0,0,16468,64454
19912,21909796,21926266,21974285,0,0,16470,64489
19921,21909798,21926266,21974314,0,0,16468,64516
19915,21909796,21926266,21974401,0,0,16470,64605
19886,21909736,21917242,21974443,0,0,7506,64707
19914,21909796,21926266,21974460,0,0,16470,64664
19926,21909799,21926266,21974566,0,0,16467,64767
19933,21910490,21926563,21974701,0,0,16073,64211
19919,21909797,21926266,21974717,0,0,16469,64920
19918,21909797,21926266,21974835,0,0,16469,65038
19927,21909799,21926266,21975000,0,0,16467,65201
19935,21910492,21926563,21975058,0,0,16071,64566
19917,21909797,21926266,21975105,0,0,16469,65308
19881,21909735,21914841,21975189,0,0,5106,65454
19911,21909796,21926266,21975299,0,0,16470,65503
19885,21909736,21917242,21975321,0,0,7506,65585
19943,21911304,21927185,21975342,0,0,15881,64038
19923,21909798,21926266,21975440,0,0,16468,65642
19924,21909798,21926266,21975533,0,0,16468,65735
20067,21975515,21975515,21975645,0,0,0,130
19920,21909797,21926266,21975703,0,0,16469,65906
19887,21909736,21917242,21975737,0,0,7506,66001
19937,21910492,21927185,21975752,0,0,16693,65260
19928,21909799,21926266,21975755,0,0,16467,65956
19916,21909797,21926266,21975880,0,0,16469,66083
20068,21975771,21975771,21975922,0,0,0,151
20071,21975952,21975952,21976031,0,0,0,79
19929,21909799,21926266,21976091,0,0,16467,66292
19890,21909737,21917242,21976195,0,0,7505,66458
19910,21909795,21926266,21976432,0,0,16471,66637
20065,21974921,21974921,21976721,0,0,0,1800
19940,21910493,21927185,21976724,0,0,16692,66231
19225,21722411,21722411,21976765,0,0,0,254354
19939,21910493,21927185,21976930,0,0,16692,66437
19938,21910492,21927185,21977015,0,0,16693,66523
19882,21909735,21915470,21977110,0,0,5735,67375
19936,21910492,21926563,21977180,0,0,16071,66688
19837,21909343,21909343,21977451,0,0,0,68108
20072,21975984,21975984,21977465,0,0,0,1481
20078,21977617,21977617,21977699,0,0,0,82
20003,21922437,21957385,21977740,0,0,34948,55303
20080,21977709,21977709,21977762,0,0,0,53
20073,21976195,21976195,21977800,0,0,0,1605
20082,21977815,21977815,21977909,0,0,0,94
19889,21909737,21917242,21977954,0,0,7505,68217
20083,21977992,21977992,21978060,0,0,0,68
20074,21976301,21976301,21978101,0,0,0,1800
19999,21919875,21957376,21978156,0,0,37501,58281
19888,21909736,21917242,21978259,0,0,7506,68523
20081,21977734,21977734,21978262,0,0,0,528
19983,21916682,21957314,21978303,0,0,40632,61621
20013,21924489,21957687,21978332,0,0,33198,53843
20077,21976498,21977800,21978370,0,0,1302,1872
20079,21977675,21977675,21978372,0,0,0,697
20084,21978155,21978155,21978504,0,0,0,349
20085,21978427,21978427,21978505,0,0,0,78
20086,21978466,21978466,21978568,0,0,0,102
19955,21911537,21932097,21978649,0,0,20560,67112
19944,21911439,21930695,21978677,0,0,19256,67238
20043,21952559,21958073,21978716,0,0,5514,26157
20087,21978808,21978808,21978912,0,0,0,104
20044,21952846,21958189,21978929,0,0,5343,26083
20088,21978874,21978874,21979066,0,0,0,192
20089,21979132,21979132,21979256,0,0,0,124
20045,21953002,21958276,21979355,0,0,5274,26353
19978,21914780,21950270,21979391,0,0,35490,64611
20092,21979491,21979491,21979564,0,0,0,73
20090,21979445,21979445,21979627,0,0,0,182
20046,21953193,21958712,21979800,0,0,5519,26607
20093,21979524,21979524,21980124,0,0,0,600
19945,21911439,21931889,21980248,0,0,20450,68809
19946,21911439,21931889,21980397,0,0,20450,68958
19950,21911440,21932097,21980420,0,0,20657,68980
20099,21980381,21980381,21980521,0,0,0,140
20069,21975822,21975822,21980598,0,0,0,4776
20102,21980620,21980620,21980687,0,0,0,67
20103,21980742,21980742,21981094,0,0,0,352
19951,21911440,21932097,21981195,0,0,20657,69755
19963,21911644,21932280,21981273,0,0,20636,69629
19962,21911644,21932190,21981380,0,0,20546,69736
19948,21911439,21932097,21981745,0,0,20658,70306
19947,21911439,21931890,21981759,0,0,20451,70320
20104,21981598,21981598,21981815,0,0,0,217
19964,21911645,21932280,21981877,0,0,20635,70232
20105,21981876,21981876,21982000,0,0,0,124
20106,21981891,21981891,21982046,0,0,0,155
20112,21982095,21982095,21982188,0,0,0,93
19952,21911440,21932097,21982291,0,0,20657,70851
19990,21918033,21961011,21982611,0,0,42978,64578
19965,21911645,21932280,21982675,0,0,20635,71030
19966,21911645,21932280,21982940,0,0,20635,71295
20070,21975892,21975892,21982949,0,0,0,7057
20047,21955854,21958804,21982995,0,0,2950,27141
19981,21915412,21956780,21983517,0,0,41368,68105
20115,21982672,21982672,21983572,0,0,0,900
19969,21911646,21932280,21984052,0,0,20634,72406
19967,21911645,21932280,21984096,0,0,20635,72451
20022,21932479,21957899,21984143,0,0,25420,51664
19970,21911646,21932280,21984652,0,0,20634,73006
20116,21984734,21984734,21984893,0,0,0,159
20118,21984862,21984862,21985041,0,0,0,179
20048,21958595,21958831,21985059,0,0,236,26464
20049,21958688,21958972,21985208,0,0,284,26520
20051,21959096,21959096,21985339,0,0,0,26243
20050,21958941,21958972,21985607,0,0,31,26666
20142,21985804,21985804,21985834,0,0,0,30
20143,21985986,21985986,21986148,0,0,0,162
20108,21981938,21981938,21986549,0,0,0,4611
20025,21933967,21957971,21986696,0,0,24004,52729
19959,21911538,21932097,21986760,0,0,20559,75222
19956,21911537,21932097,21986776,0,0,20560,75239
20146,21986732,21986732,21986888,0,0,0,156
19957,21911537,21932097,21986901,0,0,20560,75364
20010,21923796,21961957,21986973,0,0,38161,63177
19960,21911538,21932097,21987508,0,0,20559,75970
19954,21911536,21932097,21987640,0,0,20561,76104
20111,21982081,21982081,21987950,0,0,0,5869
19250,21728915,21728915,21988115,0,0,0,259200
20148,21988807,21988807,21989096,0,0,0,289
20147,21987577,21987577,21989099,0,0,0,1522
20150,21989064,21989064,21989274,0,0,0,210
20151,21989248,21989248,21989454,0,0,0,206
20152,21989454,21989454,21990055,0,0,0,601
20053,21961435,21961435,21991149,0,0,0,29714
20145,21986510,21986510,21991176,0,0,0,4666
19961,21911538,21932165,21991503,0,0,20627,79965
20059,21962960,21962961,21992311,0,0,1,29351
20156,21992239,21992239,21992411,0,0,0,172
20157,21992357,21992357,21992530,0,0,0,173
20158,21992468,21992468,21992922,0,0,0,454
20161,21993236,21993236,21993329,0,0,0,93
20162,21993434,21993434,21993538,0,0,0,104
20060,21973128,21973128,21993835,0,0,0,20707
20164,21993996,21993996,21994083,0,0,0,87
20062,21973526,21973526,21994120,0,0,0,20594
20064,21974217,21974217,21995120,0,0,0,20903
19787,21908776,21908776,21995176,0,0,0,86400
20063,21974021,21974021,21995235,0,0,0,21214
19817,21909339,21909339,21995739,0,0,0,86400
19828,21909341,21909341,21995741,0,0,0,86400
19845,21909345,21909345,21995745,0,0,0,86400
20154,21991118,21991118,21995859,0,0,0,4741
19857,21909729,21909729,21996129,0,0,0,86400
20114,21982424,21982424,21996413,0,0,0,13989
20170,21996459,21996459,21996548,0,0,0,89
19865,21909731,21910434,21996834,0,0,703,87103
19869,21909732,21911198,21997598,0,0,1466,87866
20149,21988835,21988835,21997660,0,0,0,8825
20171,21996522,21996522,21998244,0,0,0,1722
20172,21996914,21996914,21998714,0,0,0,1800
20061,21973166,21973166,21999485,0,0,0,26319
20176,21998106,21998106,21999627,0,0,0,1521
20180,21999705,21999705,21999891,0,0,0,186
20169,21995788,21995788,22000490,0,0,0,4702
20183,22000722,22000722,22000939,0,0,0,217
20182,22000497,22000497,22001534,0,0,0,1037
20185,22001538,22001538,22001703,0,0,0,165
20186,22001790,22001790,22001953,0,0,0,163
20184,22000726,22000939,22002739,0,0,213,2013
19883,21909735,21916745,22003145,0,0,7010,93410
20190,22002527,22002527,22003399,0,0,0,872
19891,21909737,21917242,22003642,0,0,7505,93905
20098,21979974,21979974,22003658,0,0,0,23684
20191,22003088,22003088,22003896,0,0,0,808
20193,22003865,22003865,22004709,0,0,0,844
20181,22000437,22000437,22005110,0,0,0,4673
20194,22003892,22003892,22005185,0,0,0,1293
20197,22005191,22005191,22005295,0,0,0,104
20179,21999636,21999636,22005409,0,0,0,5773
20199,22005340,22005340,22005546,0,0,0,206
20198,22005199,22005199,22005551,0,0,0,352
20202,22005814,22005814,22006031,0,0,0,217
20175,21997824,21997824,22006159,0,0,0,8335
20203,22005861,22006031,22006211,0,0,170,350
20113,21982271,21982271,22006463,0,0,0,24192
20200,22005539,22005539,22006523,0,0,0,984
20196,22005158,22005158,22006722,0,0,0,1564
20205,22006625,22006625,22006765,0,0,0,140
20207,22006917,22006917,22007114,0,0,0,197
20075,21976311,21976311,22007442,0,0,0,31131
19366,21748357,21748357,22007557,0,0,0,259200
20208,22007755,22007755,22007973,0,0,0,218
20209,22007948,22007948,22008196,0,0,0,248
20206,22006868,22006868,22008440,0,0,0,1572
20210,22008666,22008666,22008775,0,0,0,109
20211,22009238,22009238,22009316,0,0,0,78
20212,22009318,22009318,22009407,0,0,0,89
20213,22009367,22009367,22009440,0,0,0,73
20214,22009367,22009367,22009563,0,0,0,196
20195,22005048,22005048,22009926,0,0,0,4878
20217,22010295,22010295,22010388,0,0,0,93
20218,22010559,22010559,22010653,0,0,0,94
20219,22010764,22010764,22010861,0,0,0,97
20117,21984844,21984844,22010891,0,0,0,26047
20221,22010829,22010829,22011001,0,0,0,172
20222,22010939,22010939,22011090,0,0,0,151
20119,21984971,21984971,22011121,0,0,0,26150
19381,21752200,21752200,22011400,0,0,0,259200
20141,21985513,21985513,22011938,0,0,0,26425
20140,21985295,21985295,22012008,0,0,0,26713
20097,21979711,21979711,22012168,0,0,0,32457
20220,22010787,22010787,22012587,0,0,0,1800
19925,21909798,21926266,22012666,0,0,16468,102868
20225,22011506,22011506,22013080,0,0,0,1574
20187,22001794,22012587,22013187,0,0,10793,11393
20188,22001818,22013187,22013787,0,0,11369,11969
20163,21993788,21993788,22014271,0,0,0,20483
20189,22001825,22013787,22014387,0,0,11962,12562
20201,22005544,22005544,22014544,0,0,0,9000
20215,22009856,22009856,22014579,0,0,0,4723
20165,21994057,21994057,22014775,0,0,0,20718
20167,21995059,21995059,22016143,0,0,0,21084
20168,21995167,21995167,22016173,0,0,0,21006
20076,21976317,21976721,22017680,0,0,404,41363
20233,22016979,22016979,22017879,0,0,0,900
20155,21991979,22017680,22017898,0,0,25701,25919
19254,21731684,21731684,22018246,0,0,0,286562
20234,22017511,22017511,22018411,0,0,0,900
19953,21911535,21932097,22018497,0,0,20562,106962
19958,21911537,21932097,22018497,0,0,20560,106960
19968,21911645,21932280,22018680,0,0,20635,107035
20235,22017816,22017816,22018716,0,0,0,900
20229,22014513,22014513,22019290,0,0,0,4777
20177,21999005,21999005,22020176,0,0,0,21171
20153,21991102,21991102,22020974,0,0,0,29872
20241,22020903,22020903,22021083,0,0,0,180
20242,22021030,22021030,22021202,0,0,0,172
20236,22019172,22019172,22021872,0,0,0,2700
20244,22021851,22021851,22021955,0,0,0,104
20094,21979627,21979627,22022112,0,0,0,42485
19411,21762939,21762939,22022139,0,0,0,259200
20245,22022085,22022085,22022176,0,0,0,91
20159,21992859,21992859,22022278,0,0,0,29419
19413,21763156,21763156,22022356,0,0,0,259200
19414,21763251,21763251,22022451,0,0,0,259200
19416,21763413,21763413,22022613,0,0,0,259200
19417,21763506,21763506,22022706,0,0,0,259200
20160,21993059,21993059,22022892,0,0,0,29833
20237,22019233,22019233,22023993,0,0,0,4760
20249,22025756,22025756,22026239,0,0,0,483
20192,22003619,22003619,22027328,0,0,0,23709
20095,21979701,21979701,22027462,0,0,0,47761
20252,22027419,22027419,22027685,0,0,0,266
20253,22027654,22027654,22027840,0,0,0,186
20248,22023931,22023931,22028738,0,0,0,4807
19422,21769641,21769641,22028841,0,0,0,259200
19132,21683327,21683327,22028927,0,0,0,345600
20204,22006401,22006401,22030548,0,0,0,24147
20255,22028694,22028694,22033487,0,0,0,4793
19994,21918993,21959069,22034970,0,0,40076,115977
20228,22014208,22014208,22035290,0,0,0,21082
20230,22014712,22014712,22035455,0,0,0,20743
19995,21919010,21959407,22035711,0,0,40397,116701
20133,21985277,21985277,22036274,0,0,0,50997
20134,21985277,21985277,22036449,0,0,0,51172
20122,21985169,21985169,22036541,0,0,0,51372
20091,21979485,22036541,22036759,0,0,57056,57274
20130,21985276,21985276,22036855,0,0,0,51579
20120,21985168,21985168,22036943,0,0,0,51775
20132,21985277,21985277,22037215,0,0,0,51938
20232,22016110,22016110,22037233,0,0,0,21123
20231,22016089,22016089,22037265,0,0,0,21176
20223,22011047,22011047,22037344,0,0,0,26297
20224,22011059,22011059,22037385,0,0,0,26326
20121,21985168,21985168,22037501,0,0,0,52333
20271,22037338,22037338,22037516,0,0,0,178
20131,21985276,21985276,22037557,0,0,0,52281
20272,22037451,22037451,22037620,0,0,0,169
20123,21985169,21985169,22037865,0,0,0,52696
20265,22033445,22033445,22038198,0,0,0,4753
20124,21985169,21985169,22038361,0,0,0,53192
20226,22011875,22011875,22038601,0,0,0,26726
20227,22011947,22011947,22038767,0,0,0,26820
20126,21985216,21985216,22039954,0,0,0,54738
20128,21985216,21985216,22040488,0,0,0,55272
20127,21985216,21985216,22040601,0,0,0,55385
20125,21985216,21985216,22040830,0,0,0,55614
20129,21985216,21985216,22041511,0,0,0,56295
20136,21985293,21985293,22042262,0,0,0,56969
20137,21985293,21985293,22042744,0,0,0,57451
20274,22038138,22038138,22042895,0,0,0,4757
20247,22023111,22023111,22042911,0,0,0,19800
20135,21985293,21985293,22043330,0,0,0,58037
20138,21985293,21985293,22045149,0,0,0,59856
20277,22042832,22042832,22047641,0,0,0,4809
20254,22028262,22028262,22048062,0,0,0,19800
20139,21985293,21985293,22050144,0,0,0,64851
20239,22020104,22020104,22050982,0,0,0,30878
20243,22021139,22021139,22051140,0,0,0,30001
20279,22051073,22051073,22051244,0,0,0,171
20251,22027271,22027271,22051365,0,0,0,24094
20280,22051186,22051186,22051365,0,0,0,179
20281,22051291,22051291,22051485,0,0,0,194
20066,21975387,22050982,22051945,0,0,75595,76558
20107,21981920,22051945,22052148,0,0,70025,70228
20246,22022235,22022235,22052154,0,0,0,29919
20278,22047572,22047572,22052313,0,0,0,4741
20263,22030485,22030485,22054463,0,0,0,23978
20266,22035227,22035227,22055960,0,0,0,20733
20267,22035409,22035409,22056060,0,0,0,20651
20285,22052258,22052258,22056987,0,0,0,4729
20269,22037202,22037202,22058266,0,0,0,21064
20268,22037175,22037175,22058363,0,0,0,21188
20238,22019645,22019645,22060253,0,0,0,40608
20110,21981968,22060253,22061029,0,0,78285,79061
20289,22056925,22056925,22061617,0,0,0,4692
20270,22037281,22037281,22063719,0,0,0,26438
20273,22037566,22037566,22063798,0,0,0,26232
20293,22063657,22063657,22063828,0,0,0,171
20295,22063751,22063751,22063902,0,0,0,151
20294,22063727,22063727,22064156,0,0,0,429
20298,22064064,22064064,22064156,0,0,0,92
20299,22064128,22064128,22064300,0,0,0,172
20300,22064256,22064256,22064335,0,0,0,79
20275,22038533,22038533,22065248,0,0,0,26715
20276,22038706,22038706,22065327,0,0,0,26621
20292,22061554,22061554,22066221,0,0,0,4667
20301,22064311,22064311,22067027,0,0,0,2716
20305,22067321,22067321,22067451,0,0,0,130
19522,21814915,21814915,22067515,0,0,0,252600
19523,21815104,21815104,22067704,0,0,0,252600
20240,22020110,22020110,22068236,0,0,0,48126
20306,22068305,22068305,22068373,0,0,0,68
20307,22068395,22068395,22068462,0,0,0,67
20308,22068480,22068480,22068548,0,0,0,68
19527,21815962,21815962,22068562,0,0,0,252600
20309,22068653,22068653,22068735,0,0,0,82
20310,22068749,22068749,22068816,0,0,0,67
20311,22068857,22068857,22068924,0,0,0,67
20312,22069166,22069166,22069255,0,0,0,89
20109,21981944,22068236,22070036,0,0,86292,88092
20304,22066177,22066177,22070832,0,0,0,4655
20318,22071058,22071058,22071151,0,0,0,93
20319,22071501,22071501,22071599,0,0,0,98
20320,22071706,22071706,22071774,0,0,0,68
20321,22071793,22071793,22071890,0,0,0,97
20322,22071811,22071811,22071946,0,0,0,135
20324,22071909,22071909,22071977,0,0,0,68
20323,22071846,22071846,22072230,0,0,0,384
20326,22073012,22073012,22073291,0,0,0,279
20317,22070769,22070769,22075447,0,0,0,4678
20282,22051317,22051317,22075521,0,0,0,24204
20287,22055898,22055898,22076526,0,0,0,20628
20288,22056000,22056000,22076627,0,0,0,20627
20332,22077007,22077007,22077269,0,0,0,262
20333,22077253,22077253,22077369,0,0,0,116
20335,22077409,22077409,22077545,0,0,0,136
20337,22077493,22077493,22077602,0,0,0,109
20339,22078006,22078006,22078132,0,0,0,126
20286,22054401,22054401,22078501,0,0,0,24100
19640,21854130,21854130,22078593,0,0,0,224463
20291,22058308,22058308,22079369,0,0,0,21061
20290,22058213,22058213,22079401,0,0,0,21188
20328,22075388,22075388,22079939,0,0,0,4551
20283,22051398,22051398,22081313,0,0,0,29915
20284,22052092,22052092,22081743,0,0,0,29651
20349,22081680,22081680,22081846,0,0,0,166
20343,22078200,22078200,22083037,0,0,0,4837
20347,22079867,22079867,22084468,0,0,0,4601
20100,21980539,21980539,22088539,0,0,0,108000
20101,21980571,21980598,22088598,0,0,27,108027
20351,22084416,22084416,22088971,0,0,0,4555
20297,22063855,22063855,22090074,0,0,0,26219
20296,22063766,22063766,22090110,0,0,0,26344
20353,22090002,22090002,22090190,0,0,0,188
20354,22090038,22090038,22090215,0,0,0,177
20356,22090157,22090157,22090323,0,0,0,166
20357,22090264,22090264,22090434,0,0,0,170
20358,22090374,22090374,22090544,0,0,0,170
20359,22090481,22090481,22090666,0,0,0,185
20302,22065193,22065193,22091732,0,0,0,26539
20303,22065282,22065282,22092082,0,0,0,26800
20352,22088929,22088929,22093492,0,0,0,4563
20330,22076457,22076457,22097196,0,0,0,20739
19379,21751644,21751644,22097244,0,0,0,345600
20331,22076562,22076562,22097369,0,0,0,20807
20365,22093437,22093437,22098042,0,0,0,4605
20329,22075464,22075464,22099742,0,0,0,24278
20345,22079328,22079328,22100362,0,0,0,21034
20346,22079333,22079333,22100563,0,0,0,21230
20341,22078043,22078043,22100775,0,0,0,22732
20369,22097983,22097983,22102421,0,0,0,4438
20344,22078438,22078438,22102512,0,0,0,24074
20372,22102359,22102359,22106816,0,0,0,4457
20348,22081271,22081271,22111298,0,0,0,30027
20375,22106753,22106753,22111321,0,0,0,4568
20377,22111707,22111707,22111879,0,0,0,172
20350,22082745,22082745,22112717,0,0,0,29972
20325,22072242,22072242,22115442,0,0,0,43200
20376,22111258,22111258,22115771,0,0,0,4513
20174,21997782,22011400,22116193,0,0,13618,118411
20355,22090114,22090114,22116375,0,0,0,26261
20360,22090589,22090589,22116927,0,0,0,26338
20367,22097282,22097282,22117819,0,0,0,20537
20366,22097131,22097131,22117848,0,0,0,20717
20361,22091661,22091661,22118303,0,0,0,26642
20364,22092043,22092043,22118701,0,0,0,26658
20380,22115725,22115725,22120221,0,0,0,4496
20371,22100393,22100393,22121515,0,0,0,21122
20397,22121642,22121642,22121768,0,0,0,126
20370,22099676,22099676,22123105,0,0,0,23429
20373,22102467,22102467,22123522,0,0,0,21055
20388,22120162,22120162,22124711,0,0,0,4549
20374,22102512,22102512,22126552,0,0,0,24040
20400,22124648,22124648,22129167,0,0,0,4519
20402,22129122,22129122,22133725,0,0,0,4603
20384,22117752,22117752,22138366,0,0,0,20614
20403,22133662,22133662,22138406,0,0,0,4744
20385,22117790,22117790,22138438,0,0,0,20648
20378,22111816,22111816,22141582,0,0,0,29766
20407,22141540,22141540,22141717,0,0,0,177
20389,22121463,22121463,22142410,0,0,0,20947
20379,22112641,22112641,22142513,0,0,0,29872
20381,22116336,22116336,22142863,0,0,0,26527
20405,22138334,22138334,22142952,0,0,0,4618
20411,22142812,22142812,22142985,0,0,0,173
20399,22123478,22123478,22144493,0,0,0,21015
20386,22118247,22118247,22144988,0,0,0,26741
20387,22118640,22118640,22145185,0,0,0,26545
20398,22123042,22123042,22146791,0,0,0,23749
20412,22142876,22142876,22147469,0,0,0,4593
20401,22126486,22126486,22150198,0,0,0,23712
20418,22147408,22147408,22152032,0,0,0,4624
20313,22069228,22069228,22155628,0,0,0,86400
20420,22151963,22151963,22156582,0,0,0,4619
20406,22138380,22138380,22159012,0,0,0,20632
20404,22138293,22138293,22159109,0,0,0,20816
20327,22073083,22073083,22159483,0,0,0,86400
20383,22116864,22116864,22160064,0,0,0,43200
20421,22156527,22156527,22161128,0,0,0,4601
20409,22142339,22142339,22163381,0,0,0,21042
20414,22144433,22144433,22165531,0,0,0,21098
20424,22161082,22161082,22165880,0,0,0,4798
20396,22121636,22121636,22166001,0,0,0,44365
20362,22091894,22091894,22167162,0,0,0,75268
20166,21994385,21994385,22168770,0,0,0,174385
20413,22142922,22142922,22169158,0,0,0,26236
20429,22169096,22169096,22169267,0,0,0,171
20427,22165817,22165817,22170593,0,0,0,4776
20417,22146733,22146733,22171012,0,0,0,24279
20416,22145114,22145114,22171330,0,0,0,26216
20415,22144942,22144942,22171625,0,0,0,26683
20408,22141649,22141649,22171720,0,0,0,30071
20435,22171664,22171664,22171836,0,0,0,172
20436,22171773,22171773,22171944,0,0,0,171
20410,22142444,22142444,22172318,0,0,0,29874
20363,22091919,22091919,22172919,0,0,0,81000
20382,22116560,22116560,22173057,0,0,0,56497
20419,22150134,22150134,22174310,0,0,0,24176
20431,22170535,22170535,22175267,0,0,0,4732
20443,22179033,22179033,22179204,0,0,0,171
20444,22179141,22179141,22179311,0,0,0,170
20445,22179249,22179249,22179431,0,0,0,182
20423,22159042,22159042,22179458,0,0,0,20416
20446,22179358,22179358,22179535,0,0,0,177
20422,22158949,22158949,22179619,0,0,0,20670
20448,22179466,22179466,22179643,0,0,0,177
20442,22175202,22175202,22180103,0,0,0,4901
20216,22010013,22010013,22182813,0,0,0,172800
20425,22163326,22163326,22184531,0,0,0,21205
20451,22180044,22180044,22184741,0,0,0,4697
20426,22165469,22165469,22186418,0,0,0,20949
20454,22184700,22184700,22189448,0,0,0,4748
20456,22189396,22189396,22194145,0,0,0,4749
20432,22170970,22170970,22194983,0,0,0,24013
20430,22169204,22169204,22195263,0,0,0,26059
20459,22195221,22195221,22195367,0,0,0,146
20460,22195323,22195323,22195500,0,0,0,177
20434,22171562,22171562,22197859,0,0,0,26297
20433,22171276,22171276,22197895,0,0,0,26619
20439,22174268,22174268,22198061,0,0,0,23793
20457,22194104,22194104,22198897,0,0,0,4793
20447,22179398,22179398,22199821,0,0,0,20423
20449,22179575,22179575,22200153,0,0,0,20578
20338,22077505,22077505,22201766,0,0,0,124261
20438,22172257,22172257,22202039,0,0,0,29782
20437,22171882,22171882,22202047,0,0,0,30165
20096,21979705,21979705,22202942,0,0,0,223237
20465,22198845,22198845,22203620,0,0,0,4775
20336,22077472,22077472,22203707,0,0,0,126235
20334,22077275,22077275,22204388,0,0,0,127113
20471,22204342,22204342,22204539,0,0,0,197
20452,22184471,22184471,22205326,0,0,0,20855
20450,22179582,22179582,22206019,0,0,0,26437
20033,21940210,21947171,22206371,0,0,6961,266161
20034,21940211,21947296,22206496,0,0,7085,266285
20455,22186350,22186350,22207304,0,0,0,20954
20469,22203557,22203557,22208338,0,0,0,4781
20483,22208276,22208276,22213067,0,0,0,4791
20035,21940211,21957349,22216549,0,0,17138,276338
20036,21940211,21957551,22216751,0,0,17340,276540
20037,21940212,21957742,22216942,0,0,17530,276730
20038,21940212,21957779,22216979,0,0,17567,276767
20039,21940212,21958011,22217211,0,0,17799,276999
20041,21944269,21958013,22217213,0,0,13744,272944
20042,21946422,21958048,22217248,0,0,11626,270826
20484,22213010,22213010,22217730,0,0,0,4720
20458,22194922,22194922,22219119,0,0,0,24197
20466,22200093,22200093,22220680,0,0,0,20587
20461,22195432,22195432,22221520,0,0,0,26088
20464,22197993,22197993,22221627,0,0,0,23634
20485,22217690,22217690,22222449,0,0,0,4759
20462,22197806,22197806,22224261,0,0,0,26455
20463,22197832,22197832,22224379,0,0,0,26547
20479,22205263,22205263,22226131,0,0,0,20868
20490,22222397,22222397,22227047,0,0,0,4650
20482,22207248,22207248,22228473,0,0,0,21225
20497,22228880,22228880,22229195,0,0,0,315
20495,22228500,22228500,22229340,0,0,0,840
20178,21999272,21999272,22229367,0,0,0,230095
20496,22228655,22228655,22229468,0,0,0,813
20493,22226984,22226984,22231636,0,0,0,4652
20468,22202000,22202000,22232013,0,0,0,30013
20467,22201966,22201966,22232041,0,0,0,30075
20481,22205963,22205963,22232079,0,0,0,26116
20501,22231984,22231984,22232165,0,0,0,181
20502,22232017,22232017,22232168,0,0,0,151
20504,22232126,22232126,22232303,0,0,0,177
20503,22232096,22232096,22232408,0,0,0,312
20508,22236037,22236037,22236130,0,0,0,93
20499,22231572,22231572,22236295,0,0,0,4723
20510,22236315,22236315,22236408,0,0,0,93
20511,22237145,22237145,22237218,0,0,0,73
20512,22237443,22237443,22237536,0,0,0,93
20513,22237714,22237714,22237807,0,0,0,93
20515,22239262,22239262,22239391,0,0,0,129
20516,22239813,22239813,22239908,0,0,0,95
20509,22236228,22236228,22240848,0,0,0,4620
20518,22240429,22240429,22241003,0,0,0,574
20521,22241310,22241310,22241427,0,0,0,117
20487,22220635,22220635,22241429,0,0,0,20794
20520,22241015,22241015,22241737,0,0,0,722
20507,22235426,22235426,22242017,0,0,0,6591
20514,22238543,22238543,22242602,0,0,0,4059
20486,22219087,22219087,22243393,0,0,0,24306
20527,22243593,22243593,22244341,0,0,0,748
20528,22244572,22244572,22244918,0,0,0,346
20144,21986002,21986002,22245142,0,0,0,259140
20519,22240812,22240812,22245466,0,0,0,4654
20489,22221586,22221586,22245763,0,0,0,24177
20529,22245114,22245114,22247453,0,0,0,2339
20532,22247456,22247456,22247799,0,0,0,343
20488,22221465,22221465,22247878,0,0,0,26413
20534,22247812,22247812,22248164,0,0,0,352
20535,22248107,22248107,22248460,0,0,0,353
20536,22248399,22248399,22248731,0,0,0,332
20533,22247491,22247491,22248866,0,0,0,1375
20538,22248688,22248688,22249051,0,0,0,363
20494,22228411,22228411,22249251,0,0,0,20840
20540,22248979,22248979,22249332,0,0,0,353
20537,22248682,22248682,22249582,0,0,0,900
20543,22249269,22249269,22249623,0,0,0,354
20544,22249552,22249552,22249908,0,0,0,356
20530,22245385,22245385,22250059,0,0,0,4674
20547,22250401,22250401,22250494,0,0,0,93
20548,22250497,22250497,22250600,0,0,0,103
20549,22250540,22250540,22250648,0,0,0,108
20550,22250575,22250575,22250668,0,0,0,93
20551,22250603,22250603,22250761,0,0,0,158
20491,22224200,22224200,22250792,0,0,0,26592
20492,22224317,22224317,22251130,0,0,0,26813
20553,22251048,22251048,22251203,0,0,0,155
20440,22174284,22174284,22251285,0,0,0,77001
20555,22252193,22252193,22252318,0,0,0,125
20524,22242469,22242469,22253280,0,0,0,10811
20560,22253186,22253186,22253341,0,0,0,155
20561,22254032,22254032,22254136,0,0,0,104
20525,22242472,22242472,22254180,0,0,0,11708
20562,22254092,22254092,22254218,0,0,0,126
20563,22254188,22254188,22254334,0,0,0,146
20556,22252345,22252345,22254697,0,0,0,2352
20546,22249996,22249996,22254732,0,0,0,4736
20557,22252785,22252785,22255239,0,0,0,2454
20559,22252802,22252802,22255287,0,0,0,2485
20558,22252793,22252793,22255309,0,0,0,2516
20565,22254733,22254733,22255333,0,0,0,600
20441,22174374,22174374,22255374,0,0,0,81000
20566,22255120,22255120,22256117,0,0,0,997
20572,22256234,22256234,22256318,0,0,0,84
20574,22256604,22256604,22256799,0,0,0,195
20571,22256224,22256224,22256824,0,0,0,600
20573,22256282,22256282,22256928,0,0,0,646
20539,22248726,22248726,22256992,0,0,0,8266
20575,22256869,22256869,22257037,0,0,0,168
20541,22249033,22249033,22257543,0,0,0,8510
20576,22256993,22256993,22257593,0,0,0,600
20578,22257736,22257736,22257814,0,0,0,78
20567,22255437,22255437,22258065,0,0,0,2628
20505,22232235,22232235,22258100,0,0,0,25865
20580,22258034,22258034,22258200,0,0,0,166
20568,22255547,22255547,22258241,0,0,0,2694
20569,22256042,22256042,22258601,0,0,0,2559
20570,22256138,22256138,22258743,0,0,0,2605
20564,22254660,22254660,22259213,0,0,0,4553
20584,22259107,22259107,22259357,0,0,0,250
20587,22259679,22259679,22259746,0,0,0,67
20586,22259357,22259357,22260161,0,0,0,804
20589,22260283,22260283,22260846,0,0,0,563
20579,22257750,22257750,22261276,0,0,0,3526
20577,22257408,22257408,22261495,0,0,0,4087
20588,22260166,22260166,22261702,0,0,0,1536
20522,22241379,22241379,22261757,0,0,0,20378
20500,22231949,22231949,22261790,0,0,0,29841
20593,22261836,22261836,22261846,0,0,0,10
20595,22261891,22261891,22261901,0,0,0,10
20592,22261730,22261730,22261910,0,0,0,180
20594,22261845,22261845,22262000,0,0,0,155
20596,22261964,22261964,22262115,0,0,0,151
20597,22262072,22262072,22262145,0,0,0,73
20506,22232361,22232361,22262315,0,0,0,29954
20590,22261670,22261670,22262422,0,0,0,752
20599,22262257,22262257,22262429,0,0,0,172
20601,22262468,22262468,22262933,0,0,0,465
20585,22259160,22259160,22263785,0,0,0,4625
20173,21997707,22007442,22266642,0,0,9735,268935
20526,22243341,22243341,22267605,0,0,0,24264
20602,22263722,22263722,22268327,0,0,0,4605
20606,22268621,22268621,22268731,0,0,0,110
20607,22268659,22268659,22268758,0,0,0,99
20608,22268687,22268687,22268767,0,0,0,80
20609,22268704,22268704,22268797,0,0,0,93
20610,22269321,22269321,22269755,0,0,0,434
20531,22245706,22245706,22269953,0,0,0,24247
20612,22269628,22269628,22270015,0,0,0,387
20542,22249188,22249188,22270046,0,0,0,20858
20613,22269670,22269670,22272122,0,0,0,2452
20614,22269692,22269692,22272153,0,0,0,2461
20605,22268273,22268273,22272766,0,0,0,4493
20582,22258323,22258323,22275630,0,0,0,17307
20545,22249852,22249852,22276400,0,0,0,26548
20616,22272703,22272703,22277279,0,0,0,4576
20552,22250729,22250729,22277393,0,0,0,26664
20554,22251066,22251066,22277744,0,0,0,26678
20603,22263862,22263862,22281528,0,0,0,17666
20618,22277214,22277214,22281753,0,0,0,4539
20591,22261724,22261724,22282252,0,0,0,20528
20581,22258163,22258163,22284429,0,0,0,26266
20621,22281713,22281713,22286223,0,0,0,4510
20611,22269324,22269324,22287138,0,0,0,17814
20624,22287864,22287864,22287957,0,0,0,93
20257,22029585,22029585,22288785,0,0,0,259200
20258,22029586,22029586,22288786,0,0,0,259200
20259,22029586,22029586,22288786,0,0,0,259200
20260,22029587,22029587,22288787,0,0,0,259200
20261,22029619,22029619,22288819,0,0,0,259200
20262,22029620,22029620,22288820,0,0,0,259200
20264,22030987,22030987,22290187,0,0,0,259200
20250,22026728,22026728,22290363,0,0,0,263635
20623,22286154,22286154,22290645,0,0,0,4491
20604,22267562,22267562,22291723,0,0,0,24161
20598,22262072,22262072,22291934,0,0,0,29862
20600,22262367,22262367,22292194,0,0,0,29827
20638,22292122,22292122,22292299,0,0,0,177
20639,22292242,22292242,22292414,0,0,0,172
20640,22292356,22292356,22292529,0,0,0,173
20641,22292467,22292467,22292636,0,0,0,169
20615,22269890,22269890,22294084,0,0,0,24194
20617,22276338,22276338,22302651,0,0,0,26313
20619,22277362,22277362,22303852,0,0,0,26490
20620,22277702,22277702,22304460,0,0,0,26758
20390,22121530,22121530,22306775,0,0,0,185245
20626,22289197,22289197,22308940,0,0,0,19743
20622,22284372,22284372,22310619,0,0,0,26247
20636,22291678,22291678,22315829,0,0,0,24151
20498,22229313,22229313,22317041,0,0,0,87728
20643,22294038,22294038,22317462,0,0,0,23424
20637,22291872,22291872,22322069,0,0,0,30197
20642,22292574,22292574,22322298,0,0,0,29724
20654,22323382,22323382,22323661,0,0,0,279
20655,22323667,22323667,22324092,0,0,0,425
20658,22323739,22323739,22324405,0,0,0,666
20656,22323701,22323701,22326075,0,0,0,2374
20659,22323756,22323756,22326294,0,0,0,2538
20661,22327363,22327363,22327591,0,0,0,228
20662,22327554,22327554,22328027,0,0,0,473
20634,22290832,22290832,22328265,0,0,0,37433
20650,22319195,22319195,22328328,0,0,0,9133
20314,22069715,22069715,22328915,0,0,0,259200
20660,22327150,22327150,22328950,0,0,0,1800
20315,22069771,22069771,22328971,0,0,0,259200
20644,22302584,22302584,22328976,0,0,0,26392
20316,22069909,22069909,22329109,0,0,0,259200
20665,22329000,22329000,22329144,0,0,0,144
20669,22329297,22329297,22329390,0,0,0,93
20668,22329255,22329255,22329555,0,0,0,300
20651,22319711,22319711,22329611,0,0,0,9900
20666,22329071,22329071,22329741,0,0,0,670
20670,22329710,22329710,22329803,0,0,0,93
20671,22329998,22329998,22330076,0,0,0,78
20625,22288032,22288032,22330548,0,0,0,42516
20340,22078027,22078027,22330627,0,0,0,252600
20342,22078068,22078068,22330668,0,0,0,252600
20667,22329126,22329126,22330724,0,0,0,1598
20646,22304399,22304399,22331228,0,0,0,26829
20645,22303806,22303806,22331254,0,0,0,27448
20676,22332003,22332003,22332077,0,0,0,74
20672,22330271,22330271,22332787,0,0,0,2516
20678,22333149,22333149,22333366,0,0,0,217
20684,22335334,22335334,22335412,0,0,0,78
20683,22335326,22335326,22335467,0,0,0,141
20583,22258989,22258989,22336340,0,0,0,77351
20686,22336350,22336350,22336536,0,0,0,186
20687,22336372,22336372,22336569,0,0,0,197
20688,22336394,22336394,22336592,0,0,0,198
20690,22336695,22336695,22336850,0,0,0,155
20689,22336414,22336592,22336903,0,0,178,489
20647,22310552,22310552,22337062,0,0,0,26510
20682,22334928,22334928,22337442,0,0,0,2514
20648,22315789,22315789,22339821,0,0,0,24032
20673,22330632,22330632,22340828,0,0,0,10196
20649,22317389,22317389,22341120,0,0,0,23731
20657,22323730,22323730,22343076,0,0,0,19346
20692,22337350,22337350,22343394,0,0,0,6044
20696,22341787,22341787,22343693,0,0,0,1906
20698,22343664,22343664,22343762,0,0,0,98
20685,22335724,22335724,22343792,0,0,0,8068
20699,22343976,22343976,22344117,0,0,0,141
20701,22344195,22344195,22344582,0,0,0,387
20677,22332040,22332040,22345012,0,0,0,12972
20700,22344116,22344116,22345916,0,0,0,1800
20695,22341738,22341738,22346294,0,0,0,4556
20705,22346262,22346262,22347662,0,0,0,1400
20709,22348889,22348889,22348961,0,0,0,72
20710,22348962,22348962,22349038,0,0,0,76
20711,22349078,22349078,22349156,0,0,0,78
20712,22349289,22349289,22349356,0,0,0,67
20713,22349382,22349382,22349449,0,0,0,67
20715,22349660,22349660,22349742,0,0,0,82
20716,22349894,22349894,22350003,0,0,0,109
20704,22346236,22346236,22350706,0,0,0,4470
20718,22351214,22351214,22351328,0,0,0,114
20719,22351318,22351318,22351416,0,0,0,98
20720,22351420,22351420,22351519,0,0,0,99
20721,22351520,22351520,22351603,0,0,0,83
20722,22351567,22351567,22351657,0,0,0,90
20652,22322022,22322022,22351946,0,0,0,29924
20724,22351911,22351911,22351994,0,0,0,83
20723,22351873,22351873,22352040,0,0,0,167
20725,22351947,22351947,22352067,0,0,0,120
20729,22352107,22352107,22352148,0,0,0,41
20726,22351994,22351994,22352150,0,0,0,156
20728,22352106,22352106,22352209,0,0,0,103
20653,22322236,22322236,22352430,0,0,0,30194
20732,22352473,22352473,22352571,0,0,0,98
20730,22352247,22352247,22352847,0,0,0,600
20733,22352833,22352833,22352937,0,0,0,104
20734,22353301,22353301,22353355,0,0,0,54
20735,22353359,22353359,22353415,0,0,0,56
20736,22353379,22353379,22353498,0,0,0,119
20737,22353608,22353608,22353676,0,0,0,68
20738,22354266,22354266,22354302,0,0,0,36
20739,22354547,22354547,22354646,0,0,0,99
20740,22354891,22354891,22355000,0,0,0,109
20717,22350670,22350670,22355102,0,0,0,4432
20742,22355106,22355106,22355173,0,0,0,67
20743,22355137,22355137,22355236,0,0,0,99
20664,22328908,22328908,22355261,0,0,0,26353
20745,22355318,22355318,22355417,0,0,0,99
20746,22355463,22355463,22355593,0,0,0,130
20747,22355814,22355814,22355892,0,0,0,78
20748,22355894,22355894,22355961,0,0,0,67
20749,22356115,22356115,22356162,0,0,0,47
20750,22356301,22356301,22356430,0,0,0,129
20751,22356745,22356745,22356843,0,0,0,98
20752,22357032,22357032,22357079,0,0,0,47
20753,22357206,22357206,22357284,0,0,0,78
20453,22184652,22184652,22357452,0,0,0,172800
20754,22357363,22357363,22357459,0,0,0,96
20755,22357689,22357689,22357769,0,0,0,80
20756,22357768,22357768,22357835,0,0,0,67
20675,22331196,22331196,22358126,0,0,0,26930
20674,22331154,22331154,22358213,0,0,0,27059
20741,22355035,22355035,22359527,0,0,0,4492
20691,22337004,22337004,22363594,0,0,0,26590
20759,22359490,22359490,22363952,0,0,0,4462
20693,22339760,22339760,22363988,0,0,0,24228
20694,22341062,22341062,22365393,0,0,0,24331
20761,22363908,22363908,22368415,0,0,0,4507
20764,22368359,22368359,22372940,0,0,0,4581
20256,22029496,22029496,22375096,0,0,0,345600
20765,22372877,22372877,22377475,0,0,0,4598
20391,22121543,22121543,22380743,0,0,0,259200
20392,22121552,22121552,22380752,0,0,0,259200
20393,22121571,22121571,22380771,0,0,0,259200
20394,22121576,22121576,22380776,0,0,0,259200
20395,22121581,22121581,22380781,0,0,0,259200
20744,22355202,22355202,22381636,0,0,0,26434
20766,22377413,22377413,22381993,0,0,0,4580
20727,22352105,22352105,22382300,0,0,0,30195
20731,22352364,22352364,22382388,0,0,0,30024
20702,22344835,22344835,22384097,0,0,0,39262
20757,22358060,22358060,22384786,0,0,0,26726
20758,22358150,22358150,22384964,0,0,0,26814
20769,22381931,22381931,22386536,0,0,0,4605
20762,22363921,22363921,22388417,0,0,0,24496
20703,22344905,22344905,22388790,0,0,0,43885
20763,22365322,22365322,22389229,0,0,0,23907
20760,22363524,22363524,22390041,0,0,0,26517
20774,22386467,22386467,22391107,0,0,0,4640
20714,22349448,22349448,22392648,0,0,0,43200
20778,22391044,22391044,22395714,0,0,0,4670
20779,22395659,22395659,22400222,0,0,0,4563
20780,22400176,22400176,22404813,0,0,0,4637
20782,22405821,22405821,22405993,0,0,0,172
20784,22405900,22405900,22406087,0,0,0,187
20783,22405844,22405844,22406118,0,0,0,274
20786,22407505,22407505,22407634,0,0,0,129
20517,22240165,22240165,22407668,0,0,0,167503
20768,22381576,22381576,22408198,0,0,0,26622
20787,22408133,22408133,22408295,0,0,0,162
20788,22408161,22408161,22408297,0,0,0,136
20790,22408265,22408265,22408375,0,0,0,110
20789,22408241,22408241,22408425,0,0,0,184
20796,22408702,22408702,22408800,0,0,0,98
20798,22408993,22408993,22409113,0,0,0,120
20799,22409019,22409019,22409262,0,0,0,243
20781,22404755,22404755,22409380,0,0,0,4625
20797,22408803,22408803,22409703,0,0,0,900
20801,22409470,22409470,22409742,0,0,0,272
20804,22410298,22410298,22410391,0,0,0,93
20803,22410278,22410278,22410961,0,0,0,683
20805,22411068,22411068,22411172,0,0,0,104
20806,22411139,22411139,22411243,0,0,0,104
20772,22384718,22384718,22411495,0,0,0,26777
20808,22411548,22411548,22411658,0,0,0,110
20809,22411626,22411626,22411702,0,0,0,76
20771,22382329,22382329,22411733,0,0,0,29404
20810,22411670,22411670,22411842,0,0,0,172
20773,22384901,22384901,22411902,0,0,0,27001
20770,22382240,22382240,22411926,0,0,0,29686
20775,22388377,22388377,22412363,0,0,0,23986
20815,22412646,22412646,22412744,0,0,0,98
20816,22412854,22412854,22412952,0,0,0,98
20817,22412952,22412952,22412999,0,0,0,47
20818,22413003,22413003,22413087,0,0,0,84
20819,22413157,22413157,22413215,0,0,0,58
20820,22413290,22413290,22413358,0,0,0,68
20776,22389192,22389192,22413392,0,0,0,24200
20821,22413320,22413320,22413397,0,0,0,77
20823,22413360,22413360,22413397,0,0,0,37
20825,22413511,22413511,22413603,0,0,0,92
20829,22413705,22413705,22413765,0,0,0,60
20831,22413730,22413730,22413793,0,0,0,63
20834,22413797,22413797,22413895,0,0,0,98
20800,22409317,22409317,22414083,0,0,0,4766
20830,22413711,22413711,22414190,0,0,0,479
20832,22413738,22413738,22414240,0,0,0,502
20828,22413681,22413681,22414295,0,0,0,614
20837,22414259,22414259,22414326,0,0,0,67
20827,22413661,22413661,22414760,0,0,0,1099
20663,22328642,22328642,22415042,0,0,0,86400
20838,22415235,22415235,22415302,0,0,0,67
20839,22415502,22415502,22415626,0,0,0,124
20826,22413578,22413578,22415694,0,0,0,2116
20840,22415637,22415637,22415694,0,0,0,57
20841,22415658,22415658,22415756,0,0,0,98
20842,22415802,22415802,22415869,0,0,0,67
20824,22413413,22413413,22415870,0,0,0,2457
20843,22415875,22415875,22415957,0,0,0,82
20844,22415957,22415957,22416042,0,0,0,85
20845,22415982,22415982,22416071,0,0,0,89
20846,22416086,22416086,22416153,0,0,0,67
20847,22416189,22416189,22416277,0,0,0,88
20777,22389986,22389986,22416494,0,0,0,26508
20848,22416402,22416402,22416574,0,0,0,172
20849,22416511,22416511,22416682,0,0,0,171
20850,22416619,22416619,22416788,0,0,0,169
20836,22414020,22414020,22418743,0,0,0,4723
20785,22406631,22406631,22419207,0,0,0,12576
20428,22167672,22167672,22420272,0,0,0,252600
20853,22422433,22422433,22422551,0,0,0,118
20854,22422498,22422498,22422592,0,0,0,94
20855,22422529,22422529,22422654,0,0,0,125
20856,22422648,22422648,22422784,0,0,0,136
20857,22422731,22422731,22422814,0,0,0,83
20858,22422748,22422748,22422889,0,0,0,141
20859,22422837,22422837,22422973,0,0,0,136
20861,22423004,22423004,22423082,0,0,0,78
20860,22422937,22422937,22423088,0,0,0,151
20863,22423182,22423182,22423273,0,0,0,91
20852,22418676,22418676,22423331,0,0,0,4655
20697,22343301,22343301,22424301,0,0,0,81000
20865,22424720,22424720,22424844,0,0,0,124
20866,22424845,22424845,22424969,0,0,0,124
20867,22425064,22425064,22425188,0,0,0,124
20868,22425448,22425448,22425509,0,0,0,61
20707,22348124,22348124,22425535,0,0,0,77411
20870,22425635,22425635,22425702,0,0,0,67
20871,22425978,22425978,22426144,0,0,0,166
20873,22426183,22426183,22426783,0,0,0,600
20872,22426118,22426118,22426924,0,0,0,806
20875,22426950,22426950,22427001,0,0,0,51
20862,22423047,22423047,22427266,0,0,0,4219
20874,22426877,22426877,22427270,0,0,0,393
20877,22427227,22427227,22427363,0,0,0,136
20878,22427300,22427300,22427394,0,0,0,94
20869,22425477,22425477,22427582,0,0,0,2105
20879,22427535,22427535,22427602,0,0,0,67
20880,22427634,22427634,22427719,0,0,0,85
20882,22427726,22427726,22427820,0,0,0,94
20883,22427881,22427881,22427928,0,0,0,47
20864,22423273,22423273,22427991,0,0,0,4718
20885,22427940,22427940,22428142,0,0,0,202
20889,22428284,22428284,22428359,0,0,0,75
20891,22428324,22428324,22428423,0,0,0,99
20887,22428238,22428238,22428492,0,0,0,254
20892,22428440,22428440,22428585,0,0,0,145
20893,22428935,22428935,22429112,0,0,0,177
20895,22429218,22429218,22429313,0,0,0,95
20876,22426969,22426969,22429698,0,0,0,2729
20896,22429577,22429577,22429698,0,0,0,121
20894,22429107,22429107,22429707,0,0,0,600
20899,22429655,22429655,22429733,0,0,0,78
20898,22429650,22429650,22429761,0,0,0,111
20900,22429704,22429704,22429773,0,0,0,69
20897,22429628,22429628,22429801,0,0,0,173
20901,22429758,22429758,22430467,0,0,0,709
20903,22430380,22430380,22430511,0,0,0,131
20906,22430480,22430480,22430573,0,0,0,93
20905,22430474,22430474,22430598,0,0,0,124
20904,22430456,22430456,22430798,0,0,0,342
20908,22430703,22430703,22430875,0,0,0,172
20907,22430652,22430652,22431111,0,0,0,459
20912,22431110,22431110,22431194,0,0,0,84
20911,22431050,22431050,22431237,0,0,0,187
20913,22431155,22431155,22431279,0,0,0,124
20914,22431428,22431428,22431537,0,0,0,109
20909,22430995,22430995,22431595,0,0,0,600
20915,22431428,22431428,22431596,0,0,0,168
20916,22431607,22431607,22431772,0,0,0,165
20910,22431021,22431021,22431782,0,0,0,761
20918,22431788,22431788,22431898,0,0,0,110
20833,22413744,22413744,22432013,0,0,0,18269
20921,22431984,22431984,22432149,0,0,0,165
20922,22432046,22432046,22432200,0,0,0,154
20923,22432105,22432105,22432291,0,0,0,186
20924,22432247,22432247,22432369,0,0,0,122
20884,22427927,22427927,22432661,0,0,0,4734
20919,22431911,22431911,22432721,0,0,0,810
20926,22432430,22432430,22433030,0,0,0,600
20917,22431747,22431747,22433332,0,0,0,1585
20929,22433329,22433329,22433461,0,0,0,132
20925,22432336,22432336,22434136,0,0,0,1800
20932,22434241,22434241,22434365,0,0,0,124
20931,22434189,22434189,22434425,0,0,0,236
20933,22434391,22434391,22434469,0,0,0,78
20934,22434615,22434615,22434683,0,0,0,68
20935,22434784,22434784,22434866,0,0,0,82
20936,22434893,22434893,22434992,0,0,0,99
20791,22408344,22408344,22435033,0,0,0,26689
20938,22435356,22435356,22435527,0,0,0,171
20814,22412303,22412303,22436179,0,0,0,23876
20939,22435646,22435646,22436246,0,0,0,600
20928,22432577,22432577,22437248,0,0,0,4671
20822,22413341,22413341,22437670,0,0,0,24329
20945,22438059,22438059,22438133,0,0,0,74
20948,22438060,22438060,22438133,0,0,0,73
20946,22438060,22438060,22438153,0,0,0,93
20949,22438060,22438060,22438153,0,0,0,93
20950,22438061,22438061,22438154,0,0,0,93
20951,22438061,22438061,22438154,0,0,0,93
20952,22438061,22438061,22438154,0,0,0,93
20953,22438061,22438061,22438154,0,0,0,93
20954,22438062,22438062,22438155,0,0,0,93
20947,22438060,22438060,22438164,0,0,0,104
20955,22438062,22438062,22438169,0,0,0,107
20956,22438062,22438062,22438169,0,0,0,107
20957,22438063,22438063,22438173,0,0,0,110
20964,22438064,22438154,22438209,0,0,90,145
20963,22438064,22438154,22438231,0,0,90,167
20807,22411442,22411442,22438236,0,0,0,26794
20959,22438063,22438133,22438237,0,0,70,174
20962,22438064,22438154,22438242,0,0,90,178
20958,22438063,22438133,22438243,0,0,70,180
20960,22438063,22438153,22438246,0,0,90,183
20961,22438064,22438153,22438252,0,0,89,188
20944,22437923,22437923,22438523,0,0,0,600
20812,22411838,22411838,22438783,0,0,0,26945
20969,22439033,22439033,22439143,0,0,0,110
20968,22438790,22438790,22439390,0,0,0,600
20991,22439804,22439804,22440094,0,0,0,290
20990,22439748,22439748,22440248,0,0,0,500
20966,22438589,22438589,22440338,0,0,0,1749
20992,22440415,22440415,22440940,0,0,0,525
21093,22440999,22440999,22441077,0,0,0,78
21094,22441258,22441258,22441387,0,0,0,129
20813,22411870,22411870,22441522,0,0,0,29652
21096,22441695,22441695,22441765,0,0,0,70
21097,22441731,22441731,22441767,0,0,0,36
20940,22437197,22437197,22441845,0,0,0,4648
20811,22411780,22411780,22441937,0,0,0,30157
21099,22441874,22441874,22442046,0,0,0,172
21102,22442187,22442187,22442223,0,0,0,36
21101,22442157,22442157,22442224,0,0,0,67
21103,22442349,22442349,22442407,0,0,0,58
21104,22442394,22442394,22442560,0,0,0,166
20851,22416726,22416726,22443165,0,0,0,26439
20368,22097698,22097698,22443298,0,0,0,345600
21106,22443211,22443211,22443332,0,0,0,121
21109,22443898,22443898,22444022,0,0,0,124
20941,22437528,22437528,22444128,0,0,0,6600
20943,22437734,22437734,22444334,0,0,0,6600
21107,22443798,22443798,22444384,0,0,0,586
21108,22443896,22444128,22444854,0,0,232,958
20976,22439604,22439604,22445040,0,0,0,5436
20970,22439604,22439604,22445044,0,0,0,5440
20973,22439604,22439604,22445061,0,0,0,5457
20980,22439605,22439605,22445066,0,0,0,5461
20979,22439605,22439605,22445072,0,0,0,5467
20981,22439605,22439605,22445072,0,0,0,5467
20982,22439605,22439605,22445125,0,0,0,5520
20974,22439604,22439604,22445357,0,0,0,5753
20975,22439604,22439604,22445373,0,0,0,5769
20978,22439605,22439605,22445384,0,0,0,5779
20971,22439604,22439604,22445643,0,0,0,6039
20977,22439605,22439605,22445665,0,0,0,6060
20972,22439604,22439604,22445682,0,0,0,6078
21098,22441789,22441789,22446454,0,0,0,4665
21110,22445828,22445828,22446603,0,0,0,775
20983,22439605,22443298,22449067,0,0,3693,9462
20984,22439606,22445040,22450507,0,0,5434,10901
20985,22439606,22445044,22450511,0,0,5438,10905
20986,22439606,22445061,22450528,0,0,5455,10922
20993,22440522,22445125,22450592,0,0,4603,10070
20987,22439606,22445066,22450804,0,0,5460,11198
20988,22439606,22445072,22450841,0,0,5466,11235
20994,22440523,22445357,22450866,0,0,4834,10343
20989,22439606,22445072,22451102,0,0,5466,11496
20995,22440523,22445373,22451111,0,0,4850,10588
20997,22440524,22445643,22451152,0,0,5119,10628
21111,22446398,22446454,22451173,0,0,56,4775
20996,22440523,22445384,22451402,0,0,4861,10879
20998,22440524,22445665,22451434,0,0,5141,10910
20999,22440524,22445682,22451774,0,0,5158,11250
20792,22408394,22408394,22452622,0,0,0,44228
21112,22451059,22451059,22455756,0,0,0,4697
21001,22440525,22450507,22456016,0,0,9982,15491
21002,22440525,22450511,22456063,0,0,9986,15538
21005,22440526,22450804,22456313,0,0,10278,15787
21003,22440525,22450528,22456340,0,0,10003,15815
21009,22440527,22451111,22456577,0,0,10584,16050
21006,22440526,22450841,22456610,0,0,10315,16084
21010,22440527,22451152,22456618,0,0,10625,16091
21007,22440526,22450866,22456635,0,0,10340,16109
21004,22440525,22450592,22456653,0,0,10067,16128
21011,22440527,22451402,22456868,0,0,10875,16341
21008,22440526,22451102,22456945,0,0,10576,16419
21012,22440528,22451434,22457203,0,0,10906,16675
21013,22440608,22451774,22457240,0,0,11166,16632
21015,22440608,22452622,22458080,0,0,12014,17472
21014,22440608,22452622,22458088,0,0,12014,17480
21017,22440609,22452622,22458387,0,0,12013,17778
21018,22440609,22452622,22458680,0,0,12013,18071
21016,22440609,22452622,22458686,0,0,12013,18077
21113,22455693,22455693,22460422,0,0,0,4729
21019,22440609,22456016,22461478,0,0,15407,20869
20937,22434991,22434991,22461535,0,0,0,26544
21022,22440610,22456340,22461824,0,0,15730,21214
21020,22440610,22456063,22461848,0,0,15453,21238
20942,22437607,22437607,22461856,0,0,0,24249
21023,22440610,22456577,22462048,0,0,15967,21438
21021,22440610,22456313,22462094,0,0,15703,21484
21026,22440611,22456635,22462119,0,0,16024,21508
21024,22440611,22456610,22462369,0,0,15999,21758
21030,22440612,22457203,22462671,0,0,16591,22059
21025,22440611,22456618,22462676,0,0,16007,22065
21027,22440611,22456653,22462695,0,0,16042,22084
21028,22440612,22456868,22462934,0,0,16256,22322
21029,22440612,22456945,22462980,0,0,16333,22368
21031,22440612,22457240,22463297,0,0,16628,22685
20470,22204341,22204341,22463541,0,0,0,259200
20472,22204342,22204342,22463542,0,0,0,259200
20473,22204342,22204342,22463542,0,0,0,259200
20474,22204342,22204342,22463542,0,0,0,259200
20475,22204342,22204342,22463542,0,0,0,259200
20476,22204342,22204342,22463542,0,0,0,259200
21032,22440612,22458080,22463848,0,0,17468,23236
20477,22204745,22204745,22463945,0,0,0,259200
21033,22440626,22458088,22464127,0,0,17462,23501
20478,22204973,22204973,22464173,0,0,0,259200
21034,22440626,22458387,22464214,0,0,17761,23588
21036,22440627,22458686,22464441,0,0,18059,23814
21035,22440626,22458680,22464728,0,0,18054,24102
21114,22460381,22460381,22465024,0,0,0,4643
20480,22205845,22205845,22465045,0,0,0,259200
20965,22438192,22438192,22465144,0,0,0,26952
20967,22438717,22438717,22465328,0,0,0,26611
21037,22440627,22461478,22466960,0,0,20851,26333
21038,22440627,22461824,22467286,0,0,21197,26659
21039,22440627,22461848,22467616,0,0,21221,26989
21040,22440627,22462048,22467847,0,0,21421,27220
21042,22440627,22462119,22467890,0,0,21492,27263
21043,22440628,22462369,22468131,0,0,21741,27503
21041,22440627,22462094,22468152,0,0,21467,27525
21044,22440628,22462671,22468434,0,0,22043,27806
21048,22440628,22462980,22468446,0,0,22352,27818
21045,22440628,22462676,22468470,0,0,22048,27842
21047,22440628,22462934,22468677,0,0,22306,28049
21046,22440628,22462695,22468730,0,0,22067,28102
21049,22440629,22463297,22469104,0,0,22668,28475
21050,22440629,22463542,22469307,0,0,22913,28678
21051,22440630,22463848,22469340,0,0,23218,28710
21053,22440658,22464127,22469586,0,0,23469,28928
20930,22433599,22433599,22469599,0,0,0,36000
21128,22464992,22464992,22469614,0,0,0,4622
21054,22440660,22464214,22469680,0,0,23554,29020
21105,22443121,22443121,22469689,0,0,0,26568
21052,22440630,22463945,22469998,0,0,23315,29368
21055,22440660,22464441,22470169,0,0,23781,29509
21056,22440660,22464728,22470241,0,0,24068,29581
21095,22441480,22441480,22471438,0,0,0,29958
21100,22441985,22441985,22471590,0,0,0,29605
21058,22440661,22467286,22472748,0,0,26625,32087
21057,22440660,22466960,22472998,0,0,26300,32338
21000,22440524,22449067,22473065,0,0,8543,32541
21060,22440661,22467847,22473326,0,0,27186,32665
21059,22440661,22467616,22473385,0,0,26955,32724
21062,22440662,22468131,22473592,0,0,27469,32930
21063,22440662,22468152,22473593,0,0,27490,32931
21061,22440661,22467890,22473656,0,0,27229,32995
21066,22440663,22468470,22473974,0,0,27807,33311
21067,22440663,22468677,22474150,0,0,28014,33487
21064,22440662,22468434,22474186,0,0,27772,33524
21065,22440662,22468446,22474500,0,0,27784,33838
21070,22440664,22469307,22474775,0,0,28643,34111
21068,22440663,22468730,22474808,0,0,28067,34145
21071,22440664,22469340,22474839,0,0,28676,34175
21069,22440663,22469104,22474886,0,0,28441,34223
21073,22440683,22469599,22475074,0,0,28916,34391
21135,22471367,22475074,22475256,0,0,3707,3889
21136,22471485,22475256,22475402,0,0,3771,3917
21075,22440684,22469998,22475471,0,0,29314,34787
21072,22440664,22469586,22475660,0,0,28922,34996
21074,22440684,22469680,22475739,0,0,28996,35055
21076,22440684,22470169,22475897,0,0,29485,35213
21077,22440684,22470241,22475995,0,0,29557,35311
21078,22440685,22472748,22478196,0,0,32063,37511
21079,22440685,22472998,22478798,0,0,32313,38113
21081,22440685,22473326,22478804,0,0,32641,38119
21080,22440685,22473065,22478831,0,0,32380,38146
21082,22440686,22473385,22478863,0,0,32699,38177
21083,22440686,22473592,22479066,0,0,32906,38380
21085,22440686,22473656,22479141,0,0,32970,38455
21139,22474048,22474886,22479416,0,0,838,5368
21086,22440687,22473974,22479443,0,0,33287,38756
21133,22469547,22474886,22479457,0,0,5339,9910
21087,22440687,22474150,22479612,0,0,33463,38925
21084,22440686,22473593,22479619,0,0,32907,38933
21088,22440687,22474186,22479663,0,0,33499,38976
21089,22440687,22474500,22480531,0,0,33813,39844
21090,22440687,22474775,22480858,0,0,34088,40171
21091,22440688,22474808,22480891,0,0,34120,40203
21092,22440688,22474839,22480953,0,0,34151,40265
21140,22478543,22478543,22483175,0,0,0,4632
21119,22461791,22461856,22485993,0,0,65,24202
21141,22483113,22483175,22487762,0,0,62,4649
21117,22461493,22461535,22488033,0,0,42,26540
20886,22428223,22428223,22490989,0,0,0,62766
20888,22428250,22428250,22491223,0,0,0,62973
20902,22430297,22430297,22491319,0,0,0,61022
21143,22487637,22487762,22492357,0,0,125,4720
21150,22495838,22495838,22496148,0,0,0,310
21129,22465081,22469689,22496351,0,0,4608,31270
21153,22496510,22496510,22496616,0,0,0,106
21146,22492170,22492170,22496690,0,0,0,4520
21155,22496583,22496583,22496754,0,0,0,171
21158,22496918,22496918,22497427,0,0,0,509
21130,22465300,22471438,22498488,0,0,6138,33188
21160,22497098,22498488,22498561,0,0,1390,1463
21157,22496828,22496828,22498628,0,0,0,1800
21168,22498208,22498208,22498633,0,0,0,425
21161,22497182,22498561,22498654,0,0,1379,1472
21162,22497372,22498628,22498721,0,0,1256,1349
21163,22497399,22498654,22498800,0,0,1255,1401
21166,22497844,22498721,22498814,0,0,877,970
21170,22498960,22498960,22499040,0,0,0,80
21172,22499031,22499031,22499129,0,0,0,98
21159,22496933,22497427,22499227,0,0,494,2294
21173,22499543,22499543,22499678,0,0,0,135
21175,22499780,22499780,22499847,0,0,0,67
21174,22499645,22499678,22499849,0,0,33,204
21176,22499849,22499849,22500020,0,0,0,171
21178,22500168,22500168,22500328,0,0,0,160
20523,22241401,22241401,22500601,0,0,0,259200
21171,22498978,22498978,22500740,0,0,0,1762
21179,22500687,22500687,22500812,0,0,0,125
21180,22500807,22500807,22500958,0,0,0,151
21156,22496644,22496644,22501165,0,0,0,4521
21177,22499892,22499892,22501692,0,0,0,1800
21134,22469622,22474886,22501826,0,0,5264,32204
21183,22501216,22501692,22501856,0,0,476,640
21185,22501580,22501580,22501942,0,0,0,362
21184,22501413,22501826,22502324,0,0,413,911
21188,22502234,22502234,22502927,0,0,0,693
21189,22503550,22503550,22504243,0,0,0,693
21190,22504513,22504513,22504884,0,0,0,371
21137,22471521,22475402,22505153,0,0,3881,33632
21138,22471587,22475471,22505357,0,0,3884,33770
21182,22501124,22501124,22505647,0,0,0,4523
21181,22500829,22500829,22506387,0,0,0,5558
20890,22428303,22428303,22506439,0,0,0,78136
21164,22497541,22506439,22506532,0,0,8898,8991
21167,22498134,22506532,22506641,0,0,8398,8507
21191,22505351,22506641,22506734,0,0,1290,1383
21194,22507029,22507029,22507238,0,0,0,209
21196,22507340,22507340,22507527,0,0,0,187
21193,22505768,22505768,22507568,0,0,0,1800
21197,22507387,22507387,22507611,0,0,0,224
21198,22507579,22507579,22507723,0,0,0,144
21199,22507726,22507726,22507877,0,0,0,151
21201,22507927,22507927,22508045,0,0,0,118
20706,22347472,22347472,22508065,0,0,0,160593
21203,22508301,22508301,22508912,0,0,0,611
21195,22507093,22507093,22508915,0,0,0,1822
21204,22508819,22508819,22509408,0,0,0,589
21200,22507846,22507846,22509646,0,0,0,1800
21142,22485951,22485993,22510101,0,0,42,24150
21192,22505583,22505583,22510133,0,0,0,4550
21208,22510140,22510140,22510207,0,0,0,67
21205,22509990,22509990,22511492,0,0,0,1502
21210,22511079,22511079,22511918,0,0,0,839
21214,22512559,22512559,22512626,0,0,0,67
21215,22512629,22512629,22512696,0,0,0,67
21213,22512394,22512394,22512965,0,0,0,571
21211,22511612,22511612,22513090,0,0,0,1478
21216,22512733,22512733,22513117,0,0,0,384
21217,22512868,22513090,22513214,0,0,222,346
21218,22513606,22513606,22513688,0,0,0,82
21219,22513651,22513651,22513718,0,0,0,67
21220,22513714,22513714,22513761,0,0,0,47
21212,22511842,22511842,22513788,0,0,0,1946
21221,22513807,22513807,22513885,0,0,0,78
21207,22510070,22510070,22513917,0,0,0,3847
21222,22513807,22513807,22514195,0,0,0,388
21223,22514388,22514388,22514484,0,0,0,96
21224,22514452,22514452,22514541,0,0,0,89
21144,22487971,22488033,22514649,0,0,62,26678
21226,22514567,22514567,22514867,0,0,0,300
21225,22514505,22514505,22514872,0,0,0,367
21228,22515297,22515297,22515609,0,0,0,312
21230,22515832,22515832,22515879,0,0,0,47
21231,22515975,22515975,22516230,0,0,0,255
21233,22516199,22516199,22516458,0,0,0,259
21232,22516190,22516190,22516539,0,0,0,349
21234,22516417,22516417,22516829,0,0,0,412
21238,22516978,22516978,22517045,0,0,0,67
21237,22516922,22516922,22517301,0,0,0,379
21235,22516539,22516539,22517408,0,0,0,869
21229,22515620,22515620,22517420,0,0,0,1800
21243,22517855,22517855,22517933,0,0,0,78
21145,22491746,22491746,22518440,0,0,0,26694
21245,22518387,22518387,22518472,0,0,0,85
21147,22492289,22492289,22518792,0,0,0,26503
21239,22517394,22517394,22519172,0,0,0,1778
21227,22514577,22514577,22519587,0,0,0,5010
21248,22519205,22519205,22519615,0,0,0,410
21251,22520142,22520142,22520323,0,0,0,181
21244,22518033,22518033,22520392,0,0,0,2359
21253,22520286,22520286,22520396,0,0,0,110
21256,22520759,22520759,22520839,0,0,0,80
21257,22520894,22520894,22520962,0,0,0,68
21259,22521122,22521122,22521189,0,0,0,67
21249,22519580,22519580,22521380,0,0,0,1800
21262,22521466,22521466,22521601,0,0,0,135
21263,22521564,22521564,22522820,0,0,0,1256
21152,22496509,22496509,22523436,0,0,0,26927
21265,22522916,22522916,22523567,0,0,0,651
21268,22524346,22524346,22524560,0,0,0,214
21250,22519596,22519596,22524580,0,0,0,4984
21270,22524908,22524908,22525327,0,0,0,419
21273,22526058,22526058,22526483,0,0,0,425
21274,22526603,22526603,22526815,0,0,0,212
21202,22507982,22507982,22529582,0,0,0,21600
21240,22517609,22529582,22529675,0,0,11973,12066
21241,22517625,22529675,22529768,0,0,12050,12143
21255,22520696,22529768,22529861,0,0,9072,9165
21258,22521042,22529861,22529985,0,0,8819,8943
21260,22521194,22529985,22530109,0,0,8791,8915
21266,22523600,22530109,22530561,0,0,6509,6961
21269,22524376,22530561,22531023,0,0,6185,6647
21242,22517668,22523567,22531047,0,0,5899,13379
21271,22524957,22531023,22531426,0,0,6066,6469
21276,22527758,22531047,22531590,0,0,3289,3832
21186,22501585,22501856,22532006,0,0,271,30421
21277,22529347,22531426,22532421,0,0,2079,3074
21187,22502072,22502324,22532486,0,0,252,30414
21280,22532091,22532421,22532598,0,0,330,507
21282,22532202,22532486,22532658,0,0,284,456
21279,22530741,22532006,22532740,0,0,1265,1999
21283,22532316,22532598,22532796,0,0,282,480
21206,22510038,22510038,22534071,0,0,0,24033
21247,22518782,22518792,22545428,0,0,10,26646
21246,22518440,22518440,22545546,0,0,0,27106
20627,22289318,22289318,22548518,0,0,0,259200
20628,22289318,22289318,22548518,0,0,0,259200
20629,22289319,22289319,22548519,0,0,0,259200
20630,22289319,22289319,22548519,0,0,0,259200
20631,22289348,22289348,22548548,0,0,0,259200
20632,22289349,22289349,22548549,0,0,0,259200
21289,22542308,22548518,22548591,0,0,6210,6283
20795,22408533,22408533,22549352,0,0,0,140819
21151,22496501,22549352,22549869,0,0,52851,53368
21165,22497716,22549869,22549963,0,0,52153,52247
21288,22537536,22545546,22549988,0,0,8010,12452
20633,22290791,22290791,22549991,0,0,0,259200
21169,22498282,22549963,22550056,0,0,51681,51774
21254,22520327,22550056,22550153,0,0,29729,29826
21290,22542339,22548519,22550186,0,0,6180,7847
21264,22522034,22550153,22550270,0,0,28119,28236
21267,22523680,22524580,22551075,0,0,900,27395
21272,22525850,22531047,22557237,0,0,5197,31387
21281,22532154,22532421,22561990,0,0,267,29836
20635,22290968,22290968,22562105,0,0,0,271137
21284,22532469,22532658,22562531,0,0,189,30062
21285,22534073,22545428,22569628,0,0,11355,35555
21292,22545916,22548591,22575166,0,0,2675,29250
21300,22550120,22550120,22576549,0,0,0,26429
21293,22546226,22549869,22576921,0,0,3643,30695
21302,22551980,22551980,22578218,0,0,0,26238
21312,22576510,22576510,22581548,0,0,0,5038
21303,22558229,22558229,22582639,0,0,0,24410
21318,22581854,22581854,22583654,0,0,0,1800
21321,22584065,22584065,22584159,0,0,0,94
21320,22584027,22584027,22584259,0,0,0,232
21322,22584155,22584155,22584259,0,0,0,104
21324,22584958,22584958,22585211,0,0,0,253
21326,22586433,22586433,22586794,0,0,0,361
20835,22413997,22413997,22586797,0,0,0,172800
21329,22586434,22586434,22586981,0,0,0,547
21338,22586497,22586497,22587003,0,0,0,506
21327,22586433,22586433,22587033,0,0,0,600
21328,22586433,22586433,22587033,0,0,0,600
21330,22586434,22586434,22587034,0,0,0,600
21331,22586434,22586434,22587034,0,0,0,600
21332,22586434,22586434,22587034,0,0,0,600
21333,22586434,22586434,22587034,0,0,0,600
21334,22586435,22586435,22587035,0,0,0,600
21335,22586435,22586435,22587035,0,0,0,600
21336,22586435,22586435,22587035,0,0,0,600
21337,22586435,22586435,22587035,0,0,0,600
21339,22586497,22586497,22587097,0,0,0,600
21340,22586497,22586497,22587097,0,0,0,600
21341,22586498,22586498,22587098,0,0,0,600
21342,22586498,22586498,22587098,0,0,0,600
21343,22586498,22586498,22587098,0,0,0,600
21344,22586498,22586498,22587098,0,0,0,600
21345,22586499,22586499,22587099,0,0,0,600
20794,22408487,22408487,22587279,0,0,0,178792
21349,22587713,22587713,22588313,0,0,0,600
21350,22587713,22587713,22588313,0,0,0,600
21351,22587714,22587714,22588314,0,0,0,600
21352,22587714,22587714,22588314,0,0,0,600
21353,22587714,22587714,22588314,0,0,0,600
21354,22587714,22587714,22588314,0,0,0,600
21355,22587715,22587715,22588315,0,0,0,600
21356,22587715,22587715,22588315,0,0,0,600
21357,22587715,22587715,22588315,0,0,0,600
21358,22587715,22587715,22588315,0,0,0,600
21359,22587716,22587716,22588316,0,0,0,600
21360,22587716,22587716,22588316,0,0,0,600
21361,22587716,22587716,22588316,0,0,0,600
21362,22587717,22587717,22588317,0,0,0,600
21363,22587717,22587717,22588317,0,0,0,600
21364,22587717,22587717,22588317,0,0,0,600
21365,22587717,22587717,22588317,0,0,0,600
21366,22587718,22587718,22588318,0,0,0,600
21367,22587718,22587718,22588318,0,0,0,600
21368,22587718,22587718,22588318,0,0,0,600
21370,22588900,22588900,22589140,0,0,0,240
21381,22589168,22589168,22589266,0,0,0,98
21376,22588902,22588902,22589291,0,0,0,389
21377,22588902,22588902,22589333,0,0,0,431
21371,22588900,22588900,22589500,0,0,0,600
21372,22588900,22588900,22589500,0,0,0,600
21373,22588901,22588901,22589501,0,0,0,600
21374,22588901,22588901,22589501,0,0,0,600
21375,22588901,22588901,22589501,0,0,0,600
21378,22588902,22588902,22589502,0,0,0,600
21379,22588902,22588902,22589502,0,0,0,600
21387,22590119,22590119,22590367,0,0,0,248
21395,22590121,22590121,22590369,0,0,0,248
21388,22590119,22590119,22590719,0,0,0,600
21389,22590119,22590119,22590719,0,0,0,600
21390,22590120,22590120,22590720,0,0,0,600
21391,22590120,22590120,22590720,0,0,0,600
21392,22590120,22590120,22590720,0,0,0,600
21393,22590120,22590120,22590720,0,0,0,600
21394,22590120,22590120,22590720,0,0,0,600
21396,22590121,22590121,22590721,0,0,0,600
21397,22591252,22591252,22591424,0,0,0,172
21398,22591360,22591424,22591596,0,0,64,236
21304,22561672,22561990,22591638,0,0,318,29966
21399,22591473,22591596,22591794,0,0,123,321
21400,22591623,22591638,22591815,0,0,15,192
21401,22591737,22591794,22591964,0,0,57,227
21402,22591851,22591851,22592022,0,0,0,171
21305,22562278,22562278,22592647,0,0,0,30369
21385,22589296,22589296,22592896,0,0,0,3600
21404,22592522,22592522,22593122,0,0,0,600
21405,22592522,22592522,22593122,0,0,0,600
21406,22592522,22592522,22593122,0,0,0,600
21407,22592523,22592523,22593123,0,0,0,600
21408,22592523,22592523,22593123,0,0,0,600
21409,22592523,22592523,22593123,0,0,0,600
21410,22592523,22592523,22593123,0,0,0,600
21411,22592523,22592523,22593123,0,0,0,600
21412,22592524,22592524,22593124,0,0,0,600
21413,22592524,22592524,22593124,0,0,0,600
20679,22334197,22334197,22593397,0,0,0,259200
21261,22521326,22530109,22593428,0,0,8783,72102
21236,22516777,22517420,22593504,0,0,643,76727
20680,22334349,22334349,22593549,0,0,0,259200
21306,22571450,22593504,22593608,0,0,22054,22158
21307,22572224,22593608,22593701,0,0,21384,21477
20681,22334502,22334502,22593702,0,0,0,259200
21309,22572745,22593701,22593794,0,0,20956,21049
21310,22573168,22593794,22593902,0,0,20626,20734
21291,22544848,22593397,22593972,0,0,48549,49124
21311,22573343,22593902,22594006,0,0,20559,20663
21415,22593683,22593702,22594114,0,0,19,431
21417,22594488,22594488,22594581,0,0,0,93
21418,22594704,22594704,22594782,0,0,0,78
21419,22594755,22594782,22594924,0,0,27,169
21416,22593854,22593972,22594954,0,0,118,1100
21424,22594926,22594926,22595315,0,0,0,389
21420,22594925,22594925,22595525,0,0,0,600
21421,22594925,22594925,22595525,0,0,0,600
21422,22594925,22594925,22595525,0,0,0,600
21423,22594925,22594925,22595525,0,0,0,600
21425,22594926,22594926,22595526,0,0,0,600
21426,22594926,22594926,22595526,0,0,0,600
21427,22594926,22594926,22595526,0,0,0,600
21428,22594926,22594926,22595526,0,0,0,600
21429,22594927,22594927,22595527,0,0,0,600
21437,22595724,22595724,22595971,0,0,0,247
21441,22596775,22596775,22596891,0,0,0,116
21442,22596855,22596855,22597000,0,0,0,145
21286,22535103,22587279,22597355,0,0,52176,62252
21316,22578560,22597355,22597448,0,0,18795,18888
21447,22597334,22597334,22597576,0,0,0,242
21445,22597148,22597148,22597587,0,0,0,439
21451,22597335,22597335,22597658,0,0,0,323
21457,22597520,22597520,22597756,0,0,0,236
21456,22597519,22597519,22597910,0,0,0,391
21446,22597328,22597328,22597928,0,0,0,600
21448,22597334,22597334,22597934,0,0,0,600
21449,22597334,22597334,22597934,0,0,0,600
21450,22597334,22597334,22597934,0,0,0,600
21452,22597335,22597335,22597935,0,0,0,600
21453,22597335,22597335,22597935,0,0,0,600
21454,22597335,22597335,22597935,0,0,0,600
21455,22597336,22597336,22597936,0,0,0,600
21461,22597521,22597521,22598046,0,0,0,525
21458,22597520,22597520,22598120,0,0,0,600
21459,22597520,22597520,22598120,0,0,0,600
21460,22597520,22597520,22598120,0,0,0,600
21462,22597521,22597521,22598121,0,0,0,600
21463,22597521,22597521,22598121,0,0,0,600
21464,22597521,22597521,22598121,0,0,0,600
21465,22597521,22597576,22598176,0,0,55,655
21467,22598161,22598161,22598199,0,0,0,38
21475,22598724,22598724,22598940,0,0,0,216
21468,22598342,22598342,22599031,0,0,0,689
21472,22598723,22598723,22599125,0,0,0,402
21476,22598724,22598724,22599199,0,0,0,475
21470,22598722,22598722,22599322,0,0,0,600
21471,22598722,22598722,22599322,0,0,0,600
21473,22598723,22598723,22599323,0,0,0,600
21474,22598723,22598723,22599323,0,0,0,600
21477,22598724,22598724,22599324,0,0,0,600
21478,22598724,22598724,22599324,0,0,0,600
21308,22572432,22572432,22599388,0,0,0,26956
21482,22599423,22599423,22599488,0,0,0,65
21495,22599811,22599811,22600021,0,0,0,210
21483,22599471,22599471,22600150,0,0,0,679
21485,22599736,22599736,22600336,0,0,0,600
21486,22599736,22599736,22600336,0,0,0,600
21487,22599737,22599737,22600337,0,0,0,600
21488,22599737,22599737,22600337,0,0,0,600
21489,22599737,22599737,22600337,0,0,0,600
21490,22599737,22599737,22600337,0,0,0,600
21491,22599738,22599738,22600338,0,0,0,600
21492,22599738,22599738,22600338,0,0,0,600
21493,22599738,22599738,22600338,0,0,0,600
21494,22599738,22599738,22600338,0,0,0,600
21496,22600446,22600446,22600786,0,0,0,340
21498,22600749,22600749,22600820,0,0,0,71
21430,22594979,22599388,22601120,0,0,4409,6141
21505,22601127,22601127,22601343,0,0,0,216
21501,22601126,22601126,22601373,0,0,0,247
21502,22601126,22601126,22601466,0,0,0,340
21500,22601125,22601125,22601682,0,0,0,557
21503,22601126,22601126,22601726,0,0,0,600
21504,22601126,22601126,22601726,0,0,0,600
21506,22601127,22601127,22601727,0,0,0,600
21507,22601127,22601127,22601727,0,0,0,600
21508,22601127,22601127,22601727,0,0,0,600
21287,22536892,22587279,22601853,0,0,50387,64961
21438,22595971,22601853,22601985,0,0,5882,6014
21432,22595321,22601853,22602019,0,0,6532,6698
21440,22596659,22601985,22602137,0,0,5326,5478
21443,22596906,22602019,22602174,0,0,5113,5268
21469,22598519,22602137,22602274,0,0,3618,3755
21479,22598782,22602174,22602329,0,0,3392,3547
21509,22602139,22602139,22602348,0,0,0,209
21480,22599136,22602274,22602429,0,0,3138,3293
21519,22602297,22602297,22602559,0,0,0,262
21510,22602139,22602139,22602739,0,0,0,600
21511,22602139,22602139,22602739,0,0,0,600
21512,22602139,22602139,22602739,0,0,0,600
21513,22602160,22602160,22602760,0,0,0,600
21514,22602161,22602161,22602761,0,0,0,600
21515,22602161,22602161,22602761,0,0,0,600
21516,22602161,22602161,22602761,0,0,0,600
21517,22602161,22602161,22602761,0,0,0,600
21518,22602162,22602162,22602762,0,0,0,600
21522,22603529,22603529,22603787,0,0,0,258
21526,22603530,22603530,22603788,0,0,0,258
21275,22526788,22550270,22603942,0,0,23482,77154
21527,22603530,22603530,22604047,0,0,0,517
21528,22603530,22603530,22604078,0,0,0,548
21520,22603528,22603528,22604107,0,0,0,579
21521,22603528,22603528,22604107,0,0,0,579
21523,22603529,22603529,22604129,0,0,0,600
21524,22603529,22603529,22604129,0,0,0,600
21525,22603529,22603529,22604129,0,0,0,600
21529,22603530,22603530,22604130,0,0,0,600
21530,22604252,22604252,22604351,0,0,0,99
21314,22578156,22578156,22604708,0,0,0,26552
21497,22600497,22604708,22604884,0,0,4211,4387
21499,22600779,22604884,22605016,0,0,4105,4237
21533,22604563,22604563,22605142,0,0,0,579
21531,22604562,22604562,22605162,0,0,0,600
21532,22604562,22604562,22605162,0,0,0,600
21534,22604563,22604563,22605163,0,0,0,600
21535,22604563,22604563,22605163,0,0,0,600
21536,22604563,22604563,22605163,0,0,0,600
21537,22604564,22604564,22605164,0,0,0,600
21538,22604564,22604564,22605164,0,0,0,600
21539,22604564,22604564,22605164,0,0,0,600
21540,22604564,22604564,22605164,0,0,0,600
21542,22605360,22605360,22605459,0,0,0,99
21543,22605638,22605638,22605823,0,0,0,185
21323,22584448,22603942,22606073,0,0,19494,21625
21544,22605931,22605931,22606086,0,0,0,155
21431,22595162,22606073,22606135,0,0,10911,10973
21439,22595997,22606135,22606238,0,0,10138,10241
21545,22605931,22605931,22606531,0,0,0,600
21546,22605931,22605931,22606531,0,0,0,600
21547,22605932,22605932,22606532,0,0,0,600
21548,22605932,22605932,22606532,0,0,0,600
21549,22605932,22605932,22606532,0,0,0,600
21550,22605932,22605932,22606532,0,0,0,600
21551,22605932,22605932,22606532,0,0,0,600
21552,22605933,22605933,22606533,0,0,0,600
21553,22605933,22605933,22606533,0,0,0,600
21319,22582578,22582578,22606596,0,0,0,24018
21466,22597605,22606073,22606761,0,0,8468,9156
21555,22606965,22606965,22607189,0,0,0,224
21558,22606966,22606966,22607266,0,0,0,300
21565,22607353,22607353,22607390,0,0,0,37
21563,22607008,22607008,22607422,0,0,0,414
21556,22606965,22606965,22607565,0,0,0,600
21557,22606965,22606965,22607565,0,0,0,600
21559,22606966,22606966,22607566,0,0,0,600
21560,22606966,22606966,22607566,0,0,0,600
21561,22606966,22606966,22607566,0,0,0,600
21562,22606966,22606966,22607566,0,0,0,600
21564,22607008,22607008,22607608,0,0,0,600
20708,22348559,22348559,22607759,0,0,0,259200
21317,22581487,22581487,22607809,0,0,0,26322
21576,22608336,22608336,22608502,0,0,0,166
21572,22608335,22608335,22608687,0,0,0,352
21579,22608461,22608461,22608762,0,0,0,301
21573,22608335,22608335,22608895,0,0,0,560
21574,22608335,22608335,22608926,0,0,0,591
21577,22608336,22608336,22608927,0,0,0,591
21569,22608334,22608334,22608934,0,0,0,600
21570,22608334,22608334,22608934,0,0,0,600
21571,22608334,22608334,22608934,0,0,0,600
21575,22608335,22608335,22608935,0,0,0,600
21578,22608336,22608336,22608936,0,0,0,600
21586,22609538,22609538,22609677,0,0,0,139
21582,22609537,22609537,22610101,0,0,0,564
21587,22609538,22609538,22610102,0,0,0,564
21583,22609537,22609537,22610137,0,0,0,600
21584,22609537,22609537,22610137,0,0,0,600
21585,22609537,22609537,22610137,0,0,0,600
21588,22609538,22609538,22610138,0,0,0,600
21325,22585536,22597448,22612942,0,0,11912,27406
21568,22608299,22612942,22613109,0,0,4643,4810
21581,22608773,22613109,22613264,0,0,4336,4491
21589,22609995,22613264,22613432,0,0,3269,3437
21591,22610511,22613432,22613556,0,0,2921,3045
21599,22614673,22614673,22614740,0,0,0,67
21315,22578389,22594954,22614762,0,0,16565,36373
21590,22610030,22614762,22615014,0,0,4732,4984
21600,22614984,22614984,22615073,0,0,0,89
21592,22610650,22615014,22615468,0,0,4364,4818
21313,22577876,22594006,22616374,0,0,16130,38498
21601,22615034,22616374,22616540,0,0,1340,1506
21598,22614367,22614367,22619064,0,0,0,4697
21566,22607394,22612942,22620313,0,0,5548,12919
21414,22592579,22592579,22622008,0,0,0,29429
21580,22608730,22608762,22622045,0,0,32,13315
21403,22591960,22591964,22622065,0,0,4,30105
21604,22622017,22622017,22622163,0,0,0,146
21603,22621973,22621973,22622327,0,0,0,354
21602,22620860,22620860,22623240,0,0,0,2380
21594,22610653,22616374,22624191,0,0,5721,13538
21608,22625505,22625505,22625573,0,0,0,68
21609,22625594,22625594,22625679,0,0,0,85
21611,22625742,22625742,22625809,0,0,0,67
21607,22624863,22624863,22625902,0,0,0,1039
21612,22625938,22625938,22626006,0,0,0,68
21613,22625954,22625954,22626006,0,0,0,52
21614,22625964,22625964,22626031,0,0,0,67
21615,22626037,22626037,22626084,0,0,0,47
21616,22626170,22626170,22626222,0,0,0,52
21617,22626181,22626181,22626248,0,0,0,67
21618,22626256,22626256,22626324,0,0,0,68
21619,22626278,22626278,22626330,0,0,0,52
21620,22626290,22626290,22626373,0,0,0,83
21621,22626338,22626338,22626421,0,0,0,83
21622,22626373,22626373,22626451,0,0,0,78
21624,22627004,22627004,22627067,0,0,0,63
21623,22626645,22626645,22627694,0,0,0,1049
21481,22599318,22602329,22628721,0,0,3011,29403
21625,22628059,22628059,22628928,0,0,0,869
21484,22599666,22602429,22629182,0,0,2763,29516
21626,22629088,22629088,22630080,0,0,0,992
21627,22630174,22630174,22630247,0,0,0,73
21554,22606595,22606595,22630460,0,0,0,23865
21541,22604641,22605016,22631114,0,0,375,26473
21596,22611766,22630460,22631360,0,0,18694,19594
21629,22630715,22631360,22632291,0,0,645,1576
21595,22611032,22624191,22632300,0,0,13159,21268
21630,22631716,22631716,22632596,0,0,0,880
21567,22607740,22607740,22633948,0,0,0,26208
21606,22622289,22622289,22651907,0,0,0,29618
21610,22625648,22625648,22652177,0,0,0,26529
21605,22622121,22622121,22652206,0,0,0,30085
21628,22630659,22631114,22657221,0,0,455,26562
21631,22633889,22633948,22660714,0,0,59,26825
20793,22408426,22408426,22667626,0,0,0,259200
20802,22409631,22409631,22668831,0,0,0,259200
21593,22610652,22615468,22671597,0,0,4816,60945
21380,22588905,22632596,22678794,0,0,43691,89889
21644,22678281,22678281,22678869,0,0,0,588
21640,22678280,22678280,22678880,0,0,0,600
21641,22678280,22678280,22678880,0,0,0,600
21642,22678280,22678280,22678880,0,0,0,600
21643,22678280,22678280,22678880,0,0,0,600
21645,22678281,22678281,22678881,0,0,0,600
21646,22678281,22678281,22678881,0,0,0,600
21647,22678281,22678281,22678881,0,0,0,600
21648,22678282,22678282,22678882,0,0,0,600
21649,22678282,22678282,22678882,0,0,0,600
21650,22678282,22678282,22678882,0,0,0,600
21651,22678282,22678282,22678882,0,0,0,600
21652,22678282,22678282,22678882,0,0,0,600
21653,22678283,22678283,22678883,0,0,0,600
21654,22678283,22678283,22678883,0,0,0,600
21655,22678283,22678283,22678883,0,0,0,600
21656,22678283,22678283,22678883,0,0,0,600
21657,22678370,22678370,22678970,0,0,0,600
21658,22678370,22678370,22678970,0,0,0,600
21659,22678371,22678371,22678971,0,0,0,600
21673,22678909,22678909,22679440,0,0,0,531
21661,22678895,22678895,22679495,0,0,0,600
21662,22678895,22678895,22679495,0,0,0,600
21663,22678906,22678906,22679506,0,0,0,600
21664,22678906,22678906,22679506,0,0,0,600
21665,22678907,22678907,22679507,0,0,0,600
21666,22678907,22678907,22679507,0,0,0,600
21667,22678907,22678907,22679507,0,0,0,600
21668,22678907,22678907,22679507,0,0,0,600
21669,22678908,22678908,22679508,0,0,0,600
21670,22678908,22678908,22679508,0,0,0,600
21671,22678908,22678908,22679508,0,0,0,600
21672,22678908,22678908,22679508,0,0,0,600
21674,22678909,22678909,22679509,0,0,0,600
21675,22678909,22678909,22679509,0,0,0,600
21676,22678910,22678910,22679510,0,0,0,600
21677,22678910,22678910,22679510,0,0,0,600
21678,22678910,22678910,22679510,0,0,0,600
21679,22678910,22678910,22679510,0,0,0,600
21680,22678911,22678911,22679511,0,0,0,600
21660,22678673,22678673,22679557,0,0,0,884
20881,22427687,22427687,22680287,0,0,0,252600
21681,22679729,22679729,22680619,0,0,0,890
21632,22651855,22651907,22682068,0,0,52,30213
21633,22652143,22652177,22682343,0,0,34,30200
21684,22682250,22682250,22682422,0,0,0,172
21685,22682359,22682359,22682531,0,0,0,172
21682,22680931,22680931,22682590,0,0,0,1659
21687,22682595,22682595,22683353,0,0,0,758
21688,22684536,22684536,22685592,0,0,0,1056
21634,22660609,22660609,22686830,0,0,0,26221
21689,22686119,22686119,22686861,0,0,0,742
21692,22686862,22686862,22686909,0,0,0,47
21691,22686782,22686782,22687032,0,0,0,250
21694,22686939,22686939,22687182,0,0,0,243
21693,22686933,22686933,22687192,0,0,0,259
21695,22686942,22686942,22687216,0,0,0,274
21696,22686946,22686946,22687220,0,0,0,274
21697,22686949,22686949,22687223,0,0,0,274
21698,22686970,22686970,22687244,0,0,0,274
21699,22686975,22686975,22687249,0,0,0,274
21700,22686978,22686978,22687252,0,0,0,274
21701,22687961,22687961,22688701,0,0,0,740
21702,22689600,22689600,22690955,0,0,0,1355
20920,22431966,22431966,22691166,0,0,0,259200
20927,22432450,22432450,22691650,0,0,0,259200
21154,22496530,22691166,22691849,0,0,194636,195319
21704,22692159,22692159,22692976,0,0,0,817
21597,22614235,22619064,22698653,0,0,4829,84418
21706,22693966,22698653,22699460,0,0,4687,5494
21707,22701360,22701360,22702105,0,0,0,745
21708,22702395,22702395,22703131,0,0,0,736
21636,22668032,22680287,22703525,0,0,12255,35493
21709,22703908,22703908,22704705,0,0,0,797
21710,22704911,22704911,22705562,0,0,0,651
21711,22706070,22706070,22706163,0,0,0,93
21639,22668618,22691166,22707107,0,0,22548,38489
21712,22706708,22706708,22707235,0,0,0,527
21713,22707354,22707354,22707820,0,0,0,466
21703,22691900,22691900,22710000,0,0,0,18100
21705,22692751,22692976,22710154,0,0,225,17403
21683,22681954,22681954,22711775,0,0,0,29821
21686,22682469,22682469,22712925,0,0,0,30456
21690,22686750,22686750,22713011,0,0,0,26261
21638,22668071,22691166,22719522,0,0,23095,51451
21121,22464122,22464173,22723373,0,0,51,259251
20767,22378346,22378346,22723946,0,0,0,345600
21122,22464123,22465045,22724245,0,0,922,260122
21123,22464123,22465144,22724344,0,0,1021,260221
21124,22464123,22465144,22724344,0,0,1021,260221
21125,22464123,22465328,22724528,0,0,1205,260405
21126,22464123,22465328,22724528,0,0,1205,260405
21637,22668058,22691166,22726443,0,0,23108,58385
21127,22464123,22469614,22728814,0,0,5491,264691
21635,22668020,22671597,22729400,0,0,3577,61380
21131,22466524,22471590,22730790,0,0,5066,264266
21132,22466575,22471590,22730790,0,0,5015,264215
21115,22461406,22479066,22738266,0,0,17660,276860
21116,22461462,22480953,22740153,0,0,19491,278691
21209,22510615,22740153,22740309,0,0,229538,229694
21348,22587425,22668831,22741726,0,0,81406,154301
21714,22711712,22711712,22742162,0,0,0,30450
21715,22712879,22712879,22743149,0,0,0,30270
21346,22587342,22607759,22746352,0,0,20417,159010
21148,22493355,22493355,22752555,0,0,0,259200
21149,22493370,22493370,22752570,0,0,0,259200
21118,22461500,22500601,22759801,0,0,39101,298301
21730,22762330,22762330,22762930,0,0,0,600
21731,22762336,22762336,22762936,0,0,0,600
21732,22762336,22762336,22762936,0,0,0,600
21733,22762337,22762337,22762937,0,0,0,600
21734,22762337,22762337,22762937,0,0,0,600
21735,22762337,22762337,22762937,0,0,0,600
21736,22762337,22762337,22762937,0,0,0,600
21737,22762338,22762338,22762938,0,0,0,600
21738,22762338,22762338,22762938,0,0,0,600
21739,22762338,22762338,22762938,0,0,0,600
21740,22762338,22762338,22762938,0,0,0,600
21741,22762339,22762339,22762939,0,0,0,600
21742,22762339,22762339,22762939,0,0,0,600
21743,22762339,22762339,22762939,0,0,0,600
21744,22762340,22762340,22762940,0,0,0,600
21745,22762340,22762340,22762940,0,0,0,600
21746,22762340,22762340,22762940,0,0,0,600
21747,22762340,22762340,22762940,0,0,0,600
21748,22762341,22762341,22762941,0,0,0,600
21749,22762341,22762341,22762941,0,0,0,600
21750,22762341,22762341,22762941,0,0,0,600
21751,22762341,22762341,22762941,0,0,0,600
21752,22762341,22762341,22762941,0,0,0,600
21753,22762342,22762342,22762942,0,0,0,600
21754,22762342,22762342,22762942,0,0,0,600
21755,22762342,22762342,22762942,0,0,0,600
21756,22762342,22762342,22762942,0,0,0,600
21757,22762342,22762342,22762942,0,0,0,600
21758,22762343,22762343,22762943,0,0,0,600
21759,22762343,22762343,22762943,0,0,0,600
21769,22763161,22763161,22763548,0,0,0,387
21760,22763159,22763159,22763759,0,0,0,600
21761,22763159,22763159,22763759,0,0,0,600
21762,22763159,22763159,22763759,0,0,0,600
21763,22763159,22763159,22763759,0,0,0,600
21764,22763159,22763159,22763759,0,0,0,600
21765,22763160,22763160,22763760,0,0,0,600
21766,22763160,22763160,22763760,0,0,0,600
21767,22763160,22763160,22763760,0,0,0,600
21768,22763160,22763160,22763760,0,0,0,600
21770,22763161,22763161,22763761,0,0,0,600
21771,22763161,22763161,22763761,0,0,0,600
21772,22763161,22763161,22763761,0,0,0,600
21773,22763161,22763161,22763761,0,0,0,600
21774,22763162,22763162,22763762,0,0,0,600
21775,22763162,22763162,22763762,0,0,0,600
21776,22763162,22763162,22763762,0,0,0,600
21777,22763162,22763162,22763762,0,0,0,600
21778,22763162,22763162,22763762,0,0,0,600
21779,22763259,22763259,22763859,0,0,0,600
21780,22764744,22764744,22765344,0,0,0,600
21781,22764744,22764744,22765344,0,0,0,600
21782,22764744,22764744,22765344,0,0,0,600
21783,22764744,22764744,22765344,0,0,0,600
21784,22764745,22764745,22765345,0,0,0,600
21785,22764745,22764745,22765345,0,0,0,600
21786,22764745,22764745,22765345,0,0,0,600
21787,22764745,22764745,22765345,0,0,0,600
21788,22764745,22764745,22765345,0,0,0,600
21789,22764791,22764791,22765391,0,0,0,600
21369,22587825,22691849,22765538,0,0,104024,177713
21793,22765661,22765661,22766061,0,0,0,400
21790,22765660,22765660,22766260,0,0,0,600
21791,22765660,22765660,22766260,0,0,0,600
21792,22765660,22765660,22766260,0,0,0,600
21794,22765661,22765661,22766261,0,0,0,600
21795,22765661,22765661,22766261,0,0,0,600
21796,22765661,22765661,22766261,0,0,0,600
21797,22765661,22765661,22766261,0,0,0,600
21798,22765662,22765662,22766262,0,0,0,600
21799,22765662,22765662,22766262,0,0,0,600
21800,22767192,22767192,22767792,0,0,0,600
21801,22767198,22767198,22767798,0,0,0,600
21802,22767198,22767198,22767798,0,0,0,600
21803,22767199,22767199,22767799,0,0,0,600
21804,22767199,22767199,22767799,0,0,0,600
21805,22767199,22767199,22767799,0,0,0,600
21806,22767199,22767199,22767799,0,0,0,600
21807,22767200,22767200,22767800,0,0,0,600
21808,22767200,22767200,22767800,0,0,0,600
21809,22767200,22767200,22767800,0,0,0,600
21815,22768064,22768064,22768444,0,0,0,380
21816,22768064,22768064,22768475,0,0,0,411
21810,22768063,22768063,22768663,0,0,0,600
21811,22768063,22768063,22768663,0,0,0,600
21812,22768063,22768063,22768663,0,0,0,600
21813,22768063,22768063,22768663,0,0,0,600
21814,22768063,22768063,22768663,0,0,0,600
21817,22768064,22768064,22768664,0,0,0,600
21818,22768064,22768064,22768664,0,0,0,600
21819,22768064,22768064,22768664,0,0,0,600
21820,22769601,22769601,22770201,0,0,0,600
21821,22769607,22769607,22770207,0,0,0,600
21822,22769607,22769607,22770207,0,0,0,600
21823,22769607,22769607,22770207,0,0,0,600
21824,22769608,22769608,22770208,0,0,0,600
21825,22769608,22769608,22770208,0,0,0,600
21826,22769608,22769608,22770208,0,0,0,600
21827,22769608,22769608,22770208,0,0,0,600
21828,22769609,22769609,22770209,0,0,0,600
21829,22769609,22769609,22770209,0,0,0,600
21834,22770482,22770482,22770867,0,0,0,385
21830,22770465,22770465,22771065,0,0,0,600
21831,22770465,22770465,22771065,0,0,0,600
21832,22770465,22770465,22771065,0,0,0,600
21833,22770481,22770481,22771081,0,0,0,600
21835,22770482,22770482,22771082,0,0,0,600
21836,22770482,22770482,22771082,0,0,0,600
21837,22770482,22770482,22771082,0,0,0,600
21838,22770483,22770483,22771083,0,0,0,600
21839,22770483,22770483,22771083,0,0,0,600
21726,22742099,22742099,22772539,0,0,0,30440
21727,22743090,22743090,22773405,0,0,0,30315
21444,22597072,22606761,22779561,0,0,9689,182489
21252,22520263,22534071,22786671,0,0,13808,266408
21728,22753221,22753221,22786831,0,0,0,33610
21841,22772476,22772476,22802894,0,0,0,30418
21842,22773334,22773334,22803533,0,0,0,30199
21120,22462690,22462690,22808290,0,0,0,345600
21294,22549627,22549627,22808827,0,0,0,259200
21295,22549627,22549627,22808827,0,0,0,259200
21845,22803479,22803479,22808959,0,0,0,5480
21296,22549815,22549815,22809015,0,0,0,259200
21297,22549816,22549869,22809069,0,0,53,259253
21298,22549817,22549988,22809188,0,0,171,259371
21299,22549817,22549991,22809191,0,0,174,259374
21301,22550253,22550253,22809453,0,0,0,259200
21843,22776346,22776346,22810514,0,0,0,34168
21729,22753281,22753281,22820913,0,0,0,67632
21844,22802831,22802831,22832875,0,0,0,30044
21856,22836269,22836269,22836368,0,0,0,99
21857,22836442,22836442,22836509,0,0,0,67
21858,22836506,22836506,22836600,0,0,0,94
21859,22836567,22836567,22836664,0,0,0,97
21860,22836629,22836629,22836696,0,0,0,67
21861,22836683,22836683,22836831,0,0,0,148
21863,22836702,22836702,22836857,0,0,0,155
21862,22836696,22836696,22836863,0,0,0,167
21864,22837263,22837263,22837416,0,0,0,153
21865,22837295,22837295,22837456,0,0,0,161
21866,22837439,22837439,22837491,0,0,0,52
21867,22837455,22837455,22837522,0,0,0,67
21846,22808876,22808876,22838798,0,0,0,29922
21278,22530213,22586797,22839397,0,0,56584,309184
21869,22839692,22839692,22840015,0,0,0,323
21871,22839810,22839810,22840410,0,0,0,600
21872,22839810,22839810,22840410,0,0,0,600
21873,22839810,22839810,22840410,0,0,0,600
21874,22839826,22839826,22840426,0,0,0,600
21875,22839826,22839826,22840426,0,0,0,600
21876,22839827,22839827,22840427,0,0,0,600
21877,22839827,22839827,22840427,0,0,0,600
21878,22839827,22839827,22840427,0,0,0,600
21879,22839828,22839828,22840428,0,0,0,600
21880,22839828,22839828,22840428,0,0,0,600
21882,22840338,22840338,22840693,0,0,0,355
21883,22840527,22840527,22840875,0,0,0,348
21895,22840954,22840954,22841042,0,0,0,88
21894,22840949,22840949,22841059,0,0,0,110
21893,22840665,22840665,22841123,0,0,0,458
21884,22840527,22840527,22841127,0,0,0,600
21885,22840527,22840527,22841127,0,0,0,600
21886,22840528,22840528,22841128,0,0,0,600
21887,22840528,22840528,22841128,0,0,0,600
21888,22840528,22840528,22841128,0,0,0,600
21889,22840528,22840528,22841128,0,0,0,600
21890,22840528,22840528,22841128,0,0,0,600
21891,22840529,22840529,22841129,0,0,0,600
21892,22840529,22840529,22841129,0,0,0,600
21870,22839728,22839728,22841253,0,0,0,1525
21881,22839894,22839894,22841570,0,0,0,1676
21899,22841520,22841520,22841663,0,0,0,143
21902,22841719,22841719,22841788,0,0,0,69
21901,22841706,22841706,22841791,0,0,0,85
21906,22841895,22841895,22842030,0,0,0,135
21907,22841908,22841908,22842074,0,0,0,166
21900,22841526,22841526,22842113,0,0,0,587
21909,22842117,22842117,22842195,0,0,0,78
21921,22842291,22842291,22842389,0,0,0,98
21922,22842406,22842406,22842473,0,0,0,67
21911,22842229,22842229,22842829,0,0,0,600
21912,22842229,22842229,22842829,0,0,0,600
21913,22842229,22842229,22842829,0,0,0,600
21914,22842229,22842229,22842829,0,0,0,600
21915,22842250,22842250,22842850,0,0,0,600
21916,22842251,22842251,22842851,0,0,0,600
21917,22842251,22842251,22842851,0,0,0,600
21918,22842251,22842251,22842851,0,0,0,600
21919,22842251,22842251,22842851,0,0,0,600
21920,22842252,22842252,22842852,0,0,0,600
21904,22841804,22841804,22843195,0,0,0,1391
21938,22843137,22843137,22843219,0,0,0,82
21896,22841181,22841181,22843223,0,0,0,2042
21897,22841226,22841226,22843224,0,0,0,1998
21942,22843360,22843360,22843459,0,0,0,99
21928,22842929,22842929,22843529,0,0,0,600
21929,22842935,22842935,22843535,0,0,0,600
21930,22842935,22842935,22843535,0,0,0,600
21931,22842936,22842936,22843536,0,0,0,600
21932,22842936,22842936,22843536,0,0,0,600
21933,22842936,22842936,22843536,0,0,0,600
21934,22842936,22842936,22843536,0,0,0,600
21935,22842937,22842937,22843537,0,0,0,600
21936,22842937,22842937,22843537,0,0,0,600
21937,22842937,22842937,22843537,0,0,0,600
21910,22842163,22842163,22843610,0,0,0,1447
21944,22843967,22843967,22844060,0,0,0,93
21946,22844100,22844100,22844202,0,0,0,102
21947,22844268,22844268,22844341,0,0,0,73
21948,22844391,22844391,22844460,0,0,0,69
21949,22844413,22844413,22844477,0,0,0,64
21951,22844437,22844437,22844505,0,0,0,68
21952,22844455,22844455,22844507,0,0,0,52
21950,22844426,22844426,22844510,0,0,0,84
21953,22844471,22844471,22844538,0,0,0,67
21941,22843225,22843225,22844634,0,0,0,1409
21961,22844660,22844660,22844732,0,0,0,72
21954,22844652,22844652,22844740,0,0,0,88
21966,22844668,22844668,22844740,0,0,0,72
21967,22844730,22844730,22844782,0,0,0,52
21968,22844749,22844749,22844816,0,0,0,67
21943,22843498,22843498,22844862,0,0,0,1364
21969,22844881,22844881,22845041,0,0,0,160
21926,22842656,22842656,22845106,0,0,0,2450
21940,22843180,22843180,22845155,0,0,0,1975
21939,22843172,22843172,22845158,0,0,0,1986
21905,22841832,22841832,22845159,0,0,0,3327
21955,22844658,22844658,22845258,0,0,0,600
21956,22844658,22844658,22845258,0,0,0,600
21957,22844659,22844659,22845259,0,0,0,600
21958,22844659,22844659,22845259,0,0,0,600
21959,22844659,22844659,22845259,0,0,0,600
21960,22844659,22844659,22845259,0,0,0,600
21962,22844660,22844660,22845260,0,0,0,600
21963,22844660,22844660,22845260,0,0,0,600
21964,22844660,22844660,22845260,0,0,0,600
21965,22844660,22844660,22845260,0,0,0,600
21974,22845337,22845337,22845403,0,0,0,66
21927,22842871,22842871,22845563,0,0,0,2692
21945,22844040,22844040,22845840,0,0,0,1800
21975,22845338,22845338,22845938,0,0,0,600
21976,22845338,22845338,22845938,0,0,0,600
21977,22845338,22845338,22845938,0,0,0,600
21978,22845339,22845339,22845939,0,0,0,600
21979,22845339,22845339,22845939,0,0,0,600
21980,22845339,22845339,22845939,0,0,0,600
21981,22845340,22845340,22845940,0,0,0,600
21982,22845340,22845340,22845940,0,0,0,600
21983,22845340,22845340,22845940,0,0,0,600
21984,22845340,22845340,22845940,0,0,0,600
21903,22841798,22841798,22846024,0,0,0,4226
21988,22846217,22846217,22846347,0,0,0,130
21989,22846228,22846228,22846358,0,0,0,130
21990,22846236,22846236,22846366,0,0,0,130
21991,22846336,22846336,22846422,0,0,0,86
21992,22846346,22846346,22846438,0,0,0,92
21993,22846365,22846365,22846452,0,0,0,87
21995,22846396,22846396,22846478,0,0,0,82
21998,22847061,22847061,22847661,0,0,0,600
21999,22847067,22847067,22847667,0,0,0,600
22000,22847067,22847067,22847667,0,0,0,600
22001,22847068,22847068,22847668,0,0,0,600
22002,22847068,22847068,22847668,0,0,0,600
22003,22847068,22847068,22847668,0,0,0,600
22004,22847068,22847068,22847668,0,0,0,600
22005,22847069,22847069,22847669,0,0,0,600
22006,22847069,22847069,22847669,0,0,0,600
22007,22847069,22847069,22847669,0,0,0,600
22009,22847576,22847576,22847677,0,0,0,101
21994,22846385,22846385,22847801,0,0,0,1416
21996,22846416,22846416,22847805,0,0,0,1389
21997,22846475,22846475,22847897,0,0,0,1422
22020,22848158,22848158,22848257,0,0,0,99
22010,22847741,22847741,22848341,0,0,0,600
22011,22847741,22847741,22848341,0,0,0,600
22012,22847742,22847742,22848342,0,0,0,600
22013,22847742,22847742,22848342,0,0,0,600
22014,22847742,22847742,22848342,0,0,0,600
22015,22847742,22847742,22848342,0,0,0,600
22016,22847743,22847743,22848343,0,0,0,600
22017,22847743,22847743,22848343,0,0,0,600
22018,22847743,22847743,22848343,0,0,0,600
22019,22847744,22847744,22848344,0,0,0,600
21987,22845876,22845876,22848727,0,0,0,2851
22021,22849733,22849733,22849843,0,0,0,110
22022,22849784,22849784,22849843,0,0,0,59
22023,22849807,22849807,22849893,0,0,0,86
22024,22849848,22849848,22849963,0,0,0,115
22027,22849915,22849915,22849985,0,0,0,70
22028,22849933,22849933,22850016,0,0,0,83
22030,22850144,22850144,22850744,0,0,0,600
22031,22850145,22850145,22850745,0,0,0,600
22032,22850145,22850145,22850745,0,0,0,600
22033,22850145,22850145,22850745,0,0,0,600
22034,22850145,22850145,22850745,0,0,0,600
22035,22850146,22850146,22850746,0,0,0,600
22036,22850146,22850146,22850746,0,0,0,600
22037,22850146,22850146,22850746,0,0,0,600
22038,22850146,22850146,22850746,0,0,0,600
22039,22850146,22850146,22850746,0,0,0,600
21840,22771666,22771666,22851591,0,0,0,79925
21383,22589206,22667626,22852034,0,0,78420,262828
22008,22847524,22847524,22853311,0,0,0,5787
21986,22845518,22845518,22854565,0,0,0,9047
21898,22841500,22841500,22855482,0,0,0,13982
21971,22845102,22845102,22855604,0,0,0,10502
21970,22845063,22845063,22856428,0,0,0,11365
22050,22855874,22855874,22856552,0,0,0,678
21985,22845509,22845509,22856580,0,0,0,11071
22055,22856672,22856672,22856838,0,0,0,166
21908,22842046,22842046,22857127,0,0,0,15081
22049,22855537,22855537,22857326,0,0,0,1789
22057,22857159,22857159,22857558,0,0,0,399
22058,22857666,22857666,22857759,0,0,0,93
22061,22857993,22857993,22858086,0,0,0,93
22060,22857885,22857885,22858272,0,0,0,387
22053,22856509,22856509,22858584,0,0,0,2075
22054,22856515,22856515,22858871,0,0,0,2356
22062,22858313,22858313,22858937,0,0,0,624
22067,22858999,22858999,22859076,0,0,0,77
22040,22853864,22853864,22859642,0,0,0,5778
22041,22853928,22853928,22859675,0,0,0,5747
22042,22854054,22854054,22859765,0,0,0,5711
22051,22855976,22855976,22859954,0,0,0,3978
22063,22858510,22858510,22859955,0,0,0,1445
22064,22858542,22858542,22859956,0,0,0,1414
22052,22856365,22856365,22859988,0,0,0,3623
22074,22860171,22860171,22860265,0,0,0,94
21434,22595579,22601120,22860320,0,0,5541,264741
22043,22854768,22854768,22860471,0,0,0,5703
22065,22858814,22858814,22860502,0,0,0,1688
22076,22860510,22860510,22860614,0,0,0,104
22077,22860582,22860582,22860675,0,0,0,93
22044,22854917,22854917,22860700,0,0,0,5783
21435,22595621,22601853,22861053,0,0,6232,265432
21436,22595660,22601853,22861053,0,0,6193,265393
21973,22845118,22845118,22861406,0,0,0,16288
21972,22845105,22845105,22861415,0,0,0,16310
21855,22832812,22832812,22862939,0,0,0,30127
22084,22862981,22862981,22863074,0,0,0,93
22082,22861760,22861760,22863578,0,0,0,1818
22086,22863649,22863649,22863742,0,0,0,93
22088,22864064,22864064,22864137,0,0,0,73
22087,22863992,22863992,22864138,0,0,0,146
22090,22864289,22864289,22864514,0,0,0,225
22091,22864366,22864366,22864565,0,0,0,199
22094,22864512,22864514,22864580,0,0,2,68
22089,22864286,22864286,22864584,0,0,0,298
22048,22855534,22855534,22865411,0,0,0,9877
22098,22866052,22866052,22866274,0,0,0,222
22093,22864481,22864481,22866886,0,0,0,2405
22096,22864584,22864584,22866907,0,0,0,2323
22095,22864538,22864565,22866909,0,0,27,2371
21347,22587355,22607759,22866959,0,0,20404,279604
22102,22867007,22867007,22867101,0,0,0,94
22099,22866874,22866874,22867272,0,0,0,398
22103,22867476,22867476,22867580,0,0,0,104
22075,22860440,22860440,22867799,0,0,0,7359
22097,22865529,22865529,22867825,0,0,0,2296
22071,22859913,22859913,22867882,0,0,0,7969
22085,22863536,22863536,22867911,0,0,0,4375
22072,22859919,22859919,22867950,0,0,0,8031
22110,22868129,22868129,22868549,0,0,0,420
22111,22868565,22868565,22868658,0,0,0,93
22092,22864425,22864425,22868721,0,0,0,4296
22112,22868832,22868832,22868931,0,0,0,99
21868,22838743,22838743,22869073,0,0,0,30330
22115,22869149,22869149,22869242,0,0,0,93
22114,22869133,22869133,22869353,0,0,0,220
22116,22869286,22869286,22869385,0,0,0,99
22117,22869414,22869414,22869503,0,0,0,89
22119,22869666,22869666,22869744,0,0,0,78
22120,22869681,22869681,22869810,0,0,0,129
22121,22870460,22870460,22870496,0,0,0,36
22122,22870558,22870558,22870605,0,0,0,47
22124,22870991,22870991,22871086,0,0,0,95
22125,22871056,22871056,22871151,0,0,0,95
22126,22871067,22871067,22871151,0,0,0,84
22127,22871090,22871090,22871183,0,0,0,93
22128,22871356,22871356,22871450,0,0,0,94
22130,22871583,22871583,22871656,0,0,0,73
22118,22869462,22869462,22871772,0,0,0,2310
22133,22871821,22871821,22871898,0,0,0,77
22134,22872038,22872038,22872132,0,0,0,94
22025,22849871,22849871,22872286,0,0,0,22415
22026,22849894,22849894,22872318,0,0,0,22424
22136,22873033,22873033,22873130,0,0,0,97
22137,22873103,22873103,22873202,0,0,0,99
22138,22873201,22873201,22873279,0,0,0,78
22135,22872659,22872659,22873280,0,0,0,621
22139,22873957,22873957,22874180,0,0,0,223
22140,22874175,22874175,22874366,0,0,0,191
22141,22874334,22874334,22874494,0,0,0,160
22142,22874490,22874490,22874661,0,0,0,171
22143,22874671,22874671,22874893,0,0,0,222
22129,22871451,22871451,22875354,0,0,0,3903
22081,22861739,22861739,22881044,0,0,0,19305
22131,22871689,22871689,22881569,0,0,0,9880
22132,22871738,22871738,22881855,0,0,0,10117
22108,22867845,22867845,22886290,0,0,0,18445
21433,22595420,22601120,22889085,0,0,5700,293665
22083,22862892,22862892,22892979,0,0,0,30087
22107,22867833,22867833,22898205,0,0,0,30372
22123,22870980,22870980,22898422,0,0,0,27442
22106,22867787,22867787,22898998,0,0,0,31211
22066,22858970,22898998,22899216,0,0,40028,40246
22113,22869010,22869010,22899444,0,0,0,30434
22109,22867918,22867918,22902592,0,0,0,34674
22070,22859905,22859905,22902901,0,0,0,42996
22104,22867541,22867541,22915833,0,0,0,48292
22069,22859889,22859889,22921247,0,0,0,61358
22147,22921667,22921667,22921761,0,0,0,94
22148,22922876,22922876,22922969,0,0,0,93
22145,22892922,22892922,22923086,0,0,0,30164
22153,22923168,22923168,22923251,0,0,0,83
22154,22923317,22923317,22923410,0,0,0,93
22152,22923159,22923159,22923656,0,0,0,497
22151,22923146,22923146,22923690,0,0,0,544
22150,22923137,22923137,22923697,0,0,0,560
22155,22923718,22923718,22923812,0,0,0,94
22156,22924149,22924149,22924242,0,0,0,93
22079,22861370,22861370,22926195,0,0,0,64825
22078,22861338,22861338,22926227,0,0,0,64889
22101,22866889,22866889,22927281,0,0,0,60392
22100,22866881,22866881,22927304,0,0,0,60423
22167,22927853,22927853,22927920,0,0,0,67
22163,22927222,22927222,22928147,0,0,0,925
22165,22927276,22927276,22928170,0,0,0,894
22164,22927246,22927246,22928203,0,0,0,957
22162,22927143,22927143,22928267,0,0,0,1124
22146,22899374,22899374,22929458,0,0,0,30084
22161,22927016,22927016,22929714,0,0,0,2698
22171,22928164,22928164,22929964,0,0,0,1800
22168,22928098,22928098,22930834,0,0,0,2736
22170,22928144,22928144,22930859,0,0,0,2715
22176,22929276,22929276,22930864,0,0,0,1588
22169,22928118,22928118,22930865,0,0,0,2747
22179,22929409,22929409,22930889,0,0,0,1480
22180,22930179,22930179,22930896,0,0,0,717
22175,22929152,22929152,22930952,0,0,0,1800
22181,22930788,22930788,22931674,0,0,0,886
22182,22930795,22930795,22931711,0,0,0,916
22185,22930829,22930829,22931711,0,0,0,882
22184,22930822,22930822,22931716,0,0,0,894
22183,22930803,22930803,22931730,0,0,0,927
22177,22929392,22929392,22931801,0,0,0,2409
22192,22931831,22931831,22931896,0,0,0,65
22193,22931865,22931865,22931950,0,0,0,85
22195,22931948,22931948,22931995,0,0,0,47
22194,22931914,22931914,22931997,0,0,0,83
22197,22932030,22932030,22932205,0,0,0,175
22202,22932400,22932400,22932431,0,0,0,31
22200,22932384,22932384,22932436,0,0,0,52
22201,22932387,22932387,22932439,0,0,0,52
22199,22932342,22932342,22932442,0,0,0,100
22203,22932478,22932478,22932716,0,0,0,238
22205,22932494,22932494,22932767,0,0,0,273
22206,22932496,22932496,22932769,0,0,0,273
22204,22932482,22932482,22932776,0,0,0,294
22207,22932499,22932499,22932803,0,0,0,304
22208,22932501,22932501,22932805,0,0,0,304
22210,22932530,22932530,22932851,0,0,0,321
22209,22932504,22932504,22932861,0,0,0,357
22214,22932741,22932741,22932862,0,0,0,121
22212,22932546,22932546,22932898,0,0,0,352
22213,22932548,22932548,22932900,0,0,0,352
22216,22932860,22932860,22932938,0,0,0,78
22190,22931678,22931678,22933123,0,0,0,1445
22189,22931669,22931669,22933125,0,0,0,1456
22217,22932966,22932966,22933125,0,0,0,159
22188,22931662,22931662,22933129,0,0,0,1467
22186,22931629,22931629,22933130,0,0,0,1501
22187,22931651,22931651,22933130,0,0,0,1479
22191,22931738,22931738,22933130,0,0,0,1392
22237,22933072,22933072,22933166,0,0,0,94
22215,22932825,22932825,22933239,0,0,0,414
22218,22932966,22932966,22933296,0,0,0,330
22224,22932968,22932968,22933546,0,0,0,578
22219,22932966,22932966,22933566,0,0,0,600
22220,22932967,22932967,22933567,0,0,0,600
22221,22932967,22932967,22933567,0,0,0,600
22222,22932967,22932967,22933567,0,0,0,600
22223,22932967,22932967,22933567,0,0,0,600
22225,22932968,22932968,22933568,0,0,0,600
22226,22932968,22932968,22933568,0,0,0,600
22227,22932968,22932968,22933568,0,0,0,600
22228,22932968,22932968,22933568,0,0,0,600
22229,22932969,22932969,22933569,0,0,0,600
22230,22932969,22932969,22933569,0,0,0,600
22231,22932969,22932969,22933569,0,0,0,600
22232,22932969,22932969,22933569,0,0,0,600
22233,22932970,22932970,22933570,0,0,0,600
22234,22932970,22932970,22933570,0,0,0,600
22235,22932970,22932970,22933570,0,0,0,600
22236,22932970,22932970,22933570,0,0,0,600
22198,22932174,22932174,22933974,0,0,0,1800
22245,22933741,22933741,22934057,0,0,0,316
22246,22933892,22933892,22934492,0,0,0,600
22247,22933892,22933892,22934492,0,0,0,600
22248,22933892,22933892,22934492,0,0,0,600
22249,22933892,22933892,22934492,0,0,0,600
22250,22933893,22933893,22934493,0,0,0,600
22251,22933893,22933893,22934493,0,0,0,600
22252,22933893,22933893,22934493,0,0,0,600
22253,22933893,22933893,22934493,0,0,0,600
22254,22933894,22933894,22934494,0,0,0,600
22255,22933894,22933894,22934494,0,0,0,600
22256,22933894,22933894,22934494,0,0,0,600
22257,22933894,22933894,22934494,0,0,0,600
22258,22933895,22933895,22934495,0,0,0,600
22259,22933895,22933895,22934495,0,0,0,600
22260,22933895,22933895,22934495,0,0,0,600
22261,22933895,22933895,22934495,0,0,0,600
22262,22933896,22933896,22934496,0,0,0,600
22263,22933896,22933896,22934496,0,0,0,600
22264,22933896,22933896,22934496,0,0,0,600
22265,22933896,22933896,22934496,0,0,0,600
22266,22933896,22933896,22934496,0,0,0,600
22267,22933897,22933897,22934497,0,0,0,600
22268,22933897,22933897,22934497,0,0,0,600
22269,22933897,22933897,22934497,0,0,0,600
22270,22933897,22933897,22934497,0,0,0,600
22271,22933897,22933897,22934497,0,0,0,600
22272,22933898,22933898,22934498,0,0,0,600
22273,22933898,22933898,22934498,0,0,0,600
22274,22933898,22933898,22934498,0,0,0,600
22275,22933898,22933898,22934498,0,0,0,600
22281,22935378,22935378,22935516,0,0,0,138
22073,22860117,22860117,22935774,0,0,0,75657
22279,22935377,22935377,22935794,0,0,0,417
22282,22935378,22935378,22935795,0,0,0,417
22280,22935377,22935377,22935825,0,0,0,448
22283,22935378,22935378,22935826,0,0,0,448
22285,22935379,22935379,22935889,0,0,0,510
22286,22935379,22935379,22935920,0,0,0,541
22278,22935371,22935371,22935928,0,0,0,557
22284,22935378,22935378,22935978,0,0,0,600
22287,22935379,22935379,22935979,0,0,0,600
22277,22934876,22934876,22936265,0,0,0,1389
22294,22936582,22936582,22936829,0,0,0,247
22288,22936580,22936580,22936920,0,0,0,340
22291,22936581,22936581,22936921,0,0,0,340
22289,22936580,22936580,22936982,0,0,0,402
22295,22936582,22936582,22937015,0,0,0,433
22296,22936582,22936582,22937132,0,0,0,550
22292,22936581,22936581,22937162,0,0,0,581
22059,22857754,22857754,22937163,0,0,0,79409
22290,22936580,22936580,22937180,0,0,0,600
22293,22936581,22936581,22937181,0,0,0,600
22297,22936582,22936582,22937182,0,0,0,600
22276,22934826,22934826,22937376,0,0,0,2550
22211,22932530,22932530,22937724,0,0,0,5194
22303,22937790,22937790,22937990,0,0,0,200
21386,22589303,22678794,22937994,0,0,89491,348691
22300,22937789,22937789,22938093,0,0,0,304
22307,22937791,22937791,22938095,0,0,0,304
22304,22937790,22937790,22938354,0,0,0,564
22299,22937783,22937783,22938383,0,0,0,600
22301,22937789,22937789,22938389,0,0,0,600
22302,22937789,22937789,22938389,0,0,0,600
22305,22937790,22937790,22938390,0,0,0,600
22306,22937790,22937790,22938390,0,0,0,600
22308,22937791,22937791,22938391,0,0,0,600
22080,22861517,22861517,22938711,0,0,0,77194
22311,22938333,22938333,22938758,0,0,0,425
22310,22938217,22938217,22940017,0,0,0,1800
22320,22940194,22940194,22940461,0,0,0,267
22323,22940404,22940404,22940497,0,0,0,93
22316,22940193,22940193,22940522,0,0,0,329
22321,22940194,22940194,22940616,0,0,0,422
22313,22940192,22940192,22940656,0,0,0,464
22317,22940193,22940193,22940657,0,0,0,464
22312,22939837,22939837,22940763,0,0,0,926
22314,22940192,22940192,22940792,0,0,0,600
22315,22940192,22940192,22940792,0,0,0,600
22318,22940193,22940193,22940793,0,0,0,600
22319,22940193,22940193,22940793,0,0,0,600
22322,22940194,22940194,22940794,0,0,0,600
22328,22940631,22940631,22940838,0,0,0,207
22325,22940622,22940622,22940840,0,0,0,218
22326,22940627,22940627,22940845,0,0,0,218
22327,22940629,22940629,22940847,0,0,0,218
22329,22940653,22940653,22940851,0,0,0,198
22330,22940691,22940691,22940884,0,0,0,193
22331,22940698,22940698,22940918,0,0,0,220
22332,22940702,22940702,22940922,0,0,0,220
22333,22940704,22940704,22940924,0,0,0,220
22105,22867757,22867757,22940982,0,0,0,73225
22324,22940620,22940620,22941014,0,0,0,394
22337,22941560,22941560,22941731,0,0,0,171
22338,22941563,22941563,22941734,0,0,0,171
22336,22941554,22941554,22941742,0,0,0,188
22339,22941567,22941567,22941769,0,0,0,202
22340,22941570,22941570,22941772,0,0,0,202
22341,22941591,22941591,22941793,0,0,0,202
22342,22941639,22941639,22941825,0,0,0,186
22343,22941642,22941642,22941828,0,0,0,186
22345,22941664,22941664,22941855,0,0,0,191
22344,22941645,22941645,22941862,0,0,0,217
22335,22941316,22941316,22942744,0,0,0,1428
22350,22942602,22942602,22942803,0,0,0,201
22172,22928210,22928210,22942841,0,0,0,14631
22173,22928345,22928345,22942872,0,0,0,14527
22349,22942596,22942596,22942876,0,0,0,280
22353,22942603,22942603,22943110,0,0,0,507
22357,22942604,22942604,22943111,0,0,0,507
22351,22942602,22942602,22943170,0,0,0,568
22352,22942602,22942602,22943170,0,0,0,568
22354,22942603,22942603,22943171,0,0,0,568
22355,22942603,22942603,22943203,0,0,0,600
22356,22942603,22942603,22943203,0,0,0,600
22358,22942604,22942604,22943204,0,0,0,600
22361,22943144,22943144,22943211,0,0,0,67
22364,22943470,22943470,22943541,0,0,0,71
22367,22943997,22943997,22944199,0,0,0,202
22369,22944366,22944366,22944440,0,0,0,74
22360,22943049,22943049,22944442,0,0,0,1393
22368,22944263,22944263,22944477,0,0,0,214
22371,22944414,22944414,22944488,0,0,0,74
22348,22942474,22942474,22944549,0,0,0,2075
22359,22943004,22943004,22944608,0,0,0,1604
22372,22944443,22944443,22944612,0,0,0,169
22375,22944619,22944619,22944712,0,0,0,93
22370,22944382,22944382,22944719,0,0,0,337
22373,22944601,22944601,22944720,0,0,0,119
22174,22929048,22929048,22944785,0,0,0,15737
22411,22944747,22944785,22944868,0,0,38,121
22410,22944747,22944785,22944884,0,0,38,137
22416,22944779,22944884,22944977,0,0,105,198
22414,22944748,22944868,22944983,0,0,120,235
22393,22944743,22944743,22945082,0,0,0,339
22419,22944919,22944983,22945098,0,0,64,179
22421,22945005,22945005,22945284,0,0,0,279
22434,22945135,22945135,22945338,0,0,0,203
22435,22945138,22945138,22945341,0,0,0,203
22436,22945141,22945141,22945344,0,0,0,203
22437,22945144,22945144,22945347,0,0,0,203
22379,22944739,22944739,22945352,0,0,0,613
22433,22945126,22945126,22945364,0,0,0,238
22365,22943578,22943578,22945378,0,0,0,1800
22438,22945150,22945150,22945384,0,0,0,234
22377,22944738,22944738,22945387,0,0,0,649
22407,22944746,22944746,22945401,0,0,0,655
22427,22945007,22945082,22945420,0,0,75,413
22380,22944739,22944739,22945424,0,0,0,685
22383,22944740,22944740,22945425,0,0,0,685
22384,22944740,22944740,22945425,0,0,0,685
22386,22944741,22944741,22945442,0,0,0,701
22387,22944741,22944741,22945442,0,0,0,701
22443,22945263,22945352,22945446,0,0,89,183
22431,22945008,22945082,22945451,0,0,74,443
22390,22944742,22944742,22945474,0,0,0,732
22394,22944743,22944743,22945475,0,0,0,732
22405,22944746,22944746,22945494,0,0,0,748
22406,22944746,22944746,22945494,0,0,0,748
22423,22945006,22945082,22945500,0,0,76,494
22417,22944889,22945424,22945518,0,0,535,629
22397,22944744,22944744,22945528,0,0,0,784
22398,22944744,22944744,22945528,0,0,0,784
22401,22944745,22944745,22945529,0,0,0,784
22402,22944745,22944745,22945529,0,0,0,784
22425,22945006,22945082,22945534,0,0,76,528
22439,22945154,22945338,22945567,0,0,184,413
22440,22945159,22945341,22945570,0,0,182,411
22441,22945162,22945344,22945573,0,0,182,411
22426,22945006,22945082,22945627,0,0,76,621
22428,22945007,22945082,22945674,0,0,75,667
22424,22945006,22945082,22945682,0,0,76,676
22429,22945007,22945082,22945682,0,0,75,675
22430,22945007,22945082,22945682,0,0,75,675
22442,22945183,22945518,22945772,0,0,335,589
22159,22926333,22926333,22945818,0,0,0,19485
22160,22926589,22926589,22945841,0,0,0,19252
22347,22942447,22942447,22945879,0,0,0,3432
22196,22932008,22932008,22946105,0,0,0,14097
22385,22944740,22944740,22946130,0,0,0,1390
22446,22946039,22946039,22946317,0,0,0,278
22449,22946308,22946308,22946386,0,0,0,78
22422,22945005,22945082,22946436,0,0,77,1431
22451,22946538,22946538,22946627,0,0,0,89
22455,22946572,22946572,22946758,0,0,0,186
22452,22946552,22946552,22946759,0,0,0,207
22456,22946576,22946576,22946762,0,0,0,186
22454,22946561,22946561,22946768,0,0,0,207
22459,22946601,22946601,22946792,0,0,0,191
22457,22946580,22946580,22946797,0,0,0,217
22458,22946598,22946598,22946820,0,0,0,222
22461,22946624,22946624,22946851,0,0,0,227
22463,22946628,22946628,22946855,0,0,0,227
22460,22946605,22946605,22946909,0,0,0,304
22412,22944747,22944785,22946989,0,0,38,2242
22413,22944747,22944785,22946989,0,0,38,2242
22453,22946555,22946555,22947021,0,0,0,466
22166,22927803,22927803,22947024,0,0,0,19221
22466,22946952,22946989,22947062,0,0,37,110
22467,22947108,22947108,22947201,0,0,0,93
22469,22947260,22947260,22947451,0,0,0,191
22470,22947264,22947264,22947455,0,0,0,191
22376,22944737,22944737,22947462,0,0,0,2725
22468,22947254,22947254,22947462,0,0,0,208
22378,22944738,22944738,22947502,0,0,0,2764
22473,22947291,22947291,22947502,0,0,0,211
22476,22947317,22947317,22947502,0,0,0,185
22381,22944739,22944739,22947503,0,0,0,2764
22474,22947295,22947295,22947506,0,0,0,211
22471,22947266,22947266,22947508,0,0,0,242
22472,22947269,22947269,22947511,0,0,0,242
22382,22944739,22944739,22947534,0,0,0,2795
22475,22947299,22947299,22947541,0,0,0,242
22388,22944741,22944741,22947567,0,0,0,2826
22389,22944741,22944741,22947567,0,0,0,2826
22408,22944746,22944746,22947567,0,0,0,2821
22391,22944742,22944742,22947568,0,0,0,2826
22392,22944742,22944742,22947568,0,0,0,2826
22395,22944743,22944743,22947600,0,0,0,2857
22396,22944743,22944743,22947600,0,0,0,2857
22399,22944744,22944744,22947601,0,0,0,2857
22400,22944744,22944744,22947601,0,0,0,2857
22403,22944745,22944745,22947602,0,0,0,2857
22404,22944745,22944745,22947602,0,0,0,2857
22409,22944746,22944785,22947606,0,0,39,2860
22448,22946210,22946210,22947632,0,0,0,1422
22479,22947415,22947415,22947658,0,0,0,243
22420,22944967,22947632,22947726,0,0,2665,2759
22486,22947417,22947417,22947768,0,0,0,351
22489,22947693,22947693,22947895,0,0,0,202
22490,22947697,22947697,22947899,0,0,0,202
22491,22947700,22947700,22947902,0,0,0,202
22488,22947687,22947687,22947905,0,0,0,218
22483,22947416,22947416,22947913,0,0,0,497
22487,22947417,22947417,22947945,0,0,0,528
22492,22947719,22947726,22947955,0,0,7,236
22493,22947724,22947726,22947955,0,0,2,231
22494,22947727,22947727,22947956,0,0,0,229
22495,22947745,22947745,22947979,0,0,0,234
22496,22947748,22947748,22947982,0,0,0,234
22497,22947752,22947752,22947986,0,0,0,234
22514,22947913,22947913,22948007,0,0,0,94
22478,22947409,22947409,22948009,0,0,0,600
22480,22947415,22947415,22948010,0,0,0,595
22481,22947415,22947415,22948015,0,0,0,600
22482,22947415,22947415,22948015,0,0,0,600
22484,22947416,22947416,22948016,0,0,0,600
22485,22947416,22947416,22948016,0,0,0,600
22518,22948102,22948102,22948389,0,0,0,287
22534,22948619,22948619,22948807,0,0,0,188
22520,22948328,22948328,22948928,0,0,0,600
22521,22948328,22948328,22948928,0,0,0,600
22522,22948328,22948328,22948928,0,0,0,600
22523,22948328,22948328,22948928,0,0,0,600
22524,22948329,22948329,22948929,0,0,0,600
22525,22948329,22948329,22948929,0,0,0,600
22526,22948329,22948329,22948929,0,0,0,600
22527,22948329,22948329,22948929,0,0,0,600
22528,22948330,22948330,22948930,0,0,0,600
22529,22948330,22948330,22948930,0,0,0,600
22538,22948620,22948620,22949073,0,0,0,453
22539,22948620,22948620,22949084,0,0,0,464
22536,22948619,22948619,22949130,0,0,0,511
22535,22948619,22948619,22949173,0,0,0,554
22533,22948618,22948618,22949218,0,0,0,600
22537,22948619,22948619,22949219,0,0,0,600
22540,22948620,22948620,22949220,0,0,0,600
22541,22948620,22948620,22949220,0,0,0,600
22542,22948621,22948621,22949221,0,0,0,600
22530,22948385,22948385,22949397,0,0,0,1012
22544,22949327,22949327,22949649,0,0,0,322
22546,22949336,22949336,22949770,0,0,0,434
22547,22949339,22949339,22949773,0,0,0,434
22545,22949333,22949333,22949780,0,0,0,447
22548,22949341,22949397,22949831,0,0,56,490
22549,22949347,22949649,22950134,0,0,302,787
22551,22949353,22949773,22950207,0,0,420,854
22553,22949657,22949831,22950247,0,0,174,590
22477,22947357,22947357,22950282,0,0,0,2925
22550,22949350,22949770,22950291,0,0,420,941
22554,22950359,22950359,22950458,0,0,0,99
22555,22950528,22950528,22950629,0,0,0,101
22556,22950531,22950531,22950855,0,0,0,324
22557,22950541,22950541,22950911,0,0,0,370
22559,22950547,22950629,22950937,0,0,82,390
22561,22950572,22950629,22950999,0,0,57,427
22563,22950577,22950629,22950999,0,0,52,422
22558,22950545,22950629,22951030,0,0,84,485
22560,22950551,22950629,22951030,0,0,78,479
22552,22949492,22949780,22951048,0,0,288,1556
21382,22589197,22691849,22951049,0,0,102652,361852
22565,22950801,22951049,22951142,0,0,248,341
22564,22950580,22950855,22951285,0,0,275,705
22569,22951288,22951288,22951370,0,0,0,82
22568,22951135,22951135,22951487,0,0,0,352
22532,22948385,22948385,22951731,0,0,0,3346
22567,22951115,22951115,22951772,0,0,0,657
22571,22951652,22951652,22951901,0,0,0,249
22572,22951653,22951653,22951933,0,0,0,280
22574,22951658,22951658,22951983,0,0,0,325
22580,22951911,22951911,22951993,0,0,0,82
22578,22951699,22951699,22951994,0,0,0,295
22573,22951655,22951655,22951997,0,0,0,342
22577,22951678,22951678,22952004,0,0,0,326
22576,22951661,22951661,22952018,0,0,0,357
22575,22951660,22951660,22952022,0,0,0,362
22579,22951704,22951704,22952030,0,0,0,326
22519,22948324,22951049,22952057,0,0,2725,3733
22570,22951646,22951646,22952098,0,0,0,452
22562,22950572,22950999,22952238,0,0,427,1666
22582,22952492,22952492,22952568,0,0,0,76
22584,22952569,22952569,22952631,0,0,0,62
22585,22952597,22952597,22952659,0,0,0,62
22581,22952101,22952101,22952711,0,0,0,610
22583,22952544,22952544,22952787,0,0,0,243
22531,22948385,22951049,22952849,0,0,2664,4464
22586,22952645,22952645,22952981,0,0,0,336
22588,22952922,22952922,22953051,0,0,0,129
22589,22953087,22953087,22953141,0,0,0,54
22149,22923025,22923025,22953300,0,0,0,30275
22693,22953524,22953524,22953648,0,0,0,124
22714,22953589,22953589,22953656,0,0,0,67
22029,22849985,22849985,22953694,0,0,0,103709
22715,22953708,22953708,22953962,0,0,0,254
22717,22954411,22954411,22954536,0,0,0,125
22591,22953160,22953160,22954769,0,0,0,1609
22718,22954499,22954769,22954836,0,0,270,337
22840,22955114,22955114,22955161,0,0,0,47
22543,22948750,22951049,22955689,0,0,2299,6939
22587,22952649,22952649,22955720,0,0,0,3071
22842,22955831,22955831,22955903,0,0,0,72
22843,22956466,22956466,22956544,0,0,0,78
22846,22956979,22956979,22957046,0,0,0,67
22848,22957164,22957164,22957231,0,0,0,67
22841,22955534,22955534,22957356,0,0,0,1822
22362,22943249,22943249,22957585,0,0,0,14336
22849,22957555,22957555,22957622,0,0,0,67
22716,22954043,22957585,22957709,0,0,3542,3666
22844,22956550,22957709,22957833,0,0,1159,1283
22845,22956592,22957833,22957943,0,0,1241,1351
22593,22953452,22953452,22958956,0,0,0,5504
22594,22953452,22953452,22958956,0,0,0,5504
22597,22953452,22953694,22959180,0,0,242,5728
22598,22953453,22953694,22959180,0,0,241,5727
22595,22953452,22953452,22959204,0,0,0,5752
22596,22953452,22953452,22959482,0,0,0,6030
22346,22941879,22941879,22959761,0,0,0,17882
22309,22938066,22938066,22959816,0,0,0,21750
22363,22943342,22943342,22960995,0,0,0,17653
22600,22953453,22955689,22961188,0,0,2236,7735
22599,22953453,22955689,22961190,0,0,2236,7737
22566,22951109,22951109,22961430,0,0,0,10321
22601,22953453,22955689,22961458,0,0,2236,8005
22602,22953453,22955689,22961489,0,0,2236,8036
22604,22953454,22957585,22963084,0,0,4131,9630
22590,22953116,22953116,22963125,0,0,0,10009
22603,22953453,22957585,22963664,0,0,4132,10211
22605,22953454,22958956,22964517,0,0,5502,11063
22606,22953454,22958956,22964723,0,0,5502,11269
22607,22953454,22959180,22964978,0,0,5726,11524
22608,22953454,22959180,22965226,0,0,5726,11772
22609,22953454,22959204,22965281,0,0,5750,11827
22614,22953465,22959816,22965295,0,0,6351,11830
22611,22953455,22959761,22965497,0,0,6306,12042
22612,22953455,22959761,22965528,0,0,6306,12073
22613,22953465,22959761,22965550,0,0,6296,12085
22610,22953454,22959482,22965559,0,0,6028,12105
22615,22953465,22959816,22965559,0,0,6351,12094
22617,22953465,22960995,22966448,0,0,7530,12983
22620,22953466,22961190,22966687,0,0,7724,13221
22616,22953465,22960995,22966738,0,0,7530,13273
22618,22953465,22960995,22966788,0,0,7530,13323
22622,22953467,22961458,22966941,0,0,7991,13474
22623,22953467,22961489,22966973,0,0,8022,13506
22621,22953466,22961430,22967802,0,0,7964,14336
22626,22953468,22963664,22969116,0,0,10196,15648
22624,22953467,22963084,22969177,0,0,9617,15710
22625,22953467,22963125,22969280,0,0,9658,15813
21384,22589285,22710154,22969354,0,0,120869,380069
22860,22969834,22969834,22969994,0,0,0,160
22627,22953468,22964517,22970280,0,0,11049,16812
22861,22970402,22970402,22970469,0,0,0,67
22630,22953469,22965226,22970679,0,0,11757,17210
22628,22953468,22964723,22970765,0,0,11255,17297
22631,22953469,22965281,22970765,0,0,11812,17296
22862,22970772,22970772,22970864,0,0,0,92
22634,22953486,22965528,22970974,0,0,12042,17488
22432,22945112,22945446,22970981,0,0,334,25869
22629,22953468,22964978,22971020,0,0,11510,17552
22636,22953486,22965559,22971020,0,0,12073,17534
22633,22953486,22965497,22971260,0,0,12011,17774
22635,22953486,22965550,22971306,0,0,12064,17820
22637,22953487,22965559,22971330,0,0,12072,17843
22632,22953469,22965295,22971379,0,0,11826,17910
22863,22971330,22971330,22971397,0,0,0,67
22864,22971851,22971851,22971949,0,0,0,98
22639,22953487,22966687,22972180,0,0,13200,18693
22638,22953487,22966448,22972188,0,0,12961,18701
22643,22953488,22966973,22972465,0,0,13485,18977
22640,22953487,22966738,22972485,0,0,13251,18998
22641,22953487,22966788,22972560,0,0,13301,19073
22178,22929400,22929400,22972600,0,0,0,43200
22642,22953487,22966941,22972713,0,0,13454,19226
22866,22972959,22972959,22973026,0,0,0,67
22644,22953488,22967802,22973263,0,0,14314,19775
22445,22946035,22946035,22974508,0,0,0,28473
22645,22953489,22969116,22974608,0,0,15627,21119
22649,22953490,22969354,22974815,0,0,15864,21325
22655,22953504,22969354,22974843,0,0,15850,21339
22650,22953490,22969354,22974846,0,0,15864,21356
22646,22953489,22969177,22974979,0,0,15688,21490
22647,22953489,22969280,22975082,0,0,15791,21593
22651,22953490,22969354,22975094,0,0,15864,21604
22657,22953504,22969354,22975105,0,0,15850,21601
22656,22953504,22969354,22975133,0,0,15850,21629
22652,22953490,22969354,22975136,0,0,15864,21646
22653,22953503,22969354,22975156,0,0,15851,21653
22648,22953489,22969354,22975229,0,0,15865,21740
22654,22953503,22969354,22975401,0,0,15851,21898
22660,22953504,22970765,22976237,0,0,17261,22733
22661,22953505,22970765,22976237,0,0,17260,22732
22658,22953504,22970280,22976310,0,0,16776,22806
22659,22953504,22970679,22976430,0,0,17175,22926
22662,22953505,22970974,22976446,0,0,17469,22941
22664,22953505,22970981,22976453,0,0,17476,22948
22663,22953505,22970981,22976484,0,0,17476,22979
22665,22953505,22971020,22976492,0,0,17515,22987
22667,22953506,22971260,22976732,0,0,17754,23226
22669,22953506,22971330,22976802,0,0,17824,23296
22670,22953506,22971379,22976882,0,0,17873,23376
22668,22953506,22971306,22977057,0,0,17800,23551
22666,22953505,22971020,22977081,0,0,17515,23576
22673,22953517,22972465,22977930,0,0,18948,24413
22671,22953506,22972180,22977955,0,0,18674,24449
22674,22953517,22972485,22977970,0,0,18968,24453
22676,22953517,22972600,22978085,0,0,19083,24568
22675,22953517,22972560,22978138,0,0,19043,24621
22677,22953517,22972713,22978198,0,0,19196,24681
22672,22953506,22972188,22978273,0,0,18682,24767
22678,22953517,22973263,22979058,0,0,19746,25541
22680,22953518,22974508,22979961,0,0,20990,26443
22681,22953518,22974608,22980094,0,0,21090,26576
22682,22953518,22974815,22980270,0,0,21297,26752
22679,22953518,22974508,22980272,0,0,20990,26754
22684,22953518,22974846,22980301,0,0,21328,26783
22683,22953518,22974843,22980329,0,0,21325,26811
22686,22953519,22975082,22980537,0,0,21563,27018
22687,22953519,22975094,22980580,0,0,21575,27061
22694,22953534,22975401,22980894,0,0,21867,27360
22689,22953519,22975133,22980905,0,0,21614,27386
22690,22953519,22975136,22980908,0,0,21617,27389
22685,22953518,22974979,22981023,0,0,21461,27505
22692,22953520,22975229,22981094,0,0,21709,27574
22688,22953519,22975105,22981149,0,0,21586,27630
22691,22953519,22975156,22981176,0,0,21637,27657
22695,22953535,22976237,22981699,0,0,22702,28164
22697,22953535,22976310,22981803,0,0,22775,28268
22698,22953535,22976430,22981923,0,0,22895,28388
22701,22953536,22976484,22981945,0,0,22948,28409
22696,22953535,22976237,22982040,0,0,22702,28505
22703,22953537,22976732,22982193,0,0,23195,28656
22700,22953536,22976453,22982194,0,0,22917,28658
22699,22953536,22976446,22982217,0,0,22910,28681
22704,22953537,22976802,22982263,0,0,23265,28726
22705,22953537,22976882,22982343,0,0,23345,28806
22706,22953537,22977057,22982550,0,0,23520,29013
22707,22953537,22977081,22982853,0,0,23544,29316
22592,22953238,22953238,22983135,0,0,0,29897
22709,22953538,22977955,22983416,0,0,24417,29878
22710,22953538,22977970,22983431,0,0,24432,29893
21717,22724540,22724540,22983740,0,0,0,259200
21718,22724541,22724541,22983741,0,0,0,259200
21719,22724541,22724541,22983741,0,0,0,259200
21720,22724541,22724541,22983741,0,0,0,259200
21721,22724541,22724541,22983741,0,0,0,259200
21722,22724542,22724542,22983742,0,0,0,259200
21723,22724542,22724542,22983742,0,0,0,259200
22711,22953538,22978085,22983857,0,0,24547,30319
22713,22953538,22978198,22983969,0,0,24660,30431
22708,22953537,22977930,22983981,0,0,24393,30444
22719,22954811,22978273,22984013,0,0,23462,29202
22712,22953538,22978138,22984188,0,0,24600,30650
22865,22972632,22983742,22984419,0,0,11110,11787
22720,22954812,22979058,22984550,0,0,24246,29738
22619,22953465,22961188,22984797,0,0,7723,31332
22867,22974331,22984419,22985112,0,0,10088,10781
21724,22725931,22725931,22985131,0,0,0,259200
21725,22725964,22725964,22985164,0,0,0,259200
22868,22976678,22985112,22985185,0,0,8434,8507
22721,22954813,22979961,22985453,0,0,25148,30640
22722,22954813,22980094,22985555,0,0,25281,30742
22723,22954813,22980270,22985762,0,0,25457,30949
22724,22954813,22980272,22985764,0,0,25459,30951
22726,22954814,22980329,22985790,0,0,25515,30976
22725,22954814,22980301,22985793,0,0,25487,30979
22869,22976895,22985185,22985930,0,0,8290,9035
22727,22954814,22980537,22986029,0,0,25723,31215
22728,22954814,22980580,22986072,0,0,25766,31258
22729,22954815,22980894,22986386,0,0,26079,31571
22730,22954815,22980905,22986397,0,0,26090,31582
22733,22954816,22981094,22986586,0,0,26278,31770
22734,22954816,22981149,22986610,0,0,26333,31794
22735,22954816,22981176,22986668,0,0,26360,31852
22870,22979563,22985930,22986710,0,0,6367,7147
22731,22954815,22980908,22986958,0,0,26093,32143
22732,22954815,22981023,22987197,0,0,26208,32382
22738,22954817,22981923,22987384,0,0,27106,32567
22736,22954816,22981699,22987501,0,0,26883,32685
22740,22954826,22982040,22987502,0,0,27214,32676
22737,22954817,22981803,22987554,0,0,26986,32737
22742,22954827,22982194,22987656,0,0,27367,32829
22743,22954827,22982217,22987679,0,0,27390,32852
22741,22954826,22982193,22987686,0,0,27367,32860
22444,22946018,22946018,22987717,0,0,0,41699
22744,22954827,22982263,22987756,0,0,27436,32929
22746,22954828,22982550,22988042,0,0,27722,33214
22739,22954826,22981945,22988051,0,0,27119,33225
22745,22954827,22982343,22988053,0,0,27516,33226
22747,22954828,22982853,22988625,0,0,28025,33797
22748,22954828,22983416,22988877,0,0,28588,34049
22749,22954828,22983431,22988917,0,0,28603,34089
22753,22954829,22983969,22989424,0,0,29140,34595
22754,22954829,22983981,22989467,0,0,29152,34638
22755,22954829,22984013,22989479,0,0,29184,34650
22751,22954828,22983741,22989517,0,0,28913,34689
22750,22954828,22983740,22989536,0,0,28912,34708
22756,22954829,22984188,22989685,0,0,29359,34856
22752,22954828,22983857,22989881,0,0,29029,35053
22757,22954829,22984550,22990357,0,0,29721,35528
22758,22954829,22984797,22990852,0,0,29968,36023
22759,22954840,22985453,22990919,0,0,30613,36079
22760,22954840,22985555,22991021,0,0,30715,36181
22762,22954840,22985764,22991230,0,0,30924,36390
22763,22954840,22985790,22991256,0,0,30950,36416
22764,22954841,22985793,22991290,0,0,30952,36449
22765,22954841,22986029,22991495,0,0,31188,36654
22761,22954840,22985762,22991538,0,0,30922,36698
22766,22954841,22986072,22991569,0,0,31231,36728
22768,22954841,22986397,22991956,0,0,31556,37115
22771,22954842,22986668,22992164,0,0,31826,37322
22767,22954841,22986386,22992472,0,0,31545,37631
22769,22954841,22986586,22992640,0,0,31745,37799
22770,22954841,22986610,22992664,0,0,31769,37823
22773,22954842,22987197,22992667,0,0,32355,37825
22772,22954842,22986958,22992722,0,0,32116,37880
22774,22954842,22987384,22992871,0,0,32542,38029
22777,22954843,22987554,22993047,0,0,32711,38204
22780,22954855,22987679,22993141,0,0,32824,38286
22782,22954855,22987717,22993148,0,0,32862,38293
22781,22954855,22987686,22993179,0,0,32831,38324
22783,22954855,22987717,22993179,0,0,32862,38324
22775,22954842,22987501,22993304,0,0,32659,38462
22778,22954843,22987656,22993397,0,0,32813,38554
22787,22954856,22988053,22993526,0,0,33197,38670
22784,22954855,22987756,22993533,0,0,32901,38678
22776,22954842,22987502,22993553,0,0,32660,38711
22785,22954855,22988042,22993788,0,0,33187,38933
22786,22954855,22988051,22994104,0,0,33196,39249
22789,22954857,22988877,22994336,0,0,34020,39479
22788,22954856,22988625,22994405,0,0,33769,39549
22790,22954857,22988917,22994666,0,0,34060,39809
22508,22947912,22947912,22994906,0,0,0,46994
22793,22954858,22989479,22994969,0,0,34621,40111
22794,22954858,22989517,22994976,0,0,34659,40118
22501,22947910,22947910,22995198,0,0,0,47288
22795,22954858,22989536,22995328,0,0,34678,40470
22797,22954859,22989881,22995332,0,0,35022,40473
22509,22947912,22947912,22995402,0,0,0,47490
22499,22947910,22947910,22995438,0,0,0,47528
22796,22954858,22989685,22995457,0,0,34827,40599
22791,22954857,22989424,22995475,0,0,34567,40618
22510,22947912,22947912,22995495,0,0,0,47583
22792,22954857,22989467,22995549,0,0,34610,40692
22500,22947910,22947910,22995562,0,0,0,47652
22798,22954859,22990357,22995839,0,0,35498,40980
22512,22947912,22947912,22995888,0,0,0,47976
22847,22957124,22995839,22995932,0,0,38715,38808
22511,22947912,22947912,22996078,0,0,0,48166
22799,22954859,22990852,22996345,0,0,35993,41486
22374,22944615,22944615,22996355,0,0,0,51740
22498,22947909,22947909,22996534,0,0,0,48625
22800,22954871,22990919,22996691,0,0,36048,41820
22803,22954872,22991256,22996780,0,0,36384,41908
22801,22954871,22991021,22996793,0,0,36150,41922
22804,22954872,22991290,22996814,0,0,36418,41942
22450,22946410,22946410,22996882,0,0,0,50472
22802,22954871,22991230,22996971,0,0,36359,42100
22505,22947911,22947911,22996976,0,0,0,49065
22805,22954872,22991495,22996988,0,0,36623,42116
22502,22947911,22947911,22996997,0,0,0,49086
22807,22954872,22991569,22997062,0,0,36697,42190
22504,22947911,22947911,22997216,0,0,0,49305
22503,22947911,22947911,22997235,0,0,0,49324
22806,22954872,22991538,22997310,0,0,36666,42438
22809,22954873,22992164,22997626,0,0,37291,42753
22808,22954872,22991956,22997820,0,0,37084,42948
22810,22954873,22992472,22997973,0,0,37599,43100
22811,22954873,22992640,22998148,0,0,37767,43275
22814,22954873,22992722,22998215,0,0,37849,43342
22812,22954873,22992664,22998458,0,0,37791,43585
22334,22940794,22940794,22998485,0,0,0,57691
22816,22954874,22993047,22998527,0,0,38173,43653
22850,22958780,22998485,22998579,0,0,39705,39799
22820,22954885,22993179,22998628,0,0,38294,43743
22815,22954873,22992871,22998642,0,0,37998,43769
22447,22946203,22946203,22998704,0,0,0,52501
22813,22954873,22992667,22998741,0,0,37794,43868
22821,22954885,22993304,22998769,0,0,38419,43884
22822,22954886,22993397,22998862,0,0,38511,43976
22817,22954874,22993141,22998916,0,0,38267,44042
22818,22954874,22993148,22998954,0,0,38274,44080
22819,22954874,22993179,22998985,0,0,38305,44111
22823,22954886,22993526,22998986,0,0,38640,44100
22826,22954886,22993788,22999261,0,0,38902,44375
22824,22954886,22993533,22999282,0,0,38647,44396
22506,22947911,22947911,22999395,0,0,0,51484
22825,22954886,22993553,22999581,0,0,38667,44695
22827,22954886,22994104,22999593,0,0,39218,44707
22829,22954887,22994405,22999863,0,0,39518,44976
22418,22944890,22944977,23000341,0,0,87,55451
22830,22954887,22994666,23000403,0,0,39779,45516
22828,22954886,22994336,23000414,0,0,39450,45528
22832,22954887,22994976,23000473,0,0,40089,45586
22831,22954887,22994969,23000737,0,0,40082,45850
22833,22954887,22995328,23000841,0,0,40441,45954
22835,22954888,22995438,23000920,0,0,40550,46032
22836,22954888,22995457,23000939,0,0,40569,46051
22837,22954888,22995475,23000957,0,0,40587,46069
22834,22954887,22995332,23001073,0,0,40445,46186
22871,22980638,22995932,23001414,0,0,15294,20776
22515,22947913,22947913,23001428,0,0,0,53515
22872,22980639,22996078,23001579,0,0,15439,20940
22838,22954888,22995549,23001608,0,0,40661,46720
22839,22954888,22995562,23001621,0,0,40674,46733
22873,22980639,22996345,23001838,0,0,15706,21199
22876,22980640,22996780,23002335,0,0,16140,21695
22465,22946947,22946947,23002398,0,0,0,55451
22879,22980640,22996971,23002427,0,0,16331,21787
22875,22980639,22996691,23002432,0,0,16052,21793
22880,22980641,22996976,23002485,0,0,16335,21844
22881,22980641,22996988,23002492,0,0,16347,21851
22874,22980639,22996534,23002553,0,0,15895,21914
22878,22980640,22996814,23002628,0,0,16174,21988
22884,22980642,22997310,23002779,0,0,16668,22137
22882,22980641,22997062,23002793,0,0,16421,22152
22877,22980640,22996793,23002848,0,0,16153,22208
22885,22980642,22997626,23003124,0,0,16984,22482
22883,22980641,22997216,23003251,0,0,16575,22610
22507,22947911,22947911,23003258,0,0,0,55347
22702,22953536,22976492,23003260,0,0,22956,49724
22886,22980642,22997820,23003566,0,0,17178,22924
22888,22980643,22998148,23003646,0,0,17505,23003
22889,22980643,22998215,23003666,0,0,17572,23023
22887,22980642,22997973,23004023,0,0,17331,23381
22893,22980665,22998579,23004077,0,0,17914,23412
22897,22980666,22998741,23004208,0,0,18075,23542
22898,22980666,22998769,23004236,0,0,18103,23570
22890,22980643,22998458,23004253,0,0,17815,23610
22892,22980664,22998527,23004269,0,0,17863,23605
22894,22980665,22998579,23004352,0,0,17914,23687
22901,22980667,22998954,23004446,0,0,18287,23779
22462,22946624,22946624,23004466,0,0,0,57842
22903,22980667,22998986,23004469,0,0,18319,23802
22902,22980667,22998985,23004494,0,0,18318,23827
22891,22980663,22998485,23004522,0,0,17822,23859
22899,22980666,22998862,23004652,0,0,18196,23986
22895,22980665,22998628,23004680,0,0,17963,24015
22896,22980665,22998642,23004725,0,0,17977,24060
22905,22980668,22999282,23004836,0,0,18614,24168
22464,22946881,22946881,23004942,0,0,0,58061
22900,22980666,22998916,23005007,0,0,18250,24341
22904,22980667,22999261,23005054,0,0,18594,24387
22909,22980669,22999863,23005343,0,0,19194,24674
22906,22980668,22999395,23005476,0,0,18727,24808
22907,22980668,22999581,23005600,0,0,18913,24932
22908,22980668,22999593,23005648,0,0,18925,24980
22911,22980692,23000414,23005863,0,0,19722,25171
22912,22980693,23000473,23005948,0,0,19780,25255
22910,22980669,23000403,23006460,0,0,19734,25791
22913,22980693,23000737,23006522,0,0,20044,25829
22918,22980694,23001073,23006529,0,0,20379,25835
22914,22980693,23000841,23006588,0,0,20148,25895
22915,22980693,23000920,23006683,0,0,20227,25990
22916,22980693,23000939,23006702,0,0,20246,26009
22516,22947913,22947955,23006714,0,0,42,58801
22920,22980694,23001428,23006856,0,0,20734,26162
22919,22980694,23001414,23006873,0,0,20720,26179
22921,22980694,23001579,23007038,0,0,20885,26344
22922,22980694,23001608,23007074,0,0,20914,26380
22923,22980694,23001621,23007087,0,0,20927,26393
22925,22980695,23002335,23007827,0,0,21640,27132
22924,22980694,23001838,23007846,0,0,21144,27152
22928,22980695,23002485,23007966,0,0,21790,27271
22513,22947912,22947912,23007967,0,0,0,60055
22931,22980706,23002628,23008134,0,0,21922,27428
22926,22980695,23002427,23008187,0,0,21732,27492
22929,22980695,23002492,23008259,0,0,21797,27564
22933,22980707,23002793,23008274,0,0,22086,27567
22927,22980695,23002432,23008440,0,0,21737,27745
22935,22980708,23003124,23008585,0,0,22416,27877
22930,22980695,23002553,23008599,0,0,21858,27904
22934,22980707,23002848,23008623,0,0,22141,27916
22937,22980709,23003258,23008732,0,0,22549,28023
22936,22980708,23003251,23008765,0,0,22543,28057
22517,22947913,22947986,23008872,0,0,73,60959
22938,22980709,23003260,23009054,0,0,22551,28345
22932,22980706,23002779,23009104,0,0,22073,28398
22939,22980709,23003566,23009130,0,0,22857,28421
22941,22980710,23003666,23009137,0,0,22956,28427
22940,22980709,23003646,23009407,0,0,22937,28698
22944,22980711,23004208,23009710,0,0,23497,28999
22946,22980711,23004253,23009755,0,0,23542,29044
22947,22980711,23004269,23009759,0,0,23558,29048
22942,22980710,23004023,23009798,0,0,23313,29088
22948,22980712,23004352,23009840,0,0,23640,29128
22943,22980710,23004077,23009845,0,0,23367,29135
22851,22959016,23009759,23009852,0,0,50743,50836
22949,22980712,23004446,23009930,0,0,23734,29218
22951,22980723,23004494,23009947,0,0,23771,29224
22952,22980723,23004522,23009999,0,0,23799,29276
22955,22980724,23004725,23010184,0,0,24001,29460
22945,22980711,23004236,23010274,0,0,23525,29563
22956,22980724,23004836,23010326,0,0,24112,29602
22957,22980724,23004942,23010386,0,0,24218,29662
22953,22980723,23004652,23010392,0,0,23929,29669
22954,22980723,23004680,23010420,0,0,23957,29697
22950,22980712,23004469,23010485,0,0,23757,29773
22959,22980724,23005054,23010529,0,0,24330,29805
22958,22980724,23005007,23010781,0,0,24283,30057
22960,22980724,23005343,23010849,0,0,24619,30125
22962,22980725,23005600,23011099,0,0,24875,30374
22963,22980725,23005648,23011147,0,0,24923,30422
22961,22980724,23005476,23011261,0,0,24752,30537
22964,22980725,23005863,23011652,0,0,25138,30927
22965,22980725,23005948,23011985,0,0,25223,31260
22968,22980726,23006529,23011985,0,0,25803,31259
22971,22980739,23006702,23012191,0,0,25963,31452
22972,22980740,23006856,23012314,0,0,26116,31574
22969,22980726,23006588,23012338,0,0,25862,31612
22973,22980740,23006873,23012353,0,0,26133,31613
22970,22980728,23006683,23012442,0,0,25955,31714
22966,22980725,23006460,23012497,0,0,25735,31772
22976,22980740,23007087,23012569,0,0,26347,31829
22967,22980725,23006522,23012591,0,0,25797,31866
22975,22980740,23007074,23012629,0,0,26334,31889
22974,22980740,23007038,23012797,0,0,26298,32057
22991,22983131,22983131,23012852,0,0,0,29721
22979,22980741,23007966,23013434,0,0,27225,32693
22982,22980742,23008187,23013683,0,0,27445,32941
22984,22980743,23008274,23013740,0,0,27531,32997
22983,22980742,23008259,23013741,0,0,27517,32999
22980,22980741,23007967,23013760,0,0,27226,33019
22977,22980740,23007827,23013847,0,0,27087,33107
22981,22980742,23008134,23013874,0,0,27392,33132
22978,22980740,23007846,23013896,0,0,27106,33156
22985,22980743,23008440,23014219,0,0,27697,33476
22986,22980743,23008585,23014334,0,0,27842,33591
22987,22980743,23008599,23014379,0,0,27856,33636
22988,22980744,23008623,23014397,0,0,27879,33653
22989,22980744,23008732,23014463,0,0,27988,33719
22990,22980744,23008765,23014527,0,0,28021,33783
22298,22937106,22937106,23016417,0,0,0,79311
23008,23018080,23018080,23018159,0,0,0,79
23011,23018201,23018201,23018363,0,0,0,162
23015,23018327,23018327,23018364,0,0,0,37
23014,23018299,23018299,23018509,0,0,0,210
23018,23018470,23018470,23018537,0,0,0,67
23020,23018769,23018769,23018847,0,0,0,78
23021,23019369,23019369,23019461,0,0,0,92
22366,22943603,22943603,23019984,0,0,0,76381
23023,23019882,23019882,23020200,0,0,0,318
23022,23019839,23019839,23020439,0,0,0,600
23024,23020173,23020173,23020594,0,0,0,421
23025,23020567,23020567,23020603,0,0,0,36
23026,23020626,23020626,23020725,0,0,0,99
23027,23020727,23020727,23020825,0,0,0,98
23029,23021505,23021505,23021572,0,0,0,67
23031,23022084,23022084,23022182,0,0,0,98
23034,23024410,23024410,23024470,0,0,0,60
22917,22980693,23000957,23024908,0,0,20264,44215
23035,23025020,23025020,23025129,0,0,0,109
23036,23025553,23025553,23025651,0,0,0,98
22244,22933145,22933145,23025682,0,0,0,92537
23009,23018128,23025682,23025775,0,0,7554,7647
23012,23018233,23025775,23025868,0,0,7542,7635
23016,23018361,23018361,23026664,0,0,0,8303
23037,23026326,23026326,23026908,0,0,0,582
23017,23018464,23018464,23027171,0,0,0,8707
23039,23027015,23027015,23027532,0,0,0,517
23040,23027333,23027333,23027679,0,0,0,346
23003,23013139,23013139,23028164,0,0,0,15025
23010,23018176,23028164,23028257,0,0,9988,10081
23013,23018262,23028257,23028350,0,0,9995,10088
23043,23028297,23028350,23028422,0,0,53,125
23042,23028097,23028097,23028465,0,0,0,368
23019,23018574,23019984,23028489,0,0,1410,9915
23041,23028079,23028079,23028558,0,0,0,479
23044,23029748,23029748,23029815,0,0,0,67
23001,23010143,23010143,23030098,0,0,0,19955
23045,23030241,23030241,23030339,0,0,0,98
23046,23030551,23030551,23030820,0,0,0,269
23048,23030877,23030877,23031152,0,0,0,275
23051,23031983,23031983,23032067,0,0,0,84
23054,23033167,23033167,23033260,0,0,0,93
23053,23033105,23033105,23033409,0,0,0,304
23055,23033507,23033507,23033580,0,0,0,73
22239,22933073,22933073,23033661,0,0,0,100588
23057,23033628,23033628,23033701,0,0,0,73
23038,23026876,23033661,23033755,0,0,6785,6879
23052,23032120,23032120,23033876,0,0,0,1756
23060,23033823,23033823,23033896,0,0,0,73
23061,23033918,23033918,23034033,0,0,0,115
23059,23033817,23033817,23034090,0,0,0,273
23066,23034172,23034172,23034291,0,0,0,119
23067,23034254,23034254,23034508,0,0,0,254
23068,23034806,23034806,23034899,0,0,0,93
23070,23035081,23035081,23035174,0,0,0,93
23071,23035319,23035319,23035412,0,0,0,93
23072,23035408,23035408,23035481,0,0,0,73
23073,23035485,23035485,23035563,0,0,0,78
23074,23035568,23035568,23035674,0,0,0,106
23075,23035681,23035681,23035774,0,0,0,93
23076,23035769,23035769,23035842,0,0,0,73
23077,23035934,23035934,23036007,0,0,0,73
23078,23036042,23036042,23036115,0,0,0,73
23079,23036141,23036141,23036234,0,0,0,93
23080,23036259,23036259,23036353,0,0,0,94
23081,23036431,23036431,23036524,0,0,0,93
23082,23036527,23036527,23036620,0,0,0,93
23083,23036864,23036864,23036988,0,0,0,124
23084,23037233,23037233,23037337,0,0,0,104
23069,23035068,23035068,23042495,0,0,0,7427
23093,23037741,23042495,23042587,0,0,4754,4846
23087,23037538,23042495,23042592,0,0,4957,5054
23096,23037917,23042587,23042660,0,0,4670,4743
23102,23038253,23042592,23042685,0,0,4339,4432
23004,23013147,23013434,23044202,0,0,287,31055
23085,23037477,23037477,23046457,0,0,0,8980
23005,23016312,23016312,23049628,0,0,0,33316
23007,23016483,23016483,23049850,0,0,0,33367
23090,23037609,23049850,23049944,0,0,12241,12335
23092,23037720,23042495,23050841,0,0,4775,13121
23088,23037575,23042495,23051022,0,0,4920,13447
23089,23037578,23037578,23051099,0,0,0,13521
23104,23042172,23051022,23051146,0,0,8850,8974
23105,23042439,23051146,23051239,0,0,8707,8800
23107,23043689,23051239,23051487,0,0,7550,7798
23108,23044070,23051487,23051580,0,0,7417,7510
23109,23044161,23051580,23051653,0,0,7419,7492
23110,23044340,23051653,23051808,0,0,7313,7468
23111,23044541,23051808,23051902,0,0,7267,7361
23112,23045170,23051902,23051996,0,0,6732,6826
23086,23037507,23037507,23052091,0,0,0,14584
22855,22961527,23010392,23054513,0,0,48865,92986
23095,23037801,23046457,23054540,0,0,8656,16739
23002,23012978,23012978,23054564,0,0,0,41586
23056,23033597,23054513,23054660,0,0,20916,21063
23058,23033701,23054564,23054727,0,0,20863,21026
23047,23030602,23033755,23055047,0,0,3153,24445
23030,23022068,23022068,23055262,0,0,0,33194
23094,23037758,23042495,23056160,0,0,4737,18402
22856,22961540,23010849,23057175,0,0,49309,95635
23062,23033959,23057175,23057330,0,0,23216,23371
23103,23038673,23049628,23058444,0,0,10955,19771
23097,23037918,23049628,23058973,0,0,11710,21055
23033,23024008,23028350,23060223,0,0,4342,36215
23106,23042840,23042840,23062047,0,0,0,19207
23091,23037699,23049944,23063701,0,0,12245,26002
22242,22933088,22933088,23066109,0,0,0,133021
21853,22809640,22809640,23067910,0,0,0,258270
22241,22933082,22933082,23068602,0,0,0,135520
21847,22809497,22809497,23068697,0,0,0,259200
21848,22809498,22809498,23068698,0,0,0,259200
21849,22809498,22809498,23068698,0,0,0,259200
21850,22809498,22809498,23068698,0,0,0,259200
21851,22809520,22809520,23068720,0,0,0,259200
21852,22809520,22809520,23068720,0,0,0,259200
21854,22809736,22809736,23068936,0,0,0,259200
21716,22724137,22724137,23069737,0,0,0,345600
23049,23031081,23044202,23086085,0,0,13121,55004
23113,23051076,23054540,23087833,0,0,3464,36757
22857,22961576,23014379,23087876,0,0,52803,126300
22415,22944773,23087876,23088032,0,0,143103,143259
23114,23051113,23054727,23088969,0,0,3614,37856
23050,23031088,23054513,23088973,0,0,23425,57885
23063,23033990,23088973,23089190,0,0,54983,55200
23098,23038130,23054660,23090609,0,0,16530,52479
23099,23038201,23054727,23091836,0,0,16526,53635
22238,22933072,22933072,23094019,0,0,0,160947
23101,23038252,23057175,23094325,0,0,18923,56073
21923,22842547,22842547,23095147,0,0,0,252600
21924,22842561,22842561,23095161,0,0,0,252600
21925,22842578,22842578,23095178,0,0,0,252600
23006,23016348,23016348,23095183,0,0,0,78835
23100,23038227,23055047,23095725,0,0,16820,57498
23126,23097076,23097076,23097170,0,0,0,94
23127,23097607,23097607,23097700,0,0,0,93
23128,23098226,23098226,23098319,0,0,0,93
23129,23098758,23098758,23098851,0,0,0,93
23130,23099301,23099301,23099405,0,0,0,104
23131,23099757,23099757,23099863,0,0,0,106
23132,23100099,23100099,23100193,0,0,0,94
23133,23100412,23100412,23100514,0,0,0,102
23134,23100484,23100484,23100578,0,0,0,94
23136,23100617,23100617,23100701,0,0,0,84
23135,23100607,23100607,23100702,0,0,0,95
23137,23100662,23100662,23100749,0,0,0,87
23138,23100728,23100728,23100822,0,0,0,94
23139,23100824,23100824,23100917,0,0,0,93
23141,23100968,23100968,23101030,0,0,0,62
23142,23101074,23101074,23101167,0,0,0,93
23140,23100934,23100934,23101235,0,0,0,301
23143,23101260,23101260,23101354,0,0,0,94
23144,23101378,23101378,23101482,0,0,0,104
23145,23101439,23101439,23101512,0,0,0,73
23146,23101539,23101539,23101829,0,0,0,290
23147,23101850,23101850,23102172,0,0,0,322
23149,23102249,23102249,23102360,0,0,0,111
23150,23102335,23102335,23102429,0,0,0,94
23148,23102130,23102130,23102480,0,0,0,350
23151,23102526,23102526,23102855,0,0,0,329
23153,23102863,23102863,23102978,0,0,0,115
23154,23102935,23102935,23103008,0,0,0,73
23155,23102943,23102943,23103201,0,0,0,258
23157,23103172,23103172,23103265,0,0,0,93
23159,23103676,23103676,23103749,0,0,0,73
23158,23103571,23103571,23103852,0,0,0,281
23160,23103819,23103819,23103892,0,0,0,73
23164,23105095,23105095,23105331,0,0,0,236
23165,23105238,23105238,23105332,0,0,0,94
23166,23105386,23105386,23105479,0,0,0,93
23167,23105536,23105536,23105609,0,0,0,73
23168,23105737,23105737,23105810,0,0,0,73
23169,23106034,23106034,23106128,0,0,0,94
23170,23106278,23106278,23106537,0,0,0,259
23028,23021339,23025868,23106868,0,0,4529,85529
23171,23108199,23108199,23108835,0,0,0,636
23163,23104274,23104274,23109196,0,0,0,4922
23152,23102737,23102737,23111624,0,0,0,8887
23156,23103145,23103145,23111740,0,0,0,8595
23176,23111921,23111921,23112020,0,0,0,99
23161,23103855,23103855,23112468,0,0,0,8613
23177,23112181,23112181,23112868,0,0,0,687
23178,23113013,23113013,23113717,0,0,0,704
23162,23104012,23104012,23113779,0,0,0,9767
22045,22854961,22854961,23114161,0,0,0,259200
22046,22855004,22855004,23114204,0,0,0,259200
23180,23114217,23114217,23114288,0,0,0,71
22047,22855176,22855176,23114376,0,0,0,259200
23181,23114326,23114326,23114427,0,0,0,101
23185,23114851,23114851,23114949,0,0,0,98
23173,23109800,23109800,23114981,0,0,0,5181
23187,23115239,23115239,23115319,0,0,0,80
23188,23115256,23115256,23115350,0,0,0,94
23189,23115361,23115361,23115519,0,0,0,158
23193,23115803,23115803,23115896,0,0,0,93
23194,23115898,23115898,23115971,0,0,0,73
22056,22856853,22856853,23116053,0,0,0,259200
23195,23116109,23116109,23116202,0,0,0,93
23196,23116216,23116216,23116309,0,0,0,93
23197,23116305,23116305,23116378,0,0,0,73
23064,23034028,23116053,23116712,0,0,82025,82684
23199,23116527,23116527,23116858,0,0,0,331
23200,23116578,23116578,23116910,0,0,0,332
22243,22933088,22933088,23117044,0,0,0,183956
22240,22933079,22933079,23117051,0,0,0,183972
23198,23116411,23116411,23117115,0,0,0,704
23207,23117250,23117250,23117333,0,0,0,83
23065,23034059,23116712,23117510,0,0,82653,83451
23210,23117699,23117699,23117793,0,0,0,94
23175,23111314,23111314,23118010,0,0,0,6696
23209,23117608,23117608,23118474,0,0,0,866
23211,23118009,23118009,23118566,0,0,0,557
23206,23117152,23117152,23118867,0,0,0,1715
23214,23118788,23118788,23118873,0,0,0,85
23216,23119371,23119371,23119725,0,0,0,354
23218,23119594,23119594,23119956,0,0,0,362
23213,23118499,23118499,23120211,0,0,0,1712
23208,23117328,23117328,23120264,0,0,0,2936
23219,23120222,23120222,23120775,0,0,0,553
23179,23113933,23113933,23120805,0,0,0,6872
23186,23115057,23115057,23120836,0,0,0,5779
23191,23115410,23115410,23121072,0,0,0,5662
23222,23121045,23121045,23121124,0,0,0,79
23220,23120877,23120877,23121225,0,0,0,348
23224,23121154,23121154,23121289,0,0,0,135
23221,23121033,23121033,23121321,0,0,0,288
23225,23121321,23121321,23121388,0,0,0,67
23223,23121080,23121080,23121753,0,0,0,673
23228,23122063,23122063,23122154,0,0,0,91
23230,23122121,23122121,23122188,0,0,0,67
23226,23121648,23121648,23122237,0,0,0,589
23215,23118935,23118935,23122324,0,0,0,3389
23192,23115473,23115473,23122352,0,0,0,6879
23229,23122100,23122100,23122418,0,0,0,318
23233,23122482,23122482,23122761,0,0,0,279
23232,23122286,23122286,23122820,0,0,0,534
23236,23122974,23122974,23123054,0,0,0,80
23217,23119417,23119417,23123120,0,0,0,3703
23235,23122906,23122906,23123225,0,0,0,319
23237,23123028,23123028,23123298,0,0,0,270
23238,23123188,23123188,23123788,0,0,0,600
23239,23123236,23123236,23123871,0,0,0,635
23172,23108979,23108979,23124162,0,0,0,15183
23240,23123829,23123829,23124548,0,0,0,719
23248,23125019,23125019,23125098,0,0,0,79
23251,23125103,23125103,23125172,0,0,0,69
23254,23125203,23125203,23125266,0,0,0,63
23231,23122210,23122210,23125297,0,0,0,3087
23247,23124877,23124877,23125452,0,0,0,575
23227,23122008,23122008,23125482,0,0,0,3474
23255,23125573,23125573,23125664,0,0,0,91
23242,23124162,23124162,23125771,0,0,0,1609
23256,23125678,23125678,23125775,0,0,0,97
23258,23125744,23125744,23125819,0,0,0,75
23260,23125998,23125998,23126091,0,0,0,93
23190,23115369,23115369,23126150,0,0,0,10781
23234,23122786,23122786,23126454,0,0,0,3668
23264,23127072,23127072,23127166,0,0,0,94
23266,23127355,23127355,23127459,0,0,0,104
23267,23127485,23127485,23127595,0,0,0,110
23268,23127545,23127545,23127623,0,0,0,78
23269,23127563,23127563,23127656,0,0,0,93
23241,23124004,23124004,23127820,0,0,0,3816
23243,23124336,23124336,23127846,0,0,0,3510
23270,23127778,23127778,23127851,0,0,0,73
23265,23127349,23127349,23127960,0,0,0,611
23244,23124473,23124473,23128076,0,0,0,3603
23249,23125022,23125022,23128078,0,0,0,3056
23253,23125146,23125146,23128524,0,0,0,3378
23245,23124511,23124511,23128575,0,0,0,4064
23257,23125730,23125730,23128576,0,0,0,2846
23259,23125787,23125787,23128576,0,0,0,2789
23252,23125121,23125121,23128707,0,0,0,3586
23271,23128110,23128110,23128742,0,0,0,632
23246,23124559,23124559,23128773,0,0,0,4214
23250,23125096,23125096,23128864,0,0,0,3768
23275,23129012,23129012,23129666,0,0,0,654
23274,23128995,23128995,23129693,0,0,0,698
23276,23129025,23129025,23129775,0,0,0,750
23273,23128574,23128574,23129909,0,0,0,1335
23272,23128544,23128544,23129941,0,0,0,1397
23261,23126122,23126122,23130635,0,0,0,4513
23262,23126391,23126391,23130857,0,0,0,4466
23263,23126713,23126713,23131136,0,0,0,4423
23281,23131027,23131027,23131570,0,0,0,543
23282,23131902,23131902,23131970,0,0,0,68
23284,23132135,23132135,23132182,0,0,0,47
23283,23132011,23132011,23132519,0,0,0,508
23277,23129865,23129865,23132600,0,0,0,2735
23288,23132603,23132603,23132701,0,0,0,98
23290,23132755,23132755,23132900,0,0,0,145
23289,23132746,23132746,23132907,0,0,0,161
23294,23133003,23133003,23133163,0,0,0,160
23204,23116963,23116963,23133182,0,0,0,16219
22157,22926147,22926147,23133286,0,0,0,207139
22158,22926154,22926154,23133329,0,0,0,207175
23297,23133288,23133288,23133448,0,0,0,160
23298,23133461,23133461,23133621,0,0,0,160
23299,23133994,23133994,23134057,0,0,0,63
23300,23134010,23134010,23134057,0,0,0,47
23280,23130715,23130715,23134059,0,0,0,3344
23301,23134072,23134072,23134169,0,0,0,97
23302,23134137,23134137,23134198,0,0,0,61
23304,23134213,23134213,23134249,0,0,0,36
23287,23132586,23132586,23134253,0,0,0,1667
23303,23134170,23134170,23134254,0,0,0,84
23305,23134258,23134258,23134321,0,0,0,63
23279,23130650,23130650,23134327,0,0,0,3677
23307,23134283,23134283,23134366,0,0,0,83
23309,23134329,23134329,23134396,0,0,0,67
23312,23134896,23134896,23134998,0,0,0,102
23313,23134954,23134954,23135008,0,0,0,54
23314,23134971,23134971,23135040,0,0,0,69
23315,23135002,23135002,23135066,0,0,0,64
23317,23135029,23135029,23135097,0,0,0,68
23318,23135045,23135045,23135097,0,0,0,52
23319,23135061,23135061,23135097,0,0,0,36
23316,23135014,23135014,23135098,0,0,0,84
23320,23135116,23135116,23135240,0,0,0,124
23329,23135361,23135361,23135547,0,0,0,186
23115,23058003,23058003,23135591,0,0,0,77588
23323,23135157,23135591,23135833,0,0,434,676
23330,23135565,23135565,23135844,0,0,0,279
23212,23118210,23118210,23135867,0,0,0,17657
23203,23116961,23116961,23138868,0,0,0,21907
23326,23135198,23138868,23138961,0,0,3670,3763
23331,23135868,23138868,23139624,0,0,3000,3756
23306,23134275,23134275,23140256,0,0,0,5981
23332,23136756,23139624,23140326,0,0,2868,3570
22858,22961597,23066109,23140686,0,0,104512,179089
23336,23137017,23140326,23140946,0,0,3309,3929
23333,23136972,23140256,23141013,0,0,3284,4041
23334,23136979,23140256,23141013,0,0,3277,4034
23337,23137063,23140686,23141324,0,0,3623,4261
23338,23137089,23140686,23141364,0,0,3597,4275
23339,23137120,23140686,23141395,0,0,3566,4275
23340,23137153,23140686,23141395,0,0,3533,4242
23341,23137179,23140686,23141399,0,0,3507,4220
23342,23137201,23140686,23141430,0,0,3485,4229
23343,23137227,23140686,23141430,0,0,3459,4203
23292,23132875,23132875,23141440,0,0,0,8565
23293,23132926,23132926,23143893,0,0,0,10967
22853,22961368,23009999,23149637,0,0,48631,188269
23325,23135186,23135844,23149872,0,0,658,14686
23311,23134880,23135867,23149909,0,0,987,15029
23201,23116739,23116739,23150067,0,0,0,33328
23202,23116941,23116941,23150408,0,0,0,33467
23205,23116992,23116992,23150657,0,0,0,33665
23308,23134323,23134323,23155868,0,0,0,21545
23328,23135233,23138961,23158677,0,0,3728,23444
23327,23135221,23138868,23158987,0,0,3647,23766
23285,23132439,23132439,23160479,0,0,0,28040
23291,23132859,23132859,23161459,0,0,0,28600
23286,23132453,23132453,23162624,0,0,0,30171
23324,23135169,23135833,23163328,0,0,664,28159
23310,23134400,23134400,23168495,0,0,0,34095
22068,22859013,23168495,23168589,0,0,309482,309576
23032,23022641,23090609,23169659,0,0,67968,147018
23125,23095254,23095254,23174153,0,0,0,78899
22144,22884711,22884711,23181990,0,0,0,297279
23348,23183658,23183658,23183794,0,0,0,136
23349,23183685,23183685,23183872,0,0,0,187
23352,23184160,23184160,23184227,0,0,0,67
23353,23184298,23184298,23184365,0,0,0,67
23350,23184097,23184097,23184430,0,0,0,333
23354,23184425,23184425,23184503,0,0,0,78
23351,23184113,23184113,23184822,0,0,0,709
23347,23183604,23183604,23185586,0,0,0,1982
23356,23184600,23184600,23185587,0,0,0,987
23358,23185994,23185994,23186216,0,0,0,222
23359,23186431,23186431,23186686,0,0,0,255
23360,23186649,23186649,23186820,0,0,0,171
23361,23186811,23186811,23187411,0,0,0,600
23362,23187545,23187545,23187644,0,0,0,99
23363,23187596,23187596,23187869,0,0,0,273
23364,23187608,23187608,23188115,0,0,0,507
23174,23110866,23110866,23188259,0,0,0,77393
23369,23188219,23188219,23188317,0,0,0,98
23365,23187755,23187755,23188355,0,0,0,600
23373,23189098,23189098,23189208,0,0,0,110
23374,23189247,23189247,23189411,0,0,0,164
23375,23189310,23189310,23189496,0,0,0,186
23376,23189341,23189341,23189504,0,0,0,163
23377,23189370,23189370,23189533,0,0,0,163
23378,23189400,23189400,23189609,0,0,0,209
23380,23189427,23189427,23189645,0,0,0,218
23384,23189635,23189635,23189728,0,0,0,93
23382,23189453,23189453,23189890,0,0,0,437
23379,23189414,23189414,23189901,0,0,0,487
23390,23189965,23189965,23190132,0,0,0,167
23388,23189869,23189869,23190277,0,0,0,408
23371,23188625,23188625,23190346,0,0,0,1721
23389,23189941,23189941,23190355,0,0,0,414
23392,23190014,23190014,23190454,0,0,0,440
23393,23190101,23190101,23190546,0,0,0,445
23381,23189452,23189645,23190582,0,0,193,1130
23394,23190196,23190196,23190661,0,0,0,465
23395,23190276,23190276,23190741,0,0,0,465
23383,23189477,23189477,23190759,0,0,0,1282
23396,23190385,23190385,23190860,0,0,0,475
23397,23190547,23190547,23191689,0,0,0,1142
23398,23190629,23190629,23191771,0,0,0,1142
23370,23188320,23188320,23191920,0,0,0,3600
23399,23190787,23190787,23191958,0,0,0,1171
23372,23188672,23188672,23192272,0,0,0,3600
23400,23190881,23190881,23192498,0,0,0,1617
23408,23191467,23191467,23192521,0,0,0,1054
23407,23191441,23191441,23192548,0,0,0,1107
23409,23191483,23191483,23192618,0,0,0,1135
22852,22961351,23009852,23192747,0,0,48501,231396
23406,23191319,23191319,23193119,0,0,0,1800
23410,23191746,23191746,23193452,0,0,0,1706
23401,23191006,23191006,23194319,0,0,0,3313
23385,23189737,23189737,23194531,0,0,0,4794
23403,23191127,23191127,23194562,0,0,0,3435
23412,23194541,23194541,23195141,0,0,0,600
23413,23194572,23194572,23195172,0,0,0,600
23411,23192207,23192207,23195388,0,0,0,3181
23414,23195746,23195746,23195813,0,0,0,67
23402,23191115,23191115,23196226,0,0,0,5111
23415,23196451,23196451,23196498,0,0,0,47
23417,23196959,23196959,23197026,0,0,0,67
23420,23198021,23198021,23198120,0,0,0,99
23421,23198165,23198165,23198258,0,0,0,93
23278,23130254,23130254,23198373,0,0,0,68119
23422,23198399,23198399,23198508,0,0,0,109
23418,23197426,23197426,23198549,0,0,0,1123
23423,23198460,23198460,23198549,0,0,0,89
23424,23198506,23198506,23198610,0,0,0,104
23419,23197468,23197468,23198611,0,0,0,1143
23426,23198854,23198854,23198922,0,0,0,68
23425,23198771,23198771,23198977,0,0,0,206
23427,23199074,23199074,23199152,0,0,0,78
23429,23199924,23199924,23199992,0,0,0,68
23431,23200101,23200101,23200168,0,0,0,67
23430,23200005,23200005,23200207,0,0,0,202
23322,23135146,23135240,23200250,0,0,94,65104
23321,23135127,23135127,23200261,0,0,0,65134
23416,23196890,23196890,23200331,0,0,0,3441
23368,23188042,23188042,23201107,0,0,0,13065
23449,23201125,23201125,23201203,0,0,0,78
23450,23201261,23201261,23201447,0,0,0,186
23451,23201570,23201570,23201632,0,0,0,62
23452,23201900,23201900,23201967,0,0,0,67
23453,23202156,23202156,23202223,0,0,0,67
23405,23191195,23191195,23202284,0,0,0,11089
23428,23199228,23199228,23202574,0,0,0,3346
23455,23202527,23202527,23202594,0,0,0,67
23456,23202922,23202922,23202989,0,0,0,67
23346,23180739,23180739,23203065,0,0,0,22326
23457,23203600,23203600,23203678,0,0,0,78
23458,23203647,23203647,23203714,0,0,0,67
23459,23203746,23203746,23203835,0,0,0,89
23460,23203794,23203794,23203872,0,0,0,78
23461,23203835,23203835,23203923,0,0,0,88
23463,23203933,23203933,23204045,0,0,0,112
23462,23203892,23203892,23204131,0,0,0,239
23391,23189985,23189985,23204203,0,0,0,14218
23465,23204131,23204131,23204465,0,0,0,334
23466,23204453,23204453,23204789,0,0,0,336
23472,23204757,23204757,23205151,0,0,0,394
23474,23205176,23205176,23205373,0,0,0,197
23475,23205339,23205339,23205538,0,0,0,199
23481,23205633,23205633,23205757,0,0,0,124
23477,23205547,23205547,23206298,0,0,0,751
23479,23205631,23205631,23206375,0,0,0,744
23478,23205630,23205630,23206540,0,0,0,910
23484,23206355,23206355,23206997,0,0,0,642
23485,23206961,23206961,23207085,0,0,0,124
23489,23207582,23207582,23207675,0,0,0,93
23490,23207693,23207693,23207786,0,0,0,93
23491,23207813,23207813,23207886,0,0,0,73
23492,23207967,23207967,23208047,0,0,0,80
23467,23204456,23204456,23208056,0,0,0,3600
23468,23204461,23204461,23208061,0,0,0,3600
23469,23204466,23204466,23208066,0,0,0,3600
23470,23204469,23204469,23208069,0,0,0,3600
23493,23208015,23208015,23208112,0,0,0,97
23487,23207148,23207148,23208113,0,0,0,965
23494,23208048,23208048,23208114,0,0,0,66
23495,23208059,23208059,23208211,0,0,0,152
23486,23207099,23207099,23208250,0,0,0,1151
23497,23208145,23208145,23208251,0,0,0,106
23488,23207236,23207236,23208303,0,0,0,1067
23500,23208337,23208337,23208395,0,0,0,58
23480,23205632,23205632,23208534,0,0,0,2902
23496,23208132,23208132,23208541,0,0,0,409
23503,23208556,23208556,23208646,0,0,0,90
23504,23208615,23208615,23208708,0,0,0,93
23387,23189837,23189837,23208930,0,0,0,19093
23482,23205633,23205633,23209195,0,0,0,3562
23510,23209246,23209246,23209375,0,0,0,129
23502,23208448,23208448,23209617,0,0,0,1169
23513,23209569,23209569,23209647,0,0,0,78
23505,23208908,23208908,23209650,0,0,0,742
23514,23209809,23209809,23209876,0,0,0,67
23515,23209927,23209927,23210032,0,0,0,105
23367,23187983,23187983,23210110,0,0,0,22127
23518,23210056,23210056,23210150,0,0,0,94
23519,23210182,23210182,23210273,0,0,0,91
23520,23210233,23210233,23210311,0,0,0,78
23499,23208277,23208277,23210417,0,0,0,2140
23521,23210352,23210352,23210445,0,0,0,93
23501,23208426,23208426,23210581,0,0,0,2155
23522,23210510,23210510,23210583,0,0,0,73
23523,23210584,23210584,23210708,0,0,0,124
23524,23210733,23210733,23210830,0,0,0,97
23526,23210813,23210813,23210947,0,0,0,134
23525,23210757,23210757,23211357,0,0,0,600
23531,23211769,23211769,23211868,0,0,0,99
23530,23211646,23211646,23211880,0,0,0,234
23355,23184541,23184541,23211895,0,0,0,27354
23527,23210819,23211357,23211957,0,0,538,1138
23532,23211903,23211903,23211970,0,0,0,67
23533,23212313,23212313,23212381,0,0,0,68
23529,23211462,23211957,23212486,0,0,495,1024
23534,23213138,23213138,23213258,0,0,0,120
23535,23213221,23213221,23213258,0,0,0,37
22994,22984501,22986710,23213475,0,0,2209,228974
23546,23214279,23214279,23214700,0,0,0,421
23550,23214279,23214279,23214709,0,0,0,430
23547,23214279,23214279,23214731,0,0,0,452
23548,23214279,23214279,23214731,0,0,0,452
23549,23214279,23214279,23214731,0,0,0,452
23551,23214279,23214700,23215138,0,0,421,859
23553,23214280,23214731,23215152,0,0,451,872
23554,23214280,23214731,23215152,0,0,451,872
23555,23214280,23214731,23215152,0,0,451,872
23588,23215046,23215046,23215299,0,0,0,253
23589,23215303,23215303,23215432,0,0,0,129
23557,23214280,23215152,23215581,0,0,872,1301
23558,23214280,23215152,23215581,0,0,872,1301
23559,23214281,23215152,23215581,0,0,871,1300
23590,23215546,23215546,23215614,0,0,0,68
23556,23214280,23215138,23215620,0,0,858,1340
23560,23214281,23215581,23216010,0,0,1300,1729
23561,23214281,23215581,23216010,0,0,1300,1729
23562,23214281,23215581,23216010,0,0,1300,1729
23563,23214281,23215620,23216049,0,0,1339,1768
23592,23215926,23215926,23216085,0,0,0,159
23593,23216059,23216059,23216158,0,0,0,99
23386,23189835,23189835,23216419,0,0,0,26584
23564,23214281,23216010,23216439,0,0,1729,2158
23565,23214281,23216010,23216439,0,0,1729,2158
23566,23214282,23216010,23216439,0,0,1728,2157
23594,23216349,23216349,23216447,0,0,0,98
23567,23214282,23216049,23216478,0,0,1767,2196
23464,23203979,23203979,23216515,0,0,0,12536
23568,23214282,23216419,23216848,0,0,2137,2566
23573,23214284,23216439,23216859,0,0,2155,2575
23574,23214284,23216439,23216859,0,0,2155,2575
23575,23214284,23216439,23216859,0,0,2155,2575
23569,23214282,23216419,23216869,0,0,2137,2587
23570,23214282,23216419,23216869,0,0,2137,2587
23571,23214282,23216419,23216869,0,0,2137,2587
23572,23214283,23216419,23216870,0,0,2136,2587
23576,23214284,23216478,23216929,0,0,2194,2645
23596,23216843,23216843,23216983,0,0,0,140
23577,23214285,23216848,23217268,0,0,2563,2983
23578,23214285,23216859,23217279,0,0,2574,2994
23579,23214285,23216859,23217279,0,0,2574,2994
23581,23214286,23216869,23217289,0,0,2583,3003
23582,23214286,23216869,23217289,0,0,2583,3003
23583,23214286,23216869,23217289,0,0,2583,3003
23584,23214287,23216870,23217290,0,0,2583,3003
23580,23214285,23216859,23217311,0,0,2574,3026
23585,23214287,23216929,23217368,0,0,2642,3081
23597,23217349,23217349,23217385,0,0,0,36
23598,23217419,23217419,23217504,0,0,0,85
23599,23217439,23217439,23217508,0,0,0,69
23600,23217482,23217482,23217548,0,0,0,66
23601,23217512,23217512,23217606,0,0,0,94
23602,23217570,23217570,23217637,0,0,0,67
23586,23214287,23217268,23217707,0,0,2981,3420
23603,23217643,23217643,23217710,0,0,0,67
23604,23217751,23217751,23217787,0,0,0,36
23605,23217807,23217807,23217860,0,0,0,53
23606,23217823,23217823,23217891,0,0,0,68
23607,23217859,23217859,23217929,0,0,0,70
23608,23217873,23217873,23217943,0,0,0,70
23610,23217910,23217910,23217962,0,0,0,52
23609,23217892,23217892,23217971,0,0,0,79
23611,23217920,23217920,23217989,0,0,0,69
23612,23217929,23217929,23217999,0,0,0,70
23498,23208267,23208267,23218222,0,0,0,9955
23619,23218100,23218222,23218377,0,0,122,277
23614,23217992,23217992,23218385,0,0,0,393
23622,23218495,23218495,23218573,0,0,0,78
23613,23217978,23217978,23218606,0,0,0,628
23623,23218656,23218656,23218724,0,0,0,68
23624,23218773,23218773,23218861,0,0,0,88
23625,23218824,23218824,23218861,0,0,0,37
23366,23187957,23187957,23218887,0,0,0,30930
23621,23218122,23218887,23218980,0,0,765,858
23626,23218913,23218913,23218981,0,0,0,68
22995,22984501,22986710,23219089,0,0,2209,234588
23627,23218979,23218979,23219132,0,0,0,153
23628,23219031,23219031,23219157,0,0,0,126
23631,23219103,23219103,23219160,0,0,0,57
23528,23210915,23210915,23219618,0,0,0,8703
23404,23191169,23191169,23220561,0,0,0,29392
23506,23208933,23208933,23221159,0,0,0,12226
23508,23208942,23208942,23221529,0,0,0,12587
23344,23145036,23145036,23222985,0,0,0,77949
23536,23213351,23213351,23223910,0,0,0,10559
23509,23208947,23208947,23226341,0,0,0,17394
23507,23208938,23208938,23226460,0,0,0,17522
23633,23222667,23222667,23227055,0,0,0,4388
23629,23219037,23227055,23228140,0,0,8018,9103
23512,23209557,23209557,23228257,0,0,0,18700
23630,23219092,23228140,23228791,0,0,9048,9699
23632,23219133,23228791,23229320,0,0,9658,10187
23634,23228890,23228890,23231146,0,0,0,2256
23511,23209556,23209556,23234220,0,0,0,24664
23637,23234788,23234788,23235036,0,0,0,248
23616,23218071,23218071,23237706,0,0,0,19635
23615,23218062,23218062,23237914,0,0,0,19852
23516,23209930,23209930,23244238,0,0,0,34308
22992,22984500,22985131,23244331,0,0,631,259831
22993,22984500,22985164,23244364,0,0,664,259864
23640,23242808,23242808,23244955,0,0,0,2147
23517,23210043,23210043,23244987,0,0,0,34944
23617,23218080,23218080,23245669,0,0,0,27589
22996,22984501,22986710,23245910,0,0,2209,261409
23618,23218090,23218222,23246473,0,0,132,28383
23471,23204630,23204630,23246708,0,0,0,42078
23642,23242836,23244331,23246799,0,0,1495,3963
23641,23242823,23244238,23246904,0,0,1415,4081
22997,22984501,22987717,23246917,0,0,3216,262416
23438,23200747,23200747,23248052,0,0,0,47305
23432,23200745,23200745,23248407,0,0,0,47662
23433,23200745,23200745,23250309,0,0,0,49564
23439,23200747,23200747,23250432,0,0,0,49685
23595,23216628,23220561,23251278,0,0,3933,34650
23434,23200745,23200745,23251518,0,0,0,50773
23345,23174117,23174117,23253091,0,0,0,78974
23435,23200745,23200745,23253478,0,0,0,52733
22998,22984501,22994906,23254106,0,0,10405,269605
22999,22985275,22994906,23254106,0,0,9631,268831
23000,22985341,22995198,23254398,0,0,9857,269057
23445,23200749,23200749,23258070,0,0,0,57321
23441,23200748,23200748,23259092,0,0,0,58344
22779,22954845,23009137,23262124,0,0,54292,307279
23540,23214278,23214278,23263835,0,0,0,49557
23541,23214278,23214278,23264207,0,0,0,49929
23537,23214277,23214277,23264447,0,0,0,50170
23542,23214278,23214278,23264634,0,0,0,50356
23543,23214278,23214278,23264716,0,0,0,50438
23538,23214277,23214277,23265067,0,0,0,50790
23544,23214278,23214278,23265212,0,0,0,50934
23545,23214278,23214278,23265243,0,0,0,50965
23552,23214279,23214709,23265333,0,0,430,51054
23539,23214277,23214277,23265346,0,0,0,51069
23124,23093626,23093626,23266426,0,0,0,172800
23587,23214466,23217289,23270979,0,0,2823,56513
22854,22961468,23012353,23271553,0,0,50885,310085
23660,23279996,23279996,23282084,0,0,0,2088
23661,23282342,23282342,23282869,0,0,0,527
23662,23284314,23284314,23285131,0,0,0,817
23663,23285159,23285159,23285263,0,0,0,104
23665,23285793,23285793,23285928,0,0,0,135
23664,23285623,23285623,23287128,0,0,0,1505
23436,23200746,23200746,23287146,0,0,0,86400
23437,23200746,23200746,23287146,0,0,0,86400
23440,23200747,23200747,23287147,0,0,0,86400
23442,23200748,23200748,23287148,0,0,0,86400
23443,23200748,23200748,23287148,0,0,0,86400
23444,23200748,23200748,23287148,0,0,0,86400
23446,23200749,23200749,23287149,0,0,0,86400
23447,23200749,23200749,23287149,0,0,0,86400
23448,23200749,23200749,23287149,0,0,0,86400
23666,23285970,23285970,23287770,0,0,0,1800
23668,23288944,23288944,23290744,0,0,0,1800
23620,23218113,23218377,23290771,0,0,264,72658
23473,23204820,23204820,23291220,0,0,0,86400
23667,23287093,23287093,23295017,0,0,0,7924
23669,23299711,23299711,23299804,0,0,0,93
23670,23299820,23299820,23301620,0,0,0,1800
23652,23268498,23268498,23302149,0,0,0,33651
23655,23276040,23276040,23302191,0,0,0,26151
23651,23268425,23268425,23302273,0,0,0,33848
23653,23268643,23268643,23306157,0,0,0,37514
23657,23276076,23276076,23308439,0,0,0,32363
23674,23307624,23307624,23309019,0,0,0,1395
23658,23276095,23276095,23309579,0,0,0,33484
23678,23312014,23312014,23312087,0,0,0,73
23679,23312015,23312015,23312088,0,0,0,73
23680,23312015,23312015,23312088,0,0,0,73
23681,23312015,23312015,23312088,0,0,0,73
23682,23312015,23312015,23312088,0,0,0,73
23677,23311910,23311910,23313482,0,0,0,1572
23659,23276100,23276100,23320507,0,0,0,44407
23116,23069191,23069191,23328391,0,0,0,259200
23117,23069192,23069192,23328392,0,0,0,259200
23118,23069193,23069193,23328393,0,0,0,259200
23119,23069193,23069193,23328393,0,0,0,259200
23120,23069224,23069224,23328424,0,0,0,259200
23121,23069225,23069225,23328425,0,0,0,259200
23122,23069336,23069336,23328536,0,0,0,259200
23650,23253092,23253092,23332791,0,0,0,79699
23676,23309517,23309517,23336110,0,0,0,26593
23671,23305960,23305960,23339090,0,0,0,33130
23672,23306017,23306017,23339611,0,0,0,33594
23675,23309442,23309442,23342814,0,0,0,33372
23656,23276058,23276058,23346507,0,0,0,70449
22859,22961647,23088032,23347232,0,0,126385,385585
23476,23205479,23205479,23350992,0,0,0,145513
23697,23359632,23359632,23359767,0,0,0,135
23483,23205866,23205866,23360757,0,0,0,154891
23673,23306193,23306193,23366136,0,0,0,59943
23296,23133254,23133254,23372475,0,0,0,239221
23182,23114336,23114336,23373536,0,0,0,259200
23183,23114403,23114403,23373603,0,0,0,259200
23184,23114534,23114534,23373734,0,0,0,259200
23335,23136996,23140686,23381917,0,0,3690,244921
23700,23366251,23366251,23391786,0,0,0,25535
23295,23133240,23133240,23392440,0,0,0,259200
23698,23365904,23365904,23399256,0,0,0,33352
23699,23365987,23365987,23399762,0,0,0,33775
23713,23409031,23409031,23409315,0,0,0,284
23709,23408945,23408945,23409465,0,0,0,520
23708,23408934,23408934,23409471,0,0,0,537
23711,23408974,23408974,23409772,0,0,0,798
23710,23408962,23408962,23409776,0,0,0,814
23715,23411289,23411289,23411381,0,0,0,92
23714,23411243,23411243,23411382,0,0,0,139
23716,23411346,23411346,23411436,0,0,0,90
23717,23411399,23411399,23411467,0,0,0,68
23718,23411484,23411484,23411627,0,0,0,143
23719,23411513,23411513,23411627,0,0,0,114
23720,23411588,23411588,23411709,0,0,0,121
23722,23411675,23411675,23411738,0,0,0,63
23721,23411627,23411627,23411748,0,0,0,121
23723,23411712,23411712,23411779,0,0,0,67
23696,23332789,23332789,23412123,0,0,0,79334
23123,23069899,23069899,23415499,0,0,0,345600
23636,23234686,23234686,23420575,0,0,0,185889
23357,23185555,23185555,23426724,0,0,0,241169
23654,23275900,23275900,23430301,0,0,0,154401
23635,23234614,23234614,23435254,0,0,0,200640
23726,23440059,23440059,23440169,0,0,0,110
23729,23442052,23442052,23442181,0,0,0,129
23730,23442275,23442275,23442327,0,0,0,52
23731,23442291,23442291,23442358,0,0,0,67
23732,23442944,23442944,23443011,0,0,0,67
23591,23215767,23219618,23443172,0,0,3851,227405
23705,23391842,23391842,23443338,0,0,0,51496
23733,23443276,23443276,23443343,0,0,0,67
23734,23443675,23443675,23443742,0,0,0,67
23735,23443847,23443847,23443915,0,0,0,68
23736,23446800,23446800,23446855,0,0,0,55
23738,23447538,23447538,23447605,0,0,0,67
23741,23448005,23448005,23448052,0,0,0,47
23743,23448163,23448163,23448737,0,0,0,574
23745,23449182,23449182,23449264,0,0,0,82
23746,23449229,23449229,23449795,0,0,0,566
23748,23449956,23449956,23450029,0,0,0,73
23749,23449960,23449960,23450064,0,0,0,104
23751,23450286,23450286,23451778,0,0,0,1492
23750,23450283,23450283,23452282,0,0,0,1999
23752,23452877,23452877,23452955,0,0,0,78
23753,23453102,23453102,23453305,0,0,0,203
23643,23244912,23244912,23453356,0,0,0,208444
23754,23454905,23454905,23455032,0,0,0,127
23756,23454933,23454933,23455084,0,0,0,151
23755,23454919,23454919,23455092,0,0,0,173
23757,23454958,23454958,23455113,0,0,0,155
23758,23454975,23454975,23455576,0,0,0,601
23759,23455045,23455045,23455941,0,0,0,896
23760,23455061,23455113,23456029,0,0,52,968
23761,23457123,23457123,23457216,0,0,0,93
23764,23457300,23457300,23457404,0,0,0,104
23763,23457297,23457297,23458135,0,0,0,838
23762,23457270,23457270,23458251,0,0,0,981
23766,23459283,23459283,23459390,0,0,0,107
23767,23459299,23459299,23459483,0,0,0,184
23727,23440143,23440143,23459517,0,0,0,19374
23638,23235191,23235191,23460576,0,0,0,225385
23772,23461393,23461393,23461460,0,0,0,67
23773,23461748,23461748,23461908,0,0,0,160
23774,23462657,23462657,23462818,0,0,0,161
23639,23235206,23237706,23462956,0,0,2500,227750
23775,23463928,23463928,23463995,0,0,0,67
23776,23464126,23464126,23464204,0,0,0,78
23777,23464271,23464271,23464338,0,0,0,67
23765,23457611,23457611,23464652,0,0,0,7041
23779,23464968,23464968,23465028,0,0,0,60
23781,23465791,23465791,23465869,0,0,0,78
23768,23459362,23459362,23466165,0,0,0,6803
23782,23466016,23466016,23466176,0,0,0,160
23783,23466285,23466285,23466445,0,0,0,160
23785,23466611,23466611,23466678,0,0,0,67
23788,23467301,23467301,23467394,0,0,0,93
23789,23467424,23467424,23467523,0,0,0,99
23790,23467685,23467685,23467752,0,0,0,67
23792,23468081,23468081,23468148,0,0,0,67
23791,23468062,23468062,23470179,0,0,0,2117
23793,23470262,23470262,23470322,0,0,0,60
23794,23470921,23470921,23471071,0,0,0,150
23795,23470998,23470998,23471091,0,0,0,93
23802,23471478,23471478,23471544,0,0,0,66
23800,23471463,23471463,23471663,0,0,0,200
23807,23471812,23471812,23472004,0,0,0,192
23808,23472410,23472410,23472570,0,0,0,160
23809,23472639,23472639,23472717,0,0,0,78
23811,23473350,23473350,23473417,0,0,0,67
23812,23473637,23473637,23473706,0,0,0,69
23814,23474207,23474207,23474350,0,0,0,143
23816,23474384,23474384,23474498,0,0,0,114
23817,23474486,23474486,23474533,0,0,0,47
23818,23474543,23474543,23474637,0,0,0,94
23819,23475335,23475335,23475382,0,0,0,47
23820,23476757,23476757,23476804,0,0,0,47
23821,23476979,23476979,23477046,0,0,0,67
23707,23408910,23408910,23477070,0,0,0,68160
23822,23477234,23477234,23477301,0,0,0,67
23823,23477442,23477442,23477509,0,0,0,67
23824,23477600,23477600,23477668,0,0,0,68
23825,23477853,23477853,23477900,0,0,0,47
23769,23460565,23460565,23478329,0,0,0,17764
23780,23465040,23465040,23479017,0,0,0,13977
23826,23479251,23479251,23479311,0,0,0,60
23827,23479446,23479446,23479506,0,0,0,60
23828,23480108,23480108,23480168,0,0,0,60
23813,23473939,23473939,23481384,0,0,0,7445
23829,23481640,23481640,23481768,0,0,0,128
23810,23472656,23472656,23483341,0,0,0,10685
23712,23409007,23409007,23484115,0,0,0,75108
23683,23312495,23312495,23485295,0,0,0,172800
23685,23312496,23312496,23485296,0,0,0,172800
23830,23481735,23481735,23485335,0,0,0,3600
23833,23485127,23485127,23489585,0,0,0,4458
23724,23412059,23412059,23490399,0,0,0,78340
23454,23202278,23202278,23492583,0,0,0,290305
23644,23244923,23244955,23504155,0,0,32,259232
23645,23244935,23244955,23504155,0,0,20,259220
23646,23244944,23244955,23504155,0,0,11,259211
23647,23245020,23245020,23504220,0,0,0,259200
23648,23245075,23245075,23504275,0,0,0,259200
23649,23245105,23245105,23504305,0,0,0,259200
23739,23447977,23447977,23509163,0,0,0,61186
23747,23449349,23449349,23512675,0,0,0,63326
23798,23471448,23471448,23515148,0,0,0,43700
23799,23471459,23471459,23517233,0,0,0,45774
23737,23446824,23446824,23521116,0,0,0,74292
23838,23528024,23528024,23528184,0,0,0,160
23841,23528569,23528569,23528647,0,0,0,78
23839,23528255,23528255,23528670,0,0,0,415
23843,23528994,23528994,23529123,0,0,0,129
23842,23528808,23528808,23529371,0,0,0,563
23840,23528375,23528375,23529577,0,0,0,1202
23845,23529717,23529717,23529846,0,0,0,129
23846,23529941,23529941,23530070,0,0,0,129
23844,23529541,23529541,23531067,0,0,0,1526
23847,23530155,23530155,23532555,0,0,0,2400
23848,23531282,23531282,23532824,0,0,0,1542
23849,23533328,23533328,23533425,0,0,0,97
23850,23533345,23533345,23533431,0,0,0,86
23778,23464937,23464937,23533866,0,0,0,68929
23854,23534075,23534075,23534328,0,0,0,253
23853,23533442,23533442,23534450,0,0,0,1008
23852,23533433,23533433,23534483,0,0,0,1050
23851,23533421,23533421,23534608,0,0,0,1187
23856,23535120,23535120,23535281,0,0,0,161
23858,23535646,23535646,23535706,0,0,0,60
23859,23535669,23535669,23535736,0,0,0,67
23861,23535956,23535956,23536747,0,0,0,791
23876,23536927,23536927,23537020,0,0,0,93
23877,23536927,23536927,23537020,0,0,0,93
23878,23536928,23536928,23537021,0,0,0,93
23874,23536927,23536927,23537029,0,0,0,102
23875,23536927,23536927,23537029,0,0,0,102
23879,23536928,23537020,23537113,0,0,92,185
23880,23536928,23537020,23537113,0,0,92,185
23881,23536928,23537021,23537114,0,0,93,186
23882,23536929,23537029,23537122,0,0,100,193
23883,23536929,23537029,23537122,0,0,100,193
23884,23536929,23537113,23537206,0,0,184,277
23885,23536929,23537113,23537206,0,0,184,277
23886,23536929,23537114,23537207,0,0,185,278
23887,23536929,23537122,23537235,0,0,193,306
23888,23536930,23537122,23537235,0,0,192,305
23892,23536930,23537235,23537317,0,0,305,387
23893,23536930,23537235,23537317,0,0,305,387
23889,23536930,23537206,23537319,0,0,276,389
23890,23536930,23537206,23537319,0,0,276,389
23891,23536930,23537207,23537320,0,0,277,390
23860,23535821,23535821,23537360,0,0,0,1539
23894,23536931,23537317,23537399,0,0,386,468
23895,23536931,23537317,23537431,0,0,386,500
23896,23536931,23537319,23537433,0,0,388,502
23897,23536931,23537319,23537433,0,0,388,502
23898,23536931,23537320,23537434,0,0,389,503
23899,23536931,23537399,23537513,0,0,468,582
23903,23536932,23537434,23537540,0,0,502,608
23900,23536932,23537431,23537545,0,0,499,613
23901,23536932,23537433,23537547,0,0,501,615
23902,23536932,23537433,23537547,0,0,501,615
23904,23536932,23537513,23537619,0,0,581,687
23905,23536932,23537540,23537646,0,0,608,714
23907,23536933,23537547,23537653,0,0,614,720
23908,23536933,23537547,23537653,0,0,614,720
23906,23536932,23537545,23537683,0,0,613,751
23909,23536933,23537619,23537725,0,0,686,792
23910,23536933,23537646,23537740,0,0,713,807
23911,23536933,23537653,23537747,0,0,720,814
23912,23536933,23537653,23537747,0,0,720,814
23913,23536934,23537683,23537777,0,0,749,843
23914,23537629,23537747,23537849,0,0,118,220
23916,23537768,23537768,23538238,0,0,0,470
23915,23537683,23537683,23538455,0,0,0,772
23784,23466506,23466506,23538649,0,0,0,72143
23917,23538822,23538822,23539052,0,0,0,230
23919,23539015,23539015,23539082,0,0,0,67
23918,23539009,23539009,23539093,0,0,0,84
23920,23539137,23539137,23539327,0,0,0,190
23922,23539484,23539484,23539639,0,0,0,155
23834,23486078,23486078,23539697,0,0,0,53619
23921,23539260,23539260,23539967,0,0,0,707
23923,23539713,23539713,23540515,0,0,0,802
23924,23540166,23540166,23541196,0,0,0,1030
23925,23540177,23540177,23541317,0,0,0,1140
23926,23540186,23540186,23541419,0,0,0,1233
23701,23368919,23368919,23541719,0,0,0,172800
23927,23540438,23540438,23542568,0,0,0,2130
23929,23543433,23543433,23544326,0,0,0,893
23801,23471469,23471469,23545362,0,0,0,73893
23928,23543305,23543305,23545431,0,0,0,2126
23939,23545705,23545705,23545803,0,0,0,98
23857,23535568,23535568,23546181,0,0,0,10613
23938,23545569,23545569,23546469,0,0,0,900
23940,23546420,23546420,23546505,0,0,0,85
23931,23543873,23543873,23546536,0,0,0,2663
23941,23546437,23546437,23547213,0,0,0,776
23863,23536778,23536778,23547452,0,0,0,10674
23862,23536772,23536772,23547458,0,0,0,10686
23942,23547248,23547248,23547830,0,0,0,582
23944,23548234,23548234,23548519,0,0,0,285
23945,23549858,23549858,23549952,0,0,0,94
23855,23534161,23534161,23550068,0,0,0,15907
23947,23550442,23550442,23550535,0,0,0,93
23948,23550916,23550916,23551029,0,0,0,113
23949,23550998,23550998,23551102,0,0,0,104
23950,23551055,23551055,23551128,0,0,0,73
23951,23551136,23551136,23551320,0,0,0,184
23952,23551293,23551293,23551453,0,0,0,160
23953,23551460,23551460,23551567,0,0,0,107
23954,23551539,23551539,23551613,0,0,0,74
23955,23551581,23551581,23551675,0,0,0,94
23957,23551618,23551618,23551696,0,0,0,78
23956,23551608,23551608,23551702,0,0,0,94
23744,23448270,23448270,23551890,0,0,0,103620
23959,23552201,23552201,23552307,0,0,0,106
23958,23552171,23552171,23552315,0,0,0,144
23960,23552261,23552261,23552367,0,0,0,106
23930,23543675,23543675,23552901,0,0,0,9226
23963,23552918,23552918,23553011,0,0,0,93
23964,23553175,23553175,23553268,0,0,0,93
23965,23553185,23553185,23553278,0,0,0,93
23970,23553388,23553388,23553448,0,0,0,60
23969,23553381,23553381,23553581,0,0,0,200
23971,23553548,23553548,23553608,0,0,0,60
23973,23553727,23553727,23553787,0,0,0,60
23972,23553691,23553691,23553826,0,0,0,135
23974,23553894,23553894,23553930,0,0,0,36
23975,23554080,23554080,23554116,0,0,0,36
23976,23554244,23554244,23554311,0,0,0,67
23966,23553303,23553303,23554318,0,0,0,1015
23977,23554361,23554361,23554428,0,0,0,67
23967,23553313,23553313,23554458,0,0,0,1145
23968,23553322,23553322,23554504,0,0,0,1182
23979,23554525,23554525,23554585,0,0,0,60
23978,23554459,23554459,23554616,0,0,0,157
23981,23556090,23556090,23556168,0,0,0,78
23983,23556176,23556176,23556269,0,0,0,93
23984,23556302,23556302,23556375,0,0,0,73
23985,23556421,23556421,23556488,0,0,0,67
23832,23482171,23482171,23556648,0,0,0,74477
23742,23448012,23448012,23557613,0,0,0,109601
23740,23447995,23447995,23557624,0,0,0,109629
23986,23556605,23556605,23558058,0,0,0,1453
23987,23557321,23557321,23558311,0,0,0,990
23988,23557350,23557350,23558402,0,0,0,1052
23989,23557365,23557365,23558424,0,0,0,1059
23998,23561802,23561802,23561993,0,0,0,191
23999,23562436,23562436,23562690,0,0,0,254
24000,23562593,23562593,23562691,0,0,0,98
23831,23482152,23482152,23563152,0,0,0,81000
24001,23563007,23563007,23563293,0,0,0,286
23994,23559633,23563152,23563384,0,0,3519,3751
23982,23556110,23556110,23563530,0,0,0,7420
24004,23563567,23563567,23563727,0,0,0,160
24003,23563239,23563239,23564021,0,0,0,782
23943,23547299,23547299,23564608,0,0,0,17309
23835,23486086,23486086,23568120,0,0,0,82034
23803,23471478,23471478,23568228,0,0,0,96750
23686,23312496,23312496,23568362,0,0,0,255866
23836,23490341,23490341,23569376,0,0,0,79035
24007,23569728,23569728,23569832,0,0,0,104
24006,23569728,23569728,23569843,0,0,0,115
24008,23569729,23569729,23569864,0,0,0,135
23980,23555508,23555508,23569897,0,0,0,14389
24009,23569773,23569773,23569897,0,0,0,124
24010,23569773,23569773,23569897,0,0,0,124
24005,23563763,23563763,23569898,0,0,0,6135
24011,23569774,23569774,23569898,0,0,0,124
24012,23569774,23569774,23569898,0,0,0,124
24015,23570787,23570787,23570911,0,0,0,124
24016,23570787,23570787,23570911,0,0,0,124
24017,23570787,23570787,23570911,0,0,0,124
23687,23312496,23312496,23570972,0,0,0,258476
23996,23560229,23563384,23571160,0,0,3155,10931
24013,23570773,23570773,23574316,0,0,0,3543
24020,23574291,23574291,23574385,0,0,0,94
24021,23574336,23574385,23574478,0,0,49,142
23995,23560205,23563293,23581523,0,0,3088,21318
23871,23536926,23536926,23584556,0,0,0,47630
23865,23536924,23536924,23584782,0,0,0,47858
23867,23536925,23536925,23584814,0,0,0,47889
24023,23583871,23584556,23584835,0,0,685,964
23873,23536926,23536926,23584844,0,0,0,47918
23866,23536924,23536924,23585030,0,0,0,48106
23864,23536923,23536923,23585040,0,0,0,48117
24024,23583901,23584814,23585093,0,0,913,1192
23868,23536925,23536925,23585124,0,0,0,48199
23872,23536926,23536926,23585687,0,0,0,48761
23869,23536925,23536925,23585786,0,0,0,48861
23870,23536925,23536925,23586096,0,0,0,49171
23688,23329827,23329827,23589027,0,0,0,259200
23804,23471485,23515148,23589736,0,0,43663,118251
23689,23332621,23332621,23591821,0,0,0,259200
23690,23332622,23332622,23591822,0,0,0,259200
23691,23332639,23332639,23591839,0,0,0,259200
23692,23332639,23332639,23591839,0,0,0,259200
23693,23332639,23332639,23591839,0,0,0,259200
23694,23332640,23332640,23591840,0,0,0,259200
23695,23332698,23332698,23591898,0,0,0,259200
23786,23467279,23467279,23595611,0,0,0,128332
23787,23467284,23467284,23595616,0,0,0,128332
23991,23557565,23557624,23603132,0,0,59,45567
23684,23312495,23312495,23603400,0,0,0,290905
23992,23557578,23558424,23603996,0,0,846,46418
23990,23557558,23557613,23605114,0,0,55,47556
24002,23563026,23569376,23607366,0,0,6350,44340
23946,23550069,23550069,23609892,0,0,0,59823
23997,23560381,23563530,23613054,0,0,3149,52673
23771,23461003,23461003,23614314,0,0,0,153311
24026,23588337,23588337,23614657,0,0,0,26320
24029,23614878,23614878,23615168,0,0,0,290
24030,23615161,23615161,23615449,0,0,0,288
24031,23616775,23616775,23617567,0,0,0,792
24028,23612993,23612993,23618042,0,0,0,5049
24027,23612918,23612918,23618206,0,0,0,5288
23815,23474288,23478329,23618427,0,0,4041,144139
24032,23618012,23618012,23618929,0,0,0,917
24036,23619085,23619085,23619189,0,0,0,104
24037,23619124,23619124,23619228,0,0,0,104
24038,23619745,23619745,23619781,0,0,0,36
24040,23619898,23619898,23620368,0,0,0,470
24039,23619799,23619799,23620379,0,0,0,580
23962,23552869,23552869,23621168,0,0,0,68299
24042,23620689,23620689,23621316,0,0,0,627
24052,23622608,23622608,23622644,0,0,0,36
24047,23622054,23622054,23622750,0,0,0,696
24053,23622702,23622702,23622791,0,0,0,89
24054,23622759,23622759,23622852,0,0,0,93
24051,23622388,23622388,23623221,0,0,0,833
24056,23623728,23623728,23624581,0,0,0,853
24018,23572365,23572365,23625016,0,0,0,52651
24058,23625740,23625740,23625885,0,0,0,145
24055,23623086,23623086,23626043,0,0,0,2957
24059,23625771,23625771,23626062,0,0,0,291
24060,23625956,23625956,23626220,0,0,0,264
24061,23626310,23626310,23626414,0,0,0,104
24048,23622195,23622195,23626762,0,0,0,4567
24049,23622278,23622278,23626885,0,0,0,4607
24062,23627120,23627120,23627187,0,0,0,67
24064,23628009,23628009,23628076,0,0,0,67
24065,23628140,23628140,23628207,0,0,0,67
24066,23628424,23628424,23628472,0,0,0,48
24068,23628699,23628699,23628766,0,0,0,67
24069,23628792,23628792,23628839,0,0,0,47
24070,23628951,23628951,23629019,0,0,0,68
24071,23629066,23629066,23629133,0,0,0,67
24063,23627611,23627611,23629243,0,0,0,1632
24072,23629176,23629176,23629321,0,0,0,145
24073,23629281,23629281,23629348,0,0,0,67
24076,23629600,23629600,23629693,0,0,0,93
24074,23629528,23629528,23629695,0,0,0,167
24075,23629592,23629592,23629743,0,0,0,151
24080,23629714,23629714,23629781,0,0,0,67
24077,23629629,23629629,23629829,0,0,0,200
24081,23629790,23629790,23629976,0,0,0,186
24082,23630114,23630114,23630150,0,0,0,36
24078,23629664,23629664,23630299,0,0,0,635
24079,23629692,23629829,23630523,0,0,137,831
24083,23630452,23630452,23630677,0,0,0,225
23993,23557907,23558311,23630863,0,0,404,72956
24084,23630578,23630578,23630894,0,0,0,316
24086,23631601,23631601,23631648,0,0,0,47
24087,23631703,23631703,23631770,0,0,0,67
24088,23631935,23631935,23632090,0,0,0,155
24035,23618821,23618821,23632098,0,0,0,13277
24090,23632494,23632494,23632559,0,0,0,65
24091,23632522,23632522,23632590,0,0,0,68
24100,23633562,23633562,23633629,0,0,0,67
24101,23633654,23633654,23633721,0,0,0,67
24102,23633752,23633752,23633819,0,0,0,67
23702,23375260,23375260,23634460,0,0,0,259200
23703,23375289,23375289,23634489,0,0,0,259200
23704,23375315,23375315,23634515,0,0,0,259200
24103,23634595,23634595,23634642,0,0,0,47
24107,23634725,23634725,23634818,0,0,0,93
24109,23635999,23635999,23636067,0,0,0,68
24110,23636126,23636126,23636173,0,0,0,47
24111,23636245,23636245,23636312,0,0,0,67
24112,23636315,23636315,23636362,0,0,0,47
24113,23636570,23636570,23636637,0,0,0,67
24115,23636869,23636869,23636932,0,0,0,63
24114,23636780,23636780,23637583,0,0,0,803
24116,23637657,23637657,23637710,0,0,0,53
24117,23637663,23637663,23637730,0,0,0,67
24119,23637785,23637785,23637832,0,0,0,47
24120,23637959,23637959,23638026,0,0,0,67
24121,23638172,23638172,23638239,0,0,0,67
24122,23638353,23638353,23638420,0,0,0,67
24123,23638508,23638508,23638555,0,0,0,47
24124,23638646,23638646,23638713,0,0,0,67
24125,23638947,23638947,23639014,0,0,0,67
24126,23639018,23639018,23639065,0,0,0,47
24127,23639087,23639087,23639166,0,0,0,79
24129,23639213,23639213,23639281,0,0,0,68
24128,23639128,23639128,23639770,0,0,0,642
24130,23640106,23640106,23640173,0,0,0,67
24131,23640406,23640406,23640466,0,0,0,60
24132,23641131,23641131,23641198,0,0,0,67
23706,23408813,23408813,23642266,0,0,0,233453
24135,23642714,23642714,23642766,0,0,0,52
24136,23642717,23642717,23642801,0,0,0,84
24137,23642785,23642785,23642837,0,0,0,52
24138,23642795,23642795,23642862,0,0,0,67
24139,23642900,23642900,23642967,0,0,0,67
24140,23643094,23643094,23643162,0,0,0,68
24141,23643312,23643312,23643359,0,0,0,47
24142,23643501,23643501,23643569,0,0,0,68
24144,23644089,23644089,23644157,0,0,0,68
24145,23644211,23644211,23644295,0,0,0,84
24147,23644450,23644450,23644517,0,0,0,67
24050,23622292,23622292,23644973,0,0,0,22681
24146,23644248,23644248,23645005,0,0,0,757
24149,23644900,23644900,23645016,0,0,0,116
24067,23628440,23628440,23645108,0,0,0,16668
24045,23621150,23621150,23646366,0,0,0,25216
24151,23645985,23645985,23646698,0,0,0,713
24154,23646754,23646754,23646848,0,0,0,94
24046,23621519,23621519,23649546,0,0,0,28027
24156,23649448,23649448,23651515,0,0,0,2067
24158,23653421,23653421,23653514,0,0,0,93
24159,23653426,23653426,23653519,0,0,0,93
24160,23653431,23653431,23653524,0,0,0,93
24157,23653415,23653415,23653525,0,0,0,110
24161,23653437,23653437,23653530,0,0,0,93
23796,23471265,23471265,23656446,0,0,0,185181
24019,23573146,23573146,23659546,0,0,0,86400
24118,23637742,23637742,23660443,0,0,0,22701
24022,23579172,23581523,23661189,0,0,2351,82017
24133,23642021,23642021,23663347,0,0,0,21326
24152,23646182,23646182,23663525,0,0,0,17343
24155,23648690,23648690,23666157,0,0,0,17467
24163,23665209,23665209,23667364,0,0,0,2155
24034,23618316,23618316,23668989,0,0,0,50673
24043,23620949,23620949,23672308,0,0,0,51359
24044,23620991,23620991,23672649,0,0,0,51658
23728,23440172,23440172,23678264,0,0,0,238092
24153,23646548,23646548,23679667,0,0,0,33119
24150,23644984,23644984,23680984,0,0,0,36000
23935,23543940,23543940,23682385,0,0,0,138445
24041,23620668,23620668,23689106,0,0,0,68438
24033,23618088,23618088,23689817,0,0,0,71729
24164,23665226,23665226,23692849,0,0,0,27623
24014,23570776,23574316,23695602,0,0,3540,124826
24057,23625720,23625720,23697720,0,0,0,72000
24168,23702496,23702496,23702532,0,0,0,36
23770,23461002,23461002,23703863,0,0,0,242861
24085,23631530,23631530,23703973,0,0,0,72443
24173,23704789,23704789,23704893,0,0,0,104
24148,23644523,23644523,23705362,0,0,0,60839
24175,23705229,23705229,23705437,0,0,0,208
24178,23706038,23706038,23706105,0,0,0,67
24025,23585578,23585578,23706310,0,0,0,120732
24179,23706226,23706226,23706319,0,0,0,93
24180,23706532,23706532,23706636,0,0,0,104
24177,23705633,23705633,23706743,0,0,0,1110
24185,23707167,23707167,23707291,0,0,0,124
24186,23707490,23707490,23707738,0,0,0,248
24181,23706702,23706702,23708080,0,0,0,1378
24187,23708183,23708183,23708219,0,0,0,36
24188,23708341,23708341,23708414,0,0,0,73
24192,23709474,23709474,23709567,0,0,0,93
24193,23709597,23709597,23709681,0,0,0,84
24194,23709644,23709644,23709737,0,0,0,93
24195,23709970,23709970,23710063,0,0,0,93
24196,23710125,23710125,23710209,0,0,0,84
24197,23710177,23710177,23710270,0,0,0,93
24198,23710451,23710451,23710519,0,0,0,68
24199,23710689,23710689,23710757,0,0,0,68
24200,23710805,23710805,23710873,0,0,0,68
24201,23710902,23710902,23711197,0,0,0,295
24203,23711462,23711462,23711535,0,0,0,73
24202,23711332,23711332,23711591,0,0,0,259
24183,23706885,23706885,23712330,0,0,0,5445
24204,23712091,23712091,23712339,0,0,0,248
24182,23706884,23706884,23712476,0,0,0,5592
24184,23706886,23706886,23712509,0,0,0,5623
24205,23713351,23713351,23713951,0,0,0,600
24209,23716469,23716469,23716522,0,0,0,53
24208,23716379,23716379,23716525,0,0,0,146
24210,23716494,23716494,23717054,0,0,0,560
24211,23716538,23716538,23717138,0,0,0,600
24215,23717419,23717419,23717512,0,0,0,93
24216,23717536,23717536,23717584,0,0,0,48
24217,23717553,23717553,23717739,0,0,0,186
24218,23717668,23717668,23717814,0,0,0,146
24219,23717683,23717683,23717850,0,0,0,167
24221,23717756,23717756,23717974,0,0,0,218
24223,23717988,23717988,23718066,0,0,0,78
24222,23717782,23717974,23718192,0,0,192,410
24220,23717727,23717727,23718326,0,0,0,599
24224,23718397,23718397,23718464,0,0,0,67
24213,23717054,23717054,23718854,0,0,0,1800
24225,23718956,23718956,23719330,0,0,0,374
24226,23719367,23719367,23719575,0,0,0,208
24227,23719533,23719533,23719720,0,0,0,187
24228,23719722,23719722,23719909,0,0,0,187
24229,23720108,23720108,23720213,0,0,0,105
24230,23720173,23720173,23720403,0,0,0,230
24231,23720331,23720331,23720443,0,0,0,112
24233,23720568,23720568,23720776,0,0,0,208
24235,23720749,23720749,23720848,0,0,0,99
24236,23720791,23720791,23720879,0,0,0,88
24238,23720854,23720854,23721020,0,0,0,166
24239,23720883,23720883,23721050,0,0,0,167
24245,23721780,23721780,23721843,0,0,0,63
24246,23721830,23721830,23721893,0,0,0,63
24247,23721847,23721847,23721910,0,0,0,63
24248,23722288,23722288,23722930,0,0,0,642
24214,23717372,23717372,23723499,0,0,0,6127
24250,23724041,23724041,23724135,0,0,0,94
24251,23724576,23724576,23724680,0,0,0,104
24174,23705014,23705014,23724998,0,0,0,19984
24176,23705336,23705336,23725231,0,0,0,19895
24206,23714887,23714887,23725298,0,0,0,10411
24191,23709296,23709296,23725330,0,0,0,16034
24253,23725225,23725225,23725392,0,0,0,167
24212,23716699,23716699,23726501,0,0,0,9802
24249,23723813,23723813,23726890,0,0,0,3077
24260,23727996,23727996,23728064,0,0,0,68
24266,23728765,23728765,23728982,0,0,0,217
24263,23728721,23728721,23729233,0,0,0,512
24267,23729265,23729265,23729420,0,0,0,155
23797,23471275,23471275,23730475,0,0,0,259200
24165,23668391,23668391,23730731,0,0,0,62340
24268,23731467,23731467,23731602,0,0,0,135
24269,23731654,23731654,23731815,0,0,0,161
24271,23731991,23731991,23732120,0,0,0,129
24264,23728735,23728735,23732129,0,0,0,3394
24252,23724762,23724762,23732146,0,0,0,7384
24272,23732337,23732337,23732497,0,0,0,160
24273,23732588,23732588,23732759,0,0,0,171
24277,23734148,23734148,23734303,0,0,0,155
24278,23734297,23734297,23734375,0,0,0,78
24279,23734681,23734681,23734806,0,0,0,125
24265,23728742,23728742,23738869,0,0,0,10127
24283,23737742,23737742,23739081,0,0,0,1339
24280,23734904,23734904,23741478,0,0,0,6574
24282,23735094,23735094,23741484,0,0,0,6390
24189,23709162,23709162,23745162,0,0,0,36000
24166,23668456,23668456,23745420,0,0,0,76964
24289,23747486,23747486,23747610,0,0,0,124
24285,23738289,23738289,23748145,0,0,0,9856
24270,23731896,23731896,23750514,0,0,0,18618
24169,23703889,23703889,23754295,0,0,0,50406
24288,23747235,23747235,23754667,0,0,0,7432
23725,23416730,23416730,23762330,0,0,0,345600
24274,23733079,23733079,23769079,0,0,0,36000
24276,23733645,23733645,23773848,0,0,0,40203
24190,23709228,23709228,23774558,0,0,0,65330
24171,23703987,23703987,23775303,0,0,0,71316
24172,23704108,23704108,23775900,0,0,0,71792
24287,23740626,23740626,23779281,0,0,0,38655
24232,23720411,23720411,23779617,0,0,0,59206
24284,23737764,23737764,23785098,0,0,0,47334
23961,23552383,23552383,23789424,0,0,0,237041
24286,23739025,23739025,23791310,0,0,0,52285
24296,23794109,23794109,23794213,0,0,0,104
24298,23794416,23794416,23794851,0,0,0,435
24299,23794858,23794858,23795387,0,0,0,529
24305,23796464,23796464,23797240,0,0,0,776
24309,23796584,23797240,23797395,0,0,656,811
24306,23796518,23797240,23797967,0,0,722,1449
24317,23797946,23797967,23798061,0,0,21,115
24308,23796561,23797967,23798153,0,0,1406,1592
24316,23797945,23797967,23798211,0,0,22,266
24320,23798858,23798858,23799029,0,0,0,171
24318,23797951,23797967,23800130,0,0,16,2179
24207,23716259,23716259,23801158,0,0,0,84899
24134,23642492,23642492,23802726,0,0,0,160234
23932,23543916,23543916,23803116,0,0,0,259200
23933,23543917,23543917,23803117,0,0,0,259200
23934,23543917,23543917,23803117,0,0,0,259200
23936,23544062,23544062,23803262,0,0,0,259200
23937,23544062,23544062,23803262,0,0,0,259200
23805,23471629,23545362,23804562,0,0,73733,332933
24294,23792733,23792733,23804820,0,0,0,12087
24363,23804220,23804562,23804956,0,0,342,736
24364,23804590,23804590,23804962,0,0,0,372
24312,23797058,23797967,23805240,0,0,909,8182
24314,23797496,23797967,23805240,0,0,471,7744
24365,23804993,23805240,23805386,0,0,247,393
24366,23805104,23805386,23805769,0,0,282,665
24300,23795000,23795000,23806577,0,0,0,11577
24297,23794271,23794271,23806753,0,0,0,12482
24368,23805535,23806577,23806887,0,0,1042,1352
24304,23795808,23795808,23807361,0,0,0,11553
24370,23807115,23807115,23807454,0,0,0,339
24162,23665100,23665100,23807768,0,0,0,142668
24371,23807418,23807418,23808060,0,0,0,642
24374,23807563,23807563,23808215,0,0,0,652
24375,23807668,23807668,23808273,0,0,0,605
24311,23796686,23797395,23808378,0,0,709,11692
23837,23493904,23493904,23808396,0,0,0,314492
24313,23797431,23797967,23809057,0,0,536,11626
24377,23808582,23808582,23809218,0,0,0,636
24379,23808674,23808674,23809343,0,0,0,669
24383,23810205,23810205,23810330,0,0,0,125
24384,23810386,23810386,23810521,0,0,0,135
24385,23810673,23810673,23810815,0,0,0,142
24302,23795467,23795467,23811067,0,0,0,15600
24389,23811202,23811202,23811379,0,0,0,177
24393,23811441,23811441,23811621,0,0,0,180
24376,23808541,23808541,23811665,0,0,0,3124
24395,23811751,23811751,23811868,0,0,0,117
24367,23805426,23805769,23812415,0,0,343,6989
24398,23811947,23811947,23812547,0,0,0,600
24381,23808991,23812415,23812768,0,0,3424,3777
24400,23813017,23813017,23813090,0,0,0,73
24401,23813197,23813197,23813344,0,0,0,147
24402,23813280,23813280,23813466,0,0,0,186
24403,23813818,23813818,23813891,0,0,0,73
24404,23813856,23813856,23814104,0,0,0,248
24407,23814881,23814881,23814974,0,0,0,93
24319,23797971,23797971,23815864,0,0,0,17893
24386,23810753,23810815,23815904,0,0,62,5151
24405,23814227,23815904,23816091,0,0,1677,1864
24417,23816394,23816394,23816857,0,0,0,463
24428,23817013,23817013,23817437,0,0,0,424
24410,23816325,23816325,23821466,0,0,0,5141
24258,23727805,23727805,23825771,0,0,0,97966
23806,23471640,23568228,23827428,0,0,96588,355788
24315,23797931,23797931,23831238,0,0,0,33307
24303,23795692,23795692,23831692,0,0,0,36000
24301,23795422,23795422,23832513,0,0,0,37091
24399,23812136,23827428,23836448,0,0,15292,24312
24108,23635514,23635514,23837788,0,0,0,202274
24438,23818124,23837788,23838070,0,0,19664,19946
24448,23833215,23838070,23838349,0,0,4855,5134
24432,23817588,23836448,23841524,0,0,18860,23936
24411,23816336,23816336,23846254,0,0,0,29918
24089,23631997,23631997,23846615,0,0,0,214618
24447,23829208,23846615,23846711,0,0,17407,17503
24262,23728179,23728179,23847372,0,0,0,119193
24339,23799018,23799018,23848251,0,0,0,49233
24334,23799017,23799017,23848308,0,0,0,49291
24340,23799018,23799018,23848313,0,0,0,49295
24412,23816349,23821466,23848315,0,0,5117,31966
24336,23799017,23799017,23848510,0,0,0,49493
24452,23838362,23848251,23848530,0,0,9889,10168
24341,23799018,23799018,23848759,0,0,0,49741
24335,23799017,23799017,23848908,0,0,0,49891
24342,23799018,23799018,23848945,0,0,0,49927
24333,23799017,23799017,23849094,0,0,0,50077
24343,23799018,23799018,23849286,0,0,0,50268
24344,23799018,23799018,23849348,0,0,0,50330
24453,23843795,23848313,23849521,0,0,4518,5726
24346,23799019,23800130,23849530,0,0,1111,50511
24455,23843855,23848530,23849677,0,0,4675,5822
24454,23843830,23848510,23849701,0,0,4680,5871
24345,23799018,23800130,23850584,0,0,1112,51566
24348,23799020,23801158,23850651,0,0,2138,51631
24361,23799242,23804962,23851094,0,0,5720,51852
24347,23799019,23801158,23851116,0,0,2139,52097
24349,23799020,23801158,23851488,0,0,2138,52468
24350,23799020,23801158,23851519,0,0,2138,52499
24382,23809188,23812768,23851721,0,0,3580,42533
24359,23799023,23802726,23851863,0,0,3703,52840
24355,23799022,23802726,23851897,0,0,3704,52875
24240,23721090,23721090,23852468,0,0,0,131378
24352,23799021,23802726,23852653,0,0,3705,53632
24356,23799022,23802726,23852746,0,0,3704,53724
24357,23799022,23802726,23852808,0,0,3704,53786
24360,23799023,23802726,23852839,0,0,3703,53816
24358,23799022,23802726,23852963,0,0,3704,53941
24353,23799021,23802726,23853087,0,0,3705,54066
24422,23816459,23832513,23853197,0,0,16054,36738
24423,23816469,23832513,23853228,0,0,16044,36759
24351,23799020,23802726,23853366,0,0,3706,54346
24354,23799021,23802726,23853604,0,0,3705,54583
24420,23816441,23832513,23853622,0,0,16072,37181
24421,23816450,23832513,23853653,0,0,16063,37203
24414,23816369,23827428,23853655,0,0,11059,37286
24416,23816380,23827428,23854173,0,0,11048,37793
24413,23816359,23827428,23854443,0,0,11069,38084
24418,23816425,23831238,23855119,0,0,14813,38694
24419,23816433,23831692,23855531,0,0,15259,39098
24449,23836361,23846711,23859672,0,0,10350,23311
24257,23727597,23727597,23860654,0,0,0,133057
24237,23720827,23720827,23862418,0,0,0,141591
24450,23837146,23849094,23864967,0,0,11948,27821
24430,23817488,23831238,23867005,0,0,13750,49517
24255,23727195,23727195,23873544,0,0,0,146349
24456,23853223,23853223,23874030,0,0,0,20807
24457,23853241,23853241,23874164,0,0,0,20923
24458,23853655,23853655,23874756,0,0,0,21101
24459,23853659,23853659,23874791,0,0,0,21132
24256,23727432,23727432,23877848,0,0,0,150416
24254,23726914,23726914,23879252,0,0,0,152338
24295,23793740,23793740,23879998,0,0,0,86258
24170,23703984,23703984,23881269,0,0,0,177285
24292,23792254,23792254,23881337,0,0,0,89083
24293,23792326,23792326,23881367,0,0,0,89041
24451,23837698,23838349,23881549,0,0,651,43851
24234,23720673,23720673,23881689,0,0,0,161016
24099,23633244,23633244,23883389,0,0,0,250145
24460,23856384,23859672,23883482,0,0,3288,27098
24461,23856395,23859672,23883545,0,0,3277,27150
24321,23799015,23799015,23885415,0,0,0,86400
24322,23799015,23799015,23885415,0,0,0,86400
24323,23799015,23799015,23885415,0,0,0,86400
24324,23799015,23799015,23885415,0,0,0,86400
24325,23799015,23799015,23885415,0,0,0,86400
24326,23799016,23799016,23885416,0,0,0,86400
24327,23799016,23799016,23885416,0,0,0,86400
24328,23799016,23799016,23885416,0,0,0,86400
24329,23799016,23799016,23885416,0,0,0,86400
24330,23799016,23799016,23885416,0,0,0,86400
24331,23799016,23799016,23885416,0,0,0,86400
24332,23799016,23799016,23885416,0,0,0,86400
24337,23799017,23799017,23885417,0,0,0,86400
24338,23799017,23799017,23885417,0,0,0,86400
24275,23733127,23733127,23885658,0,0,0,152531
24310,23796623,23885658,23886341,0,0,89035,89718
24462,23858753,23859672,23886480,0,0,919,27727
24362,23801160,23803116,23886706,0,0,1956,85546
24463,23859271,23862418,23889307,0,0,3147,30036
24281,23735034,23735034,23891799,0,0,0,156765
24464,23859396,23864967,23891831,0,0,5571,32435
24092,23632888,23632888,23892088,0,0,0,259200
24093,23632889,23632889,23892089,0,0,0,259200
24094,23632889,23632889,23892089,0,0,0,259200
24095,23632889,23632889,23892089,0,0,0,259200
24096,23632912,23632912,23892112,0,0,0,259200
24097,23632913,23632913,23892113,0,0,0,259200
24098,23633000,23633000,23892200,0,0,0,259200
24465,23859538,23864967,23892213,0,0,5429,32675
24104,23634651,23634651,23893851,0,0,0,259200
24105,23634677,23634677,23893877,0,0,0,259200
24106,23634718,23634718,23893918,0,0,0,259200
24244,23721218,23721218,23894156,0,0,0,172938
24467,23873967,23874030,23894654,0,0,63,20687
24468,23874154,23874164,23894695,0,0,10,20541
24466,23862435,23864967,23894860,0,0,2532,32425
24469,23874711,23874756,23895725,0,0,45,21014
24470,23874759,23874791,23895738,0,0,32,20979
24387,23811037,23811067,23897467,0,0,30,86430
24495,23897778,23897778,23897902,0,0,0,124
24291,23790190,23790190,23900287,0,0,0,110097
24143,23644034,23644034,23903234,0,0,0,259200
24472,23880133,23881337,23904127,0,0,1204,23994
24473,23880238,23881337,23904201,0,0,1099,23963
24243,23721185,23721185,23908710,0,0,0,187525
24259,23727961,23727961,23911333,0,0,0,183372
24475,23885478,23885478,23912094,0,0,0,26616
24476,23886098,23886098,23912814,0,0,0,26716
24388,23811096,23827428,23912891,0,0,16332,101795
24477,23886208,23886208,23913414,0,0,0,27206
24478,23886726,23886726,23913933,0,0,0,27207
24482,23894544,23894544,23915034,0,0,0,20490
24483,23894648,23894648,23915180,0,0,0,20532
24485,23895652,23895652,23916543,0,0,0,20891
24484,23895637,23895637,23916575,0,0,0,20938
24509,23916511,23916511,23916606,0,0,0,95
24480,23892275,23892275,23921451,0,0,0,29176
24513,23921389,23921389,23921563,0,0,0,174
24514,23921501,23921501,23921672,0,0,0,171
24446,23829189,23841524,23921936,0,0,12335,92747
24241,23721128,23721128,23922704,0,0,0,201576
24512,23918664,23918664,23923464,0,0,0,4800
24500,23902944,23902944,23926665,0,0,0,23721
24501,23903102,23903102,23926811,0,0,0,23709
24474,23881201,23881367,23928923,0,0,166,47722
24242,23721154,23721154,23932264,0,0,0,211110
24435,23817829,23836448,23932579,0,0,18619,114750
24507,23915123,23915123,23935531,0,0,0,20408
24506,23914968,23914968,23935895,0,0,0,20927
24508,23916487,23916487,23937345,0,0,0,20858
24510,23916512,23916512,23937376,0,0,0,20864
24167,23702333,23702333,23937586,0,0,0,235253
24502,23912039,23912039,23938136,0,0,0,26097
24503,23912752,23912752,23938994,0,0,0,26242
24504,23913408,23913408,23940139,0,0,0,26731
24505,23913932,23913932,23940714,0,0,0,26782
24511,23916543,23916543,23945343,0,0,0,28800
24261,23728061,23728061,23946297,0,0,0,218236
24408,23815014,23815904,23948843,0,0,890,133829
24516,23926631,23926631,23950480,0,0,0,23849
24409,23816264,23816264,23950675,0,0,0,134411
24517,23926764,23926764,23950707,0,0,0,23943
24515,23921610,23921610,23951388,0,0,0,29778
24531,23951325,23951325,23954988,0,0,0,3663
24521,23935468,23935468,23955912,0,0,0,20444
24522,23935842,23935842,23956304,0,0,0,20462
24481,23892582,23892582,23957078,0,0,0,64496
24445,23826261,23837788,23957548,0,0,11527,131287
24523,23937276,23937276,23958121,0,0,0,20845
24524,23937324,23937324,23958156,0,0,0,20832
24390,23811256,23851094,23960900,0,0,39838,149644
24391,23811269,23851721,23963250,0,0,40452,151981
24525,23938074,23938074,23964615,0,0,0,26541
24526,23938931,23938931,23965526,0,0,0,26595
24527,23940104,23940104,23966677,0,0,0,26573
24528,23940648,23940648,23967165,0,0,0,26517
24440,23819828,23837788,23970786,0,0,17960,150958
24433,23817600,23836448,23971919,0,0,18848,154319
24518,23929523,23929523,23972266,0,0,0,42743
24479,23888561,23888561,23972289,0,0,0,83728
24392,23811280,23855531,23972914,0,0,44251,161634
24529,23950420,23950420,23973514,0,0,0,23094
24530,23950650,23950650,23973712,0,0,0,23062
24439,23819769,23837788,23974228,0,0,18019,154459
24533,23955843,23955843,23976422,0,0,0,20579
24534,23956242,23956242,23976789,0,0,0,20547
24535,23958080,23958080,23979089,0,0,0,21009
24536,23958093,23958093,23979122,0,0,0,21029
24415,23816374,23825771,23979373,0,0,9397,162999
24496,23897898,23897898,23979590,0,0,0,81692
24554,23981243,23981243,23981324,0,0,0,81
24555,23981294,23981294,23981387,0,0,0,93
24556,23981450,23981450,23981575,0,0,0,125
24557,23981594,23981594,23981729,0,0,0,135
24558,23981691,23981691,23981815,0,0,0,124
24431,23817547,23832513,23982383,0,0,14966,164836
24559,23982845,23982845,23982938,0,0,0,93
24560,23982992,23982992,23983148,0,0,0,156
24561,23983447,23983447,23983789,0,0,0,342
24541,23970038,23970038,23984219,0,0,0,14181
24532,23954919,23954919,23984890,0,0,0,29971
24538,23965458,23965458,23988443,0,0,0,22985
24519,23929836,23929836,23988480,0,0,0,58644
24537,23964553,23964553,23990869,0,0,0,26316
24564,23990818,23990818,23990985,0,0,0,167
24567,23990931,23990931,23991097,0,0,0,166
24568,23991035,23991035,23991203,0,0,0,168
24539,23966625,23966625,23993438,0,0,0,26813
24540,23967107,23967107,23993982,0,0,0,26875
24406,23814622,23827428,23994199,0,0,12806,179577
24574,23995427,23995427,23995507,0,0,0,80
24545,23973452,23973452,23995548,0,0,0,22096
24546,23973648,23973648,23995757,0,0,0,22109
24579,23996068,23996068,23996141,0,0,0,73
24548,23976367,23976367,23996941,0,0,0,20574
24549,23976726,23976726,23997323,0,0,0,20597
24441,23819882,23837788,23999789,0,0,17906,179907
24550,23979030,23979030,23999995,0,0,0,20965
24551,23979060,23979060,24000026,0,0,0,20966
24425,23816662,23827428,24000772,0,0,10766,184110
24494,23897620,23897620,24001119,0,0,0,103499
24562,23984832,23984832,24014113,0,0,0,29281
24586,24014054,24014054,24014468,0,0,0,414
24563,23988386,23988386,24014604,0,0,0,26218
24587,24014427,24014427,24014857,0,0,0,430
24443,23820135,23837788,24017441,0,0,17653,197306
24580,23996879,23996879,24017485,0,0,0,20606
24543,23971805,23971805,24017578,0,0,0,45773
24569,23991141,23991141,24017651,0,0,0,26510
24591,24017607,24017607,24017784,0,0,0,177
24581,23997276,23997276,24017946,0,0,0,20670
24585,24008838,24008838,24018076,0,0,0,9238
24577,23995506,23995506,24019291,0,0,0,23785
24578,23995696,23995696,24019427,0,0,0,23731
24570,23993359,23993359,24020361,0,0,0,27002
24582,23999949,23999949,24021002,0,0,0,21053
24572,23993920,23993920,24021044,0,0,0,27124
24583,23999964,23999964,24021075,0,0,0,21111
24434,23817669,23836448,24022938,0,0,18779,205269
24424,23816521,23827428,24025789,0,0,10907,209268
24547,23973890,23973890,24026234,0,0,0,52344
24552,23979404,23979404,24028512,0,0,0,49108
24426,23816885,23831238,24037176,0,0,14353,220291
24590,24017422,24017422,24037896,0,0,0,20474
24593,24017882,24017882,24038402,0,0,0,20520
24588,24014539,24014539,24041040,0,0,0,26501
24553,23979420,23979420,24041318,0,0,0,61898
24369,23806635,23806635,24041661,0,0,0,235026
24599,24021004,24021004,24041872,0,0,0,20868
24597,24020951,24020951,24041903,0,0,0,20952
24589,24014808,24014808,24042797,0,0,0,27989
24437,23817943,23836448,24043005,0,0,18505,225062
24594,24019229,24019229,24043459,0,0,0,24230
24595,24019382,24019382,24043560,0,0,0,24178
24499,23902008,23902008,24043785,0,0,0,141777
24575,23995476,23995476,24044163,0,0,0,48687
24592,24017714,24017714,24044544,0,0,0,26830
24444,23820138,23837788,24044641,0,0,17650,224503
24394,23811471,23815864,24046797,0,0,4393,235326
24596,24020298,24020298,24047410,0,0,0,27112
24610,24047503,24047503,24047689,0,0,0,186
24611,24047505,24047505,24047692,0,0,0,187
24598,24020964,24020964,24047860,0,0,0,26896
24576,23995501,23995501,24048130,0,0,0,52629
24615,24048738,24048738,24048967,0,0,0,229
24614,24048729,24048729,24048989,0,0,0,260
24616,24049835,24049835,24050053,0,0,0,218
24542,23970062,23970062,24050576,0,0,0,80514
24617,24050249,24050249,24050745,0,0,0,496
24619,24050683,24050683,24050776,0,0,0,93
24622,24050932,24050932,24051222,0,0,0,290
24621,24050870,24050870,24051405,0,0,0,535
24623,24051373,24051373,24051495,0,0,0,122
24630,24052605,24052605,24052691,0,0,0,86
24632,24053163,24053163,24053231,0,0,0,68
24635,24053619,24053619,24053686,0,0,0,67
24634,24053366,24053366,24054037,0,0,0,671
24520,23929869,23929869,24054829,0,0,0,124960
24627,24051575,24051575,24054973,0,0,0,3398
24638,24055376,24055376,24055485,0,0,0,109
24639,24055498,24055498,24055565,0,0,0,67
24640,24055731,24055731,24055798,0,0,0,67
24544,23972293,23972293,24055876,0,0,0,83583
24642,24055827,24055827,24055905,0,0,0,78
24643,24055927,24055927,24056051,0,0,0,124
24644,24056215,24056215,24056357,0,0,0,142
24307,23796545,23797240,24056440,0,0,695,259895
24625,24051464,24051464,24056546,0,0,0,5082
24626,24051513,24051513,24056546,0,0,0,5033
24647,24057014,24057014,24057073,0,0,0,59
24645,24056562,24056562,24057513,0,0,0,951
24649,24058213,24058213,24058318,0,0,0,105
24600,24037833,24037833,24058349,0,0,0,20516
24651,24058592,24058592,24058665,0,0,0,73
24601,24038347,24038347,24058889,0,0,0,20542
24378,23808663,23811665,24059709,0,0,3002,251046
24656,24060293,24060293,24060417,0,0,0,124
24658,24060700,24060700,24060835,0,0,0,135
24659,24060789,24060789,24060862,0,0,0,73
24657,24060675,24060675,24060893,0,0,0,218
24660,24061093,24061093,24061186,0,0,0,93
24661,24061208,24061208,24061301,0,0,0,93
24662,24061379,24061379,24061535,0,0,0,156
24648,24057078,24057078,24062162,0,0,0,5084
24663,24062057,24062057,24062186,0,0,0,129
24633,24053225,24053225,24062311,0,0,0,9086
24665,24062497,24062497,24062621,0,0,0,124
24604,24041851,24041851,24062775,0,0,0,20924
24603,24041827,24041827,24062821,0,0,0,20994
24668,24062791,24062791,24062946,0,0,0,155
24671,24063008,24063008,24063143,0,0,0,135
24672,24063511,24063511,24063636,0,0,0,125
24664,24062369,24062369,24064678,0,0,0,2309
24677,24064777,24064777,24064932,0,0,0,155
24678,24065165,24065165,24065301,0,0,0,136
24679,24065308,24065308,24065448,0,0,0,140
24372,23807506,23807506,24066706,0,0,0,259200
24373,23807521,23807768,24066968,0,0,247,259447
24641,24055825,24055825,24067156,0,0,0,11331
24602,24040980,24040980,24067327,0,0,0,26347
24606,24043392,24043392,24067672,0,0,0,24280
24607,24043520,24043520,24067707,0,0,0,24187
24687,24067738,24067738,24067816,0,0,0,78
24684,24067548,24067548,24067941,0,0,0,393
24688,24067936,24067936,24068040,0,0,0,104
24689,24068470,24068470,24068538,0,0,0,68
24690,24069151,24069151,24069435,0,0,0,284
24676,24064647,24064647,24069751,0,0,0,5104
24618,24050293,24050293,24069933,0,0,0,19640
24608,24044491,24044491,24070868,0,0,0,26377
24696,24071857,24071857,24072012,0,0,0,155
24605,24042734,24042734,24072350,0,0,0,29616
24699,24072404,24072404,24072470,0,0,0,66
24691,24069957,24069957,24072540,0,0,0,2583
24700,24072427,24072427,24073339,0,0,0,912
24704,24073306,24073306,24073461,0,0,0,155
24705,24073561,24073561,24073685,0,0,0,124
24706,24073782,24073782,24073886,0,0,0,104
24609,24047363,24047363,24074218,0,0,0,26855
24708,24074517,24074517,24074672,0,0,0,155
24709,24074921,24074921,24075025,0,0,0,104
24396,23811814,23815864,24075064,0,0,4050,263250
24397,23811906,23815864,24075064,0,0,3958,263158
24710,24075162,24075162,24075304,0,0,0,142
24711,24075218,24075218,24075343,0,0,0,125
24712,24075341,24075341,24077123,0,0,0,1782
24703,24072603,24072603,24077683,0,0,0,5080
24613,24047980,24047980,24078095,0,0,0,30115
24650,24058284,24058284,24078692,0,0,0,20408
24692,24070420,24070420,24078943,0,0,0,8523
24652,24058816,24058816,24079218,0,0,0,20402
24698,24072305,24072305,24079999,0,0,0,7694
24695,24071649,24071649,24080121,0,0,0,8472
24715,24077062,24077062,24080662,0,0,0,3600
24702,24072555,24072555,24081092,0,0,0,8537
24719,24081714,24081714,24081808,0,0,0,94
24666,24062728,24062728,24083490,0,0,0,20762
24667,24062736,24062736,24083529,0,0,0,20793
24427,23816935,23831238,24085210,0,0,14303,268275
24724,24084736,24084736,24085254,0,0,0,518
24725,24084770,24084770,24085277,0,0,0,507
24727,24085632,24085632,24086310,0,0,0,678
24654,24059354,24059354,24088288,0,0,0,28934
24734,24088391,24088391,24088511,0,0,0,120
24429,23817252,23831692,24090892,0,0,14440,273640
24612,24047805,24047805,24091005,0,0,0,43200
24685,24067603,24067603,24091497,0,0,0,23894
24686,24067644,24067644,24091538,0,0,0,23894
24739,24092554,24092554,24092991,0,0,0,437
24682,24067284,24067284,24093569,0,0,0,26285
24669,24062946,24062946,24095396,0,0,0,32450
24670,24062977,24062977,24095476,0,0,0,32499
24436,23817883,23836448,24095648,0,0,18565,277765
24442,23819938,23837788,24096988,0,0,17850,277050
24675,24064367,24064367,24096988,0,0,0,32621
24693,24070806,24070806,24097298,0,0,0,26492
24680,24065420,24065420,24097903,0,0,0,32483
24731,24087202,24087202,24098343,0,0,0,11141
24717,24078652,24078652,24098767,0,0,0,20115
24718,24079156,24079156,24099305,0,0,0,20149
24681,24066238,24066238,24099383,0,0,0,33145
24707,24074151,24074151,24100685,0,0,0,26534
24683,24067341,24067341,24102047,0,0,0,34706
24745,24098475,24098475,24102189,0,0,0,3714
24697,24072301,24072301,24102279,0,0,0,29978
24721,24083431,24083431,24104000,0,0,0,20569
24722,24083491,24083491,24104074,0,0,0,20583
24742,24096739,24096739,24107400,0,0,0,10661
24743,24096939,24096939,24107618,0,0,0,10679
24716,24078030,24078030,24107850,0,0,0,29820
24754,24107790,24107790,24107970,0,0,0,180
24290,23762889,23762889,24108489,0,0,0,345600
24646,24056955,24056955,24110297,0,0,0,53342
24723,24083976,24083976,24111287,0,0,0,27311
24571,23993397,23993397,24114118,0,0,0,120721
24738,24091495,24091495,24115074,0,0,0,23579
24747,24098705,24098705,24119377,0,0,0,20672
24741,24093507,24093507,24119761,0,0,0,26254
24748,24099235,24099235,24119794,0,0,0,20559
24720,24081945,24081945,24123557,0,0,0,41612
24744,24097227,24097227,24123591,0,0,0,26364
24637,24054874,24054874,24123624,0,0,0,68750
24752,24103933,24103933,24124927,0,0,0,20994
24753,24104015,24104015,24124975,0,0,0,20960
24763,24123933,24123933,24125410,0,0,0,1477
24766,24125746,24125746,24126958,0,0,0,1212
24749,24100646,24100646,24127397,0,0,0,26751
24768,24127560,24127560,24128639,0,0,0,1079
24701,24072487,24072487,24128973,0,0,0,56486
24769,24129373,24129373,24130346,0,0,0,973
24756,24108533,24108533,24130465,0,0,0,21932
24770,24131185,24131185,24132106,0,0,0,921
24750,24102218,24102218,24132198,0,0,0,29980
24772,24132400,24132400,24132463,0,0,0,63
24774,24132998,24132998,24133888,0,0,0,890
24737,24091427,24091427,24134627,0,0,0,43200
24775,24133918,24133918,24134758,0,0,0,840
24776,24134833,24134833,24135634,0,0,0,801
24777,24135546,24135546,24135733,0,0,0,187
24735,24088470,24088470,24135986,0,0,0,47516
24779,24136156,24136156,24136357,0,0,0,201
24778,24135739,24135739,24136540,0,0,0,801
24781,24136646,24136646,24137418,0,0,0,772
24755,24107970,24107970,24137994,0,0,0,30024
24758,24115014,24115014,24138264,0,0,0,23250
24783,24137553,24137553,24138292,0,0,0,739
24785,24138208,24138208,24138354,0,0,0,146
24788,24138695,24138695,24138749,0,0,0,54
24471,23875651,23879998,24139198,0,0,4347,263547
24787,24138460,24138460,24139203,0,0,0,743
24792,24139277,24139277,24139401,0,0,0,124
24790,24139031,24139031,24139530,0,0,0,499
24714,24077016,24077016,24139669,0,0,0,62653
24653,24058851,24058851,24139908,0,0,0,81057
24793,24139725,24139725,24139916,0,0,0,191
24773,24132589,24132589,24139938,0,0,0,7349
24636,24053799,24053799,24140038,0,0,0,86239
24794,24139971,24139971,24140118,0,0,0,147
24759,24119377,24119377,24140124,0,0,0,20747
24796,24140114,24140114,24140287,0,0,0,173
24798,24140148,24140148,24140302,0,0,0,154
24799,24140251,24140251,24140333,0,0,0,82
24795,24140082,24140082,24140460,0,0,0,378
24761,24119800,24119800,24140537,0,0,0,20737
24746,24098561,24098561,24140899,0,0,0,42338
24802,24140732,24140732,24140950,0,0,0,218
24800,24140286,24140286,24141091,0,0,0,805
24803,24140893,24140893,24141599,0,0,0,706
24791,24139047,24139047,24141771,0,0,0,2724
24804,24141360,24141360,24142214,0,0,0,854
24807,24142333,24142333,24142391,0,0,0,58
24789,24138748,24138748,24143332,0,0,0,4584
24805,24141605,24141605,24143333,0,0,0,1728
24808,24142361,24142361,24144321,0,0,0,1960
24760,24119688,24119688,24145912,0,0,0,26224
24764,24124933,24124933,24146046,0,0,0,21113
24765,24124996,24124996,24146109,0,0,0,21113
24815,24145942,24145942,24146568,0,0,0,626
24811,24144253,24144253,24146785,0,0,0,2532
24819,24146535,24146535,24147673,0,0,0,1138
24821,24147659,24147659,24147752,0,0,0,93
24822,24147870,24147870,24148212,0,0,0,342
24824,24148511,24148511,24148666,0,0,0,155
24825,24148569,24148569,24148724,0,0,0,155
24829,24148702,24148702,24148795,0,0,0,93
24826,24148580,24148580,24148797,0,0,0,217
24733,24088328,24088328,24148886,0,0,0,60558
24827,24148592,24148592,24148964,0,0,0,372
24828,24148603,24148603,24149223,0,0,0,620
24782,24137513,24137513,24149481,0,0,0,11968
24823,24148151,24148151,24149950,0,0,0,1799
24762,24123553,24123553,24149997,0,0,0,26444
24655,24060198,24060198,24150075,0,0,0,89877
24831,24149964,24149964,24151773,0,0,0,1809
24620,24050840,24050840,24153097,0,0,0,102257
24631,24052957,24052957,24153745,0,0,0,100788
24767,24127380,24127380,24153942,0,0,0,26562
24380,23808690,23809057,24154657,0,0,367,345967
24801,24140335,24140335,24154780,0,0,0,14445
24812,24145757,24145757,24155836,0,0,0,10079
24486,23897087,23897087,24156287,0,0,0,259200
24487,23897122,23897122,24156322,0,0,0,259200
24836,24155738,24155738,24156377,0,0,0,639
24488,23897358,23897358,24156558,0,0,0,259200
24489,23897359,23897359,24156559,0,0,0,259200
24490,23897360,23897360,24156560,0,0,0,259200
24491,23897360,23897360,24156560,0,0,0,259200
24492,23897480,23897480,24156680,0,0,0,259200
24493,23897481,23897481,24156681,0,0,0,259200
24841,24156645,24156645,24157065,0,0,0,420
24838,24156395,24156395,24157171,0,0,0,776
24839,24156601,24156601,24157172,0,0,0,571
24847,24157326,24157326,24157420,0,0,0,94
24846,24157240,24157240,24157506,0,0,0,266
24845,24157112,24157112,24157777,0,0,0,665
24497,23898964,23898964,24158164,0,0,0,259200
24850,24158207,24158207,24158287,0,0,0,80
24498,23899141,23899141,24158341,0,0,0,259200
24849,24157710,24157710,24159509,0,0,0,1799
24628,24052111,24052111,24159562,0,0,0,107451
24859,24159473,24159473,24159573,0,0,0,100
24858,24159308,24159308,24159574,0,0,0,266
24860,24159558,24159558,24159653,0,0,0,95
24797,24140134,24140134,24160201,0,0,0,20067
24786,24138255,24138255,24161276,0,0,0,23021
24867,24161326,24161326,24161481,0,0,0,155
24771,24132199,24132199,24161909,0,0,0,29710
24844,24157004,24157004,24162060,0,0,0,5056
24869,24162987,24162987,24163054,0,0,0,67
24870,24163301,24163301,24163390,0,0,0,89
24871,24163356,24163356,24163480,0,0,0,124
24873,24163796,24163796,24163920,0,0,0,124
24810,24144252,24144252,24164327,0,0,0,20075
24834,24152596,24152596,24164781,0,0,0,12185
24624,24051443,24051443,24165223,0,0,0,113780
24674,24064139,24064139,24165374,0,0,0,101235
24673,24063797,24063797,24165476,0,0,0,101679
24816,24146003,24146003,24166434,0,0,0,20431
24818,24146053,24146053,24166497,0,0,0,20444
24784,24137994,24137994,24167119,0,0,0,29125
24876,24167111,24167111,24167283,0,0,0,172
24879,24168731,24168731,24168799,0,0,0,68
24880,24168885,24168885,24169107,0,0,0,222
24814,24145920,24145920,24169539,0,0,0,23619
24751,24103122,24103122,24172328,0,0,0,69206
24817,24146008,24146008,24172410,0,0,0,26402
24813,24145867,24145867,24172732,0,0,0,26865
24865,24161236,24161236,24174673,0,0,0,13437
24832,24150007,24150007,24176096,0,0,0,26089
24887,24177910,24177910,24178081,0,0,0,171
24835,24153879,24153879,24180553,0,0,0,26674
24864,24160149,24160149,24180714,0,0,0,20565
24886,24176695,24176695,24181795,0,0,0,5100
24881,24169141,24169141,24184471,0,0,0,15330
24874,24164265,24164265,24184892,0,0,0,20627
24866,24161254,24161254,24184974,0,0,0,23720
24893,24186994,24186994,24187067,0,0,0,73
24875,24166473,24166473,24187353,0,0,0,20880
24729,24085814,24085814,24189160,0,0,0,103346
24780,24136235,24136235,24191192,0,0,0,54957
24868,24161846,24161846,24191516,0,0,0,29670
24883,24170456,24170456,24191557,0,0,0,21101
24882,24169603,24169603,24192890,0,0,0,23287
24894,24187021,24187021,24193465,0,0,0,6444
24877,24167229,24167229,24196591,0,0,0,29362
24884,24172460,24172460,24198200,0,0,0,25740
24854,24158321,24158321,24198756,0,0,0,40435
24885,24172669,24172669,24199289,0,0,0,26620
24809,24143270,24143270,24200918,0,0,0,57648
24872,24163755,24163755,24201962,0,0,0,38207
24890,24181819,24181819,24202349,0,0,0,20530
24820,24146751,24146751,24204535,0,0,0,57784
24888,24178019,24178019,24204654,0,0,0,26635
24891,24184821,24184821,24205337,0,0,0,20516
24852,24158289,24158289,24206561,0,0,0,48272
24730,24085876,24085876,24207497,0,0,0,121621
24889,24180554,24180554,24207701,0,0,0,27147
24892,24185721,24185721,24207879,0,0,0,22158
24895,24187314,24187314,24208260,0,0,0,20946
24896,24191490,24191490,24212353,0,0,0,20863
24726,24085556,24085556,24214107,0,0,0,128551
24728,24085685,24085685,24215078,0,0,0,129393
24898,24192826,24192826,24215864,0,0,0,23038
24573,23994815,23994815,24219635,0,0,0,224820
24910,24219822,24219822,24219957,0,0,0,135
24915,24221361,24221361,24221454,0,0,0,93
24912,24221310,24221310,24221474,0,0,0,164
24911,24221296,24221296,24221475,0,0,0,179
24916,24221381,24221381,24221475,0,0,0,94
24913,24221323,24221323,24221478,0,0,0,155
24914,24221337,24221337,24221524,0,0,0,187
24897,24192755,24192755,24222033,0,0,0,29278
24917,24221964,24221964,24222154,0,0,0,190
24918,24222084,24222084,24222247,0,0,0,163
24920,24222100,24222100,24222272,0,0,0,172
24921,24222111,24222111,24222272,0,0,0,161
24922,24222129,24222129,24222284,0,0,0,155
24902,24202286,24202286,24222768,0,0,0,20482
24924,24222730,24222730,24222843,0,0,0,113
24925,24222751,24222751,24222909,0,0,0,158
24926,24222768,24222768,24222934,0,0,0,166
24928,24222791,24222791,24222939,0,0,0,148
24927,24222781,24222781,24222940,0,0,0,159
24929,24222816,24222816,24222940,0,0,0,124
24900,24198137,24198137,24224515,0,0,0,26378
24904,24205283,24205283,24225519,0,0,0,20236
24935,24225358,24225358,24225552,0,0,0,194
24901,24199226,24199226,24225758,0,0,0,26532
24931,24224270,24224270,24226136,0,0,0,1866
24899,24196520,24196520,24226648,0,0,0,30128
24837,24156337,24156337,24227103,0,0,0,70766
24940,24226944,24226944,24227266,0,0,0,322
24941,24227021,24227021,24227327,0,0,0,306
24942,24228312,24228312,24228645,0,0,0,333
24907,24208189,24208189,24228793,0,0,0,20604
24944,24228756,24228756,24228882,0,0,0,126
24948,24229092,24229092,24229186,0,0,0,94
24949,24229116,24229116,24229210,0,0,0,94
24947,24229065,24229065,24229239,0,0,0,174
24946,24228839,24228839,24229420,0,0,0,581
24930,24222977,24222977,24229607,0,0,0,6630
24950,24229662,24229662,24229849,0,0,0,187
24903,24204591,24204591,24231292,0,0,0,26701
24906,24207816,24207816,24231520,0,0,0,23704
24954,24232833,24232833,24232896,0,0,0,63
24908,24212316,24212316,24232926,0,0,0,20610
24955,24232846,24232846,24232940,0,0,0,94
24957,24232884,24232896,24232990,0,0,12,106
24958,24232902,24232940,24233045,0,0,38,143
24960,24233431,24233431,24233515,0,0,0,84
24905,24207639,24207639,24234680,0,0,0,27041
24965,24234675,24234675,24234749,0,0,0,74
24978,24236770,24236770,24236899,0,0,0,129
24968,24235663,24235663,24238056,0,0,0,2393
24971,24235933,24235933,24238357,0,0,0,2424
24909,24215804,24215804,24239514,0,0,0,23710
24584,24006244,24006244,24240559,0,0,0,234315
24961,24233472,24233472,24241252,0,0,0,7780
24984,24242763,24242763,24242857,0,0,0,94
24970,24235884,24235884,24242881,0,0,0,6997
24962,24233890,24233890,24242919,0,0,0,9029
24985,24242853,24242853,24242957,0,0,0,104
24986,24243007,24243007,24243097,0,0,0,90
24923,24222686,24222686,24243151,0,0,0,20465
24989,24243121,24243121,24243591,0,0,0,470
24966,24235038,24235038,24243941,0,0,0,8903
24990,24244046,24244046,24244120,0,0,0,74
24732,24088257,24088257,24244635,0,0,0,156378
24936,24225458,24225458,24245887,0,0,0,20429
24987,24243046,24243046,24246427,0,0,0,3381
24991,24246373,24246373,24246447,0,0,0,74
24996,24249061,24249061,24249185,0,0,0,124
24945,24228762,24228762,24249551,0,0,0,20789
24999,24249509,24249509,24249562,0,0,0,53
24565,23990829,23990829,24250029,0,0,0,259200
24566,23990889,23990889,24250089,0,0,0,259200
24933,24224446,24224446,24250888,0,0,0,26442
24919,24222090,24222090,24250993,0,0,0,28903
24977,24236655,24236655,24251570,0,0,0,14915
24994,24246858,24246858,24251842,0,0,0,4984
24937,24225696,24225696,24252218,0,0,0,26522
24956,24232883,24232883,24253667,0,0,0,20784
24953,24231475,24231475,24253838,0,0,0,22363
24995,24247579,24247579,24254506,0,0,0,6927
24952,24231228,24231228,24254622,0,0,0,23394
24983,24242237,24242237,24254963,0,0,0,12726
24938,24226595,24226595,24255689,0,0,0,29094
24997,24249300,24249300,24256587,0,0,0,7287
25000,24249530,24249530,24256743,0,0,0,7213
25013,24259705,24259705,24260082,0,0,0,377
25012,24258304,24258304,24260163,0,0,0,1859
25011,24258299,24258299,24260169,0,0,0,1870
24964,24234635,24234635,24260710,0,0,0,26075
24830,24149029,24149029,24261158,0,0,0,112129
24981,24239451,24239451,24261601,0,0,0,22150
25014,24260123,24260123,24261991,0,0,0,1868
25015,24260128,24260128,24262016,0,0,0,1888
24988,24243064,24243064,24263221,0,0,0,20157
24980,24236989,24236989,24263351,0,0,0,26362
25019,24261950,24261950,24263833,0,0,0,1883
25020,24261959,24261959,24263862,0,0,0,1903
24833,24150720,24150720,24264136,0,0,0,113416
25025,24264714,24264714,24264807,0,0,0,93
25023,24263794,24263794,24265683,0,0,0,1889
25024,24263802,24263802,24265711,0,0,0,1909
24932,24224396,24224396,24266365,0,0,0,41969
24992,24246504,24246504,24266651,0,0,0,20147
25026,24265641,24265641,24267522,0,0,0,1881
25027,24265647,24265647,24267578,0,0,0,1931
25002,24250823,24250823,24269193,0,0,0,18370
25029,24267479,24267479,24269585,0,0,0,2106
25030,24267518,24267518,24269613,0,0,0,2095
24998,24249495,24249495,24270011,0,0,0,20516
24963,24234219,24234219,24270219,0,0,0,36000
24967,24235551,24235551,24271551,0,0,0,36000
24969,24235786,24235786,24271786,0,0,0,36000
24972,24235995,24235995,24271995,0,0,0,36000
24973,24236071,24236071,24272071,0,0,0,36000
24974,24236092,24236092,24272092,0,0,0,36000
24975,24236133,24236133,24272133,0,0,0,36000
24976,24236160,24236160,24272160,0,0,0,36000
25005,24253623,24253623,24274132,0,0,0,20509
25006,24253779,24253779,24276180,0,0,0,22401
25004,24252624,24252624,24278751,0,0,0,26127
24993,24246791,24246791,24279496,0,0,0,32705
25007,24254561,24254561,24280393,0,0,0,25832
25003,24250930,24250930,24280759,0,0,0,29829
25041,24280751,24280751,24280928,0,0,0,177
25042,24280863,24280863,24281035,0,0,0,172
25043,24280979,24280979,24281148,0,0,0,169
25044,24281085,24281085,24281267,0,0,0,182
25022,24263252,24263252,24283452,0,0,0,20200
25008,24255618,24255618,24283497,0,0,0,27879
24736,24088650,24088650,24283815,0,0,0,195165
25018,24261623,24261623,24285311,0,0,0,23688
25028,24266674,24266674,24286986,0,0,0,20312
25017,24260710,24260710,24287375,0,0,0,26665
25034,24271348,24271348,24291960,0,0,0,20612
24806,24142090,24142090,24294527,0,0,0,152437
25036,24274287,24274287,24294838,0,0,0,20551
25031,24269306,24269306,24295377,0,0,0,26071
25021,24262883,24262883,24298883,0,0,0,36000
25037,24276957,24276957,24299664,0,0,0,22707
25047,24283389,24283389,24303994,0,0,0,20605
25032,24269533,24269533,24305533,0,0,0,36000
25033,24269554,24269554,24305554,0,0,0,36000
25040,24279724,24279724,24306372,0,0,0,26648
25050,24286923,24286923,24307540,0,0,0,20617
25049,24285258,24285258,24307617,0,0,0,22359
25045,24281192,24281192,24307763,0,0,0,26571
24878,24168454,24168454,24309056,0,0,0,140602
25067,24308289,24308289,24309429,0,0,0,1140
25010,24256245,24256245,24309652,0,0,0,53407
25075,24310009,24310009,24310108,0,0,0,99
25076,24310020,24310020,24310113,0,0,0,93
25077,24310064,24310064,24310158,0,0,0,94
25061,24308086,24308086,24310338,0,0,0,2252
25079,24310594,24310594,24310749,0,0,0,155
25046,24282455,24282455,24310855,0,0,0,28400
25074,24309371,24309371,24311400,0,0,0,2029
24629,24052310,24052310,24311510,0,0,0,259200
25082,24311573,24311573,24311688,0,0,0,115
25071,24308445,24308445,24312306,0,0,0,3861
25078,24310294,24310294,24312597,0,0,0,2303
25052,24291891,24291891,24312881,0,0,0,20990
25048,24283505,24283505,24313436,0,0,0,29931
25081,24311330,24311330,24313583,0,0,0,2253
25087,24313508,24313508,24313590,0,0,0,82
25080,24310799,24310799,24313830,0,0,0,3031
25051,24287316,24287316,24313872,0,0,0,26556
25084,24312552,24312552,24314510,0,0,0,1958
25088,24313529,24313529,24314557,0,0,0,1028
25053,24294791,24294791,24315782,0,0,0,20991
25094,24314514,24314514,24316492,0,0,0,1978
25083,24312239,24312239,24317422,0,0,0,5183
25098,24317518,24317518,24317586,0,0,0,68
25099,24317633,24317633,24317700,0,0,0,67
25096,24316430,24316430,24318594,0,0,0,2164
25102,24318928,24318928,24319107,0,0,0,179
25104,24318957,24318957,24319138,0,0,0,181
25105,24318973,24318973,24319169,0,0,0,196
25106,24318988,24318988,24319199,0,0,0,211
25107,24319002,24319002,24319220,0,0,0,218
25103,24318942,24318942,24319386,0,0,0,444
25097,24317370,24317370,24319521,0,0,0,2151
25090,24313798,24313798,24319552,0,0,0,5754
25109,24320016,24320016,24320153,0,0,0,137
24934,24224532,24224532,24320403,0,0,0,95871
25101,24318547,24318547,24320799,0,0,0,2252
25054,24295310,24295310,24321679,0,0,0,26369
25110,24320539,24320539,24321726,0,0,0,1187
25108,24319456,24319456,24321733,0,0,0,2277
25112,24321613,24321613,24321790,0,0,0,177
25055,24299607,24299607,24321841,0,0,0,22234
25116,24322423,24322423,24322697,0,0,0,274
25016,24260486,24260486,24322941,0,0,0,62455
25111,24320742,24320742,24323022,0,0,0,2280
25118,24323064,24323064,24323131,0,0,0,67
25100,24317980,24317980,24323176,0,0,0,5196
25119,24323186,24323186,24323280,0,0,0,94
25113,24321689,24321689,24323931,0,0,0,2242
25092,24313914,24313914,24324060,0,0,0,10146
25056,24303924,24303924,24324355,0,0,0,20431
25122,24324312,24324312,24324417,0,0,0,105
25124,24324617,24324617,24324691,0,0,0,74
25117,24322960,24322960,24324879,0,0,0,1919
25126,24324880,24324880,24324974,0,0,0,94
25127,24324999,24324999,24325104,0,0,0,105
25125,24324838,24324838,24326324,0,0,0,1486
25070,24308301,24308301,24326910,0,0,0,18609
25129,24325777,24325777,24326939,0,0,0,1162
25069,24308297,24308297,24327216,0,0,0,18919
25132,24326261,24326261,24327420,0,0,0,1159
25135,24327582,24327582,24327696,0,0,0,114
25137,24327723,24327723,24327817,0,0,0,94
25058,24307480,24307480,24327905,0,0,0,20425
25139,24327864,24327864,24327957,0,0,0,93
25062,24308229,24308229,24328010,0,0,0,19781
25140,24327963,24327963,24328062,0,0,0,99
25066,24308285,24308285,24328307,0,0,0,20022
25133,24326401,24326401,24328347,0,0,0,1946
25143,24328374,24328374,24328479,0,0,0,105
25134,24327376,24327376,24329252,0,0,0,1876
25146,24329023,24329023,24329349,0,0,0,326
25147,24329079,24329079,24329407,0,0,0,328
25148,24329192,24329192,24329516,0,0,0,324
25150,24329254,24329254,24329577,0,0,0,323
25059,24307554,24307554,24329788,0,0,0,22234
25151,24329375,24329375,24329866,0,0,0,491
25142,24328284,24328284,24330159,0,0,0,1875
25156,24330202,24330202,24330296,0,0,0,94
25144,24328479,24328479,24330695,0,0,0,2216
25149,24329204,24329204,24330725,0,0,0,1521
24694,24071577,24071577,24330777,0,0,0,259200
25064,24308277,24308277,24331129,0,0,0,22852
25068,24308293,24308293,24331196,0,0,0,22903
25158,24331290,24331290,24331383,0,0,0,93
25159,24331442,24331442,24331536,0,0,0,94
25153,24330006,24330006,24331671,0,0,0,1665
25065,24308280,24308280,24332189,0,0,0,23909
25162,24332245,24332245,24332339,0,0,0,94
25163,24332348,24332348,24332439,0,0,0,91
25164,24332404,24332404,24332471,0,0,0,67
25154,24330086,24330086,24332609,0,0,0,2523
25167,24332700,24332700,24332773,0,0,0,73
25165,24332526,24332526,24332837,0,0,0,311
25166,24332570,24332570,24332896,0,0,0,326
25057,24306309,24306309,24333099,0,0,0,26790
25063,24308241,24308241,24333237,0,0,0,24996
25170,24333179,24333179,24333505,0,0,0,326
25085,24312826,24312826,24333734,0,0,0,20908
25168,24332903,24332903,24333789,0,0,0,886
25161,24331943,24331943,24333843,0,0,0,1900
25172,24333803,24333803,24334140,0,0,0,337
25060,24307701,24307701,24334466,0,0,0,26765
25175,24334399,24334399,24334572,0,0,0,173
25177,24334622,24334622,24334747,0,0,0,125
24713,24076099,24076099,24335299,0,0,0,259200
25136,24327669,24327669,24335635,0,0,0,7966
24939,24226683,24226683,24335702,0,0,0,109019
25095,24315724,24315724,24336566,0,0,0,20842
25178,24334929,24334929,24336803,0,0,0,1874
25131,24326233,24326233,24336863,0,0,0,10630
25186,24337264,24337264,24337378,0,0,0,114
25183,24336759,24336759,24338410,0,0,0,1651
25185,24337102,24337102,24338440,0,0,0,1338
25184,24336775,24336775,24338446,0,0,0,1671
25155,24330121,24330121,24339696,0,0,0,9575
25192,24340178,24340178,24340242,0,0,0,64
25091,24313825,24313825,24340270,0,0,0,26445
25194,24340343,24340343,24340941,0,0,0,598
25009,24255902,24255902,24341654,0,0,0,85752
24943,24228365,24228365,24341949,0,0,0,113584
25160,24331670,24331670,24343086,0,0,0,11416
25089,24313780,24313780,24343253,0,0,0,29473
25086,24313373,24313373,24343512,0,0,0,30139
25115,24321799,24321799,24343884,0,0,0,22085
25123,24324316,24324316,24344473,0,0,0,20157
25181,24336122,24336122,24347940,0,0,0,11818
25114,24321730,24321730,24347975,0,0,0,26245
25138,24327863,24327863,24348013,0,0,0,20150
24951,24231181,24231181,24349846,0,0,0,118665
25093,24314446,24314446,24350446,0,0,0,36000
25120,24323475,24323475,24351355,0,0,0,27880
24740,24092690,24092690,24351890,0,0,0,259200
25152,24329726,24329726,24352408,0,0,0,22682
25171,24333664,24333664,24354223,0,0,0,20559
25189,24338366,24338366,24354320,0,0,0,15954
25191,24339858,24339858,24354351,0,0,0,14493
25206,24354277,24354277,24356194,0,0,0,1917
25207,24354281,24354281,24357067,0,0,0,2786
25182,24336523,24336523,24357072,0,0,0,20549
25209,24356123,24356123,24357976,0,0,0,1853
25208,24354916,24354916,24358196,0,0,0,3280
25212,24357031,24357031,24358927,0,0,0,1896
25169,24333063,24333063,24359247,0,0,0,26184
25213,24357937,24357937,24359813,0,0,0,1876
25176,24334514,24334514,24360572,0,0,0,26058
25216,24359771,24359771,24363451,0,0,0,3680
24982,24240599,24240599,24363953,0,0,0,123354
25200,24344414,24344414,24364915,0,0,0,20501
25193,24340213,24340213,24366622,0,0,0,26409
25199,24343824,24343824,24366905,0,0,0,23081
25202,24347947,24347947,24368455,0,0,0,20508
25197,24343189,24343189,24371423,0,0,0,28234
25223,24371362,24371362,24371534,0,0,0,172
25224,24371471,24371471,24371642,0,0,0,171
25225,24371579,24371579,24371747,0,0,0,168
25204,24353363,24353363,24372949,0,0,0,19586
25187,24337357,24337357,24373357,0,0,0,36000
25188,24337411,24337411,24373411,0,0,0,36000
25198,24343469,24343469,24373532,0,0,0,30063
25201,24347903,24347903,24373890,0,0,0,25987
25228,24373833,24373833,24374004,0,0,0,171
25190,24338384,24338384,24374384,0,0,0,36000
25203,24352362,24352362,24374690,0,0,0,22328
25205,24354169,24354169,24375036,0,0,0,20867
25211,24356998,24356998,24377834,0,0,0,20836
25145,24328953,24328953,24380918,0,0,0,51965
25219,24364850,24364850,24385339,0,0,0,20489
25215,24359207,24359207,24385925,0,0,0,26718
25217,24360500,24360500,24386713,0,0,0,26213
25236,24388196,24388196,24388290,0,0,0,94
25222,24368396,24368396,24388924,0,0,0,20528
25221,24366852,24366852,24390496,0,0,0,23644
24979,24236882,24236882,24391979,0,0,0,155097
25001,24249804,24249804,24392874,0,0,0,143070
25220,24366551,24366551,24392940,0,0,0,26389
25214,24358866,24358866,24394866,0,0,0,36000
25240,24393896,24393896,24394900,0,0,0,1004
25242,24395689,24395689,24395771,0,0,0,82
25231,24374974,24374974,24395876,0,0,0,20902
25245,24395740,24395771,24395939,0,0,31,199
25243,24395710,24395710,24396404,0,0,0,694
25244,24395715,24395771,24396735,0,0,56,1020
25230,24374622,24374622,24397211,0,0,0,22589
25232,24377775,24377775,24398729,0,0,0,20954
25250,24398549,24398549,24398884,0,0,0,335
25251,24398579,24398579,24398915,0,0,0,336
25218,24363394,24363394,24399394,0,0,0,36000
25226,24371686,24371686,24400002,0,0,0,28316
25253,24399939,24399939,24400136,0,0,0,197
25255,24400105,24400105,24400229,0,0,0,124
25229,24373941,24373941,24400312,0,0,0,26371
25257,24400875,24400875,24400935,0,0,0,60
25259,24401540,24401540,24401579,0,0,0,39
25260,24401969,24401969,24402119,0,0,0,150
25262,24402220,24402220,24402324,0,0,0,104
25173,24333851,24333851,24402442,0,0,0,68591
25174,24333949,24333949,24402467,0,0,0,68518
25258,24401431,24401431,24403125,0,0,0,1694
25227,24373472,24373472,24403246,0,0,0,29774
25233,24385279,24385279,24405676,0,0,0,20397
25263,24402371,24402371,24406329,0,0,0,3958
25274,24407580,24407580,24407674,0,0,0,94
25275,24407594,24407594,24407729,0,0,0,135
25276,24407613,24407729,24407823,0,0,116,210
25237,24388861,24388861,24409240,0,0,0,20379
25073,24308915,24308915,24409797,0,0,0,100882
25235,24386660,24386660,24412396,0,0,0,25736
25283,24412349,24412349,24412526,0,0,0,177
25234,24385863,24385863,24412615,0,0,0,26752
25284,24412466,24412466,24412663,0,0,0,197
25072,24308834,24308834,24413070,0,0,0,104236
25238,24390426,24390426,24413275,0,0,0,22849
25288,24413714,24413714,24413793,0,0,0,79
25289,24413939,24413939,24414006,0,0,0,67
25290,24414099,24414099,24414259,0,0,0,160
24840,24156601,24156601,24415801,0,0,0,259200
24842,24156709,24156709,24415909,0,0,0,259200
25246,24395833,24395833,24416555,0,0,0,20722
25241,24395232,24395232,24416586,0,0,0,21354
24848,24157599,24157599,24416799,0,0,0,259200
24851,24158264,24158264,24417464,0,0,0,259200
24853,24158299,24158299,24417499,0,0,0,259200
24855,24158338,24158338,24417538,0,0,0,259200
24856,24158379,24158379,24417579,0,0,0,259200
25280,24409941,24409941,24418165,0,0,0,8224
24857,24159112,24159112,24418312,0,0,0,259200
24861,24159667,24159667,24418867,0,0,0,259200
24862,24159702,24159702,24418902,0,0,0,259200
25239,24392878,24392878,24419046,0,0,0,26168
24863,24160019,24160019,24419219,0,0,0,259200
25252,24398666,24398666,24419403,0,0,0,20737
25247,24397177,24397177,24420287,0,0,0,23110
25121,24323776,24323776,24425887,0,0,0,102111
25272,24405605,24405605,24426124,0,0,0,20519
25256,24400250,24400250,24426481,0,0,0,26231
25196,24341653,24341653,24426941,0,0,0,85288
25254,24400049,24400049,24428861,0,0,0,28812
25279,24409172,24409172,24429700,0,0,0,20528
25291,24415140,24417464,24430785,0,0,2324,15645
25039,24279170,24279170,24430944,0,0,0,151774
25038,24279079,24279079,24431287,0,0,0,152208
25310,24429105,24429105,24432537,0,0,0,3432
25266,24403209,24403209,24432982,0,0,0,29773
25249,24398410,24398410,24434410,0,0,0,36000
25287,24413220,24413220,24436216,0,0,0,22996
25294,24416494,24416494,24437404,0,0,0,20910
25286,24412582,24412615,24438590,0,0,33,26008
25285,24412537,24412537,24439031,0,0,0,26494
25265,24403198,24403198,24439198,0,0,0,36000
25267,24403211,24403211,24439211,0,0,0,36000
25268,24403609,24403609,24439609,0,0,0,36000
25304,24419340,24419340,24440262,0,0,0,20922
25270,24404364,24404364,24440364,0,0,0,36000
25305,24420227,24420227,24443902,0,0,0,23675
25301,24419011,24419011,24445820,0,0,0,26809
25306,24426066,24426066,24446638,0,0,0,20572
25311,24429638,24429638,24450081,0,0,0,20443
25248,24397367,24397367,24450086,0,0,0,52719
25319,24441409,24441409,24452071,0,0,0,10662
25307,24426413,24426413,24452372,0,0,0,25959
25325,24452316,24452316,24452485,0,0,0,169
25326,24452422,24452422,24452592,0,0,0,170
25327,24452529,24452529,24452696,0,0,0,167
24757,24108787,24108787,24454387,0,0,0,345600
25309,24428777,24428777,24457216,0,0,0,28439
25330,24457174,24457174,24457344,0,0,0,170
25315,24437334,24437334,24458278,0,0,0,20944
25314,24436153,24436153,24459509,0,0,0,23356
25318,24440191,24440191,24461061,0,0,0,20870
25312,24432922,24432922,24462332,0,0,0,29410
25316,24438497,24438497,24465041,0,0,0,26544
25336,24464997,24464997,24465174,0,0,0,177
25337,24465108,24465108,24465276,0,0,0,168
25338,24465221,24465221,24465389,0,0,0,168
25339,24465327,24465327,24465496,0,0,0,169
25317,24438994,24438994,24465816,0,0,0,26822
25321,24443839,24443839,24466610,0,0,0,22771
25323,24446569,24446569,24467197,0,0,0,20628
25324,24450024,24450024,24470595,0,0,0,20571
25322,24445774,24445774,24472298,0,0,0,26524
24843,24156995,24156995,24475167,0,0,0,318172
25328,24452634,24452634,24479089,0,0,0,26455
25332,24458240,24458240,24479189,0,0,0,20949
25313,24435997,24435997,24481833,0,0,0,45836
25334,24461001,24461001,24481979,0,0,0,20978
25333,24459442,24459442,24482407,0,0,0,22965
25335,24462285,24462285,24485087,0,0,0,22802
25331,24457288,24457288,24485251,0,0,0,27963
25343,24467137,24467137,24487712,0,0,0,20575
25342,24466548,24466548,24489517,0,0,0,22969
25345,24470532,24470532,24491131,0,0,0,20599
25340,24465433,24465433,24491768,0,0,0,26335
25356,24491707,24491707,24491867,0,0,0,160
25357,24491815,24491815,24491971,0,0,0,156
25358,24491923,24491923,24492111,0,0,0,188
25341,24465753,24465753,24492146,0,0,0,26393
24959,24233266,24233266,24492466,0,0,0,259200
25035,24273567,24273567,24495908,0,0,0,222341
25346,24472241,24472241,24498552,0,0,0,26311
25195,24340413,24340413,24500086,0,0,0,159673
25348,24479146,24479146,24500166,0,0,0,21020
25141,24328104,24328104,24500904,0,0,0,172800
25264,24402407,24402407,24501102,0,0,0,98695
25349,24481916,24481916,24502922,0,0,0,21006
25273,24405665,24405665,24504999,0,0,0,99334
25347,24479021,24479021,24505656,0,0,0,26635
25350,24482349,24482349,24505859,0,0,0,23510
25180,24336072,24336072,24507203,0,0,0,171131
25351,24485029,24485029,24508066,0,0,0,23037
25353,24487673,24487673,24508261,0,0,0,20588
25278,24408957,24408957,24509072,0,0,0,100115
25355,24491060,24491060,24511614,0,0,0,20554
25281,24410249,24410249,24511863,0,0,0,101614
25277,24408706,24408706,24512577,0,0,0,103871
25354,24489455,24489455,24512824,0,0,0,23369
25282,24410317,24413070,24513867,0,0,2753,103550
25352,24485187,24485187,24514160,0,0,0,28973
25308,24426920,24426920,24515076,0,0,0,88156
25364,24501509,24501509,24515414,0,0,0,13905
25359,24492034,24492034,24517843,0,0,0,25809
25360,24492081,24492081,24518368,0,0,0,26287
25363,24500110,24500110,24521028,0,0,0,20918
25366,24502868,24502868,24523842,0,0,0,20974
25362,24498489,24498489,24525300,0,0,0,26811
25269,24404119,24404119,24525641,0,0,0,121522
25271,24404959,24404959,24527969,0,0,0,123010
25370,24508201,24508201,24528667,0,0,0,20466
25368,24505795,24505795,24528774,0,0,0,22979
25369,24508015,24508015,24530705,0,0,0,22690
25261,24402031,24402031,24530988,0,0,0,128957
25367,24505600,24505600,24531549,0,0,0,25949
25388,24531486,24531486,24531656,0,0,0,170
25389,24531593,24531593,24531764,0,0,0,171
25390,24531701,24531701,24531868,0,0,0,167
25371,24511561,24511561,24532067,0,0,0,20506
25372,24512780,24512780,24535694,0,0,0,22914
25377,24520982,24520982,24541875,0,0,0,20893
25373,24514106,24514106,24543486,0,0,0,29380
25375,24517788,24517788,24543968,0,0,0,26180
25396,24543908,24543908,24544066,0,0,0,158
25378,24523795,24523795,24544693,0,0,0,20898
25376,24518311,24518311,24545391,0,0,0,27080
25380,24528605,24528605,24548753,0,0,0,20148
25379,24525256,24525256,24552059,0,0,0,26803
25392,24532005,24532005,24552216,0,0,0,20211
25381,24528714,24528714,24552246,0,0,0,23532
25391,24531820,24531820,24558005,0,0,0,26185
25404,24557966,24557966,24558143,0,0,0,177
25405,24558076,24558076,24558242,0,0,0,166
25406,24558187,24558187,24558366,0,0,0,179
25393,24535649,24535649,24559127,0,0,0,23478
25386,24530642,24530642,24559478,0,0,0,28836
25407,24558305,24558305,24560085,0,0,0,1780
25394,24541817,24541817,24562366,0,0,0,20549
25398,24544631,24544631,24565175,0,0,0,20544
25400,24548691,24548691,24569267,0,0,0,20576
25397,24544017,24544017,24570252,0,0,0,26235
25414,24570189,24570189,24570359,0,0,0,170
25409,24559437,24559437,24570688,0,0,0,11251
25399,24545319,24545319,24572000,0,0,0,26681
25395,24543414,24543414,24572072,0,0,0,28658
25402,24552162,24552162,24572721,0,0,0,20559
25403,24552184,24552184,24576063,0,0,0,23879
25401,24551994,24551994,24578387,0,0,0,26393
25416,24570631,24570631,24581887,0,0,0,11256
25408,24559063,24559063,24582107,0,0,0,23044
25411,24562319,24562319,24583237,0,0,0,20918
25128,24325209,24325209,24584409,0,0,0,259200
25130,24326000,24326000,24585200,0,0,0,259200
25412,24565112,24565112,24586042,0,0,0,20930
25410,24560015,24560015,24586392,0,0,0,26377
25413,24569207,24569207,24589609,0,0,0,20402
25320,24443818,24450086,24589756,0,0,6268,145938
25157,24330975,24330975,24590175,0,0,0,259200
25344,24470374,24470374,24592044,0,0,0,121670
25419,24572662,24572662,24593112,0,0,0,20450
25179,24335641,24335641,24594841,0,0,0,259200
25415,24570296,24570296,24596313,0,0,0,26017
25374,24515020,24515020,24598336,0,0,0,83316
25417,24571947,24571947,24598595,0,0,0,26648
25420,24576001,24576001,24599661,0,0,0,23660
25418,24572015,24572015,24600626,0,0,0,28611
25433,24600569,24600569,24600721,0,0,0,152
25434,24600678,24600678,24600856,0,0,0,178
25435,24600785,24600785,24600954,0,0,0,169
25436,24600900,24600900,24601072,0,0,0,172
25424,24583174,24583174,24604030,0,0,0,20856
25421,24578330,24578330,24604853,0,0,0,26523
25423,24582048,24582048,24605583,0,0,0,23535
25425,24585985,24585985,24606808,0,0,0,20823
25427,24589569,24589569,24610062,0,0,0,20493
25422,24581844,24581844,24611739,0,0,0,29895
25426,24586336,24586336,24612338,0,0,0,26002
25428,24593043,24593043,24613533,0,0,0,20490
25210,24356756,24356756,24615956,0,0,0,259200
25448,24615855,24615855,24619390,0,0,0,3535
25449,24615912,24615912,24620022,0,0,0,4110
25429,24596250,24596250,24622314,0,0,0,26064
25450,24622271,24622271,24622449,0,0,0,178
25451,24622380,24622380,24622552,0,0,0,172
25452,24622497,24622497,24622665,0,0,0,168
25453,24622602,24622602,24622770,0,0,0,168
25454,24622708,24622708,24622998,0,0,0,290
25432,24599595,24599595,24623460,0,0,0,23865
25447,24615815,24615815,24623990,0,0,0,8175
25438,24603968,24603968,24624869,0,0,0,20901
25431,24598549,24598549,24625185,0,0,0,26636
25446,24615773,24615773,24625779,0,0,0,10006
25384,24530377,24530377,24626530,0,0,0,96153
25383,24530292,24530292,24626631,0,0,0,96339
25385,24530572,24530572,24627022,0,0,0,96450
25441,24606760,24606760,24627624,0,0,0,20864
25440,24605525,24605525,24629359,0,0,0,23834
25437,24601010,24601010,24630086,0,0,0,29076
25461,24630039,24630039,24630217,0,0,0,178
25462,24630151,24630151,24630317,0,0,0,166
25463,24630258,24630258,24630427,0,0,0,169
25442,24609995,24609995,24630499,0,0,0,20504
25464,24630369,24630369,24630537,0,0,0,168
25466,24630475,24630475,24630646,0,0,0,171
25439,24604786,24604786,24631286,0,0,0,26500
25387,24531040,24531040,24632855,0,0,0,101815
25445,24613471,24613471,24633976,0,0,0,20505
25444,24612269,24612269,24638642,0,0,0,26373
25443,24611677,24611677,24639707,0,0,0,28030
25457,24624812,24624812,24645975,0,0,0,21163
25456,24623393,24623393,24646442,0,0,0,23049
25459,24627585,24627585,24648504,0,0,0,20919
25455,24622954,24622954,24648980,0,0,0,26026
25475,24648913,24648913,24649080,0,0,0,167
25465,24630441,24630441,24651115,0,0,0,20674
25458,24625127,24625127,24651624,0,0,0,26497
25460,24629313,24629313,24652979,0,0,0,23666
25469,24633939,24633939,24654589,0,0,0,20650
25482,24657230,24657230,24657297,0,0,0,67
25481,24656890,24656890,24657399,0,0,0,509
25484,24657659,24657659,24657764,0,0,0,105
25468,24631228,24631228,24657903,0,0,0,26675
25485,24657834,24657834,24658092,0,0,0,258
25483,24657473,24657473,24658126,0,0,0,653
25486,24658023,24658023,24658164,0,0,0,141
25487,24658159,24658159,24658295,0,0,0,136
25488,24658382,24658382,24658449,0,0,0,67
25490,24658792,24658792,24658980,0,0,0,188
25491,24658918,24658918,24659012,0,0,0,94
25467,24630584,24630584,24659192,0,0,0,28608
25493,24659129,24659129,24659280,0,0,0,151
25495,24659231,24659231,24659413,0,0,0,182
25494,24659223,24659223,24659622,0,0,0,399
25489,24658468,24658468,24660239,0,0,0,1771
25497,24660133,24660133,24660521,0,0,0,388
25492,24658970,24658970,24661212,0,0,0,2242
25499,24660833,24660833,24661723,0,0,0,890
25500,24661279,24661279,24661911,0,0,0,632
25303,24419129,24419129,24661967,0,0,0,242838
25329,24455064,24455064,24661970,0,0,0,206906
25292,24416113,24416113,24661974,0,0,0,245861
25293,24416155,24416155,24661974,0,0,0,245819
25300,24418572,24418572,24661977,0,0,0,243405
25302,24419097,24419097,24661978,0,0,0,242881
25297,24417683,24418165,24662456,0,0,482,244773
25470,24638588,24638588,24664717,0,0,0,26129
25502,24662880,24662880,24665089,0,0,0,2209
25472,24645913,24645913,24666989,0,0,0,21076
25507,24667964,24667964,24668031,0,0,0,67
25509,24668113,24668113,24668149,0,0,0,36
25471,24639644,24639644,24669350,0,0,0,29706
25474,24648438,24648438,24669479,0,0,0,21041
25473,24646384,24646384,24670438,0,0,0,24054
25503,24663274,24663274,24670598,0,0,0,7324
25504,24663390,24663390,24670598,0,0,0,7208
25515,24671119,24671119,24671507,0,0,0,388
25477,24651054,24651054,24671658,0,0,0,20604
25518,24671800,24671800,24672276,0,0,0,476
25519,24672242,24672242,24672601,0,0,0,359
25513,24670120,24670120,24672641,0,0,0,2521
25521,24672553,24672553,24672672,0,0,0,119
25520,24672421,24672421,24672869,0,0,0,448
25476,24649025,24649025,24675060,0,0,0,26035
25480,24654528,24654528,24675158,0,0,0,20630
25527,24675013,24675013,24675185,0,0,0,172
25479,24652921,24652921,24676782,0,0,0,23861
25295,24417600,24417600,24676800,0,0,0,259200
25296,24417644,24417644,24676844,0,0,0,259200
25532,24676898,24676898,24677035,0,0,0,137
25530,24676056,24676056,24677143,0,0,0,1087
25298,24417733,24418165,24677365,0,0,432,259632
25299,24417773,24418165,24677365,0,0,392,259592
25478,24651553,24651553,24677817,0,0,0,26264
25535,24677949,24677949,24678009,0,0,0,60
25536,24677982,24677982,24678129,0,0,0,147
25544,24678773,24678773,24678858,0,0,0,85
25547,24679036,24679036,24679813,0,0,0,777
25542,24678236,24678236,24679844,0,0,0,1608
25549,24679969,24679969,24680031,0,0,0,62
25548,24679911,24679911,24680544,0,0,0,633
25539,24678082,24678082,24681544,0,0,0,3462
25534,24677898,24677898,24681664,0,0,0,3766
25553,24681624,24681624,24681810,0,0,0,186
25517,24671747,24671747,24682157,0,0,0,10410
25430,24598274,24598274,24682729,0,0,0,84455
25525,24672904,24672904,24684646,0,0,0,11742
25498,24660428,24660428,24687249,0,0,0,26821
25506,24666924,24666924,24687954,0,0,0,21030
25496,24659346,24659346,24688511,0,0,0,29165
25382,24529353,24529353,24689057,0,0,0,159704
25559,24689345,24689345,24689501,0,0,0,156
25512,24669413,24669413,24690426,0,0,0,21013
25501,24662636,24662636,24690463,0,0,0,27827
25554,24682236,24682236,24691024,0,0,0,8788
25516,24671595,24671595,24692080,0,0,0,20485
25514,24670376,24670376,24694000,0,0,0,23624
25562,24692661,24692661,24694718,0,0,0,2057
25528,24675084,24675084,24695495,0,0,0,20411
25511,24669287,24669287,24697337,0,0,0,28050
25567,24697290,24697290,24697467,0,0,0,177
25565,24696647,24696647,24697745,0,0,0,1098
25508,24668043,24668043,24698172,0,0,0,30129
25569,24698140,24698140,24698265,0,0,0,125
25566,24697262,24697262,24698484,0,0,0,1222
25531,24676720,24676720,24699809,0,0,0,23089
25523,24672609,24672609,24700212,0,0,0,27603
25573,24698695,24698695,24700484,0,0,0,1789
25545,24678828,24678828,24700822,0,0,0,21994
25529,24675127,24675127,24701521,0,0,0,26394
25365,24502139,24502139,24701570,0,0,0,199431
25576,24701567,24701567,24701598,0,0,0,31
25575,24701458,24701458,24701639,0,0,0,181
25533,24677733,24677733,24701661,0,0,0,23928
25568,24697404,24697404,24701665,0,0,0,4261
25556,24687194,24687194,24701670,0,0,0,14476
25558,24688456,24688456,24701670,0,0,0,13214
25522,24672587,24672587,24701941,0,0,0,29354
25537,24678063,24678063,24701948,0,0,0,23885
25526,24674521,24674521,24701981,0,0,0,27460
25551,24681487,24681487,24701981,0,0,0,20494
25552,24681611,24681611,24701981,0,0,0,20370
25541,24678124,24678124,24702038,0,0,0,23914
25555,24685660,24685660,24702095,0,0,0,16435
25505,24664649,24664649,24707849,0,0,0,43200
25557,24687894,24687894,24708668,0,0,0,20774
25584,24705346,24705346,24708946,0,0,0,3600
25581,24702389,24702389,24709531,0,0,0,7142
25560,24690390,24690390,24711193,0,0,0,20803
25561,24692012,24692012,24712560,0,0,0,20548
25564,24695423,24695423,24715989,0,0,0,20566
25563,24693934,24693934,24717800,0,0,0,23866
25574,24699739,24699739,24723762,0,0,0,24023
25585,24708620,24708620,24729636,0,0,0,21016
25586,24711124,24711124,24732080,0,0,0,20956
25587,24712505,24712505,24733001,0,0,0,20496
25588,24715936,24715936,24736435,0,0,0,20499
25595,24736495,24736495,24736555,0,0,0,60
25524,24672681,24672681,24737409,0,0,0,64728
25570,24698328,24698328,24738406,0,0,0,40078
25596,24738350,24738350,24738465,0,0,0,115
25597,24738482,24738482,24738576,0,0,0,94
25598,24739407,24739407,24739466,0,0,0,59
25361,24495971,24495971,24740483,0,0,0,244512
25589,24717746,24717746,24741592,0,0,0,23846
25599,24739457,24739457,24742438,0,0,0,2981
25578,24702207,24702207,24743586,0,0,0,41379
25603,24743516,24743516,24743786,0,0,0,270
25601,24743434,24743434,24743856,0,0,0,422
25606,24744304,24744304,24744397,0,0,0,93
25607,24744500,24744500,24744567,0,0,0,67
25602,24743462,24743462,24744699,0,0,0,1237
25604,24743523,24743523,24746600,0,0,0,3077
25611,24747328,24747328,24747388,0,0,0,60
25590,24723707,24723707,24747466,0,0,0,23759
25613,24747709,24747709,24747844,0,0,0,135
25608,24745257,24745257,24748651,0,0,0,3394
25605,24743743,24743743,24749096,0,0,0,5353
25620,24749303,24749303,24749551,0,0,0,248
25629,24749905,24749905,24750154,0,0,0,249
25591,24729596,24729596,24750617,0,0,0,21021
25577,24702176,24702176,24750618,0,0,0,48442
25630,24750560,24750560,24750664,0,0,0,104
25632,24750565,24750565,24750700,0,0,0,135
25614,24747928,24747928,24751528,0,0,0,3600
25592,24732028,24732028,24753073,0,0,0,21045
25593,24732958,24732958,24753425,0,0,0,20467
25641,24756020,24756020,24756198,0,0,0,178
25644,24756130,24756130,24756253,0,0,0,123
25645,24756144,24756144,24756309,0,0,0,165
25646,24756167,24756167,24756344,0,0,0,177
25647,24756257,24756257,24756426,0,0,0,169
25594,24736372,24736372,24756900,0,0,0,20528
25579,24702356,24702356,24758886,0,0,0,56530
25580,24702372,24702372,24758959,0,0,0,56587
25583,24702402,24702402,24758980,0,0,0,56578
25582,24702396,24702396,24758985,0,0,0,56589
25628,24749859,24749859,24758989,0,0,0,9130
25634,24750585,24750585,24759466,0,0,0,8881
25660,24760178,24760178,24760349,0,0,0,171
25658,24759523,24759523,24760689,0,0,0,1166
25656,24759075,24759075,24761515,0,0,0,2440
25657,24759439,24759439,24761626,0,0,0,2187
25654,24758911,24758911,24761668,0,0,0,2757
25655,24758927,24758927,24761728,0,0,0,2801
25676,24761727,24761727,24761821,0,0,0,94
25671,24761367,24761367,24761890,0,0,0,523
25662,24760882,24760882,24762382,0,0,0,1500
25664,24760967,24760967,24762467,0,0,0,1500
25665,24761025,24761025,24762525,0,0,0,1500
25666,24761112,24761112,24762612,0,0,0,1500
25668,24761182,24761182,24762682,0,0,0,1500
25673,24761563,24761563,24764657,0,0,0,3094
25661,24760255,24760255,24764701,0,0,0,4446
25672,24761454,24761454,24764714,0,0,0,3260
25652,24758836,24758836,24764730,0,0,0,5894
25653,24758886,24758886,24764744,0,0,0,5858
25675,24761684,24761684,24764763,0,0,0,3079
25674,24761630,24761630,24764769,0,0,0,3139
25692,24764866,24764866,24764996,0,0,0,130
25691,24764845,24764845,24765036,0,0,0,191
25693,24765008,24765008,24765176,0,0,0,168
25694,24765417,24765417,24765576,0,0,0,159
25600,24741524,24741524,24765685,0,0,0,24161
25697,24765760,24765760,24765915,0,0,0,155
25615,24748174,24748174,24766174,0,0,0,18000
25616,24748271,24748271,24766271,0,0,0,18000
25700,24766099,24766099,24766273,0,0,0,174
25617,24748313,24748313,24766313,0,0,0,18000
25618,24748341,24748341,24766341,0,0,0,18000
25705,24766788,24766788,24766881,0,0,0,93
25677,24761859,24761859,24766957,0,0,0,5098
25659,24759675,24759675,24767542,0,0,0,7867
25633,24750569,24750569,24767908,0,0,0,17339
25684,24764667,24764667,24768267,0,0,0,3600
25635,24750640,24750640,24768347,0,0,0,17707
25670,24761300,24761300,24769189,0,0,0,7889
25612,24747412,24747412,24771407,0,0,0,23995
25631,24750563,24750563,24771485,0,0,0,20922
25707,24770799,24770799,24773306,0,0,0,2507
25637,24753011,24753011,24773827,0,0,0,20816
25638,24753363,24753363,24773900,0,0,0,20537
25714,24775373,24775373,24775466,0,0,0,93
25711,24773366,24773366,24776966,0,0,0,3600
25651,24756837,24756837,24777091,0,0,0,20254
25706,24768325,24768325,24777174,0,0,0,8849
25636,24750764,24750764,24777866,0,0,0,27102
25669,24761197,24761197,24779197,0,0,0,18000
25648,24756276,24756276,24782834,0,0,0,26558
25716,24782778,24782778,24782951,0,0,0,173
25717,24782888,24782888,24783056,0,0,0,168
25718,24782994,24782994,24783163,0,0,0,169
25643,24756125,24756125,24783296,0,0,0,27171
25642,24756095,24756095,24783433,0,0,0,27338
25650,24756367,24756367,24783474,0,0,0,27107
25722,24783394,24783394,24783571,0,0,0,177
25723,24783507,24783507,24783673,0,0,0,166
25640,24755934,24755934,24784722,0,0,0,28788
25619,24748841,24748841,24784841,0,0,0,36000
25621,24749600,24749600,24785600,0,0,0,36000
25622,24749635,24749635,24785635,0,0,0,36000
25623,24749651,24749651,24785651,0,0,0,36000
25649,24756350,24756350,24785769,0,0,0,29419
25727,24785757,24785757,24786023,0,0,0,266
25728,24786381,24786381,24786463,0,0,0,82
25729,24786431,24786431,24786525,0,0,0,94
25730,24786807,24786807,24786962,0,0,0,155
25732,24787309,24787309,24787402,0,0,0,93
25733,24787835,24787835,24787908,0,0,0,73
25571,24698486,24698486,24789238,0,0,0,90752
25696,24765629,24765629,24789591,0,0,0,23962
25734,24788264,24788264,24790149,0,0,0,1885
25736,24790387,24790387,24790480,0,0,0,93
25709,24771446,24771446,24792071,0,0,0,20625
25737,24790541,24790541,24792901,0,0,0,2360
25713,24773853,24773853,24794375,0,0,0,20522
25712,24773763,24773763,24794378,0,0,0,20615
25609,24746201,24746201,24794966,0,0,0,48765
25708,24771354,24771354,24795237,0,0,0,23883
25731,24787131,24787131,24796124,0,0,0,8993
25715,24777028,24777028,24797524,0,0,0,20496
25572,24698628,24698628,24799122,0,0,0,100494
25510,24668147,24668147,24800879,0,0,0,132732
25724,24783617,24783617,24809635,0,0,0,26018
25719,24783101,24783101,24809698,0,0,0,26597
25720,24783235,24783235,24809728,0,0,0,26493
25721,24783387,24783387,24810015,0,0,0,26628
25738,24792010,24792010,24812906,0,0,0,20896
25725,24784659,24784659,24813196,0,0,0,28537
25735,24789591,24789591,24813281,0,0,0,23690
25748,24813128,24813128,24813305,0,0,0,177
25750,24813247,24813247,24813418,0,0,0,171
25739,24794302,24794302,24814635,0,0,0,20333
25726,24785706,24785706,24814895,0,0,0,29189
25740,24794337,24794337,24815188,0,0,0,20851
25742,24797489,24797489,24817848,0,0,0,20359
25741,24795174,24795174,24819196,0,0,0,24022
25757,24823591,24823591,24823695,0,0,0,104
25759,24825143,24825143,24825396,0,0,0,253
25758,24823697,24823697,24825785,0,0,0,2088
25683,24764650,24764650,24826532,0,0,0,61882
25685,24764671,24764671,24826618,0,0,0,61947
25686,24764682,24764682,24826629,0,0,0,61947
25687,24764692,24764692,24826685,0,0,0,61993
25688,24764720,24764720,24826704,0,0,0,61984
25689,24764731,24764731,24826715,0,0,0,61984
25690,24764744,24764744,24826759,0,0,0,62015
25769,24827245,24827245,24827556,0,0,0,311
25770,24827587,24827587,24828285,0,0,0,698
25772,24828175,24828175,24828618,0,0,0,443
25773,24828328,24828328,24828866,0,0,0,538
25775,24828427,24828427,24829019,0,0,0,592
25776,24828491,24828491,24829154,0,0,0,663
25787,24832305,24832305,24832398,0,0,0,93
25747,24812842,24812842,24833616,0,0,0,20774
25752,24814579,24814579,24835120,0,0,0,20541
25743,24809575,24809575,24835563,0,0,0,25988
25754,24815143,24815143,24835892,0,0,0,20749
25744,24809646,24809646,24836214,0,0,0,26568
25746,24809954,24809954,24836315,0,0,0,26361
25794,24836172,24836172,24836345,0,0,0,173
25745,24809666,24809666,24836421,0,0,0,26755
25749,24813230,24813230,24836923,0,0,0,23693
25755,24817789,24817789,24838286,0,0,0,20497
25765,24826677,24826677,24838629,0,0,0,11952
25767,24826736,24826736,24838629,0,0,0,11893
25768,24826759,24826759,24838660,0,0,0,11901
25786,24831470,24831470,24838781,0,0,0,7311
25785,24831059,24831059,24838784,0,0,0,7725
25760,24825239,24825239,24840797,0,0,0,15558
25751,24813358,24813358,24841759,0,0,0,28401
25810,24842736,24842736,24842766,0,0,0,30
25756,24819129,24819129,24843043,0,0,0,23914
25811,24842962,24842962,24843110,0,0,0,148
25807,24840566,24840566,24844456,0,0,0,3890
25753,24814833,24814833,24844607,0,0,0,29774
25816,24844538,24844538,24844612,0,0,0,74
25819,24844626,24844626,24844712,0,0,0,86
25804,24838565,24838565,24846168,0,0,0,7603
25774,24828405,24828405,24846405,0,0,0,18000
25771,24827943,24827943,24846681,0,0,0,18738
25610,24746599,24746599,24847037,0,0,0,100438
25830,24848150,24848150,24848495,0,0,0,345
25832,24848812,24848812,24848886,0,0,0,74
25806,24838587,24838587,24848940,0,0,0,10353
25805,24838579,24838579,24848943,0,0,0,10364
25824,24846106,24846106,24848952,0,0,0,2846
25835,24849035,24849035,24849128,0,0,0,93
25836,24849271,24849271,24849365,0,0,0,94
25837,24849392,24849392,24849702,0,0,0,310
25838,24849674,24849674,24849830,0,0,0,156
25788,24832421,24832421,24850421,0,0,0,18000
25831,24848298,24848298,24850919,0,0,0,2621
25840,24851049,24851049,24851122,0,0,0,73
25827,24846566,24846566,24851550,0,0,0,4984
25839,24850168,24850168,24851640,0,0,0,1472
25841,24851239,24851239,24851870,0,0,0,631
25550,24681257,24681257,24852010,0,0,0,170753
25842,24851884,24851884,24852368,0,0,0,484
25846,24852336,24852336,24852398,0,0,0,62
25843,24851896,24851896,24852399,0,0,0,503
25833,24848827,24848827,24852427,0,0,0,3600
25845,24851918,24851918,24852428,0,0,0,510
25844,24851906,24851906,24852493,0,0,0,587
25789,24833556,24833556,24854466,0,0,0,20910
25790,24835057,24835057,24855511,0,0,0,20454
25828,24847010,24847010,24855665,0,0,0,8655
25859,24855477,24855477,24855942,0,0,0,465
25829,24847045,24847045,24856420,0,0,0,9375
25834,24849025,24849025,24856428,0,0,0,7403
25793,24835825,24835825,24856719,0,0,0,20894
25853,24853134,24853134,24856722,0,0,0,3588
25854,24853564,24853564,24856759,0,0,0,3195
25866,24857456,24857456,24857777,0,0,0,321
25803,24838223,24838223,24858605,0,0,0,20382
25766,24826709,24826709,24858793,0,0,0,32084
25814,24843267,24843267,24858795,0,0,0,15528
25817,24844541,24844541,24858795,0,0,0,14254
25849,24852529,24852529,24858795,0,0,0,6266
25860,24856678,24856678,24858795,0,0,0,2117
25879,24858764,24858764,24858795,0,0,0,31
25862,24856679,24856679,24858796,0,0,0,2117
25864,24856690,24856690,24858796,0,0,0,2106
25825,24846490,24846490,24858797,0,0,0,12307
25857,24855431,24855431,24858797,0,0,0,3366
25781,24829076,24829076,24858798,0,0,0,29722
25871,24858018,24858018,24858798,0,0,0,780
25851,24852576,24852576,24858800,0,0,0,6224
25808,24841695,24841695,24858801,0,0,0,17106
25847,24852513,24852513,24858801,0,0,0,6288
25867,24857720,24857720,24858801,0,0,0,1081
25873,24858032,24858032,24858801,0,0,0,769
25877,24858563,24858563,24858802,0,0,0,239
25777,24829021,24829021,24858803,0,0,0,29782
25791,24835502,24835502,24858803,0,0,0,23301
25799,24836379,24836379,24858803,0,0,0,22424
25820,24844680,24844680,24858803,0,0,0,14123
25822,24845439,24845439,24858803,0,0,0,13364
25869,24857930,24857930,24858803,0,0,0,873
25875,24858067,24858067,24858803,0,0,0,736
25779,24829050,24829050,24858804,0,0,0,29754
25783,24829546,24829546,24858804,0,0,0,29258
25795,24836232,24836232,24858804,0,0,0,22572
25797,24836286,24836286,24858804,0,0,0,22518
25801,24836870,24836870,24858804,0,0,0,21934
25812,24842985,24842985,24858804,0,0,0,15819
25855,24854404,24854404,24858804,0,0,0,4400
25762,24826520,24826520,24858871,0,0,0,32351
25763,24826596,24826596,24858912,0,0,0,32316
25764,24826621,24826621,24858913,0,0,0,32292
25861,24856678,24856678,24859027,0,0,0,2349
25874,24858032,24858032,24859033,0,0,0,1001
25865,24856690,24856690,24859121,0,0,0,2431
25885,24860118,24860118,24860258,0,0,0,140
25667,24761120,24761120,24860987,0,0,0,99867
25802,24836870,24836870,24861074,0,0,0,24204
25815,24843267,24843267,24861267,0,0,0,18000
25868,24857720,24857720,24861610,0,0,0,3890
25792,24835502,24835502,24861749,0,0,0,26247
25887,24861687,24861687,24861977,0,0,0,290
25888,24861906,24861906,24862165,0,0,0,259
25798,24836286,24836286,24862285,0,0,0,25999
25821,24844680,24844680,24862680,0,0,0,18000
25796,24836232,24836232,24862747,0,0,0,26515
25800,24836379,24836379,24862831,0,0,0,26452
25823,24845439,24845439,24863439,0,0,0,18000
25826,24846490,24846490,24864490,0,0,0,18000
25893,24864633,24864633,24864727,0,0,0,94
25678,24762761,24762761,24864872,0,0,0,102111
25663,24760917,24760917,24864935,0,0,0,104018
25894,24864942,24864942,24865006,0,0,0,64
25813,24842985,24842985,24866686,0,0,0,23701
25809,24841695,24841695,24869510,0,0,0,27815
25901,24872065,24872065,24872125,0,0,0,60
25899,24871366,24871366,24872655,0,0,0,1289
25626,24749707,24749707,24873399,0,0,0,123692
25818,24844541,24844541,24873879,0,0,0,29338
25856,24854404,24854404,24875213,0,0,0,20809
25900,24871851,24871851,24875265,0,0,0,3414
25858,24855431,24855431,24875530,0,0,0,20099
25680,24763048,24763048,24876897,0,0,0,113849
25863,24856679,24856679,24877473,0,0,0,20794
25679,24762994,24762994,24877910,0,0,0,114916
25872,24858018,24858018,24878436,0,0,0,20418
25878,24858563,24858563,24878676,0,0,0,20113
25540,24678090,24678090,24882560,0,0,0,204470
25886,24861012,24861012,24884743,0,0,0,23731
25681,24763107,24763107,24884949,0,0,0,121842
25852,24852576,24852576,24887365,0,0,0,34789
25889,24862131,24862131,24888040,0,0,0,25909
25890,24862223,24862223,24888176,0,0,0,25953
25909,24888133,24888133,24888310,0,0,0,177
25682,24763174,24763174,24888439,0,0,0,125265
25908,24887994,24887994,24888689,0,0,0,695
25911,24888648,24888648,24889321,0,0,0,673
25891,24862680,24862680,24889410,0,0,0,26730
25892,24862772,24862772,24889511,0,0,0,26739
25639,24755502,24755502,24889790,0,0,0,134288
25912,24889283,24889283,24889987,0,0,0,704
25897,24866624,24866624,24890371,0,0,0,23747
25848,24852513,24852513,24892580,0,0,0,40067
25850,24852529,24852529,24893329,0,0,0,40800
25624,24749668,24749668,24893668,0,0,0,144000
25625,24749687,24749687,24893687,0,0,0,144000
25627,24749721,24749721,24893721,0,0,0,144000
25903,24875150,24875150,24895644,0,0,0,20494
25904,24875474,24875474,24896026,0,0,0,20552
25702,24766180,24766180,24897280,0,0,0,131100
25896,24865050,24865050,24897556,0,0,0,32506
25905,24877409,24877409,24897942,0,0,0,20533
25898,24869450,24869450,24898667,0,0,0,29217
25920,24898590,24898590,24898770,0,0,0,180
25701,24766102,24766102,24899171,0,0,0,133069
25906,24878615,24878615,24899184,0,0,0,20569
25902,24873825,24873825,24903535,0,0,0,29710
25870,24857930,24857930,24905127,0,0,0,47197
25907,24884678,24884678,24908376,0,0,0,23698
25704,24766241,24766241,24908987,0,0,0,142746
25703,24766210,24766210,24909693,0,0,0,143483
25925,24910026,24910026,24910093,0,0,0,67
25926,24910130,24910130,24910378,0,0,0,248
25927,24910421,24910421,24910494,0,0,0,73
25928,24910459,24910459,24910552,0,0,0,93
25695,24765481,24765481,24911525,0,0,0,146044
25931,24911583,24911583,24911656,0,0,0,73
25930,24911330,24911330,24911899,0,0,0,569
25932,24911960,24911960,24912054,0,0,0,94
25929,24910620,24910620,24912237,0,0,0,1617
25933,24912328,24912328,24912401,0,0,0,73
25934,24912696,24912696,24912770,0,0,0,74
25937,24913279,24913279,24913346,0,0,0,67
25916,24890300,24890300,24914488,0,0,0,24188
25910,24888244,24888244,24914491,0,0,0,26247
25943,24914449,24914449,24914812,0,0,0,363
25913,24889349,24889349,24915942,0,0,0,26593
25914,24889457,24889457,24916046,0,0,0,26589
25918,24895964,24895964,24916122,0,0,0,20158
25915,24889921,24889921,24916503,0,0,0,26582
25917,24895581,24895581,24916508,0,0,0,20927
25950,24916472,24916472,24916604,0,0,0,132
25948,24916421,24916421,24916608,0,0,0,187
25952,24916551,24916551,24916673,0,0,0,122
25951,24916524,24916524,24916677,0,0,0,153
25955,24916677,24916677,24916781,0,0,0,104
25883,24858870,24858870,24916897,0,0,0,58027
25882,24858854,24858854,24916923,0,0,0,58069
25881,24858828,24858828,24916929,0,0,0,58101
25880,24858764,24858764,24916951,0,0,0,58187
25963,24917304,24917304,24917398,0,0,0,94
25940,24914151,24914151,24917581,0,0,0,3430
25876,24858067,24858067,24917855,0,0,0,59788
25884,24859018,24859018,24917929,0,0,0,58911
25966,24918657,24918657,24918905,0,0,0,248
25919,24897889,24897889,24919050,0,0,0,21161
25922,24899122,24899122,24919322,0,0,0,20200
25970,24919347,24919347,24919440,0,0,0,93
25972,24921316,24921316,24921415,0,0,0,99
25973,24921496,24921496,24921589,0,0,0,93
25969,24919290,24919290,24921661,0,0,0,2371
25974,24921659,24921659,24921775,0,0,0,116
25975,24921747,24921747,24921841,0,0,0,94
25976,24921925,24921925,24922018,0,0,0,93
25977,24923079,24923079,24923160,0,0,0,81
25978,24923128,24923128,24923190,0,0,0,62
25979,24923637,24923637,24923700,0,0,0,63
25980,24923751,24923751,24923855,0,0,0,104
25981,24923855,24923855,24923948,0,0,0,93
25985,24927179,24927179,24927290,0,0,0,111
25987,24927296,24927296,24927391,0,0,0,95
25989,24927390,24927390,24927461,0,0,0,71
25698,24766040,24766040,24927463,0,0,0,161423
25990,24927416,24927416,24928406,0,0,0,990
25921,24898699,24898699,24928476,0,0,0,29777
25992,24928443,24928443,24928589,0,0,0,146
25964,24917794,24917794,24928705,0,0,0,10911
25993,24928548,24928548,24928736,0,0,0,188
25965,24917863,24917863,24928774,0,0,0,10911
25959,24916888,24916888,24929100,0,0,0,12212
25956,24916864,24916864,24929214,0,0,0,12350
25958,24916880,24916880,24929260,0,0,0,12380
25957,24916870,24916870,24929261,0,0,0,12391
25991,24927544,24927544,24930621,0,0,0,3077
25935,24912729,24912729,24930729,0,0,0,18000
25936,24913153,24913153,24931153,0,0,0,18000
25924,24908317,24908317,24932121,0,0,0,23804
25923,24903473,24903473,24932247,0,0,0,28774
25941,24914375,24914375,24932375,0,0,0,18000
25939,24913672,24913672,24932515,0,0,0,18843
25971,24919501,24919501,24932519,0,0,0,13018
25994,24928653,24928653,24934372,0,0,0,5719
25996,24928709,24928709,24934386,0,0,0,5677
25953,24916570,24916570,24934570,0,0,0,18000
25761,24825754,24825754,24935318,0,0,0,109564
25947,24916061,24916061,24935959,0,0,0,19898
25949,24916465,24916465,24936928,0,0,0,20463
25538,24678080,24678080,24937280,0,0,0,259200
25543,24678312,24678312,24937512,0,0,0,259200
25942,24914423,24914423,24938112,0,0,0,23689
25546,24678962,24678962,24938162,0,0,0,259200
25968,24919277,24919277,24939118,0,0,0,19841
25967,24918989,24918989,24939444,0,0,0,20455
25944,24914774,24914774,24941214,0,0,0,26440
25945,24915879,24915879,24942250,0,0,0,26371
25946,24916000,24916000,24942798,0,0,0,26798
25954,24916632,24916632,24942900,0,0,0,26268
25938,24913522,24913522,24946117,0,0,0,32595
25998,24929104,24929104,24947104,0,0,0,18000
25960,24917011,24917011,24947593,0,0,0,30582
25961,24917103,24917103,24947669,0,0,0,30566
25962,24917162,24917162,24947671,0,0,0,30509
25982,24926667,24926667,24948009,0,0,0,21342
25895,24864976,24864976,24948011,0,0,0,83035
25986,24927269,24927269,24948011,0,0,0,20742
25699,24766073,24766073,24948012,0,0,0,181939
25983,24927029,24927029,24948012,0,0,0,20983
25984,24927178,24927178,24948012,0,0,0,20834
25988,24927364,24927364,24948012,0,0,0,20648
25995,24928666,24928666,24957065,0,0,0,28399
25784,24829546,24829546,24959445,0,0,0,129899
25778,24829021,24829021,24965980,0,0,0,136959
25782,24829076,24829076,24966486,0,0,0,137410
25780,24829050,24829050,24969794,0,0,0,140744
25710,24772998,24772998,24997470,0,0,0,224472
26000,24929208,24929208,25003575,0,0,0,74367
25999,24929147,24929147,25003576,0,0,0,74429
25997,24929067,24929067,25003580,0,0,0,74513
