id,Arrival,Start,Completion,No_of_expansion,No_of_shrinkage,Wait_time,Turn_around_time
10001,3565775,3565775,3565821,0,0,0,46
10002,3566023,3566023,3566069,0,0,0,46
10003,3566371,3566371,3566421,0,0,0,50
10004,3566603,3566603,3566648,0,0,0,45
10008,3567070,3567070,3567099,0,0,0,29
10007,3567069,3567069,3567127,0,0,0,58
10009,3567084,3567084,3567162,0,0,0,78
10010,3567290,3567290,3567336,0,0,0,46
10011,3567511,3567511,3567557,0,0,0,46
10012,3567829,3567829,3567876,0,0,0,47
10014,3568491,3568491,3568570,0,0,0,79
10017,3568764,3568764,3568817,0,0,0,53
10016,3568708,3568708,3568834,0,0,0,126
10015,3568502,3568502,3568888,0,0,0,386
10019,3568975,3568975,3569022,0,0,0,47
10022,3569143,3569143,3569220,0,0,0,77
10020,3569051,3569051,3569268,0,0,0,217
10021,3569101,3569101,3569579,0,0,0,478
10018,3568955,3568955,3569950,0,0,0,995
10027,3569926,3569926,3569961,0,0,0,35
10024,3569539,3569539,3570037,0,0,0,498
10029,3570138,3570138,3570170,0,0,0,32
10032,3570256,3570256,3570289,0,0,0,33
10030,3570159,3570159,3570387,0,0,0,228
10033,3570454,3570454,3570499,0,0,0,45
10034,3570595,3570595,3570643,0,0,0,48
10035,3570671,3570671,3570701,0,0,0,30
10006,3567043,3567043,3570821,0,0,0,3778
10013,3567904,3567904,3570821,0,0,0,2917
10039,3570938,3570938,3570976,0,0,0,38
10040,3571016,3571016,3571054,0,0,0,38
10038,3570857,3570857,3571079,0,0,0,222
10036,3570717,3570717,3571155,0,0,0,438
10041,3571163,3571163,3571197,0,0,0,34
10031,3570236,3570236,3571457,0,0,0,1221
10042,3571431,3571431,3571481,0,0,0,50
10043,3571443,3571443,3571642,0,0,0,199
10046,3571608,3571608,3571659,0,0,0,51
10044,3571498,3571498,3571667,0,0,0,169
10050,3572109,3572109,3572152,0,0,0,43
10045,3571598,3571598,3572211,0,0,0,613
10051,3572184,3572184,3572228,0,0,0,44
10047,3571841,3571841,3572457,0,0,0,616
10053,3572604,3572604,3572694,0,0,0,90
10054,3572705,3572705,3572743,0,0,0,38
10052,3572512,3572512,3572968,0,0,0,456
10023,3569528,3569528,3573183,0,0,0,3655
10059,3573213,3573213,3573256,0,0,0,43
10058,3573206,3573206,3573287,0,0,0,81
10049,3571940,3571940,3573479,0,0,0,1539
10056,3573166,3573166,3573602,0,0,0,436
10057,3573191,3573191,3573759,0,0,0,568
10061,3573632,3573632,3573800,0,0,0,168
10062,3573808,3573808,3573846,0,0,0,38
10055,3572996,3572996,3574311,0,0,0,1315
10064,3574391,3574391,3574444,0,0,0,53
10048,3571903,3571903,3574483,0,0,0,2580
10063,3574167,3574167,3574532,0,0,0,365
10068,3574578,3574578,3574609,0,0,0,31
10071,3574886,3574886,3574964,0,0,0,78
10005,3566852,3566852,3575024,0,0,0,8172
10072,3575076,3575076,3575112,0,0,0,36
10070,3574657,3574657,3575148,0,0,0,491
10074,3575216,3575216,3575269,0,0,0,53
10066,3574507,3574507,3575440,0,0,0,933
10076,3575428,3575428,3575508,0,0,0,80
10065,3574452,3574452,3575683,0,0,0,1231
10078,3575667,3575667,3575708,0,0,0,41
10075,3575341,3575341,3575733,0,0,0,392
10028,3570115,3570115,3575812,0,0,0,5697
10079,3575775,3575812,3575828,0,0,37,53
10026,3569709,3569709,3575962,0,0,0,6253
10083,3575909,3575909,3575963,0,0,0,54
10080,3575821,3575828,3576045,0,0,7,224
10077,3575505,3575505,3576095,0,0,0,590
10086,3576082,3576082,3576511,0,0,0,429
10088,3576527,3576527,3576579,0,0,0,52
10069,3574642,3575024,3576792,0,0,382,2150
10081,3575830,3575962,3576810,0,0,132,980
10037,3570757,3570757,3576818,0,0,0,6061
10093,3576918,3576918,3576933,0,0,0,15
10090,3576753,3576753,3577198,0,0,0,445
10060,3573609,3573609,3577305,0,0,0,3696
10094,3577331,3577331,3577414,0,0,0,83
10082,3575836,3575962,3577539,0,0,126,1703
10096,3577655,3577655,3577706,0,0,0,51
10097,3577680,3577680,3577814,0,0,0,134
10099,3577892,3577892,3578171,0,0,0,279
10101,3578049,3578049,3578671,0,0,0,622
10104,3578601,3578601,3578693,0,0,0,92
10095,3577337,3577337,3578746,0,0,0,1409
10106,3578926,3578926,3579011,0,0,0,85
10107,3579183,3579183,3579274,0,0,0,91
10098,3577823,3577823,3579305,0,0,0,1482
10067,3574531,3574531,3580055,0,0,0,5524
10109,3579571,3580055,3580099,0,0,484,528
10110,3579663,3580055,3580124,0,0,392,461
10112,3579913,3580055,3580135,0,0,142,222
10113,3580158,3580158,3580631,0,0,0,473
10102,3578170,3578170,3580645,0,0,0,2475
10114,3580594,3580594,3580676,0,0,0,82
10115,3580665,3580665,3580716,0,0,0,51
10118,3580837,3580837,3580909,0,0,0,72
10119,3581048,3581048,3581094,0,0,0,46
10120,3581201,3581201,3581250,0,0,0,49
10105,3578706,3578706,3581405,0,0,0,2699
10100,3578037,3578037,3581481,0,0,0,3444
10121,3581504,3581504,3581550,0,0,0,46
10125,3581939,3581939,3582031,0,0,0,92
10122,3581532,3581532,3582189,0,0,0,657
10111,3579814,3580055,3582521,0,0,241,2707
10126,3582434,3582434,3582624,0,0,0,190
10084,3575945,3576792,3583292,0,0,847,7347
10130,3583604,3583604,3583844,0,0,0,240
10132,3583970,3583970,3584060,0,0,0,90
10133,3584058,3584060,3584353,0,0,2,295
10128,3582826,3583292,3584424,0,0,466,1598
10129,3583549,3584424,3584462,0,0,875,913
10131,3583613,3584462,3584510,0,0,849,897
10136,3584464,3584464,3584574,0,0,0,110
10124,3581826,3581826,3584861,0,0,0,3035
10073,3575211,3575708,3585045,0,0,497,9834
10137,3585212,3585212,3585384,0,0,0,172
10139,3585331,3585331,3585447,0,0,0,116
10134,3584169,3584510,3585563,0,0,341,1394
10138,3585247,3585563,3585711,0,0,316,464
10140,3585378,3585711,3585828,0,0,333,450
10135,3584361,3585045,3586182,0,0,684,1821
10143,3585994,3586182,3586295,0,0,188,301
10145,3586232,3586232,3586913,0,0,0,681
10092,3576818,3576818,3587131,0,0,0,10313
10142,3585966,3585966,3587483,0,0,0,1517
10146,3587535,3587535,3588202,0,0,0,667
10144,3586118,3586295,3588767,0,0,177,2649
10108,3579222,3579305,3588890,0,0,83,9668
10127,3582515,3582521,3590643,0,0,6,8128
10148,3590260,3590643,3590947,0,0,383,687
10150,3591117,3591117,3591192,0,0,0,75
10091,3576801,3576801,3591604,0,0,0,14803
10147,3589368,3590643,3591700,0,0,1275,2332
10149,3590644,3591700,3592118,0,0,1056,1474
10153,3591887,3592118,3593262,0,0,231,1375
10141,3585513,3585828,3593402,0,0,315,7889
10087,3576431,3588890,3593868,0,0,12459,17437
10089,3576684,3593868,3594032,0,0,17184,17348
10157,3594527,3594527,3595095,0,0,0,568
10156,3593825,3593825,3595199,0,0,0,1374
10159,3596989,3596989,3597119,0,0,0,130
10103,3578485,3594032,3603073,0,0,15547,24588
10117,3580713,3603073,3604026,0,0,22360,23313
10123,3581800,3604026,3604047,0,0,22226,22247
10155,3593469,3604047,3604728,0,0,10578,11259
10154,3593085,3593402,3607503,0,0,317,14418
10161,3605210,3605210,3609048,0,0,0,3838
10162,3611226,3611226,3617619,0,0,0,6393
10160,3600678,3604728,3618819,0,0,4050,18141
10163,3630244,3630244,3631185,0,0,0,941
10164,3634245,3634245,3634465,0,0,0,220
10165,3636949,3636949,3636971,0,0,0,22
10166,3638215,3638215,3638235,0,0,0,20
10167,3638998,3638998,3640530,0,0,0,1532
10116,3580702,3580702,3642266,0,0,0,61564
10025,3569595,3569595,3642272,0,0,0,72677
10085,3576062,3576062,3642272,0,0,0,66210
10151,3591594,3591594,3642272,0,0,0,50678
10168,3642379,3642379,3642428,0,0,0,49
10152,3591801,3592118,3642587,0,0,317,50786
10169,3642407,3642407,3642715,0,0,0,308
10170,3642609,3642609,3642800,0,0,0,191
10171,3643119,3643119,3643166,0,0,0,47
10172,3643307,3643307,3643621,0,0,0,314
10173,3643512,3643512,3643627,0,0,0,115
10176,3645319,3645319,3645871,0,0,0,552
10178,3646244,3646244,3646290,0,0,0,46
10175,3643879,3643879,3647804,0,0,0,3925
10184,3647594,3647594,3647992,0,0,0,398
10180,3647241,3647241,3648202,0,0,0,961
10177,3645672,3645672,3648219,0,0,0,2547
10186,3648354,3648354,3648485,0,0,0,131
10187,3648822,3648822,3648939,0,0,0,117
10188,3648883,3648883,3648947,0,0,0,64
10182,3647562,3647562,3648948,0,0,0,1386
10189,3649163,3649163,3649289,0,0,0,126
10179,3647029,3647029,3649340,0,0,0,2311
10185,3648211,3648211,3649415,0,0,0,1204
10192,3649397,3649397,3649469,0,0,0,72
10191,3649386,3649386,3649500,0,0,0,114
10195,3649791,3649791,3649840,0,0,0,49
10174,3643877,3643877,3649869,0,0,0,5992
10194,3649662,3649662,3650036,0,0,0,374
10198,3650068,3650068,3650114,0,0,0,46
10201,3650371,3650371,3650416,0,0,0,45
10203,3650553,3650553,3650598,0,0,0,45
10205,3651140,3651140,3651153,0,0,0,13
10204,3650744,3650744,3651291,0,0,0,547
10193,3649484,3649484,3651415,0,0,0,1931
10197,3650054,3651415,3651441,0,0,1361,1387
10207,3651472,3651472,3651516,0,0,0,44
10200,3650252,3651441,3651558,0,0,1189,1306
10209,3651697,3651697,3651720,0,0,0,23
10210,3651748,3651748,3651795,0,0,0,47
10212,3652078,3652078,3652091,0,0,0,13
10213,3652159,3652159,3652204,0,0,0,45
10215,3652366,3652366,3652412,0,0,0,46
10217,3652943,3652943,3652992,0,0,0,49
10214,3652191,3652191,3653038,0,0,0,847
10219,3653167,3653167,3653214,0,0,0,47
10218,3653058,3653058,3653384,0,0,0,326
10222,3653336,3653384,3653450,0,0,48,114
10224,3653359,3653384,3653679,0,0,25,320
10221,3653326,3653384,3654031,0,0,58,705
10228,3654277,3654277,3654344,0,0,0,67
10181,3647525,3647525,3654558,0,0,0,7033
10226,3653553,3653553,3654677,0,0,0,1124
10227,3653681,3653681,3654773,0,0,0,1092
10223,3653344,3653384,3655163,0,0,40,1819
10231,3654684,3654684,3655652,0,0,0,968
10158,3595538,3604728,3655698,0,0,9190,60160
10232,3655538,3655538,3655872,0,0,0,334
10196,3649823,3650036,3655875,0,0,213,6052
10235,3656179,3656179,3656206,0,0,0,27
10230,3654618,3654618,3656220,0,0,0,1602
10236,3656224,3656224,3656248,0,0,0,24
10238,3656283,3656283,3656408,0,0,0,125
10240,3656464,3656464,3656521,0,0,0,57
10242,3656543,3656543,3656571,0,0,0,28
10244,3656598,3656598,3656654,0,0,0,56
10247,3656718,3656718,3656736,0,0,0,18
10246,3656713,3656713,3656773,0,0,0,60
10248,3656789,3656789,3656852,0,0,0,63
10239,3656453,3656453,3656925,0,0,0,472
10251,3656886,3656886,3656968,0,0,0,82
10233,3655600,3655600,3657342,0,0,0,1742
10249,3656859,3656859,3657363,0,0,0,504
10252,3656982,3657342,3657418,0,0,360,436
10253,3657091,3657363,3657439,0,0,272,348
10255,3657154,3657439,3657505,0,0,285,351
10256,3657184,3657505,3657551,0,0,321,367
10258,3657255,3657551,3657593,0,0,296,338
10260,3657375,3657593,3658021,0,0,218,646
10261,3657433,3658021,3658115,0,0,588,682
10262,3657663,3658115,3658205,0,0,452,542
10264,3657693,3658205,3658351,0,0,512,658
10211,3652007,3655875,3658432,0,0,3868,6425
10265,3657774,3658351,3658449,0,0,577,675
10234,3655687,3658432,3659244,0,0,2745,3557
10245,3656701,3659244,3659485,0,0,2543,2784
10257,3657247,3659244,3659666,0,0,1997,2419
10254,3657129,3657418,3659820,0,0,289,2691
10202,3650444,3651441,3659907,0,0,997,9463
10250,3656874,3656968,3660010,0,0,94,3136
10267,3660235,3660235,3660537,0,0,0,302
10199,3650205,3651441,3660575,0,0,1236,10370
10237,3656247,3656247,3660631,0,0,0,4384
10272,3660617,3660617,3660631,0,0,0,14
10273,3660719,3660719,3660731,0,0,0,12
10216,3652449,3652449,3661096,0,0,0,8647
10183,3647572,3647572,3661231,0,0,0,13659
10268,3660439,3660537,3661333,0,0,98,894
10270,3660581,3660581,3661437,0,0,0,856
10280,3661448,3661448,3661566,0,0,0,118
10278,3661335,3661335,3661919,0,0,0,584
10275,3661016,3661016,3662158,0,0,0,1142
10283,3662019,3662019,3662403,0,0,0,384
10282,3661912,3661912,3663250,0,0,0,1338
10263,3657670,3659907,3663957,0,0,2237,6287
10279,3661344,3663957,3664133,0,0,2613,2789
10289,3663340,3664133,3664219,0,0,793,879
10286,3662622,3663957,3664273,0,0,1335,1651
10271,3660608,3660608,3664297,0,0,0,3689
10269,3660513,3660537,3664395,0,0,24,3882
10292,3663692,3664273,3664443,0,0,581,751
10293,3664330,3664330,3664557,0,0,0,227
10285,3662535,3662535,3664653,0,0,0,2118
10296,3664635,3664653,3664708,0,0,18,73
10288,3663220,3663250,3665075,0,0,30,1855
10294,3664408,3664408,3665521,0,0,0,1113
10274,3660726,3660726,3665526,0,0,0,4800
10298,3665448,3665448,3665800,0,0,0,352
10300,3665893,3665893,3666075,0,0,0,182
10220,3653254,3653254,3666307,0,0,0,13053
10297,3664912,3664912,3666364,0,0,0,1452
10302,3666254,3666254,3666642,0,0,0,388
10266,3659269,3659485,3666796,0,0,216,7527
10301,3666198,3666198,3666799,0,0,0,601
10306,3666799,3666799,3666811,0,0,0,12
10206,3651446,3651446,3667042,0,0,0,15596
10303,3666377,3667042,3667330,0,0,665,953
10299,3665685,3666796,3667372,0,0,1111,1687
10309,3667437,3667437,3667452,0,0,0,15
10307,3666819,3667372,3667532,0,0,553,713
10313,3667890,3667890,3667945,0,0,0,55
10290,3663413,3664219,3667984,0,0,806,4571
10311,3667613,3667613,3668180,0,0,0,567
10276,3661047,3661096,3668433,0,0,49,7386
10315,3668305,3668305,3668448,0,0,0,143
10314,3668272,3668272,3668863,0,0,0,591
10318,3668593,3668593,3669069,0,0,0,476
10305,3666679,3666679,3669953,0,0,0,3274
10319,3669520,3669520,3670027,0,0,0,507
10320,3670051,3670051,3670104,0,0,0,53
10321,3670337,3670337,3670665,0,0,0,328
10317,3668503,3668503,3670682,0,0,0,2179
10322,3670659,3670659,3670718,0,0,0,59
10312,3667717,3670718,3670841,0,0,3001,3124
10323,3671071,3671071,3671133,0,0,0,62
10190,3649187,3649187,3671171,0,0,0,21984
10324,3671257,3671257,3671303,0,0,0,46
10325,3671595,3671595,3671648,0,0,0,53
10328,3671839,3671839,3671887,0,0,0,48
10329,3672154,3672154,3672188,0,0,0,34
10330,3672199,3672199,3672218,0,0,0,19
10331,3672283,3672283,3672318,0,0,0,35
10332,3672445,3672445,3672478,0,0,0,33
10333,3672529,3672529,3672557,0,0,0,28
10287,3663164,3665526,3673301,0,0,2362,10137
10334,3672982,3672982,3673328,0,0,0,346
10308,3667068,3667532,3673717,0,0,464,6649
10335,3673742,3673742,3673830,0,0,0,88
10208,3651535,3673717,3675219,0,0,22182,23684
10304,3666562,3667330,3675431,0,0,768,8869
10225,3653506,3675219,3675688,0,0,21713,22182
10229,3654408,3675688,3676624,0,0,21280,22216
10338,3676617,3676617,3676654,0,0,0,37
10241,3656524,3676624,3676673,0,0,20100,20149
10243,3656572,3676673,3677258,0,0,20101,20686
10259,3657260,3677258,3677778,0,0,19998,20518
10277,3661096,3677778,3679162,0,0,16682,18066
10281,3661453,3679162,3682803,0,0,17709,21350
10337,3675452,3675452,3683721,0,0,0,8269
10295,3664618,3664618,3683728,0,0,0,19110
10316,3668358,3668358,3683766,0,0,0,15408
10284,3662069,3662069,3683768,0,0,0,21699
10327,3671772,3671772,3683769,0,0,0,11997
10326,3671755,3671755,3683770,0,0,0,12015
10336,3674054,3674054,3683824,0,0,0,9770
10291,3663559,3682803,3683958,0,0,19244,20399
10310,3667503,3683824,3683979,0,0,16321,16476
10339,3686628,3686628,3689186,0,0,0,2558
10343,3689945,3689945,3690717,0,0,0,772
10341,3688415,3688415,3692100,0,0,0,3685
10345,3691731,3691731,3692133,0,0,0,402
10344,3689986,3689986,3692709,0,0,0,2723
10340,3686841,3686841,3701263,0,0,0,14422
10342,3688492,3688492,3702069,0,0,0,13577
10346,3711726,3711726,3714061,0,0,0,2335
10348,3715497,3715497,3715588,0,0,0,91
10349,3715715,3715715,3715745,0,0,0,30
10350,3715787,3715787,3715815,0,0,0,28
10351,3715870,3715870,3716003,0,0,0,133
10352,3716030,3716030,3716063,0,0,0,33
10353,3716170,3716170,3716196,0,0,0,26
10347,3714003,3714003,3716260,0,0,0,2257
10354,3716234,3716234,3716266,0,0,0,32
10356,3716302,3716302,3716328,0,0,0,26
10357,3716354,3716354,3716380,0,0,0,26
10358,3716444,3716444,3716522,0,0,0,78
10355,3716244,3716244,3718528,0,0,0,2284
10360,3719707,3719707,3719834,0,0,0,127
10359,3718461,3718461,3720812,0,0,0,2351
10364,3720750,3720750,3720881,0,0,0,131
10361,3720388,3720388,3721637,0,0,0,1249
10366,3722262,3722262,3722346,0,0,0,84
10368,3722819,3722819,3723186,0,0,0,367
10365,3720783,3720783,3723193,0,0,0,2410
10369,3723060,3723060,3723718,0,0,0,658
10367,3722783,3722783,3723868,0,0,0,1085
10371,3723397,3723397,3724785,0,0,0,1388
10372,3724769,3724769,3725111,0,0,0,342
10375,3724959,3724959,3725122,0,0,0,163
10376,3725102,3725102,3725198,0,0,0,96
10377,3725270,3725270,3725522,0,0,0,252
10379,3725613,3725613,3725790,0,0,0,177
10383,3726123,3726123,3726169,0,0,0,46
10384,3726196,3726196,3726217,0,0,0,21
10370,3723131,3723131,3726332,0,0,0,3201
10381,3725956,3725956,3726332,0,0,0,376
10378,3725343,3725343,3726391,0,0,0,1048
10385,3726224,3726332,3726411,0,0,108,187
10388,3726486,3726486,3726513,0,0,0,27
10387,3726472,3726472,3726533,0,0,0,61
10389,3726666,3726666,3726698,0,0,0,32
10363,3720660,3720660,3726905,0,0,0,6245
10391,3726884,3726884,3726909,0,0,0,25
10390,3726752,3726752,3727131,0,0,0,379
10362,3720648,3720648,3727140,0,0,0,6492
10382,3725977,3726391,3727336,0,0,414,1359
10394,3727017,3727017,3727505,0,0,0,488
10397,3727403,3727403,3727516,0,0,0,113
10399,3727645,3727645,3727698,0,0,0,53
10398,3727605,3727605,3727739,0,0,0,134
10392,3726928,3726928,3727747,0,0,0,819
10400,3727745,3727745,3727775,0,0,0,30
10401,3728127,3728127,3728517,0,0,0,390
10374,3724857,3724857,3728782,0,0,0,3925
10380,3725867,3726391,3728882,0,0,524,3015
10386,3726305,3726332,3729052,0,0,27,2747
10395,3727079,3728782,3729855,0,0,1703,2776
10393,3726971,3726971,3729927,0,0,0,2956
10407,3729252,3729252,3729991,0,0,0,739
10402,3728793,3729855,3730007,0,0,1062,1214
10413,3729960,3729960,3730027,0,0,0,67
10396,3727225,3727225,3730112,0,0,0,2887
10410,3729479,3729479,3730188,0,0,0,709
10418,3730265,3730265,3730307,0,0,0,42
10403,3728854,3728854,3730320,0,0,0,1466
10414,3730109,3730109,3730657,0,0,0,548
10409,3729379,3729855,3730817,0,0,476,1438
10416,3730173,3730173,3730850,0,0,0,677
10422,3730855,3730855,3730938,0,0,0,83
10423,3730867,3730867,3730949,0,0,0,82
10424,3730925,3730925,3730956,0,0,0,31
10425,3730974,3730974,3731019,0,0,0,45
10426,3731019,3731019,3731084,0,0,0,65
10417,3730215,3730320,3731128,0,0,105,913
10415,3730121,3730121,3731403,0,0,0,1282
10427,3731249,3731403,3731432,0,0,154,183
10428,3731264,3731432,3731445,0,0,168,181
10429,3731381,3731445,3731475,0,0,64,94
10430,3731405,3731475,3731513,0,0,70,108
10405,3729004,3729004,3731788,0,0,0,2784
10433,3731590,3731788,3731802,0,0,198,212
10434,3731690,3731802,3731830,0,0,112,140
10421,3730760,3730817,3731841,0,0,57,1081
10436,3731825,3731830,3731892,0,0,5,67
10420,3730624,3730657,3731989,0,0,33,1365
10437,3731911,3731989,3732005,0,0,78,94
10431,3731422,3731513,3732095,0,0,91,673
10441,3732102,3732102,3732196,0,0,0,94
10442,3732332,3732332,3732428,0,0,0,96
10439,3732014,3732014,3732520,0,0,0,506
10440,3732026,3732026,3732546,0,0,0,520
10443,3732518,3732518,3732586,0,0,0,68
10444,3732549,3732549,3732588,0,0,0,39
10445,3732560,3732560,3732614,0,0,0,54
10447,3732590,3732590,3732626,0,0,0,36
10449,3732646,3732646,3732673,0,0,0,27
10450,3732660,3732660,3732856,0,0,0,196
10451,3732922,3732922,3732947,0,0,0,25
10453,3732969,3732969,3732994,0,0,0,25
10455,3733011,3733011,3733024,0,0,0,13
10454,3733004,3733004,3733039,0,0,0,35
10446,3732570,3732570,3733071,0,0,0,501
10419,3730581,3731128,3733351,0,0,547,2770
10457,3733195,3733351,3733381,0,0,156,186
10458,3733246,3733351,3733385,0,0,105,139
10459,3733362,3733362,3733394,0,0,0,32
10462,3733446,3733446,3733492,0,0,0,46
10460,3733368,3733368,3733513,0,0,0,145
10461,3733422,3733513,3733572,0,0,91,150
10463,3733572,3733572,3733588,0,0,0,16
10448,3732624,3732624,3733677,0,0,0,1053
10467,3733841,3733841,3733878,0,0,0,37
10465,3733634,3733634,3733883,0,0,0,249
10469,3734055,3734055,3734084,0,0,0,29
10452,3732952,3733071,3734086,0,0,119,1134
10471,3734148,3734148,3734181,0,0,0,33
10464,3733600,3733600,3734254,0,0,0,654
10473,3734215,3734254,3734277,0,0,39,62
10474,3734222,3734277,3734309,0,0,55,87
10475,3734308,3734309,3734324,0,0,1,16
10432,3731433,3731788,3734328,0,0,355,2895
10435,3731738,3731892,3734337,0,0,154,2599
10476,3734321,3734324,3734348,0,0,3,27
10478,3734369,3734369,3734394,0,0,0,25
10479,3734401,3734401,3734424,0,0,0,23
10481,3734661,3734661,3734676,0,0,0,15
10477,3734342,3734342,3734778,0,0,0,436
10483,3734767,3734767,3734782,0,0,0,15
10485,3734910,3734910,3734960,0,0,0,50
10484,3734862,3734862,3735081,0,0,0,219
10488,3734985,3735081,3735133,0,0,96,148
10482,3734757,3734757,3735313,0,0,0,556
10486,3734919,3734919,3735483,0,0,0,564
10373,3724828,3724828,3735620,0,0,0,10792
10491,3735205,3735483,3735759,0,0,278,554
10480,3734564,3735620,3736396,0,0,1056,1832
10495,3735592,3736396,3736421,0,0,804,829
10494,3735514,3736396,3736424,0,0,882,910
10500,3735638,3736424,3736445,0,0,786,807
10498,3735627,3736421,3736446,0,0,794,819
10502,3735726,3736446,3736467,0,0,720,741
10503,3735790,3736467,3736477,0,0,677,687
10504,3735809,3736477,3736548,0,0,668,739
10492,3735344,3736396,3736579,0,0,1052,1235
10487,3734977,3734977,3736748,0,0,0,1771
10506,3735925,3736748,3736834,0,0,823,909
10507,3735955,3736834,3736887,0,0,879,932
10508,3735960,3736887,3736995,0,0,927,1035
10501,3735654,3736445,3737010,0,0,791,1356
10509,3736085,3736995,3737065,0,0,910,980
10511,3736252,3737065,3737095,0,0,813,843
10510,3736092,3737010,3737129,0,0,918,1037
10513,3736433,3737129,3737166,0,0,696,733
10490,3735074,3735313,3737257,0,0,239,2183
10515,3736602,3737257,3737318,0,0,655,716
10499,3735634,3736579,3737334,0,0,945,1700
10517,3737210,3737318,3737364,0,0,108,154
10512,3736424,3737095,3737771,0,0,671,1347
10519,3737383,3737771,3737826,0,0,388,443
10493,3735442,3735759,3737968,0,0,317,2526
10518,3737300,3737364,3738050,0,0,64,750
10522,3738102,3738102,3738136,0,0,0,34
10514,3736454,3737166,3738280,0,0,712,1826
10505,3735821,3736548,3738294,0,0,727,2473
10525,3738250,3738280,3738380,0,0,30,130
10526,3738369,3738369,3738389,0,0,0,20
10527,3738408,3738408,3738459,0,0,0,51
10489,3735034,3735133,3738658,0,0,99,3624
10528,3738698,3738698,3738744,0,0,0,46
10523,3738120,3738120,3738956,0,0,0,836
10524,3738215,3738215,3738985,0,0,0,770
10472,3734176,3734181,3739334,0,0,5,5158
10531,3739029,3739334,3739372,0,0,305,343
10521,3737725,3737826,3740070,0,0,101,2345
10532,3739104,3739372,3740178,0,0,268,1074
10535,3739383,3740178,3740239,0,0,795,856
10536,3739887,3740239,3740272,0,0,352,385
10537,3739931,3740272,3740312,0,0,341,381
10530,3739021,3739334,3740483,0,0,313,1462
10466,3733693,3733693,3740784,0,0,0,7091
10539,3740092,3740483,3740990,0,0,391,898
10540,3740100,3740990,3741047,0,0,890,947
10541,3740169,3741047,3741095,0,0,878,926
10538,3740052,3740312,3741208,0,0,260,1156
10544,3740311,3741208,3741271,0,0,897,960
10545,3740330,3741271,3741285,0,0,941,955
10411,3729502,3730007,3741286,0,0,505,11784
10468,3734017,3734086,3741322,0,0,69,7305
10546,3740449,3741285,3741340,0,0,836,891
10456,3733108,3733351,3741489,0,0,243,8381
10533,3739321,3740070,3741533,0,0,749,2212
10550,3740951,3741489,3741542,0,0,538,591
10552,3741522,3741542,3741578,0,0,20,56
10549,3740939,3741489,3742007,0,0,550,1068
10554,3741596,3742007,3742074,0,0,411,478
10555,3741656,3742074,3742112,0,0,418,456
10557,3741804,3742112,3742158,0,0,308,354
10551,3741103,3741533,3742189,0,0,430,1086
10516,3736829,3737334,3742211,0,0,505,5382
10547,3740799,3741340,3742333,0,0,541,1534
10556,3741706,3742211,3742339,0,0,505,633
10560,3741898,3742333,3742437,0,0,435,539
10408,3729288,3729855,3742450,0,0,567,13162
10562,3742014,3742339,3742523,0,0,325,509
10561,3741985,3742450,3742574,0,0,465,589
10558,3741843,3742158,3742680,0,0,315,837
10563,3742073,3742339,3742688,0,0,266,615
10553,3741583,3741583,3742934,0,0,0,1351
10568,3742668,3742668,3742954,0,0,0,286
10573,3743047,3743047,3743104,0,0,0,57
10564,3742344,3742437,3743206,0,0,93,862
10567,3742520,3742574,3743266,0,0,54,746
10566,3742514,3742574,3743272,0,0,60,758
10572,3743038,3743038,3743282,0,0,0,244
10559,3741862,3742189,3743738,0,0,327,1876
10578,3743594,3743738,3743813,0,0,144,219
10548,3740809,3741489,3743860,0,0,680,3051
10577,3743571,3743571,3743880,0,0,0,309
10571,3742985,3742985,3744056,0,0,0,1071
10583,3744210,3744210,3744283,0,0,0,73
10579,3743918,3743918,3744300,0,0,0,382
10570,3742979,3742979,3744325,0,0,0,1346
10575,3743441,3743441,3744383,0,0,0,942
10520,3737697,3741322,3744887,0,0,3625,7190
10412,3729887,3730007,3744931,0,0,120,15044
10588,3744773,3744887,3744995,0,0,114,222
10589,3744794,3744931,3745006,0,0,137,212
10534,3739327,3740784,3745030,0,0,1457,5703
10591,3745193,3745193,3745264,0,0,0,71
10592,3745428,3745428,3745539,0,0,0,111
10594,3745822,3745822,3745953,0,0,0,131
10595,3745920,3745920,3745966,0,0,0,46
10584,3744433,3744433,3746031,0,0,0,1598
10587,3744758,3744887,3746100,0,0,129,1342
10576,3743526,3743526,3746145,0,0,0,2619
10586,3744522,3744887,3746357,0,0,365,1835
10529,3738754,3738754,3746428,0,0,0,7674
10600,3746667,3746667,3746695,0,0,0,28
10574,3743400,3743400,3746886,0,0,0,3486
10599,3746616,3746886,3746949,0,0,270,333
10602,3746919,3746949,3747041,0,0,30,122
10597,3746249,3746249,3747207,0,0,0,958
10569,3742958,3742958,3747234,0,0,0,4276
10606,3747333,3747333,3747367,0,0,0,34
10580,3744026,3744026,3747651,0,0,0,3625
10581,3744146,3744146,3747659,0,0,0,3513
10593,3745799,3745799,3747734,0,0,0,1935
10543,3740279,3741095,3747736,0,0,816,7457
10612,3747687,3747736,3747924,0,0,49,237
10610,3747457,3747659,3748003,0,0,202,546
10604,3747026,3747041,3748053,0,0,15,1027
10613,3747774,3747924,3748172,0,0,150,398
10608,3747384,3747384,3748189,0,0,0,805
10617,3748150,3748189,3748266,0,0,39,116
10616,3747935,3748172,3748392,0,0,237,457
10582,3744175,3744325,3748500,0,0,150,4325
10614,3747812,3748003,3748574,0,0,191,762
10611,3747592,3748500,3748592,0,0,908,1000
10620,3748384,3748574,3748657,0,0,190,273
10619,3748366,3748392,3748750,0,0,26,384
10623,3748594,3748750,3748817,0,0,156,223
10596,3746117,3746117,3748860,0,0,0,2743
10622,3748489,3748657,3749167,0,0,168,678
10603,3746972,3746972,3749236,0,0,0,2264
10609,3747404,3747651,3749247,0,0,247,1843
10629,3749235,3749235,3749291,0,0,0,56
10615,3747926,3748053,3749361,0,0,127,1435
10628,3749177,3749247,3749685,0,0,70,508
10632,3749398,3749685,3749697,0,0,287,299
10634,3749610,3749697,3749747,0,0,87,137
10627,3749139,3749139,3749822,0,0,0,683
10630,3749323,3749323,3749836,0,0,0,513
10635,3749897,3749897,3749971,0,0,0,74
10638,3750115,3750115,3750170,0,0,0,55
10637,3750076,3750076,3750197,0,0,0,121
10633,3749515,3749685,3750363,0,0,170,848
10639,3750211,3750211,3750415,0,0,0,204
10641,3750462,3750462,3750576,0,0,0,114
10636,3750003,3750003,3750578,0,0,0,575
10643,3750507,3750507,3750578,0,0,0,71
10631,3749381,3749381,3750612,0,0,0,1231
10644,3750583,3750612,3750645,0,0,29,62
10645,3750623,3750645,3750679,0,0,22,56
10646,3750641,3750679,3750717,0,0,38,76
10497,3735605,3741286,3751716,0,0,5681,16111
10642,3750473,3751716,3752515,0,0,1243,2042
10649,3750834,3752515,3752565,0,0,1681,1731
10650,3751330,3752515,3752985,0,0,1185,1655
10496,3735600,3738985,3753610,0,0,3385,18010
10653,3751998,3753610,3753972,0,0,1612,1974
10652,3751708,3752565,3754129,0,0,857,2421
10655,3752988,3753610,3755259,0,0,622,2271
10621,3748405,3748592,3755276,0,0,187,6871
10656,3753113,3753113,3755293,0,0,0,2180
10590,3744946,3744995,3755335,0,0,49,10389
10624,3748745,3755335,3756480,0,0,6590,7735
10651,3751696,3752565,3756496,0,0,869,4800
10598,3746411,3746411,3756524,0,0,0,10113
10654,3752897,3755259,3756527,0,0,2362,3630
10661,3756530,3756530,3756546,0,0,0,16
10626,3748829,3748860,3756612,0,0,31,7783
10607,3747364,3747364,3756670,0,0,0,9306
10647,3750703,3750717,3756687,0,0,14,5984
10565,3742475,3742523,3756719,0,0,48,14244
10625,3748754,3748754,3756726,0,0,0,7972
10640,3750360,3750578,3756743,0,0,218,6383
10404,3728964,3756743,3756774,0,0,27779,27810
10618,3748159,3748266,3756777,0,0,107,8618
10406,3729141,3756774,3756864,0,0,27633,27723
10585,3744453,3744887,3757162,0,0,434,12709
10662,3757363,3757363,3757431,0,0,0,68
10665,3757484,3757484,3757582,0,0,0,98
10663,3757373,3757373,3757979,0,0,0,606
10666,3757599,3757599,3758140,0,0,0,541
10668,3758155,3758155,3758317,0,0,0,162
10648,3750756,3752515,3758430,0,0,1759,7674
10669,3758345,3758345,3758514,0,0,0,169
10438,3731923,3756864,3759525,0,0,24941,27602
10658,3755421,3755421,3760231,0,0,0,4810
10470,3734071,3759525,3760582,0,0,25454,26511
10660,3755924,3755924,3760973,0,0,0,5049
10676,3759701,3760973,3761033,0,0,1272,1332
10677,3759983,3761033,3761079,0,0,1050,1096
10678,3760415,3761079,3761136,0,0,664,721
10667,3757780,3758514,3761270,0,0,734,3490
10679,3761260,3761260,3761321,0,0,0,61
10672,3758743,3761270,3761383,0,0,2527,2640
10670,3758550,3761270,3761460,0,0,2720,2910
10674,3759133,3761460,3761545,0,0,2327,2412
10542,3740183,3760582,3761570,0,0,20399,21387
10673,3758881,3761383,3761596,0,0,2502,2715
10680,3761672,3761672,3761731,0,0,0,59
10671,3758598,3760231,3761839,0,0,1633,3241
10601,3746889,3761570,3761851,0,0,14681,14962
10681,3761726,3761726,3762074,0,0,0,348
10605,3747293,3761851,3762642,0,0,14558,15349
10682,3762823,3762823,3763070,0,0,0,247
10683,3762883,3762883,3763478,0,0,0,595
10686,3763556,3763556,3763743,0,0,0,187
10690,3764076,3764076,3764454,0,0,0,378
10691,3764607,3764607,3764640,0,0,0,33
10692,3764800,3764800,3764825,0,0,0,25
10675,3759274,3761545,3765119,0,0,2271,5845
10664,3757380,3757380,3765167,0,0,0,7787
10689,3763947,3765119,3765189,0,0,1172,1242
10693,3765286,3765286,3765470,0,0,0,184
10688,3763901,3763901,3765994,0,0,0,2093
10695,3766018,3766018,3766051,0,0,0,33
10696,3767105,3767105,3767766,0,0,0,661
10698,3767950,3767950,3767986,0,0,0,36
10697,3767430,3767430,3767987,0,0,0,557
10700,3768170,3768170,3768515,0,0,0,345
10659,3755483,3762642,3768837,0,0,7159,13354
10702,3769709,3769709,3769738,0,0,0,29
10684,3762912,3762912,3770830,0,0,0,7918
10704,3770034,3770830,3770892,0,0,796,858
10706,3770554,3770892,3770969,0,0,338,415
10707,3770842,3770969,3771260,0,0,127,418
10708,3771336,3771336,3771647,0,0,0,311
10709,3771707,3771707,3772334,0,0,0,627
10694,3765824,3765824,3772478,0,0,0,6654
10699,3767993,3767993,3776722,0,0,0,8729
10711,3774314,3776722,3776732,0,0,2408,2418
10712,3774474,3776732,3777361,0,0,2258,2887
10713,3775175,3777361,3778012,0,0,2186,2837
10685,3763115,3768837,3778838,0,0,5722,15723
10657,3755128,3756480,3779146,0,0,1352,24018
10715,3776611,3779146,3779642,0,0,2535,3031
10687,3763668,3778838,3784184,0,0,15170,20516
10714,3775233,3778012,3784826,0,0,2779,9593
10716,3776882,3779146,3785214,0,0,2264,8332
10718,3778185,3784826,3785427,0,0,6641,7242
10719,3779512,3785214,3785890,0,0,5702,6378
10703,3769955,3769955,3785909,0,0,0,15954
10721,3782333,3785890,3785947,0,0,3557,3614
10722,3783853,3785909,3785956,0,0,2056,2103
10724,3784882,3785947,3785999,0,0,1065,1117
10720,3780937,3785427,3786238,0,0,4490,5301
10701,3769651,3772478,3786721,0,0,2827,17070
10705,3770061,3779146,3788649,0,0,9085,18588
10717,3776892,3779642,3788877,0,0,2750,11985
10710,3773107,3784184,3795539,0,0,11077,22432
10723,3784478,3788877,3798392,0,0,4399,13914
10733,3801075,3801075,3801147,0,0,0,72
10726,3801051,3801051,3801184,0,0,0,133
10734,3801075,3801147,3801255,0,0,72,180
10727,3801051,3801184,3801336,0,0,133,285
10735,3801075,3801255,3801383,0,0,180,308
10728,3801051,3801336,3801506,0,0,285,455
10736,3801075,3801383,3801546,0,0,308,471
10729,3801051,3801506,3801694,0,0,455,643
10737,3801075,3801546,3801710,0,0,471,635
10738,3801075,3801710,3801892,0,0,635,817
10730,3801051,3801694,3801900,0,0,643,849
10731,3801051,3801900,3802123,0,0,849,1072
10739,3801075,3801892,3802143,0,0,817,1068
10740,3801163,3802143,3802183,0,0,980,1020
10741,3801183,3802183,3802220,0,0,1000,1037
10744,3801238,3802220,3802291,0,0,982,1053
10746,3801256,3802291,3802378,0,0,1035,1122
10732,3801051,3802123,3802398,0,0,1072,1347
10748,3801326,3802378,3802428,0,0,1052,1102
10742,3801183,3802398,3802435,0,0,1215,1252
10743,3801202,3802435,3802489,0,0,1233,1287
10758,3801885,3802428,3802535,0,0,543,650
10745,3801256,3802489,3802542,0,0,1233,1286
10747,3801274,3802542,3802611,0,0,1268,1337
10749,3801326,3802611,3802661,0,0,1285,1335
10750,3801849,3802661,3802700,0,0,812,851
10759,3801885,3802535,3802763,0,0,650,878
10725,3793991,3795539,3802867,0,0,1548,8876
10751,3801867,3802700,3802947,0,0,833,1080
10761,3801886,3802867,3802973,0,0,981,1087
10752,3801884,3802947,3803056,0,0,1063,1172
10762,3801886,3802973,3803200,0,0,1087,1314
10753,3801884,3803056,3803226,0,0,1172,1342
10754,3801884,3803226,3803514,0,0,1342,1630
10763,3801886,3803200,3803549,0,0,1314,1663
10755,3801884,3803514,3803865,0,0,1630,1981
10760,3801885,3802763,3804136,0,0,878,2251
10766,3801908,3804136,3804219,0,0,2228,2311
10765,3801887,3804136,3804240,0,0,2249,2353
10764,3801886,3803549,3804440,0,0,1663,2554
10767,3801908,3804219,3804482,0,0,2311,2574
10768,3801908,3804240,3804503,0,0,2332,2595
10772,3801910,3804503,3804646,0,0,2593,2736
10773,3801910,3804503,3804647,0,0,2593,2737
10756,3801884,3803865,3804759,0,0,1981,2875
10769,3801908,3804440,3804766,0,0,2532,2858
10774,3801910,3804646,3804970,0,0,2736,3060
10775,3801910,3804647,3805088,0,0,2737,3178
10776,3801910,3804766,3805208,0,0,2856,3298
10779,3801912,3805088,3805229,0,0,3176,3317
10780,3801912,3805088,3805288,0,0,3176,3376
10770,3801908,3804440,3805371,0,0,2532,3463
10785,3801936,3805371,3805487,0,0,3435,3551
10786,3801937,3805371,3805546,0,0,3434,3609
10781,3801912,3805208,3805766,0,0,3296,3854
10757,3801884,3804759,3805772,0,0,2875,3888
10796,3802050,3805766,3805826,0,0,3716,3776
10782,3801912,3805208,3805828,0,0,3296,3916
10791,3801989,3805772,3805835,0,0,3783,3846
10792,3801990,3805835,3805896,0,0,3845,3906
10793,3801990,3805835,3805897,0,0,3845,3907
10787,3801937,3805371,3805904,0,0,3434,3967
10777,3801910,3804766,3805932,0,0,2856,4022
10799,3802050,3805826,3805946,0,0,3776,3896
10802,3802110,3805828,3805951,0,0,3718,3841
10794,3801991,3805896,3805956,0,0,3905,3965
10797,3802050,3805896,3805957,0,0,3846,3907
10798,3802050,3805897,3805958,0,0,3847,3908
10788,3801937,3805371,3805966,0,0,3434,4029
10800,3802050,3805896,3806017,0,0,3846,3967
10805,3802110,3805897,3806077,0,0,3787,3967
10771,3801908,3804482,3806130,0,0,2574,4222
10812,3802232,3805897,3806135,0,0,3665,3903
10807,3802169,3805956,3806137,0,0,3787,3968
10808,3802169,3805958,3806140,0,0,3789,3971
10813,3802349,3805932,3806232,0,0,3583,3883
10814,3802349,3805957,3806258,0,0,3608,3909
10803,3802110,3806140,3806263,0,0,4030,4153
10815,3802469,3805897,3806266,0,0,3428,3797
10816,3802469,3805904,3806274,0,0,3435,3805
10811,3802232,3806130,3806307,0,0,3898,4075
10804,3802110,3806263,3806386,0,0,4153,4276
10809,3802232,3806307,3806424,0,0,4075,4192
10817,3802531,3805946,3806431,0,0,3415,3900
10818,3802531,3805951,3806436,0,0,3420,3905
10823,3803076,3806017,3806437,0,0,2941,3361
10778,3801910,3804970,3806557,0,0,3060,4647
10783,3801912,3805229,3806755,0,0,3317,4843
10821,3802838,3806135,3806794,0,0,3297,3956
10789,3801937,3805487,3806807,0,0,3550,4870
10784,3801912,3805288,3806814,0,0,3376,4902
10824,3803256,3806424,3806844,0,0,3168,3588
10790,3801937,3805546,3806866,0,0,3609,4929
10795,3802049,3806844,3806907,0,0,4795,4858
10801,3802110,3806907,3806967,0,0,4797,4857
10820,3802777,3806386,3806986,0,0,3609,4209
10806,3802169,3806967,3807088,0,0,4798,4919
10810,3802232,3806986,3807104,0,0,4754,4872
10819,3802776,3807088,3807689,0,0,4312,4913
10822,3802897,3807104,3807703,0,0,4207,4806
10825,3806560,3807689,3813055,0,0,1129,6495
10831,3819814,3819814,3819859,0,0,0,45
10832,3819956,3819956,3819981,0,0,0,25
10835,3820133,3820133,3820180,0,0,0,47
10834,3820033,3820033,3820344,0,0,0,311
10838,3820440,3820440,3820473,0,0,0,33
10839,3820506,3820506,3820574,0,0,0,68
10840,3820606,3820606,3820634,0,0,0,28
10842,3820983,3820983,3820998,0,0,0,15
10843,3821109,3821109,3821243,0,0,0,134
10828,3817961,3817961,3821257,0,0,0,3296
10844,3821358,3821358,3821405,0,0,0,47
10841,3820775,3820775,3821482,0,0,0,707
10846,3821774,3821774,3821836,0,0,0,62
10826,3814693,3814693,3822191,0,0,0,7498
10847,3822149,3822149,3822215,0,0,0,66
10848,3822220,3822220,3822266,0,0,0,46
10827,3814737,3814737,3822401,0,0,0,7664
10850,3822511,3822511,3822556,0,0,0,45
10849,3822301,3822301,3822580,0,0,0,279
10853,3822791,3822791,3822832,0,0,0,41
10836,3820199,3820199,3822875,0,0,0,2676
10837,3820224,3820224,3822893,0,0,0,2669
10854,3822910,3822910,3822959,0,0,0,49
10830,3819732,3819732,3823176,0,0,0,3444
10855,3823486,3823486,3823533,0,0,0,47
10833,3819998,3819998,3823811,0,0,0,3813
10845,3821482,3821482,3823906,0,0,0,2424
10851,3822654,3822654,3823909,0,0,0,1255
10861,3824421,3824421,3824472,0,0,0,51
10860,3824216,3824216,3824685,0,0,0,469
10863,3824680,3824680,3824734,0,0,0,54
10864,3824853,3824853,3824909,0,0,0,56
10862,3824616,3824616,3825132,0,0,0,516
10867,3825076,3825076,3825145,0,0,0,69
10868,3825141,3825141,3825196,0,0,0,55
10869,3825248,3825248,3825315,0,0,0,67
10870,3825509,3825509,3825678,0,0,0,169
10858,3823846,3823846,3825685,0,0,0,1839
10871,3825764,3825764,3826071,0,0,0,307
10829,3818790,3818790,3826272,0,0,0,7482
10874,3826163,3826163,3826367,0,0,0,204
10859,3823918,3823918,3826970,0,0,0,3052
10875,3826569,3826970,3827037,0,0,401,468
10852,3822718,3822718,3827080,0,0,0,4362
10876,3826793,3827037,3827084,0,0,244,291
10878,3826973,3827084,3827096,0,0,111,123
10877,3826871,3827080,3828016,0,0,209,1145
10865,3825040,3825040,3828285,0,0,0,3245
10882,3827380,3828285,3828317,0,0,905,937
10885,3827926,3828285,3828333,0,0,359,407
10881,3827174,3828016,3828594,0,0,842,1420
10886,3827979,3828317,3828891,0,0,338,912
10887,3828188,3828333,3829043,0,0,145,855
10879,3827009,3827096,3829244,0,0,87,2235
10891,3828780,3829043,3829355,0,0,263,575
10888,3828255,3828594,3829376,0,0,339,1121
10883,3827559,3829376,3829460,0,0,1817,1901
10890,3828763,3828891,3829800,0,0,128,1037
10892,3828793,3829244,3829961,0,0,451,1168
10896,3829460,3829961,3829976,0,0,501,516
10898,3829509,3829976,3830612,0,0,467,1103
10895,3829450,3829800,3831039,0,0,350,1589
10901,3829614,3831039,3831052,0,0,1425,1438
10884,3827791,3829460,3833605,0,0,1669,5814
10899,3829524,3830612,3834567,0,0,1088,5043
10903,3829780,3834567,3834626,0,0,4787,4846
10857,3823648,3823648,3834657,0,0,0,11009
10866,3825048,3825048,3834782,0,0,0,9734
10889,3828372,3833605,3834835,0,0,5233,6463
10907,3830210,3834835,3834923,0,0,4625,4713
10902,3829651,3831052,3834978,0,0,1401,5327
10909,3830325,3834923,3835003,0,0,4598,4678
10910,3830430,3834978,3835050,0,0,4548,4620
10911,3830664,3835003,3835060,0,0,4339,4396
10912,3830776,3835050,3835108,0,0,4274,4332
10913,3830960,3835060,3835127,0,0,4100,4167
10914,3831125,3835108,3835169,0,0,3983,4044
10916,3831283,3835127,3835183,0,0,3844,3900
10917,3831442,3835169,3835235,0,0,3727,3793
10918,3831747,3835183,3835291,0,0,3436,3544
10919,3831852,3835235,3835343,0,0,3383,3491
10922,3832039,3835343,3835368,0,0,3304,3329
10923,3832106,3835368,3835416,0,0,3262,3310
10924,3832176,3835416,3835438,0,0,3240,3262
10925,3832198,3835438,3835476,0,0,3240,3278
10926,3832347,3835476,3835509,0,0,3129,3162
10920,3831869,3835291,3835514,0,0,3422,3645
10856,3823561,3823561,3835983,0,0,0,12422
10927,3832591,3835509,3836211,0,0,2918,3620
10906,3829946,3834835,3836227,0,0,4889,6281
10930,3832925,3836227,3836306,0,0,3302,3381
10929,3832801,3836211,3836309,0,0,3410,3508
10932,3833250,3836309,3836351,0,0,3059,3101
10931,3833169,3836306,3836425,0,0,3137,3256
10933,3833484,3836351,3836526,0,0,2867,3042
10935,3833629,3836526,3836576,0,0,2897,2947
10937,3833763,3836576,3836744,0,0,2813,2981
10934,3833549,3836425,3836782,0,0,2876,3233
10939,3834009,3836782,3836817,0,0,2773,2808
10872,3825925,3825925,3837666,0,0,0,11741
10938,3833972,3836744,3837691,0,0,2772,3719
10921,3831923,3837666,3837693,0,0,5743,5770
10942,3834627,3837691,3837730,0,0,3064,3103
10936,3833637,3837693,3837734,0,0,4056,4097
10905,3829810,3834626,3837747,0,0,4816,7937
10944,3834684,3837747,3837836,0,0,3063,3152
10946,3834924,3837836,3837874,0,0,2912,2950
10947,3834962,3837874,3838007,0,0,2912,3045
10949,3835087,3838007,3838132,0,0,2920,3045
10950,3835211,3838132,3838158,0,0,2921,2947
10952,3835322,3838158,3838369,0,0,2836,3047
10943,3834643,3837730,3838609,0,0,3087,3966
10955,3835490,3838609,3838642,0,0,3119,3152
10941,3834487,3836817,3839004,0,0,2330,4517
10953,3835377,3838369,3839681,0,0,2992,4304
10904,3829803,3834657,3839940,0,0,4854,10137
10945,3834692,3839940,3839980,0,0,5248,5288
10958,3836041,3839004,3840577,0,0,2963,4536
10962,3836589,3840577,3840651,0,0,3988,4062
10963,3836612,3840651,3840791,0,0,4039,4179
10960,3836393,3839681,3840899,0,0,3288,4506
10964,3836765,3840791,3841003,0,0,4026,4238
10966,3837371,3840899,3841520,0,0,3528,4149
10968,3837493,3841520,3841596,0,0,4027,4103
10969,3837661,3841596,3841710,0,0,3935,4049
10970,3837781,3841710,3841780,0,0,3929,3999
10971,3837808,3841780,3841807,0,0,3972,3999
10973,3837902,3841807,3841939,0,0,3905,4037
10873,3826039,3826367,3842149,0,0,328,16110
10928,3832724,3835514,3842320,0,0,2790,9596
10976,3838065,3842320,3842454,0,0,4255,4389
10957,3835987,3838642,3842625,0,0,2655,6638
10897,3829478,3842149,3842751,0,0,12671,13273
10975,3838056,3841939,3842765,0,0,3883,4709
10900,3829539,3842751,3842803,0,0,13212,13264
10908,3830298,3842751,3842807,0,0,12453,12509
10978,3838120,3842625,3842813,0,0,4505,4693
10951,3835306,3842807,3842843,0,0,7501,7537
10915,3831182,3842803,3842858,0,0,11621,11676
10980,3838249,3842813,3842893,0,0,4564,4644
10956,3835820,3842843,3842897,0,0,7023,7077
10979,3838185,3842765,3842920,0,0,4580,4735
10982,3838483,3842897,3842920,0,0,4414,4437
10981,3838364,3842893,3842972,0,0,4529,4608
10987,3841584,3842920,3842974,0,0,1336,1390
10988,3841865,3842920,3842990,0,0,1055,1125
10983,3838504,3842897,3843107,0,0,4393,4603
10991,3842807,3842974,3843161,0,0,167,354
10984,3839109,3843107,3843164,0,0,3998,4055
10989,3842075,3842972,3843307,0,0,897,1232
10993,3843232,3843232,3843311,0,0,0,79
10994,3843505,3843505,3843687,0,0,0,182
10996,3844128,3844128,3844178,0,0,0,50
10998,3844415,3844415,3844461,0,0,0,46
10967,3837405,3841003,3845010,0,0,3598,7605
11000,3845026,3845026,3845419,0,0,0,393
11001,3845639,3845639,3845688,0,0,0,49
11002,3845699,3845699,3845882,0,0,0,183
11003,3845788,3845788,3845932,0,0,0,144
10977,3838088,3842454,3846640,0,0,4366,8552
11006,3847003,3847003,3847235,0,0,0,232
11007,3847047,3847047,3847478,0,0,0,431
10894,3829314,3835983,3847741,0,0,6669,18427
10961,3836462,3847741,3847822,0,0,11279,11360
10893,3829268,3834782,3847898,0,0,5514,18630
11011,3849670,3849670,3849907,0,0,0,237
10999,3844660,3844660,3849914,0,0,0,5254
10990,3842436,3849914,3849943,0,0,7478,7507
10992,3843063,3849943,3849973,0,0,6880,6910
10995,3843640,3849973,3850005,0,0,6333,6365
10997,3844388,3850005,3850035,0,0,5617,5647
10974,3837958,3847822,3851427,0,0,9864,13469
10940,3834106,3837734,3851458,0,0,3628,17352
10959,3836072,3842858,3851599,0,0,6786,15527
11014,3851192,3851458,3851636,0,0,266,444
10880,3827159,3842149,3852030,0,0,14990,24871
11012,3850221,3851458,3852065,0,0,1237,1844
11010,3849073,3851427,3852549,0,0,2354,3476
11015,3852489,3852489,3852590,0,0,0,101
11005,3846134,3850035,3853001,0,0,3901,6867
10986,3841011,3847898,3853002,0,0,6887,11991
11017,3853691,3853691,3854030,0,0,0,339
11018,3854894,3854894,3855278,0,0,0,384
10954,3835461,3842807,3855356,0,0,7346,19895
11004,3845803,3855356,3855455,0,0,9553,9652
11013,3850363,3851599,3855559,0,0,1236,5196
10948,3834995,3839980,3856711,0,0,4985,21716
11022,3855885,3856711,3856728,0,0,826,843
11023,3855938,3856728,3856761,0,0,790,823
11024,3856060,3856761,3856793,0,0,701,733
11021,3855661,3856711,3857002,0,0,1050,1341
11025,3856446,3856793,3857077,0,0,347,631
11027,3856870,3857077,3857127,0,0,207,257
11009,3847406,3855455,3857155,0,0,8049,9749
11028,3857042,3857127,3857194,0,0,85,152
11026,3856860,3857002,3857251,0,0,142,391
11030,3857258,3857258,3857292,0,0,0,34
11029,3857138,3857194,3857410,0,0,56,272
11031,3857376,3857376,3857410,0,0,0,34
11019,3855637,3855637,3857632,0,0,0,1995
11033,3857664,3857664,3857717,0,0,0,53
11034,3857729,3857729,3857806,0,0,0,77
11035,3858193,3858193,3858264,0,0,0,71
11036,3858274,3858274,3858687,0,0,0,413
11037,3858601,3858601,3858741,0,0,0,140
11032,3857658,3857658,3858817,0,0,0,1159
11039,3858885,3858885,3858922,0,0,0,37
11040,3859069,3859069,3859239,0,0,0,170
11038,3858879,3858879,3859241,0,0,0,362
11042,3859180,3859180,3859245,0,0,0,65
10985,3839269,3843164,3859263,0,0,3895,19994
11043,3859225,3859239,3859271,0,0,14,46
11044,3859451,3859451,3859504,0,0,0,53
11046,3859651,3859651,3859679,0,0,0,28
11045,3859616,3859616,3859710,0,0,0,94
11047,3859755,3859755,3859786,0,0,0,31
11048,3859939,3859939,3859969,0,0,0,30
11049,3860049,3860049,3860100,0,0,0,51
11050,3860069,3860069,3860157,0,0,0,88
11051,3860259,3860259,3860319,0,0,0,60
11052,3860434,3860434,3860671,0,0,0,237
11054,3860705,3860705,3860725,0,0,0,20
11041,3859152,3859152,3860896,0,0,0,1744
10965,3837239,3852030,3861340,0,0,14791,24101
11056,3862078,3862078,3862139,0,0,0,61
11020,3855656,3855656,3862146,0,0,0,6490
11053,3860518,3860518,3863209,0,0,0,2691
11055,3861315,3861315,3863636,0,0,0,2321
11058,3863644,3863644,3863667,0,0,0,23
11059,3864587,3864587,3864602,0,0,0,15
11060,3864619,3864619,3865107,0,0,0,488
11062,3865316,3865316,3865332,0,0,0,16
11063,3865468,3865468,3865479,0,0,0,11
11065,3865809,3865809,3865822,0,0,0,13
11066,3865847,3865847,3865864,0,0,0,17
11016,3853198,3857155,3865953,0,0,3957,12755
11068,3866492,3866492,3866958,0,0,0,466
11064,3865539,3865539,3867084,0,0,0,1545
11067,3866373,3866373,3867117,0,0,0,744
11069,3867114,3867114,3867640,0,0,0,526
11072,3867649,3867649,3868005,0,0,0,356
11071,3867635,3867635,3868446,0,0,0,811
11073,3867654,3867654,3868466,0,0,0,812
11074,3868437,3868446,3868891,0,0,9,454
11070,3867534,3867534,3869005,0,0,0,1471
11075,3868667,3868667,3869077,0,0,0,410
11080,3870354,3870354,3870684,0,0,0,330
11082,3871352,3871352,3871464,0,0,0,112
11083,3872144,3872144,3872490,0,0,0,346
11077,3868932,3869005,3873158,0,0,73,4226
11057,3862297,3862297,3873245,0,0,0,10948
11084,3873014,3873014,3873333,0,0,0,319
11078,3869296,3873158,3873520,0,0,3862,4224
11085,3873250,3873520,3873559,0,0,270,309
11086,3873359,3873559,3873742,0,0,200,383
11079,3869554,3873333,3873988,0,0,3779,4434
11087,3873796,3873796,3874155,0,0,0,359
11088,3874156,3874156,3874344,0,0,0,188
10972,3837828,3853001,3875712,0,0,15173,37884
11089,3879426,3879426,3881114,0,0,0,1688
11090,3880559,3880559,3881162,0,0,0,603
11076,3868907,3868907,3881909,0,0,0,13002
11008,3847169,3865953,3883579,0,0,18784,36410
11081,3870424,3883579,3883928,0,0,13155,13504
11092,3888404,3888404,3888659,0,0,0,255
11093,3888679,3888679,3888703,0,0,0,24
11096,3895584,3895584,3896115,0,0,0,531
11099,3897059,3897059,3897100,0,0,0,41
11102,3897471,3897471,3897509,0,0,0,38
11101,3897248,3897248,3897835,0,0,0,587
11103,3897808,3897808,3897866,0,0,0,58
11104,3897983,3897983,3898034,0,0,0,51
11105,3898057,3898057,3898347,0,0,0,290
11107,3898457,3898457,3898603,0,0,0,146
11109,3898705,3898705,3899040,0,0,0,335
11106,3898202,3898202,3899550,0,0,0,1348
11111,3899048,3899550,3899612,0,0,502,564
11110,3898739,3899040,3899655,0,0,301,916
11061,3864807,3881909,3899944,0,0,17102,35137
11113,3899295,3899655,3900824,0,0,360,1529
11115,3900171,3900824,3900898,0,0,653,727
11116,3900347,3900898,3901007,0,0,551,660
11114,3899706,3900824,3901018,0,0,1118,1312
11117,3900504,3901007,3901021,0,0,503,517
11119,3900710,3901021,3901037,0,0,311,327
11120,3900780,3901037,3901068,0,0,257,288
11118,3900543,3901018,3901110,0,0,475,567
11121,3900793,3901068,3901170,0,0,275,377
11123,3900970,3901170,3901255,0,0,200,285
11108,3898465,3898465,3901901,0,0,0,3436
11125,3901143,3901255,3902368,0,0,112,1225
11128,3902094,3902368,3902587,0,0,274,493
11122,3900807,3901110,3902691,0,0,303,1884
11131,3902457,3902691,3902993,0,0,234,536
11132,3902823,3902993,3903012,0,0,170,189
11127,3901331,3901901,3903028,0,0,570,1697
11091,3882839,3883928,3903340,0,0,1089,20501
11135,3903163,3903163,3903361,0,0,0,198
11133,3902871,3903012,3903370,0,0,141,499
11126,3901308,3901901,3903421,0,0,593,2113
11136,3903374,3903421,3903517,0,0,47,143
11137,3903452,3903517,3903532,0,0,65,80
11130,3902409,3902587,3903574,0,0,178,1165
11094,3889162,3899944,3903670,0,0,10782,14508
11095,3895028,3903670,3903729,0,0,8642,8701
11138,3903635,3903635,3903968,0,0,0,333
11097,3896881,3896881,3904320,0,0,0,7439
11140,3904136,3904136,3904427,0,0,0,291
11134,3902982,3903370,3904482,0,0,388,1500
11141,3904178,3904320,3905025,0,0,142,847
11145,3904455,3905025,3905103,0,0,570,648
11124,3901011,3901901,3905169,0,0,890,4158
11146,3904531,3905103,3905195,0,0,572,664
11139,3904124,3904124,3905216,0,0,0,1092
11149,3905120,3905195,3905218,0,0,75,98
11147,3904827,3905169,3905258,0,0,342,431
11148,3905109,3905169,3905261,0,0,60,152
11100,3897238,3903729,3905688,0,0,6491,8450
11129,3902300,3905261,3909229,0,0,2961,6929
11112,3899198,3905688,3910728,0,0,6490,11530
11154,3905496,3910728,3910743,0,0,5232,5247
11157,3905874,3910728,3910770,0,0,4854,4896
11161,3906145,3910728,3910771,0,0,4583,4626
11163,3906264,3910743,3910779,0,0,4479,4515
11159,3905991,3910728,3910783,0,0,4737,4792
11164,3906394,3910770,3910799,0,0,4376,4405
11167,3906611,3910783,3910840,0,0,4172,4229
11152,3905321,3910728,3910847,0,0,5407,5526
11150,3905290,3910728,3910853,0,0,5438,5563
11165,3906429,3910771,3910888,0,0,4342,4459
11153,3905461,3910728,3910890,0,0,5267,5429
11170,3906774,3910847,3910912,0,0,4073,4138
11168,3906667,3910799,3910923,0,0,4132,4256
11177,3907367,3910890,3910985,0,0,3523,3618
11173,3907147,3910888,3910986,0,0,3741,3839
11171,3906867,3910853,3911023,0,0,3986,4156
11180,3907588,3910923,3911029,0,0,3335,3441
11155,3905680,3910728,3911056,0,0,5048,5376
11151,3905316,3910728,3911081,0,0,5412,5765
11184,3907783,3911029,3911093,0,0,3246,3310
11191,3908341,3911093,3911113,0,0,2752,2772
11176,3907355,3910890,3911124,0,0,3535,3769
11192,3908473,3911113,3911258,0,0,2640,2785
11156,3905849,3910728,3911262,0,0,4879,5413
11186,3907864,3911081,3911285,0,0,3217,3421
11196,3908728,3911258,3911472,0,0,2530,2744
11185,3907846,3911056,3911473,0,0,3210,3627
11197,3908744,3911262,3911503,0,0,2518,2759
11200,3909146,3911472,3911523,0,0,2326,2377
11202,3909230,3911503,3911560,0,0,2273,2330
11201,3909206,3911473,3911578,0,0,2267,2372
11183,3907730,3911023,3911655,0,0,3293,3925
11158,3905921,3910728,3911690,0,0,4807,5769
11211,3909847,3911690,3911709,0,0,1843,1862
11206,3909297,3911578,3911716,0,0,2281,2419
11195,3908605,3911124,3911739,0,0,2519,3134
11213,3909877,3911709,3911781,0,0,1832,1904
11216,3910117,3911781,3911798,0,0,1664,1681
11182,3907708,3910986,3911812,0,0,3278,4104
11214,3909925,3911716,3911828,0,0,1791,1903
11208,3909680,3911655,3911830,0,0,1975,2150
11169,3906680,3910840,3911833,0,0,4160,5153
11223,3911148,3911830,3911843,0,0,682,695
11221,3910437,3911828,3911849,0,0,1391,1412
11227,3911401,3911843,3911875,0,0,442,474
11203,3909242,3911523,3911877,0,0,2281,2635
11228,3911555,3911849,3911898,0,0,294,343
11226,3911341,3911833,3911923,0,0,492,582
11230,3911800,3911877,3911935,0,0,77,135
11232,3911933,3911935,3911945,0,0,2,12
11229,3911610,3911875,3911951,0,0,265,341
11179,3907427,3910912,3912041,0,0,3485,4614
11178,3907373,3911923,3912066,0,0,4550,4693
11188,3908141,3911951,3912109,0,0,3810,3968
11234,3912124,3912124,3912134,0,0,0,10
11217,3910141,3911798,3912209,0,0,1657,2068
11212,3909861,3912109,3912291,0,0,2248,2430
11220,3910347,3912209,3912379,0,0,1862,2032
11235,3912250,3912379,3912390,0,0,129,140
11098,3896927,3903340,3912408,0,0,6413,15481
11174,3907158,3912408,3912462,0,0,5250,5304
11172,3906872,3912408,3912489,0,0,5536,5617
11236,3912481,3912481,3912496,0,0,0,15
11187,3908062,3912489,3912544,0,0,4427,4482
11237,3912647,3912647,3912657,0,0,0,10
11238,3912672,3912672,3912726,0,0,0,54
11240,3912884,3912884,3912943,0,0,0,59
11241,3913072,3913072,3913149,0,0,0,77
11239,3912864,3912864,3913253,0,0,0,389
11218,3910244,3911812,3913330,0,0,1568,3086
11243,3913389,3913389,3913463,0,0,0,74
11198,3908854,3911285,3913478,0,0,2431,4624
11245,3913713,3913713,3913778,0,0,0,65
11247,3913988,3913988,3914046,0,0,0,58
11244,3913429,3913429,3914466,0,0,0,1037
11242,3913359,3913359,3914787,0,0,0,1428
11248,3914051,3914051,3914790,0,0,0,739
11194,3908518,3914790,3914847,0,0,6272,6329
11204,3909250,3914847,3914907,0,0,5597,5657
11207,3909408,3914907,3914955,0,0,5499,5547
11210,3909805,3914955,3915015,0,0,5150,5210
11249,3914092,3915015,3915098,0,0,923,1006
11250,3914430,3915098,3915146,0,0,668,716
11253,3914994,3915146,3915231,0,0,152,237
11251,3914813,3915146,3915332,0,0,333,519
11256,3915326,3915326,3915568,0,0,0,242
11215,3909953,3911739,3916068,0,0,1786,6115
11262,3916204,3916204,3916259,0,0,0,55
11233,3912006,3912291,3916374,0,0,285,4368
11254,3915040,3916374,3916437,0,0,1334,1397
11257,3915510,3916437,3916502,0,0,927,992
11259,3915898,3915898,3916577,0,0,0,679
11264,3916380,3916577,3916631,0,0,197,251
11258,3915805,3916502,3916776,0,0,697,971
11261,3916164,3916164,3916841,0,0,0,677
11266,3916542,3916841,3917023,0,0,299,481
11265,3916500,3916631,3917069,0,0,131,569
11269,3917066,3917069,3917185,0,0,3,119
11270,3917088,3917185,3917204,0,0,97,116
11166,3906479,3910779,3917217,0,0,4300,10738
11142,3904414,3904427,3917323,0,0,13,12909
11272,3917213,3917213,3917364,0,0,0,151
11276,3917366,3917366,3917383,0,0,0,17
11277,3917396,3917396,3917431,0,0,0,35
11273,3917258,3917258,3917482,0,0,0,224
11267,3916658,3917023,3917498,0,0,365,840
11205,3909291,3911560,3918065,0,0,2269,8774
11282,3917598,3918065,3918078,0,0,467,480
11279,3917480,3917480,3918639,0,0,0,1159
11284,3917682,3918639,3918693,0,0,957,1011
11285,3918092,3918693,3918756,0,0,601,664
11255,3915163,3915163,3919093,0,0,0,3930
11287,3918250,3919093,3919904,0,0,843,1654
11288,3918258,3919904,3919935,0,0,1646,1677
11290,3918520,3919935,3920287,0,0,1415,1767
11292,3919154,3920287,3920304,0,0,1133,1150
11293,3919187,3920304,3920313,0,0,1117,1126
11294,3919245,3920313,3920322,0,0,1068,1077
11181,3907611,3910985,3920566,0,0,3374,12955
11162,3906229,3910728,3920598,0,0,4499,14369
11283,3917619,3918078,3920633,0,0,459,3014
11298,3919699,3920633,3920695,0,0,934,996
11299,3919749,3920695,3920714,0,0,946,965
11263,3916324,3920598,3920750,0,0,4274,4426
11301,3920336,3920714,3921416,0,0,378,1080
11302,3920412,3921416,3921437,0,0,1004,1025
11144,3904439,3909229,3921862,0,0,4790,17423
11286,3918243,3918756,3922387,0,0,513,4144
11306,3920989,3922387,3922484,0,0,1398,1495
11193,3908489,3912066,3922534,0,0,3577,14045
11307,3921425,3922484,3922575,0,0,1059,1150
11305,3920921,3921437,3922620,0,0,516,1699
11295,3919501,3922534,3922706,0,0,3033,3205
11309,3921605,3922620,3922725,0,0,1015,1120
11311,3921936,3922706,3922768,0,0,770,832
11308,3921572,3922575,3922891,0,0,1003,1319
11297,3919658,3920566,3923042,0,0,908,3384
11312,3922061,3922706,3923051,0,0,645,990
11317,3923020,3923042,3923189,0,0,22,169
11320,3923337,3923337,3923426,0,0,0,89
11316,3922999,3922999,3923773,0,0,0,774
11322,3923871,3923871,3923889,0,0,0,18
11323,3923899,3923899,3923962,0,0,0,63
11321,3923444,3923444,3923985,0,0,0,541
11190,3908276,3912544,3923993,0,0,4268,15717
11280,3917512,3923993,3924092,0,0,6481,6580
11281,3917525,3924092,3924146,0,0,6567,6621
11268,3916771,3920750,3924207,0,0,3979,7436
11291,3918798,3924207,3924274,0,0,5409,5476
11289,3918340,3924146,3924278,0,0,5806,5938
11303,3920504,3924274,3924316,0,0,3770,3812
11324,3924296,3924296,3924363,0,0,0,67
11310,3921702,3924316,3924371,0,0,2614,2669
11326,3924693,3924693,3924702,0,0,0,9
11318,3923124,3923124,3924785,0,0,0,1661
11314,3922477,3922725,3924944,0,0,248,2467
11296,3919612,3920322,3925099,0,0,710,5487
11327,3924759,3924759,3925142,0,0,0,383
11275,3917303,3917323,3925191,0,0,20,7888
11325,3924592,3924592,3925358,0,0,0,766
11329,3925221,3925221,3925430,0,0,0,209
11332,3925549,3925549,3926004,0,0,0,455
11175,3907245,3912462,3926051,0,0,5217,18806
11333,3925600,3926004,3926094,0,0,404,494
11260,3916101,3916776,3926174,0,0,675,10073
11336,3925901,3926174,3926526,0,0,273,625
11331,3925510,3926051,3927616,0,0,541,2106
11225,3911336,3925191,3934090,0,0,13855,22754
11337,3926417,3926417,3934350,0,0,0,7933
11328,3924855,3924855,3934389,0,0,0,9534
11339,3926916,3926916,3934408,0,0,0,7492
11143,3904431,3904482,3934409,0,0,51,29978
11338,3926479,3926479,3934414,0,0,0,7935
11278,3917402,3917498,3934453,0,0,96,17051
11315,3922700,3922768,3934457,0,0,68,11757
11319,3923277,3934409,3934528,0,0,11132,11251
11330,3925241,3925358,3934533,0,0,117,9292
11341,3934791,3934791,3934796,0,0,0,5
11334,3925614,3926094,3934867,0,0,480,9253
11304,3920845,3924278,3937744,0,0,3433,16899
11271,3917198,3921862,3938984,0,0,4664,21786
11160,3905999,3937744,3939976,0,0,31745,33977
11343,3940563,3940563,3940596,0,0,0,33
11189,3908267,3939976,3940735,0,0,31709,32468
11344,3940908,3940908,3940967,0,0,0,59
11199,3909038,3940735,3941443,0,0,31697,32405
11346,3941236,3941236,3941606,0,0,0,370
11209,3909759,3941443,3941950,0,0,31684,32191
11347,3941665,3941665,3942099,0,0,0,434
11348,3942009,3942009,3942100,0,0,0,91
11219,3910292,3941950,3942317,0,0,31658,32025
11222,3910812,3942317,3942646,0,0,31505,31834
11224,3911193,3942646,3943363,0,0,31453,32170
11349,3944637,3944637,3944826,0,0,0,189
11231,3911916,3943363,3945375,0,0,31447,33459
11246,3913937,3945375,3945422,0,0,31438,31485
11350,3945351,3945351,3945534,0,0,0,183
11252,3914824,3945422,3945976,0,0,30598,31152
11351,3945832,3945832,3946017,0,0,0,185
11352,3946383,3946383,3946669,0,0,0,286
11340,3932471,3932471,3946820,0,0,0,14349
11274,3917292,3945976,3947397,0,0,28684,30105
11313,3922222,3947397,3947984,0,0,25175,25762
11300,3920233,3934090,3948063,0,0,13857,27830
11345,3941153,3948063,3948083,0,0,6910,6930
11342,3935523,3935523,3948749,0,0,0,13226
11356,3948928,3948928,3949029,0,0,0,101
11335,3925810,3947984,3949557,0,0,22174,23747
11358,3950276,3950276,3950468,0,0,0,192
11359,3950502,3950502,3950687,0,0,0,185
11357,3949334,3949334,3950994,0,0,0,1660
11361,3951074,3951074,3952710,0,0,0,1636
11353,3947595,3947595,3953520,0,0,0,5925
11362,3952828,3952828,3954083,0,0,0,1255
11363,3952991,3952991,3954137,0,0,0,1146
11364,3954461,3954461,3956253,0,0,0,1792
11360,3950760,3950760,3957662,0,0,0,6902
11365,3954676,3954676,3958176,0,0,0,3500
11366,3958106,3958106,3961550,0,0,0,3444
11367,3958810,3958810,3962196,0,0,0,3386
11368,3961492,3961492,3964864,0,0,0,3372
11369,3964774,3964774,3968402,0,0,0,3628
11370,3968353,3968353,3971632,0,0,0,3279
11371,3971566,3971566,3975004,0,0,0,3438
11372,3974943,3974943,3978275,0,0,0,3332
11355,3948295,3948295,3979242,0,0,0,30947
11373,3978219,3978219,3981511,0,0,0,3292
11354,3948290,3948290,3983610,0,0,0,35320
11375,3981446,3981446,3984720,0,0,0,3274
11374,3981410,3981410,3984801,0,0,0,3391
11376,3984651,3984651,3987099,0,0,0,2448
11377,3987034,3987034,3989344,0,0,0,2310
11380,3989293,3989293,3991604,0,0,0,2311
11378,3987323,3987323,3992115,0,0,0,4792
11384,3993520,3993520,3993547,0,0,0,27
11382,3991534,3991534,3993890,0,0,0,2356
11381,3989348,3989348,3995862,0,0,0,6514
11386,3993835,3993835,3996230,0,0,0,2395
11388,3996179,3996179,3998514,0,0,0,2335
11389,3998442,3998442,4000772,0,0,0,2330
11383,3992119,3992119,4001373,0,0,0,9254
11392,4002576,4002576,4002682,0,0,0,106
11390,4000714,4000714,4003051,0,0,0,2337
11387,3995801,3995801,4003297,0,0,0,7496
11393,4002709,4002709,4003338,0,0,0,629
11396,4003363,4003363,4003724,0,0,0,361
11379,3989250,3989250,4003785,0,0,0,14535
11398,4005029,4005029,4005112,0,0,0,83
11399,4005250,4005250,4005266,0,0,0,16
11394,4002992,4002992,4005317,0,0,0,2325
11401,4006200,4006200,4006464,0,0,0,264
11400,4005265,4005265,4007613,0,0,0,2348
11391,4001378,4001378,4008583,0,0,0,7205
11395,4003352,4003352,4009250,0,0,0,5898
11397,4003387,4003387,4009384,0,0,0,5997
11404,4009263,4009263,4009514,0,0,0,251
11402,4007547,4007547,4009875,0,0,0,2328
11406,4010255,4010255,4010484,0,0,0,229
11385,3993594,3993594,4011620,0,0,0,18026
11407,4011463,4011463,4011686,0,0,0,223
11405,4009813,4009813,4012272,0,0,0,2459
11409,4012273,4012273,4013188,0,0,0,915
11403,4009236,4009236,4013309,0,0,0,4073
11413,4014740,4014740,4015122,0,0,0,382
11408,4012256,4012256,4015687,0,0,0,3431
11416,4016256,4016256,4016404,0,0,0,148
11411,4013252,4013252,4016850,0,0,0,3598
11418,4017424,4017424,4017862,0,0,0,438
11419,4018474,4018474,4018863,0,0,0,389
11415,4015619,4015619,4019750,0,0,0,4131
11420,4019366,4019366,4019773,0,0,0,407
11422,4020212,4020212,4020880,0,0,0,668
11423,4020931,4020931,4020949,0,0,0,18
11412,4013916,4013916,4021328,0,0,0,7412
11424,4021237,4021237,4021764,0,0,0,527
11425,4022161,4022161,4022179,0,0,0,18
11414,4015489,4015489,4023010,0,0,0,7521
11417,4016788,4016788,4023015,0,0,0,6227
11421,4019703,4019703,4023222,0,0,0,3519
11428,4023067,4023067,4023305,0,0,0,238
11410,4012552,4012552,4023593,0,0,0,11041
11431,4023697,4023697,4023800,0,0,0,103
11432,4023927,4023927,4024294,0,0,0,367
11433,4024317,4024317,4024591,0,0,0,274
11434,4024982,4024982,4025299,0,0,0,317
11429,4023188,4023188,4025577,0,0,0,2389
11435,4025300,4025300,4025750,0,0,0,450
11437,4025800,4025800,4026115,0,0,0,315
11438,4026221,4026221,4026437,0,0,0,216
11439,4026624,4026624,4026952,0,0,0,328
11440,4026808,4026808,4027117,0,0,0,309
11436,4025555,4025555,4028012,0,0,0,2457
11442,4028297,4028297,4028544,0,0,0,247
11426,4022984,4022984,4028749,0,0,0,5765
11427,4023023,4023023,4029969,0,0,0,6946
11445,4029803,4029803,4030028,0,0,0,225
11441,4027949,4027949,4030536,0,0,0,2587
11444,4029724,4029724,4030588,0,0,0,864
11447,4030715,4030715,4030849,0,0,0,134
11446,4030489,4030489,4032999,0,0,0,2510
11430,4023593,4023593,4034156,0,0,0,10563
11451,4034473,4034473,4034574,0,0,0,101
11452,4034585,4034585,4034614,0,0,0,29
11449,4032938,4032938,4035353,0,0,0,2415
11454,4035290,4035290,4037915,0,0,0,2625
11453,4034705,4034705,4038665,0,0,0,3960
11443,4029471,4029471,4039844,0,0,0,10373
11456,4037852,4037852,4040296,0,0,0,2444
11458,4040232,4040232,4042520,0,0,0,2288
11459,4042510,4042510,4044866,0,0,0,2356
11460,4044796,4044796,4047124,0,0,0,2328
11461,4047059,4047059,4049421,0,0,0,2362
11448,4032319,4034156,4051155,0,0,1837,18836
11455,4037490,4037490,4051937,0,0,0,14447
11464,4049364,4049364,4051939,0,0,0,2575
11450,4034159,4039844,4053884,0,0,5685,19725
11465,4051915,4051915,4054266,0,0,0,2351
11468,4054203,4054203,4056526,0,0,0,2323
11457,4039845,4051155,4058723,0,0,11310,18878
11462,4047413,4053884,4058893,0,0,6471,11480
11469,4056458,4056458,4058893,0,0,0,2435
11470,4058833,4058833,4061167,0,0,0,2334
11471,4061094,4061094,4063552,0,0,0,2458
11466,4051940,4051940,4066144,0,0,0,14204
11472,4063493,4063493,4066171,0,0,0,2678
11467,4053217,4058723,4066253,0,0,5506,13036
11473,4066111,4066111,4068524,0,0,0,2413
11475,4068458,4068458,4070798,0,0,0,2340
11463,4048202,4058893,4073143,0,0,10691,24941
11477,4070736,4070736,4073367,0,0,0,2631
11480,4073303,4073303,4075643,0,0,0,2340
11476,4070107,4070107,4075795,0,0,0,5688
11482,4075645,4075645,4075851,0,0,0,206
11484,4076022,4076022,4076359,0,0,0,337
11485,4077648,4077648,4077660,0,0,0,12
11486,4077667,4077667,4077676,0,0,0,9
11488,4077765,4077765,4077814,0,0,0,49
11487,4077749,4077749,4077960,0,0,0,211
11481,4075617,4075617,4078043,0,0,0,2426
11490,4078051,4078051,4078195,0,0,0,144
11478,4071361,4071361,4078232,0,0,0,6871
11491,4078397,4078397,4078602,0,0,0,205
11493,4078815,4078815,4079041,0,0,0,226
11495,4079768,4079768,4079975,0,0,0,207
11497,4080365,4080365,4080423,0,0,0,58
11489,4078006,4078006,4080502,0,0,0,2496
11483,4075733,4075733,4081315,0,0,0,5582
11500,4080505,4080505,4081716,0,0,0,1211
11498,4080473,4080473,4081718,0,0,0,1245
11499,4080479,4080502,4082909,0,0,23,2430
11502,4082097,4082097,4083687,0,0,0,1590
11504,4082831,4082909,4085280,0,0,78,2449
11479,4071964,4078232,4085949,0,0,6268,13985
11507,4087179,4087179,4087270,0,0,0,91
11506,4085202,4085202,4087735,0,0,0,2533
11474,4067463,4073143,4087986,0,0,5680,20523
11510,4088084,4088084,4088120,0,0,0,36
11513,4089529,4089529,4089594,0,0,0,65
11514,4089811,4089811,4089832,0,0,0,21
11515,4090044,4090044,4090067,0,0,0,23
11508,4087727,4087727,4090099,0,0,0,2372
11492,4078655,4081315,4090515,0,0,2660,11860
11518,4090493,4090493,4091002,0,0,0,509
11519,4090955,4091002,4092417,0,0,47,1462
11520,4091614,4092417,4092431,0,0,803,817
11521,4091704,4092417,4093291,0,0,713,1587
11516,4090076,4090076,4093561,0,0,0,3485
11494,4079682,4085949,4095245,0,0,6267,15563
11522,4091859,4093291,4095362,0,0,1432,3503
11526,4094508,4095362,4095401,0,0,854,893
11527,4095038,4095401,4095436,0,0,363,398
11528,4095426,4095436,4095480,0,0,10,54
11529,4095689,4095689,4095728,0,0,0,39
11523,4093495,4093561,4096083,0,0,66,2588
11501,4081253,4087986,4096105,0,0,6733,14852
11525,4094452,4095362,4096204,0,0,910,1752
11531,4096346,4096346,4096381,0,0,0,35
11533,4096424,4096424,4096455,0,0,0,31
11534,4096686,4096686,4096718,0,0,0,32
11535,4096746,4096746,4096954,0,0,0,208
11536,4097387,4097387,4097659,0,0,0,272
11496,4080291,4087986,4098707,0,0,7695,18416
11530,4095951,4096083,4098738,0,0,132,2787
11505,4082986,4087986,4099759,0,0,5000,16773
11509,4087863,4090515,4101118,0,0,2652,13255
11538,4098051,4098707,4101219,0,0,656,3168
11540,4098540,4098738,4102800,0,0,198,4260
11537,4097777,4097777,4103774,0,0,0,5997
11512,4089376,4095245,4103925,0,0,5869,14549
11544,4103518,4103774,4103925,0,0,256,407
11545,4103808,4103808,4104111,0,0,0,303
11546,4104150,4104150,4104504,0,0,0,354
11517,4090159,4095245,4104950,0,0,5086,14791
11547,4105402,4105402,4105687,0,0,0,285
11543,4102532,4102800,4105785,0,0,268,3253
11550,4106213,4106213,4106265,0,0,0,52
11551,4106460,4106460,4106550,0,0,0,90
11524,4094362,4096105,4107585,0,0,1743,13223
11548,4105461,4105461,4109313,0,0,0,3852
11541,4100450,4100450,4109850,0,0,0,9400
11539,4098477,4099759,4111068,0,0,1282,12591
11549,4105833,4105833,4113357,0,0,0,7524
11552,4109246,4109246,4113359,0,0,0,4113
11558,4113254,4113359,4113405,0,0,105,151
11554,4111191,4113357,4113436,0,0,2166,2245
11556,4112025,4113357,4113456,0,0,1332,1431
11557,4112823,4113359,4113462,0,0,536,639
11560,4113358,4113405,4113504,0,0,47,146
11561,4113592,4113592,4113632,0,0,0,40
11563,4114295,4114295,4114409,0,0,0,114
11559,4113353,4113456,4115777,0,0,103,2424
11564,4115604,4115604,4118123,0,0,0,2519
11553,4109858,4111068,4119883,0,0,1210,10025
11566,4118059,4118059,4120601,0,0,0,2542
11567,4120537,4120537,4123064,0,0,0,2527
11542,4100997,4101219,4123879,0,0,222,22882
11503,4082311,4109850,4123948,0,0,27539,41637
11568,4123002,4123002,4125560,0,0,0,2558
11570,4125495,4125495,4128043,0,0,0,2548
11571,4127977,4127977,4130591,0,0,0,2614
11555,4111913,4119883,4130799,0,0,7970,18886
11572,4130533,4130533,4133135,0,0,0,2602
11562,4113875,4123879,4133770,0,0,10004,19895
11575,4133912,4133912,4133983,0,0,0,71
11573,4133024,4133024,4135390,0,0,0,2366
11574,4133480,4133480,4137473,0,0,0,3993
11576,4135340,4135390,4137865,0,0,50,2525
11569,4124063,4124063,4138225,0,0,0,14162
11580,4138766,4138766,4140456,0,0,0,1690
11577,4137749,4137749,4140893,0,0,0,3144
11565,4115955,4133770,4141336,0,0,17815,25381
11581,4140829,4140829,4143146,0,0,0,2317
11511,4088982,4123948,4143485,0,0,34966,54503
11582,4143082,4143082,4145532,0,0,0,2450
11583,4145470,4145470,4147790,0,0,0,2320
11584,4147726,4147726,4150060,0,0,0,2334
11585,4149995,4149995,4152415,0,0,0,2420
11579,4138267,4138267,4152734,0,0,0,14467
11586,4152351,4152351,4154678,0,0,0,2327
11589,4156013,4156013,4156269,0,0,0,256
11578,4137860,4141336,4156450,0,0,3476,18590
11588,4154613,4154613,4157060,0,0,0,2447
11591,4156936,4156936,4159182,0,0,0,2246
11594,4159165,4159182,4159443,0,0,17,278
11595,4159298,4159443,4159525,0,0,145,227
11593,4158997,4158997,4159546,0,0,0,549
11598,4160241,4160241,4160311,0,0,0,70
11592,4157020,4157020,4160777,0,0,0,3757
11532,4096410,4143485,4161214,0,0,47075,64804
11601,4160845,4161214,4161329,0,0,369,484
11602,4161207,4161214,4161495,0,0,7,288
11603,4161451,4161451,4161550,0,0,0,99
11604,4161685,4161685,4161772,0,0,0,87
11599,4160353,4160353,4161802,0,0,0,1449
11607,4161891,4161891,4161937,0,0,0,46
11606,4161765,4161772,4161974,0,0,7,209
11610,4162385,4162385,4162427,0,0,0,42
11608,4161985,4161985,4162634,0,0,0,649
11611,4162402,4162427,4162810,0,0,25,408
11612,4163059,4163059,4163101,0,0,0,42
11614,4163260,4163260,4163292,0,0,0,32
11600,4160708,4160777,4163322,0,0,69,2614
11615,4163555,4163555,4163929,0,0,0,374
11616,4163751,4163751,4163963,0,0,0,212
11617,4163901,4163901,4163969,0,0,0,68
11618,4164068,4164068,4164130,0,0,0,62
11619,4164488,4164488,4164550,0,0,0,62
11620,4164530,4164530,4164584,0,0,0,54
11622,4164739,4164739,4164787,0,0,0,48
11621,4164566,4164566,4165198,0,0,0,632
11624,4165358,4165358,4165414,0,0,0,56
11613,4163245,4163245,4165539,0,0,0,2294
11623,4164916,4164916,4165666,0,0,0,750
11625,4165500,4165500,4165811,0,0,0,311
11630,4166051,4166051,4166121,0,0,0,70
11590,4156601,4161214,4166174,0,0,4613,9573
11596,4159581,4159581,4166223,0,0,0,6642
11597,4159596,4159596,4166333,0,0,0,6737
11628,4165964,4165964,4166440,0,0,0,476
11627,4165732,4165732,4166625,0,0,0,893
11636,4166668,4166668,4166710,0,0,0,42
11640,4166965,4166965,4167024,0,0,0,59
11637,4166676,4166676,4167026,0,0,0,350
11638,4166738,4166738,4167183,0,0,0,445
11641,4167249,4167249,4167290,0,0,0,41
11634,4166501,4166501,4167388,0,0,0,887
11642,4167434,4167434,4167486,0,0,0,52
11635,4166632,4166632,4167562,0,0,0,930
11644,4167716,4167716,4167738,0,0,0,22
11643,4167703,4167703,4167763,0,0,0,60
11647,4168115,4168115,4168175,0,0,0,60
11648,4168627,4168627,4168670,0,0,0,43
11605,4161719,4161719,4168721,0,0,0,7002
11626,4165518,4165518,4168855,0,0,0,3337
11631,4166236,4166236,4168865,0,0,0,2629
11639,4166917,4166917,4168889,0,0,0,1972
11654,4168955,4168955,4169004,0,0,0,49
11655,4169130,4169130,4169185,0,0,0,55
11657,4169575,4169575,4169617,0,0,0,42
11653,4168909,4168909,4169647,0,0,0,738
11587,4152974,4156450,4170282,0,0,3476,17308
11658,4169760,4169760,4170436,0,0,0,676
11661,4170378,4170378,4170461,0,0,0,83
11663,4170477,4170477,4170514,0,0,0,37
11664,4170659,4170659,4170695,0,0,0,36
11646,4168107,4168107,4170784,0,0,0,2677
11662,4170454,4170454,4170814,0,0,0,360
11660,4170057,4170784,4170971,0,0,727,914
11652,4168832,4168855,4171188,0,0,23,2356
11667,4171264,4171264,4171324,0,0,0,60
11666,4171229,4171229,4171424,0,0,0,195
11669,4171470,4171470,4171651,0,0,0,181
11671,4171667,4171667,4171697,0,0,0,30
11668,4171319,4171319,4171706,0,0,0,387
11650,4168725,4168725,4171985,0,0,0,3260
11674,4171887,4171985,4171997,0,0,98,110
11670,4171520,4171520,4172006,0,0,0,486
11632,4166325,4166325,4172106,0,0,0,5781
11677,4172221,4172221,4172280,0,0,0,59
11678,4172255,4172255,4172299,0,0,0,44
11649,4168658,4168658,4172418,0,0,0,3760
11675,4171913,4171985,4172503,0,0,72,590
11672,4171725,4171725,4172505,0,0,0,780
11679,4172510,4172510,4172541,0,0,0,31
11656,4169546,4170282,4172666,0,0,736,3120
11681,4173020,4173020,4173058,0,0,0,38
11682,4173207,4173207,4173237,0,0,0,30
11683,4173240,4173240,4173317,0,0,0,77
11633,4166459,4166459,4173318,0,0,0,6859
11686,4173386,4173386,4173418,0,0,0,32
11687,4173592,4173592,4173623,0,0,0,31
11688,4173677,4173677,4173707,0,0,0,30
11689,4173805,4173805,4173838,0,0,0,33
11684,4173270,4173270,4174272,0,0,0,1002
11609,4162237,4172666,4174464,0,0,10429,12227
11665,4171132,4171132,4175043,0,0,0,3911
11692,4174717,4174717,4175411,0,0,0,694
11690,4173943,4173943,4176048,0,0,0,2105
11629,4165977,4174464,4176268,0,0,8487,10291
11697,4175268,4176048,4176907,0,0,780,1639
11698,4175355,4176907,4177362,0,0,1552,2007
11699,4175438,4177362,4177480,0,0,1924,2042
11701,4175806,4177480,4177728,0,0,1674,1922
11702,4176192,4177728,4177794,0,0,1536,1602
11704,4176517,4177794,4177840,0,0,1277,1323
11645,4167951,4176268,4178020,0,0,8317,10069
11673,4171745,4171745,4178043,0,0,0,6298
11706,4176842,4178043,4178123,0,0,1201,1281
11676,4172079,4172079,4178236,0,0,0,6157
11705,4176548,4177840,4178316,0,0,1292,1768
11709,4178126,4178316,4178360,0,0,190,234
11685,4173358,4178236,4178361,0,0,4878,5003
11680,4172802,4172802,4178399,0,0,0,5597
11707,4177002,4178043,4178624,0,0,1041,1622
11711,4180521,4180521,4180564,0,0,0,43
11693,4174929,4178399,4181165,0,0,3470,6236
11700,4175666,4181165,4181650,0,0,5499,5984
11694,4175031,4175031,4183569,0,0,0,8538
11695,4175070,4175070,4183571,0,0,0,8501
11715,4183805,4183805,4183845,0,0,0,40
11696,4175131,4175411,4183888,0,0,280,8757
11708,4177715,4178123,4184033,0,0,408,6318
11716,4184079,4184079,4184122,0,0,0,43
11717,4184195,4184195,4184836,0,0,0,641
11718,4184822,4184822,4184913,0,0,0,91
11714,4183716,4183716,4184943,0,0,0,1227
11712,4181353,4181353,4185199,0,0,0,3846
11651,4168796,4178020,4185438,0,0,9224,16642
11720,4185226,4185226,4185500,0,0,0,274
11724,4185669,4185669,4186222,0,0,0,553
11726,4186304,4186304,4186342,0,0,0,38
11725,4185779,4185779,4186435,0,0,0,656
11727,4186503,4186503,4186541,0,0,0,38
11729,4187780,4187780,4188156,0,0,0,376
11730,4188109,4188109,4188157,0,0,0,48
11731,4188300,4188300,4188326,0,0,0,26
11713,4183471,4183471,4188354,0,0,0,4883
11732,4188316,4188316,4188495,0,0,0,179
11734,4188488,4188488,4188506,0,0,0,18
11735,4188513,4188513,4188563,0,0,0,50
11736,4188602,4188602,4188626,0,0,0,24
11737,4188629,4188629,4188645,0,0,0,16
11738,4188649,4188649,4188663,0,0,0,14
11740,4188733,4188733,4188750,0,0,0,17
11728,4187602,4187602,4188913,0,0,0,1311
11741,4188877,4188877,4188948,0,0,0,71
11742,4188964,4188964,4189001,0,0,0,37
11733,4188408,4188408,4189044,0,0,0,636
11719,4185122,4185122,4189052,0,0,0,3930
11744,4189456,4189456,4189597,0,0,0,141
11722,4185562,4185562,4189679,0,0,0,4117
11703,4176281,4189679,4189697,0,0,13398,13416
11743,4189351,4189351,4190286,0,0,0,935
11659,4170048,4185438,4191708,0,0,15390,21660
11739,4188690,4188690,4192518,0,0,0,3828
11745,4189755,4190286,4194927,0,0,531,5172
11749,4194203,4194927,4196087,0,0,724,1884
11752,4197741,4197741,4197869,0,0,0,128
11753,4197960,4197960,4198006,0,0,0,46
11747,4190299,4192518,4198344,0,0,2219,8045
11691,4174417,4178361,4199620,0,0,3944,25203
11710,4179319,4189697,4203441,0,0,10378,24122
11721,4185478,4191708,4203671,0,0,6230,18193
11746,4189788,4198344,4204054,0,0,8556,14266
11748,4190820,4199620,4204494,0,0,8800,13674
11756,4201051,4204054,4204598,0,0,3003,3547
11759,4204663,4204663,4204915,0,0,0,252
11723,4185618,4203441,4204920,0,0,17823,19302
11760,4205076,4205076,4205235,0,0,0,159
11761,4205493,4205493,4207962,0,0,0,2469
11757,4201743,4204054,4207977,0,0,2311,6234
11754,4198910,4203671,4209472,0,0,4761,10562
11762,4207895,4207895,4210518,0,0,0,2623
11750,4195502,4203671,4210664,0,0,8169,15162
11764,4210459,4210459,4212770,0,0,0,2311
11767,4214353,4214353,4214713,0,0,0,360
11765,4212704,4212704,4215023,0,0,0,2319
11768,4214962,4214962,4217429,0,0,0,2467
11769,4217152,4217152,4218608,0,0,0,1456
11771,4218678,4218678,4218972,0,0,0,294
11772,4219206,4219206,4219767,0,0,0,561
11773,4219983,4219983,4220326,0,0,0,343
11774,4220352,4220352,4220642,0,0,0,290
11770,4217365,4217429,4221239,0,0,64,3874
11775,4221000,4221000,4221681,0,0,0,681
11776,4221094,4221239,4223873,0,0,145,2779
11763,4210099,4210664,4224888,0,0,565,14789
11751,4197438,4209472,4224918,0,0,12034,27480
11777,4223641,4223641,4225980,0,0,0,2339
11755,4199523,4203671,4226669,0,0,4148,27146
11778,4225936,4225936,4228362,0,0,0,2426
11779,4228300,4228300,4230620,0,0,0,2320
11758,4203394,4224918,4231528,0,0,21524,28134
11780,4230552,4230552,4232893,0,0,0,2341
11781,4232828,4232828,4235317,0,0,0,2489
11782,4235235,4235235,4237576,0,0,0,2341
11784,4237526,4237526,4239854,0,0,0,2328
11786,4241158,4241158,4241173,0,0,0,15
11787,4241498,4241498,4241510,0,0,0,12
11785,4239782,4239782,4242117,0,0,0,2335
11790,4242180,4242180,4242195,0,0,0,15
11791,4242452,4242452,4243052,0,0,0,600
11794,4243437,4243437,4243481,0,0,0,44
11792,4243006,4243006,4243773,0,0,0,767
11796,4243692,4243773,4243817,0,0,81,125
11797,4243959,4243959,4244001,0,0,0,42
11795,4243570,4243570,4244180,0,0,0,610
11799,4244286,4244286,4244326,0,0,0,40
11789,4242058,4242058,4244397,0,0,0,2339
11783,4237271,4237271,4244616,0,0,0,7345
11800,4244292,4244292,4244763,0,0,0,471
11805,4244635,4244763,4244806,0,0,128,171
11806,4244850,4244850,4244887,0,0,0,37
11801,4244349,4244349,4244901,0,0,0,552
11807,4244943,4244943,4245115,0,0,0,172
11809,4245446,4245446,4245490,0,0,0,44
11810,4245627,4245627,4245641,0,0,0,14
11811,4245692,4245692,4245729,0,0,0,37
11812,4245888,4245888,4245926,0,0,0,38
11813,4246203,4246203,4246243,0,0,0,40
11814,4246414,4246414,4246452,0,0,0,38
11815,4246613,4246613,4246627,0,0,0,14
11808,4245416,4245416,4246775,0,0,0,1359
11816,4246754,4246754,4246791,0,0,0,37
11802,4244379,4244397,4246867,0,0,18,2488
11818,4246984,4246984,4246999,0,0,0,15
11819,4247003,4247003,4247041,0,0,0,38
11821,4247175,4247175,4247190,0,0,0,15
11823,4248003,4248003,4248044,0,0,0,41
11820,4247161,4247161,4248091,0,0,0,930
11766,4212889,4231528,4249270,0,0,18639,36381
11788,4241516,4249270,4249320,0,0,7754,7804
11822,4247960,4248091,4249595,0,0,131,1635
11824,4248079,4249595,4250154,0,0,1516,2075
11830,4248492,4250154,4250193,0,0,1662,1701
11831,4248767,4250193,4250238,0,0,1426,1471
11832,4248848,4250238,4250274,0,0,1390,1426
11833,4248891,4250274,4250301,0,0,1383,1410
11834,4248944,4250301,4250318,0,0,1357,1374
11835,4249074,4250318,4250340,0,0,1244,1266
11836,4249113,4250340,4250362,0,0,1227,1249
11837,4249155,4250362,4250384,0,0,1207,1229
11838,4249192,4250384,4250418,0,0,1192,1226
11839,4249284,4250418,4250439,0,0,1134,1155
11817,4246829,4246829,4250461,0,0,0,3632
11840,4249380,4250439,4250463,0,0,1059,1083
11842,4249879,4250461,4250499,0,0,582,620
11828,4248390,4250154,4250673,0,0,1764,2283
11844,4250654,4250673,4250729,0,0,19,75
11793,4243036,4243036,4250883,0,0,0,7847
11847,4250977,4250977,4251023,0,0,0,46
11848,4251168,4251168,4251202,0,0,0,34
11845,4250838,4250838,4251589,0,0,0,751
11803,4244559,4244616,4252285,0,0,57,7726
11849,4252299,4252299,4252419,0,0,0,120
11850,4252393,4252393,4252435,0,0,0,42
11851,4252452,4252452,4252477,0,0,0,25
11852,4252477,4252477,4252626,0,0,0,149
11853,4252559,4252559,4252666,0,0,0,107
11854,4252747,4252747,4252882,0,0,0,135
11843,4250422,4250463,4252954,0,0,41,2532
11857,4253449,4253449,4253481,0,0,0,32
11856,4253320,4253320,4253801,0,0,0,481
11798,4244256,4244616,4254164,0,0,360,9908
11861,4254188,4254188,4254209,0,0,0,21
11862,4254311,4254311,4254354,0,0,0,43
11859,4254064,4254064,4254446,0,0,0,382
11864,4254916,4254916,4254933,0,0,0,17
11863,4254458,4254458,4255000,0,0,0,542
11865,4255231,4255231,4255392,0,0,0,161
11867,4255673,4255673,4255725,0,0,0,52
11868,4255733,4255733,4255778,0,0,0,45
11855,4252901,4252901,4255934,0,0,0,3033
11870,4256028,4256028,4256358,0,0,0,330
11872,4256434,4256434,4256471,0,0,0,37
11846,4250862,4250883,4256974,0,0,21,6112
11874,4256572,4256974,4256998,0,0,402,426
11877,4256964,4256974,4257004,0,0,10,40
11875,4256629,4256974,4257023,0,0,345,394
11871,4256373,4256373,4257146,0,0,0,773
11878,4257175,4257175,4257202,0,0,0,27
11880,4257445,4257445,4257476,0,0,0,31
11881,4257844,4257844,4257879,0,0,0,35
11883,4258037,4258037,4258073,0,0,0,36
11884,4258319,4258319,4258350,0,0,0,31
11882,4257934,4257934,4258417,0,0,0,483
11804,4244618,4249320,4258731,0,0,4702,14113
11885,4258770,4258770,4258801,0,0,0,31
11825,4248111,4258731,4258815,0,0,10620,10704
11826,4248157,4258731,4258862,0,0,10574,10705
11827,4248351,4258815,4258906,0,0,10464,10555
11886,4259140,4259140,4259211,0,0,0,71
11887,4259187,4259187,4259219,0,0,0,32
11889,4259608,4259608,4259638,0,0,0,30
11869,4255888,4255888,4259685,0,0,0,3797
11893,4259838,4259838,4259889,0,0,0,51
11829,4248460,4258862,4259947,0,0,10402,11487
11892,4259788,4259788,4260036,0,0,0,248
11888,4259314,4259314,4260039,0,0,0,725
11890,4259680,4259680,4264481,0,0,0,4801
11860,4254083,4254083,4264489,0,0,0,10406
11873,4256499,4256499,4264489,0,0,0,7990
11899,4260493,4264489,4264499,0,0,3996,4006
11894,4260078,4264481,4264512,0,0,4403,4434
11897,4260351,4264489,4264516,0,0,4138,4165
11896,4260304,4264489,4264520,0,0,4185,4216
11900,4260656,4264489,4264534,0,0,3833,3878
11895,4260246,4264481,4264552,0,0,4235,4306
11876,4256889,4257023,4264618,0,0,134,7729
11898,4260461,4264489,4264625,0,0,4028,4164
11891,4259715,4260039,4264806,0,0,324,5091
11902,4265285,4265285,4265368,0,0,0,83
11841,4249467,4258906,4266312,0,0,9439,16845
11906,4266657,4266657,4267046,0,0,0,389
11909,4267086,4267086,4267111,0,0,0,25
11879,4257189,4259947,4267136,0,0,2758,9947
11910,4267534,4267534,4267559,0,0,0,25
11911,4267716,4267716,4267732,0,0,0,16
11912,4267761,4267761,4267829,0,0,0,68
11914,4268132,4268132,4268191,0,0,0,59
11916,4268297,4268297,4268403,0,0,0,106
11907,4266666,4266666,4268426,0,0,0,1760
11918,4268647,4268647,4268707,0,0,0,60
11919,4268673,4268673,4268708,0,0,0,35
11920,4268861,4268861,4268889,0,0,0,28
11921,4269040,4269040,4269070,0,0,0,30
11915,4268280,4268280,4269251,0,0,0,971
11923,4269277,4269277,4269308,0,0,0,31
11924,4269308,4269308,4269342,0,0,0,34
11926,4269709,4269709,4269740,0,0,0,31
11927,4269854,4269854,4269879,0,0,0,25
11925,4269488,4269488,4270092,0,0,0,604
11928,4269875,4269879,4270262,0,0,4,387
11929,4270302,4270302,4270336,0,0,0,34
11930,4270326,4270336,4270369,0,0,10,43
11922,4269065,4269070,4270539,0,0,5,1474
11932,4270714,4270714,4270734,0,0,0,20
11933,4270742,4270742,4270766,0,0,0,24
11935,4270844,4270844,4270884,0,0,0,40
11931,4270488,4270488,4271033,0,0,0,545
11934,4270768,4270768,4271167,0,0,0,399
11936,4271051,4271167,4271980,0,0,116,929
11938,4271504,4271980,4272014,0,0,476,510
11939,4271663,4271980,4272077,0,0,317,414
11937,4271433,4271980,4272089,0,0,547,656
11942,4272220,4272220,4272295,0,0,0,75
11941,4272167,4272167,4272789,0,0,0,622
11946,4273064,4273064,4273553,0,0,0,489
11903,4265850,4265850,4273654,0,0,0,7804
11945,4273012,4273012,4273684,0,0,0,672
11948,4273692,4273692,4274177,0,0,0,485
11943,4272374,4272374,4274957,0,0,0,2583
11905,4266615,4266615,4275580,0,0,0,8965
11908,4266681,4266681,4276418,0,0,0,9737
11950,4276848,4276848,4276876,0,0,0,28
11917,4268540,4268540,4277167,0,0,0,8627
11949,4274037,4274037,4277606,0,0,0,3569
11951,4277574,4277574,4277827,0,0,0,253
11913,4268012,4268012,4280746,0,0,0,12734
11947,4273630,4273654,4281647,0,0,24,8017
11953,4279084,4281647,4281867,0,0,2563,2783
11955,4279466,4281867,4281962,0,0,2401,2496
11956,4279829,4281962,4282306,0,0,2133,2477
11959,4282441,4282441,4282564,0,0,0,123
11960,4282733,4282733,4282971,0,0,0,238
11901,4261872,4264618,4284335,0,0,2746,22463
11957,4280373,4284335,4284379,0,0,3962,4006
11858,4254026,4277827,4284453,0,0,23801,30427
11962,4283520,4283520,4284834,0,0,0,1314
11963,4283853,4284379,4284871,0,0,526,1018
11952,4277892,4280746,4285131,0,0,2854,7239
11961,4283007,4285131,4285142,0,0,2124,2135
11965,4284930,4284930,4285413,0,0,0,483
11954,4279330,4281647,4285468,0,0,2317,6138
11866,4255653,4284453,4286255,0,0,28800,30602
11966,4285789,4285789,4286446,0,0,0,657
11967,4287849,4287849,4288027,0,0,0,178
11958,4281586,4284335,4288996,0,0,2749,7410
11969,4289103,4289103,4291465,0,0,0,2362
11904,4266122,4286255,4292224,0,0,20133,26102
11970,4291395,4291395,4293676,0,0,0,2281
11968,4288167,4288167,4295892,0,0,0,7725
11972,4293672,4293672,4296159,0,0,0,2487
11971,4293495,4293495,4297530,0,0,0,4035
11977,4297700,4297700,4297847,0,0,0,147
11974,4296084,4296084,4298483,0,0,0,2399
11979,4298495,4298495,4298774,0,0,0,279
11980,4298725,4298774,4298814,0,0,49,89
11981,4299121,4299121,4299154,0,0,0,33
11982,4299684,4299684,4299878,0,0,0,194
11983,4299873,4299873,4300002,0,0,0,129
11964,4284108,4285142,4300272,0,0,1034,16164
11984,4300201,4300201,4300586,0,0,0,385
11978,4298461,4298461,4300978,0,0,0,2517
11985,4300668,4300668,4301057,0,0,0,389
11987,4301036,4301036,4301065,0,0,0,29
11988,4301323,4301323,4301418,0,0,0,95
11989,4301726,4301726,4301931,0,0,0,205
11990,4302567,4302567,4302685,0,0,0,118
11986,4300955,4300955,4303543,0,0,0,2588
11992,4303479,4303479,4305830,0,0,0,2351
11993,4305756,4305756,4308142,0,0,0,2386
11975,4296447,4296447,4310555,0,0,0,14108
11940,4272108,4292224,4310559,0,0,20116,38451
11944,4272465,4310559,4310619,0,0,38094,38154
11994,4308080,4308080,4310644,0,0,0,2564
11991,4303420,4303420,4312258,0,0,0,8838
11995,4310573,4310573,4313152,0,0,0,2579
11973,4293678,4310619,4314535,0,0,16941,20857
11997,4313098,4313098,4315582,0,0,0,2484
11998,4315513,4315513,4317871,0,0,0,2358
11999,4317807,4317807,4320094,0,0,0,2287
11976,4297593,4314535,4320363,0,0,16942,22770
12002,4320362,4320362,4320423,0,0,0,61
12000,4320067,4320067,4322665,0,0,0,2598
12003,4322602,4322602,4325164,0,0,0,2562
12005,4325107,4325107,4327422,0,0,0,2315
12006,4327335,4327335,4328277,0,0,0,942
12010,4328734,4328734,4329133,0,0,0,399
12007,4327358,4327358,4329704,0,0,0,2346
12013,4329862,4329862,4329913,0,0,0,51
12014,4330086,4330086,4330115,0,0,0,29
12015,4330119,4330119,4330573,0,0,0,454
12016,4330345,4330573,4330628,0,0,228,283
12017,4330564,4330628,4330662,0,0,64,98
12018,4330991,4330991,4331045,0,0,0,54
12020,4331306,4331306,4331337,0,0,0,31
12004,4324782,4324782,4331629,0,0,0,6847
12021,4331363,4331629,4331664,0,0,266,301
12023,4331748,4331748,4331781,0,0,0,33
12012,4329665,4329704,4332117,0,0,39,2452
12024,4332022,4332117,4332146,0,0,95,124
12027,4332210,4332210,4332232,0,0,0,22
12011,4329403,4329403,4332651,0,0,0,3248
12028,4332470,4332651,4332680,0,0,181,210
12030,4333251,4333251,4333282,0,0,0,31
12031,4333645,4333645,4333678,0,0,0,33
12009,4328260,4328260,4334190,0,0,0,5930
12033,4333793,4334190,4334219,0,0,397,426
12035,4334090,4334190,4334239,0,0,100,149
12034,4333959,4334190,4334244,0,0,231,285
12032,4333677,4333678,4334251,0,0,1,574
12001,4320344,4320344,4334494,0,0,0,14150
12038,4334597,4334597,4334664,0,0,0,67
12039,4334725,4334725,4334742,0,0,0,17
12025,4332066,4332146,4334909,0,0,80,2843
12037,4334372,4334372,4335264,0,0,0,892
12041,4334830,4334830,4335343,0,0,0,513
12043,4335393,4335393,4335455,0,0,0,62
12044,4335525,4335525,4335691,0,0,0,166
12042,4335310,4335310,4335877,0,0,0,567
12046,4336144,4336144,4336216,0,0,0,72
12045,4335741,4335741,4336366,0,0,0,625
12049,4336917,4336917,4336970,0,0,0,53
12047,4336219,4336219,4337064,0,0,0,845
12051,4337184,4337184,4337230,0,0,0,46
12048,4336499,4336499,4337393,0,0,0,894
12053,4337586,4337586,4337685,0,0,0,99
12040,4334809,4334809,4337839,0,0,0,3030
12052,4337436,4337436,4337840,0,0,0,404
12055,4338148,4338148,4338206,0,0,0,58
12022,4331641,4331664,4338682,0,0,23,7041
12059,4338968,4338968,4339027,0,0,0,59
12057,4338669,4338669,4339237,0,0,0,568
11996,4312261,4320363,4339355,0,0,8102,27094
12008,4327477,4339355,4339417,0,0,11878,11940
12056,4338180,4338180,4339483,0,0,0,1303
12061,4339639,4339639,4339668,0,0,0,29
12036,4334173,4334244,4339980,0,0,71,5807
12063,4340038,4340038,4340095,0,0,0,57
12066,4340353,4340353,4340412,0,0,0,59
12054,4337820,4337820,4340530,0,0,0,2710
12068,4340711,4340711,4340739,0,0,0,28
12060,4339576,4339576,4341212,0,0,0,1636
12071,4341254,4341254,4341344,0,0,0,90
12069,4340889,4340889,4341489,0,0,0,600
12070,4340973,4340973,4341547,0,0,0,574
12073,4341600,4341600,4341652,0,0,0,52
12074,4341729,4341729,4342296,0,0,0,567
12075,4342258,4342258,4342326,0,0,0,68
12076,4342556,4342556,4342608,0,0,0,52
12080,4342983,4342983,4343007,0,0,0,24
12079,4342963,4342963,4343018,0,0,0,55
12072,4341347,4341347,4343021,0,0,0,1674
12081,4343065,4343065,4343175,0,0,0,110
12077,4342637,4342637,4343200,0,0,0,563
12083,4343310,4343310,4343362,0,0,0,52
12085,4343707,4343707,4343763,0,0,0,56
12067,4340502,4340502,4343799,0,0,0,3297
12082,4343205,4343799,4343962,0,0,594,757
12086,4343720,4343763,4344295,0,0,43,575
12084,4343325,4343962,4344436,0,0,637,1111
12087,4343732,4344436,4344470,0,0,704,738
12093,4344417,4344417,4345655,0,0,0,1238
12065,4340253,4340253,4345725,0,0,0,5472
12062,4339880,4339880,4346518,0,0,0,6638
12090,4343820,4346518,4346541,0,0,2698,2721
12091,4343902,4346518,4346541,0,0,2616,2639
12092,4344294,4346541,4346594,0,0,2247,2300
12058,4338691,4338691,4346688,0,0,0,7997
12094,4345804,4346541,4346770,0,0,737,966
12096,4346281,4346688,4346775,0,0,407,494
12100,4346906,4346906,4346955,0,0,0,49
12101,4347162,4347162,4347186,0,0,0,24
12098,4346692,4346692,4347314,0,0,0,622
12095,4346076,4346541,4347361,0,0,465,1285
12103,4347367,4347367,4347421,0,0,0,54
12104,4347660,4347660,4347692,0,0,0,32
12102,4347346,4347346,4347725,0,0,0,379
12107,4348107,4348107,4348158,0,0,0,51
12019,4331256,4339417,4348368,0,0,8161,17112
12108,4348389,4348389,4348428,0,0,0,39
12106,4348093,4348368,4348434,0,0,275,341
12109,4348401,4348401,4348446,0,0,0,45
12110,4348438,4348438,4348480,0,0,0,42
12088,4343776,4344470,4348610,0,0,694,4834
12064,4340218,4340218,4348733,0,0,0,8515
12112,4348771,4348771,4348824,0,0,0,53
12113,4348792,4348792,4348838,0,0,0,46
12114,4348832,4348838,4348888,0,0,6,56
12115,4349096,4349096,4349146,0,0,0,50
12116,4349165,4349165,4349209,0,0,0,44
12117,4349283,4349283,4349332,0,0,0,49
12119,4349433,4349433,4349487,0,0,0,54
12026,4332147,4348733,4349513,0,0,16586,17366
12120,4349604,4349604,4349653,0,0,0,49
12121,4349841,4349841,4349893,0,0,0,52
12123,4350023,4350023,4350092,0,0,0,69
12078,4342844,4343200,4350207,0,0,356,7363
12124,4350125,4350207,4350247,0,0,82,122
12125,4350220,4350220,4350268,0,0,0,48
12122,4349933,4349933,4350347,0,0,0,414
12126,4350356,4350356,4350403,0,0,0,47
12127,4350393,4350393,4350442,0,0,0,49
12128,4350562,4350562,4350612,0,0,0,50
12129,4350685,4350685,4350735,0,0,0,50
12130,4350767,4350767,4350809,0,0,0,42
12131,4350854,4350854,4350899,0,0,0,45
12132,4351045,4351045,4351094,0,0,0,49
12134,4351201,4351201,4351250,0,0,0,49
12135,4351337,4351337,4351399,0,0,0,62
12097,4346504,4346775,4351636,0,0,271,5132
12137,4351512,4351512,4351717,0,0,0,205
12139,4351791,4351791,4351838,0,0,0,47
12138,4351687,4351687,4351903,0,0,0,216
12105,4347890,4347890,4351973,0,0,0,4083
12140,4351900,4351900,4351985,0,0,0,85
12143,4352167,4352167,4352181,0,0,0,14
12142,4352007,4352007,4352296,0,0,0,289
12144,4352270,4352270,4352320,0,0,0,50
12145,4352286,4352286,4352323,0,0,0,37
12146,4352422,4352422,4352752,0,0,0,330
12147,4352703,4352703,4352801,0,0,0,98
12148,4352760,4352760,4352803,0,0,0,43
12089,4343816,4345725,4352853,0,0,1909,9037
12151,4352851,4352851,4352885,0,0,0,34
12150,4352843,4352843,4352890,0,0,0,47
12149,4352832,4352832,4353213,0,0,0,381
12029,4332988,4349513,4353620,0,0,16525,20632
12153,4352970,4353213,4353866,0,0,243,896
12154,4353010,4353866,4353917,0,0,856,907
12155,4353186,4353917,4353966,0,0,731,780
12157,4353493,4353966,4354022,0,0,473,529
12158,4354259,4354259,4354323,0,0,0,64
12141,4351952,4351952,4354686,0,0,0,2734
12136,4351362,4351362,4359961,0,0,0,8599
12118,4349418,4349418,4360026,0,0,0,10608
12161,4354629,4354629,4360067,0,0,0,5438
12163,4354717,4360026,4360136,0,0,5309,5419
12152,4352931,4359961,4361285,0,0,7030,8354
12156,4353319,4354686,4361330,0,0,1367,8011
12159,4354309,4361285,4361342,0,0,6976,7033
12166,4355822,4361342,4361363,0,0,5520,5541
12169,4360264,4361363,4363057,0,0,1099,2793
12170,4360354,4360354,4363228,0,0,0,2874
12111,4348739,4352890,4364027,0,0,4151,15288
12164,4354953,4360067,4365135,0,0,5114,10182
12050,4336969,4353620,4365726,0,0,16651,28757
12165,4355593,4361342,4366409,0,0,5749,10816
12162,4354650,4361330,4366643,0,0,6680,11993
12171,4360726,4363057,4367026,0,0,2331,6300
12099,4346761,4365726,4367661,0,0,18965,20900
12173,4362583,4363228,4368475,0,0,645,5892
12179,4368194,4368194,4368648,0,0,0,454
12180,4368758,4368758,4369781,0,0,0,1023
12167,4356110,4366643,4370626,0,0,10533,14516
12177,4364838,4365135,4370856,0,0,297,6018
12160,4354336,4367661,4373118,0,0,13325,18782
12168,4359805,4370626,4374032,0,0,10821,14227
12176,4363570,4370856,4374286,0,0,7286,10716
12172,4361386,4373118,4374891,0,0,11732,13505
12183,4375198,4375198,4375375,0,0,0,177
12184,4375514,4375514,4375628,0,0,0,114
12185,4375673,4375673,4375747,0,0,0,74
12186,4375886,4375886,4375947,0,0,0,61
12187,4376080,4376080,4376155,0,0,0,75
12188,4376320,4376320,4376468,0,0,0,148
12189,4376705,4376705,4376829,0,0,0,124
12190,4377066,4377066,4377170,0,0,0,104
12191,4377325,4377325,4377394,0,0,0,69
12178,4367026,4374032,4377484,0,0,7006,10458
12133,4351194,4364027,4377753,0,0,12833,26559
12174,4362846,4374891,4392485,0,0,12045,29639
12175,4363168,4377484,4394139,0,0,14316,30971
12193,4377648,4394139,4394187,0,0,16491,16539
12194,4377714,4394139,4394193,0,0,16425,16479
12192,4377489,4394139,4394199,0,0,16650,16710
12196,4378679,4394139,4394249,0,0,15460,15570
12203,4380742,4394199,4394258,0,0,13457,13516
12201,4380613,4394193,4394271,0,0,13580,13658
12197,4379080,4394139,4394277,0,0,15059,15197
12198,4380008,4394139,4394289,0,0,14131,14281
12200,4380277,4394187,4394328,0,0,13910,14051
12202,4380682,4394258,4394445,0,0,13576,13763
12205,4381097,4394277,4394462,0,0,13180,13365
12207,4381759,4394328,4394516,0,0,12569,12757
12199,4380242,4394139,4394763,0,0,13897,14521
12195,4377939,4394139,4394766,0,0,16200,16827
12182,4375038,4377753,4397253,0,0,2715,22215
12208,4382397,4394445,4397951,0,0,12048,15554
12206,4381156,4394516,4408715,0,0,13360,27559
12181,4373026,4392485,4410792,0,0,19459,37766
12211,4395303,4397951,4412127,0,0,2648,16824
12209,4390536,4397253,4412281,0,0,6717,21745
12214,4413492,4413492,4416893,0,0,0,3401
12204,4380763,4410792,4421847,0,0,30029,41084
12212,4409474,4409474,4423656,0,0,0,14182
12217,4422145,4423656,4423685,0,0,1511,1540
12216,4421982,4423656,4423697,0,0,1674,1715
12213,4412514,4412514,4423898,0,0,0,11384
12215,4421140,4421140,4424525,0,0,0,3385
12210,4391818,4421847,4439701,0,0,30029,47883
12218,4422268,4424525,4439898,0,0,2257,17630
12221,4427942,4439701,4443083,0,0,11759,15141
12219,4424538,4439701,4443090,0,0,15163,18552
12223,4431341,4443083,4446539,0,0,11742,15198
12225,4435046,4446539,4446611,0,0,11493,11565
12226,4435216,4446539,4446986,0,0,11323,11770
12224,4434687,4443090,4447307,0,0,8403,12620
12232,4447211,4447211,4447340,0,0,0,129
12220,4425078,4439701,4447769,0,0,14623,22691
12233,4447656,4447656,4447822,0,0,0,166
12234,4448609,4448609,4448767,0,0,0,158
12222,4427987,4439898,4450073,0,0,11911,22086
12230,4440314,4446611,4450276,0,0,6297,9962
12231,4444733,4447769,4452219,0,0,3036,7486
12227,4437996,4447307,4454033,0,0,9311,16037
12235,4449193,4450073,4455176,0,0,880,5983
12236,4450948,4450948,4455569,0,0,0,4621
12228,4438930,4447769,4455712,0,0,8839,16782
12238,4454302,4454302,4461289,0,0,0,6987
12239,4455508,4455508,4461290,0,0,0,5782
12240,4458693,4461289,4461660,0,0,2596,2967
12244,4470007,4470007,4470113,0,0,0,106
12246,4472026,4472026,4472202,0,0,0,176
12247,4472476,4472476,4472504,0,0,0,28
12229,4439979,4450073,4472595,0,0,10094,32616
12237,4453558,4455712,4472973,0,0,2154,19415
12249,4472898,4472898,4473334,0,0,0,436
12250,4473440,4473440,4473549,0,0,0,109
12251,4474041,4474041,4474498,0,0,0,457
12252,4474543,4474543,4477558,0,0,0,3015
12253,4477425,4477425,4477570,0,0,0,145
12254,4477663,4477663,4477684,0,0,0,21
12255,4478306,4478306,4478561,0,0,0,255
12248,4472721,4472721,4480552,0,0,0,7831
12243,4469685,4469685,4483916,0,0,0,14231
12241,4460744,4472973,4484804,0,0,12229,24060
12242,4464886,4484804,4486697,0,0,19918,21811
12256,4483597,4483597,4491312,0,0,0,7715
12257,4483927,4483927,4498162,0,0,0,14235
12259,4491314,4491314,4499087,0,0,0,7773
12245,4470821,4486697,4499175,0,0,15876,28354
12262,4502784,4502784,4502852,0,0,0,68
12263,4504127,4504127,4504177,0,0,0,50
12264,4504943,4504943,4504990,0,0,0,47
12261,4502155,4502155,4505902,0,0,0,3747
12258,4485188,4499087,4506108,0,0,13899,20920
12266,4506211,4506211,4506269,0,0,0,58
12260,4499091,4499175,4506898,0,0,84,7807
12269,4507217,4507217,4507301,0,0,0,84
12271,4508789,4508789,4508873,0,0,0,84
12272,4510252,4510252,4510310,0,0,0,58
12265,4505841,4505841,4511243,0,0,0,5402
12274,4511691,4511691,4511786,0,0,0,95
12275,4511813,4511813,4511941,0,0,0,128
12276,4512147,4512147,4512234,0,0,0,87
12277,4512554,4512554,4512637,0,0,0,83
12278,4513068,4513068,4513155,0,0,0,87
12267,4506335,4506335,4513512,0,0,0,7177
12270,4507764,4507764,4513758,0,0,0,5994
12281,4513675,4513675,4513761,0,0,0,86
12280,4513567,4513761,4513977,0,0,194,410
12283,4514429,4514429,4514522,0,0,0,93
12284,4515368,4515368,4515454,0,0,0,86
12282,4514165,4514165,4515956,0,0,0,1791
12286,4516058,4516058,4516142,0,0,0,84
12288,4516820,4516820,4516902,0,0,0,82
12273,4511187,4511187,4517161,0,0,0,5974
12290,4517357,4517357,4517458,0,0,0,101
12287,4516126,4516126,4519848,0,0,0,3722
12279,4513524,4513524,4520781,0,0,0,7257
12291,4519933,4519933,4521112,0,0,0,1179
12285,4515973,4515973,4521289,0,0,0,5316
12293,4521931,4521931,4521998,0,0,0,67
12295,4522376,4522376,4522461,0,0,0,85
12294,4522284,4522284,4522575,0,0,0,291
12296,4522799,4522799,4522857,0,0,0,58
12289,4517099,4517099,4522927,0,0,0,5828
12298,4523095,4523095,4523133,0,0,0,38
12299,4523175,4523175,4523230,0,0,0,55
12300,4523347,4523347,4523355,0,0,0,8
12301,4523720,4523720,4523731,0,0,0,11
12302,4523835,4523835,4523867,0,0,0,32
12303,4523923,4523923,4524169,0,0,0,246
12304,4524188,4524188,4524194,0,0,0,6
12305,4524213,4524213,4524243,0,0,0,30
12306,4524299,4524299,4524361,0,0,0,62
12268,4506823,4506823,4525152,0,0,0,18329
12308,4524884,4525152,4525221,0,0,268,337
12292,4520802,4520802,4527769,0,0,0,6967
12312,4527685,4527769,4527837,0,0,84,152
12314,4528317,4528317,4528400,0,0,0,83
12297,4522864,4522864,4528635,0,0,0,5771
12316,4529754,4529754,4530058,0,0,0,304
12309,4525156,4525221,4530219,0,0,65,5063
12310,4526096,4527769,4531517,0,0,1673,5421
12313,4527780,4528635,4535668,0,0,855,7888
12307,4524497,4524497,4535829,0,0,0,11332
12319,4534806,4535829,4536034,0,0,1023,1228
12323,4535765,4536034,4536335,0,0,269,570
12315,4528570,4531517,4537274,0,0,2947,8704
12324,4536950,4536950,4538055,0,0,0,1105
12322,4535381,4535829,4541093,0,0,448,5712
12329,4540515,4541093,4541111,0,0,578,596
12330,4540690,4541093,4541132,0,0,403,442
12331,4540777,4541111,4541175,0,0,334,398
12318,4534257,4535668,4541421,0,0,1411,7164
12320,4534820,4535829,4541885,0,0,1009,7065
12332,4542106,4542106,4542128,0,0,0,22
12333,4542566,4542566,4542585,0,0,0,19
12334,4543230,4543230,4543249,0,0,0,19
12326,4538093,4538093,4543609,0,0,0,5516
12327,4539986,4539986,4545748,0,0,0,5762
12311,4526314,4530219,4553899,0,0,3905,27585
12325,4537143,4541885,4555488,0,0,4742,18345
12338,4554714,4555488,4556025,0,0,774,1311
12317,4530155,4553899,4559046,0,0,23744,28891
12335,4548375,4555488,4559182,0,0,7113,10807
12328,4540155,4545748,4561795,0,0,5593,21640
12336,4548748,4555488,4562347,0,0,6740,13599
12321,4535304,4559046,4563894,0,0,23742,28590
12339,4555054,4559182,4573409,0,0,4128,18355
12337,4549519,4561795,4577808,0,0,12276,28289
12340,4566788,4566788,4579936,0,0,0,13148
12341,4569275,4569275,4583483,0,0,0,14208
12342,4579946,4579946,4587138,0,0,0,7192
12347,4591303,4591303,4591319,0,0,0,16
12348,4592697,4592697,4592716,0,0,0,19
12349,4593485,4593485,4593503,0,0,0,18
12350,4594116,4594116,4594134,0,0,0,18
12343,4588485,4588485,4594218,0,0,0,5733
12352,4594474,4594474,4594491,0,0,0,17
12346,4590532,4590532,4594794,0,0,0,4262
12353,4595559,4595559,4595572,0,0,0,13
12345,4589666,4589666,4596503,0,0,0,6837
12356,4597341,4597341,4597355,0,0,0,14
12357,4597493,4597493,4597506,0,0,0,13
12354,4595879,4595879,4598171,0,0,0,2292
12358,4599301,4599301,4599320,0,0,0,19
12359,4599633,4599633,4599649,0,0,0,16
12351,4594163,4594163,4599987,0,0,0,5824
12344,4589018,4589018,4600344,0,0,0,11326
12361,4601430,4601430,4601450,0,0,0,20
12362,4602070,4602070,4602091,0,0,0,21
12355,4596508,4596508,4603964,0,0,0,7456
12366,4605515,4605515,4605541,0,0,0,26
12367,4605566,4605566,4605638,0,0,0,72
12369,4605809,4605809,4605840,0,0,0,31
12365,4605134,4605134,4606272,0,0,0,1138
12371,4606198,4606198,4606755,0,0,0,557
12360,4599924,4599924,4606855,0,0,0,6931
12373,4608192,4608192,4608324,0,0,0,132
12374,4608554,4608554,4608583,0,0,0,29
12368,4605593,4605593,4609274,0,0,0,3681
12375,4609812,4609812,4612766,0,0,0,2954
12370,4605852,4605852,4612883,0,0,0,7031
12364,4603969,4603969,4613335,0,0,0,9366
12363,4602078,4602078,4614477,0,0,0,12399
12372,4606795,4606795,4614906,0,0,0,8111
12378,4613627,4614477,4616698,0,0,850,3071
12381,4617888,4617888,4618141,0,0,0,253
12382,4618197,4618197,4618917,0,0,0,720
12383,4618940,4618940,4619028,0,0,0,88
12385,4619415,4619415,4619611,0,0,0,196
12376,4612884,4612884,4620606,0,0,0,7722
12377,4613342,4613342,4623780,0,0,0,10438
12384,4619102,4619102,4623844,0,0,0,4742
12391,4624694,4624694,4624714,0,0,0,20
12380,4614907,4616698,4625100,0,0,1791,10193
12379,4614495,4614906,4625379,0,0,411,10884
12392,4625299,4625299,4625554,0,0,0,255
12393,4625794,4625794,4625813,0,0,0,19
12394,4626469,4626469,4626662,0,0,0,193
12389,4623309,4623780,4627575,0,0,471,4266
12386,4620619,4620619,4627625,0,0,0,7006
12390,4623863,4623863,4627933,0,0,0,4070
12398,4627930,4627930,4628115,0,0,0,185
12399,4628122,4628122,4628140,0,0,0,18
12400,4628357,4628357,4628542,0,0,0,185
12401,4628983,4628983,4629273,0,0,0,290
12405,4630238,4630238,4630257,0,0,0,19
12406,4630776,4630776,4630828,0,0,0,52
12408,4631838,4631838,4631856,0,0,0,18
12396,4627106,4627106,4632879,0,0,0,5773
12402,4629364,4629364,4633059,0,0,0,3695
12395,4626514,4626514,4633384,0,0,0,6870
12397,4627628,4627628,4634661,0,0,0,7033
12410,4633702,4634661,4634680,0,0,959,978
12387,4622299,4633384,4635092,0,0,11085,12793
12403,4629534,4635092,4635123,0,0,5558,5589
12404,4629863,4635123,4636583,0,0,5260,6720
12388,4622681,4622681,4645223,0,0,0,22542
12413,4646368,4646368,4646524,0,0,0,156
12414,4646716,4646716,4650745,0,0,0,4029
12412,4641315,4641315,4655466,0,0,0,14151
12407,4631729,4636583,4660195,0,0,4854,28466
12409,4631888,4660195,4661671,0,0,28307,29783
12411,4634665,4661671,4669284,0,0,27006,34619
12415,4655466,4655466,4669691,0,0,0,14225
12416,4662956,4662956,4669968,0,0,0,7012
12418,4670536,4670536,4672021,0,0,0,1485
12420,4675027,4675027,4675121,0,0,0,94
12417,4669972,4669972,4676989,0,0,0,7017
12421,4675137,4675137,4679185,0,0,0,4048
12425,4679743,4679743,4679774,0,0,0,31
12426,4679779,4679779,4679803,0,0,0,24
12427,4680398,4680398,4680604,0,0,0,206
12419,4674963,4674963,4680799,0,0,0,5836
12429,4681080,4681080,4681299,0,0,0,219
12430,4682362,4682362,4682385,0,0,0,23
12422,4676120,4676120,4683038,0,0,0,6918
12431,4683002,4683002,4683901,0,0,0,899
12423,4676993,4676993,4683995,0,0,0,7002
12428,4680736,4680736,4686643,0,0,0,5907
12435,4685686,4686643,4687223,0,0,957,1537
12438,4687923,4687923,4687948,0,0,0,25
12439,4688008,4688008,4688090,0,0,0,82
12424,4678920,4678920,4690309,0,0,0,11389
12434,4684529,4686643,4690686,0,0,2114,6157
12433,4683998,4683998,4691600,0,0,0,7602
12432,4683044,4683044,4691701,0,0,0,8657
12437,4686582,4690309,4698616,0,0,3727,12034
12440,4691611,4691611,4699247,0,0,0,7636
12446,4699512,4699512,4699595,0,0,0,83
12447,4699913,4699913,4699991,0,0,0,78
12448,4700346,4700346,4700485,0,0,0,139
12436,4685902,4690309,4701628,0,0,4407,15726
12449,4701651,4701651,4701674,0,0,0,23
12441,4691709,4691709,4702008,0,0,0,10299
12442,4694891,4694891,4703320,0,0,0,8429
12445,4699252,4702008,4709682,0,0,2756,10430
12444,4697238,4698616,4709806,0,0,1378,12568
12457,4706803,4709806,4710582,0,0,3003,3779
12454,4704670,4709682,4710682,0,0,5012,6012
12443,4696588,4699247,4710763,0,0,2659,14175
12453,4703781,4709682,4710819,0,0,5901,7038
12463,4710497,4710763,4710996,0,0,266,499
12461,4710132,4710682,4711019,0,0,550,887
12451,4702096,4709682,4711544,0,0,7586,9448
12464,4711362,4711544,4713352,0,0,182,1990
12450,4702024,4703320,4714063,0,0,1296,12039
12459,4708040,4710582,4714171,0,0,2542,6131
12460,4708447,4710763,4714731,0,0,2316,6284
12469,4713846,4714731,4714819,0,0,885,973
12470,4714222,4714731,4714819,0,0,509,597
12471,4714849,4714849,4714939,0,0,0,90
12465,4711639,4714063,4715204,0,0,2424,3565
12472,4715471,4715471,4715577,0,0,0,106
12466,4711679,4711679,4716322,0,0,0,4643
12455,4705094,4709682,4716673,0,0,4588,11579
12456,4705664,4709682,4717400,0,0,4018,11736
12475,4718273,4718273,4718460,0,0,0,187
12452,4703321,4709682,4718873,0,0,6361,15552
12476,4718916,4718916,4719034,0,0,0,118
12468,4712576,4713352,4719426,0,0,776,6850
12474,4716257,4716257,4719867,0,0,0,3610
12477,4719853,4719867,4719881,0,0,14,28
12467,4712558,4714171,4721052,0,0,1613,8494
12478,4721708,4721708,4721774,0,0,0,66
12479,4722438,4722438,4722533,0,0,0,95
12473,4715690,4715690,4724015,0,0,0,8325
12462,4710259,4711019,4725534,0,0,760,15275
12481,4724089,4724089,4725838,0,0,0,1749
12458,4706928,4719426,4727051,0,0,12498,20123
12480,4722940,4727051,4727963,0,0,4111,5023
12484,4725844,4725844,4728414,0,0,0,2570
12486,4727908,4727908,4729455,0,0,0,1547
12488,4729599,4729599,4729703,0,0,0,104
12489,4729747,4729747,4729849,0,0,0,102
12487,4728444,4728444,4730678,0,0,0,2234
12482,4724337,4724337,4731243,0,0,0,6906
12492,4732127,4732127,4732148,0,0,0,21
12493,4732313,4732313,4732324,0,0,0,11
12490,4730739,4730739,4732515,0,0,0,1776
12483,4724745,4725534,4732602,0,0,789,7857
12495,4733069,4733069,4733092,0,0,0,23
12496,4733214,4733214,4733228,0,0,0,14
12497,4733342,4733342,4733354,0,0,0,12
12494,4732526,4732526,4734056,0,0,0,1530
12498,4734098,4734098,4737386,0,0,0,3288
12491,4731844,4731844,4739106,0,0,0,7262
12499,4737396,4737396,4741072,0,0,0,3676
12485,4726946,4727963,4745763,0,0,1017,18817
12500,4763039,4763039,4763068,0,0,0,29
12501,4763395,4763395,4763464,0,0,0,69
12502,4764903,4764903,4764920,0,0,0,17
12503,4764925,4764925,4764942,0,0,0,17
12504,4764946,4764946,4764963,0,0,0,17
12507,4765221,4765221,4765280,0,0,0,59
12506,4765210,4765210,4765587,0,0,0,377
12508,4765536,4765536,4765593,0,0,0,57
12510,4765794,4765794,4765802,0,0,0,8
12512,4765847,4765847,4765853,0,0,0,6
12511,4765811,4765811,4765867,0,0,0,56
12513,4765890,4765890,4766116,0,0,0,226
12518,4766708,4766708,4766760,0,0,0,52
12520,4766953,4766953,4767009,0,0,0,56
12522,4767235,4767235,4767285,0,0,0,50
12519,4766934,4766934,4767421,0,0,0,487
12523,4767375,4767375,4767660,0,0,0,285
12525,4767596,4767596,4767660,0,0,0,64
12526,4767871,4767871,4767936,0,0,0,65
12524,4767494,4767494,4768039,0,0,0,545
12528,4768177,4768177,4768672,0,0,0,495
12530,4768674,4768674,4768734,0,0,0,60
12532,4768963,4768963,4769012,0,0,0,49
12537,4769402,4769402,4769498,0,0,0,96
12529,4768226,4768226,4769682,0,0,0,1456
12536,4769343,4769343,4769764,0,0,0,421
12538,4769672,4769672,4769768,0,0,0,96
12533,4769078,4769078,4770069,0,0,0,991
12540,4769866,4770069,4770956,0,0,203,1090
12516,4766584,4766584,4771254,0,0,0,4670
12544,4770983,4771254,4771303,0,0,271,320
12545,4771124,4771254,4771303,0,0,130,179
12543,4770763,4771254,4771310,0,0,491,547
12531,4768693,4768693,4771342,0,0,0,2649
12548,4771385,4771385,4771439,0,0,0,54
12541,4769935,4770956,4771467,0,0,1021,1532
12505,4765059,4765059,4771575,0,0,0,6516
12549,4771552,4771552,4771602,0,0,0,50
12542,4769949,4771254,4771606,0,0,1305,1657
12546,4771270,4771303,4771648,0,0,33,378
12521,4766970,4766970,4771652,0,0,0,4682
12552,4771794,4771794,4771847,0,0,0,53
12553,4772019,4772019,4772069,0,0,0,50
12554,4772281,4772281,4772330,0,0,0,49
12555,4772470,4772470,4772519,0,0,0,49
12557,4772587,4772587,4772595,0,0,0,8
12509,4765772,4765772,4772826,0,0,0,7054
12558,4772815,4772815,4772867,0,0,0,52
12556,4772511,4772511,4772886,0,0,0,375
12560,4772959,4772959,4773008,0,0,0,49
12561,4773146,4773146,4773195,0,0,0,49
12562,4773355,4773355,4773429,0,0,0,74
12514,4766233,4766233,4773432,0,0,0,7199
12564,4773438,4773438,4773488,0,0,0,50
12565,4773451,4773488,4773527,0,0,37,76
12566,4773664,4773664,4773717,0,0,0,53
12567,4773792,4773792,4773849,0,0,0,57
12568,4774009,4774009,4774065,0,0,0,56
12569,4774199,4774199,4774828,0,0,0,629
12570,4774909,4774909,4774927,0,0,0,18
12571,4774934,4774934,4774986,0,0,0,52
12572,4775077,4775077,4775128,0,0,0,51
12573,4775206,4775206,4775257,0,0,0,51
12574,4775551,4775551,4775604,0,0,0,53
12547,4771352,4771352,4775679,0,0,0,4327
12575,4775663,4775663,4775712,0,0,0,49
12577,4775836,4775836,4775886,0,0,0,50
12578,4776259,4776259,4776318,0,0,0,59
12580,4776638,4776638,4776673,0,0,0,35
12582,4776755,4776755,4776806,0,0,0,51
12579,4776387,4776387,4776861,0,0,0,474
12583,4777046,4777046,4777102,0,0,0,56
12584,4777280,4777280,4777332,0,0,0,52
12551,4771701,4771701,4777446,0,0,0,5745
12586,4777301,4777301,4777537,0,0,0,236
12585,4777293,4777537,4777568,0,0,244,275
12587,4777342,4777568,4778260,0,0,226,918
12581,4776739,4776739,4779788,0,0,0,3049
12590,4778215,4779788,4779833,0,0,1573,1618
12589,4778139,4779788,4779844,0,0,1649,1705
12559,4772824,4772826,4779850,0,0,2,7026
12591,4778291,4779833,4779885,0,0,1542,1594
12596,4778841,4779850,4779899,0,0,1009,1058
12597,4779025,4779850,4779899,0,0,825,874
12598,4779166,4779850,4779899,0,0,684,733
12600,4779366,4779850,4779899,0,0,484,533
12595,4778710,4779850,4779900,0,0,1140,1190
12594,4778534,4779850,4779904,0,0,1316,1370
12601,4779571,4779885,4779932,0,0,314,361
12593,4778441,4779844,4779951,0,0,1403,1510
12588,4778101,4778260,4780149,0,0,159,2048
12603,4780115,4780115,4780170,0,0,0,55
12592,4778306,4779850,4780253,0,0,1544,1947
12604,4780294,4780294,4780377,0,0,0,83
12608,4780482,4780482,4780551,0,0,0,69
12515,4766433,4766433,4780578,0,0,0,14145
12607,4780386,4780386,4780677,0,0,0,291
12539,4769688,4769768,4780709,0,0,80,11021
12609,4780496,4780551,4781085,0,0,55,589
12613,4781129,4781129,4781229,0,0,0,100
12612,4781011,4781011,4781294,0,0,0,283
12550,4771580,4771580,4781583,0,0,0,10003
12614,4781566,4781566,4781624,0,0,0,58
12616,4781668,4781668,4781718,0,0,0,50
12618,4781739,4781739,4781751,0,0,0,12
12605,4780358,4780358,4781803,0,0,0,1445
12563,4773381,4773429,4781942,0,0,48,8561
12619,4781786,4781786,4782020,0,0,0,234
12621,4782038,4782038,4782093,0,0,0,55
12623,4782411,4782411,4782515,0,0,0,104
12622,4782325,4782325,4782560,0,0,0,235
12625,4782683,4782683,4782780,0,0,0,97
12599,4779176,4779899,4782872,0,0,723,3696
12626,4783176,4783176,4783289,0,0,0,113
12627,4783298,4783298,4783351,0,0,0,53
12628,4783406,4783406,4783449,0,0,0,43
12629,4783477,4783477,4783500,0,0,0,23
12630,4783536,4783536,4783638,0,0,0,102
12631,4783751,4783751,4783802,0,0,0,51
12634,4784351,4784351,4784451,0,0,0,100
12576,4775679,4775679,4784599,0,0,0,8920
12635,4784632,4784632,4784686,0,0,0,54
12637,4784834,4784834,4784889,0,0,0,55
12638,4785205,4785205,4785262,0,0,0,57
12611,4780651,4780709,4785316,0,0,58,4665
12617,4781694,4781694,4785829,0,0,0,4135
12640,4785443,4785829,4785880,0,0,386,437
12639,4785330,4785829,4785921,0,0,499,591
12641,4785629,4785880,4785931,0,0,251,302
12642,4785816,4785921,4785970,0,0,105,154
12643,4785925,4785931,4785974,0,0,6,49
12624,4782640,4785316,4785986,0,0,2676,3346
12602,4779853,4780149,4787169,0,0,296,7316
12646,4786302,4787169,4787195,0,0,867,893
12645,4786210,4787169,4787224,0,0,959,1014
12652,4787119,4787169,4787249,0,0,50,130
12648,4786755,4787169,4787262,0,0,414,507
12651,4787019,4787169,4787378,0,0,150,359
12654,4787604,4787604,4787687,0,0,0,83
12653,4787272,4787272,4787688,0,0,0,416
12632,4783882,4783882,4787765,0,0,0,3883
12633,4784247,4784247,4787900,0,0,0,3653
12655,4787998,4787998,4788029,0,0,0,31
12656,4788298,4788298,4788365,0,0,0,67
12659,4788929,4788929,4789009,0,0,0,80
12660,4789020,4789020,4789061,0,0,0,41
12661,4789080,4789080,4789158,0,0,0,78
12662,4789464,4789464,4789657,0,0,0,193
12663,4789609,4789609,4789698,0,0,0,89
12658,4788690,4788690,4789728,0,0,0,1038
12665,4789701,4789701,4789756,0,0,0,55
12647,4786736,4787169,4790002,0,0,433,3266
12667,4789972,4789972,4790019,0,0,0,47
12669,4790076,4790076,4790121,0,0,0,45
12670,4790190,4790190,4790259,0,0,0,69
12620,4781921,4781942,4790302,0,0,21,8381
12671,4790284,4790284,4790331,0,0,0,47
12636,4784732,4785986,4790332,0,0,1254,5600
12668,4789994,4789994,4790461,0,0,0,467
12664,4789622,4789622,4790467,0,0,0,845
12673,4790444,4790444,4790537,0,0,0,93
12666,4789709,4789709,4790594,0,0,0,885
12674,4790552,4790552,4790598,0,0,0,46
12676,4790632,4790632,4790737,0,0,0,105
12675,4790606,4790606,4790811,0,0,0,205
12678,4791069,4791069,4791217,0,0,0,148
12679,4791092,4791092,4791221,0,0,0,129
12680,4791241,4791241,4791271,0,0,0,30
12682,4791410,4791410,4791526,0,0,0,116
12677,4790920,4790920,4791609,0,0,0,689
12681,4791350,4791350,4791662,0,0,0,312
12610,4780645,4780645,4791774,0,0,0,11129
12685,4791718,4791718,4791799,0,0,0,81
12615,4781597,4781597,4791866,0,0,0,10269
12689,4792177,4792177,4792276,0,0,0,99
12690,4792353,4792353,4792462,0,0,0,109
12692,4792885,4792885,4793006,0,0,0,121
12693,4793018,4793018,4793267,0,0,0,249
12691,4792423,4792423,4793279,0,0,0,856
12683,4791461,4791461,4793291,0,0,0,1830
12688,4792077,4792077,4793691,0,0,0,1614
12695,4793735,4793735,4793834,0,0,0,99
12687,4791924,4791924,4793877,0,0,0,1953
12650,4786884,4787169,4794199,0,0,285,7315
12696,4794170,4794170,4794455,0,0,0,285
12644,4786031,4786031,4794519,0,0,0,8488
12697,4794758,4794758,4794772,0,0,0,14
12698,4794781,4794781,4794830,0,0,0,49
12699,4794858,4794858,4794902,0,0,0,44
12700,4794985,4794985,4795034,0,0,0,49
12701,4795349,4795349,4795461,0,0,0,112
12702,4795549,4795549,4796121,0,0,0,572
12657,4788675,4788675,4796603,0,0,0,7928
12705,4796904,4796904,4796963,0,0,0,59
12672,4790399,4790399,4797205,0,0,0,6806
12686,4791885,4791885,4799385,0,0,0,7500
12703,4796704,4796704,4799615,0,0,0,2911
12704,4796894,4796894,4800571,0,0,0,3677
12706,4797186,4797186,4801304,0,0,0,4118
12649,4786875,4790332,4803905,0,0,3457,17030
12517,4766659,4803905,4804158,0,0,37246,37499
12527,4768150,4804158,4815965,0,0,36008,47815
12694,4793339,4793877,4816676,0,0,538,23337
12713,4806513,4816676,4816737,0,0,10163,10224
12709,4805105,4816676,4816746,0,0,11571,11641
12711,4806217,4816676,4816746,0,0,10459,10529
12712,4806299,4816676,4816772,0,0,10377,10473
12716,4807032,4816746,4816782,0,0,9714,9750
12715,4806928,4816737,4816785,0,0,9809,9857
12717,4807800,4816746,4816792,0,0,8946,8992
12718,4808101,4816772,4816796,0,0,8671,8695
12720,4808152,4816782,4816802,0,0,8630,8650
12721,4808186,4816785,4816810,0,0,8599,8624
12724,4808246,4816802,4816852,0,0,8556,8606
12725,4808459,4816810,4816862,0,0,8351,8403
12714,4806713,4816676,4816929,0,0,9963,10216
12726,4808524,4816852,4816947,0,0,8328,8423
12723,4808238,4816796,4816985,0,0,8558,8747
12728,4809141,4816947,4817001,0,0,7806,7860
12710,4805783,4816676,4817026,0,0,10893,11243
12730,4809760,4817001,4817049,0,0,7241,7289
12729,4809655,4816985,4817051,0,0,7330,7396
12733,4810621,4817049,4817096,0,0,6428,6475
12731,4809923,4817026,4817121,0,0,7103,7198
12734,4811891,4817096,4817175,0,0,5205,5284
12732,4810090,4817026,4817186,0,0,6936,7096
12737,4815647,4817186,4817472,0,0,1539,1825
12727,4808857,4816862,4817484,0,0,8005,8627
12735,4813347,4817175,4819716,0,0,3828,6369
12722,4808194,4816792,4820008,0,0,8598,11814
12719,4808111,4816929,4820706,0,0,8818,12595
12534,4769118,4815965,4820729,0,0,46847,51611
12739,4820191,4820706,4820967,0,0,515,776
12740,4820898,4820967,4821218,0,0,69,320
12535,4769141,4820729,4822071,0,0,51588,52930
12738,4818714,4818714,4824347,0,0,0,5633
12707,4799392,4799392,4824629,0,0,0,25237
12708,4801245,4801245,4826474,0,0,0,25229
12741,4821755,4821755,4826776,0,0,0,5021
12606,4780377,4822071,4829243,0,0,41694,48866
12736,4815392,4820008,4834145,0,0,4616,18753
12742,4829528,4829528,4843692,0,0,0,14164
12743,4841890,4843692,4843723,0,0,1802,1833
12744,4842197,4843723,4845011,0,0,1526,2814
12745,4848948,4848948,4850402,0,0,0,1454
12746,4849885,4850402,4850460,0,0,517,575
12747,4851990,4851990,4852014,0,0,0,24
12684,4791709,4829243,4852314,0,0,37534,60605
12749,4856957,4856957,4859445,0,0,0,2488
12750,4860489,4860489,4860732,0,0,0,243
12751,4863223,4863223,4863304,0,0,0,81
12756,4868250,4868250,4868295,0,0,0,45
12758,4868456,4868456,4868557,0,0,0,101
12759,4868456,4868456,4868557,0,0,0,101
12760,4868607,4868607,4868665,0,0,0,58
12762,4868674,4868674,4868717,0,0,0,43
12755,4867851,4867851,4868904,0,0,0,1053
12764,4868786,4868786,4868913,0,0,0,127
12761,4868662,4868662,4868931,0,0,0,269
12767,4868903,4868931,4868985,0,0,28,82
12765,4868832,4868904,4868986,0,0,72,154
12766,4868857,4868913,4868998,0,0,56,141
12770,4868974,4868986,4869045,0,0,12,71
12768,4868933,4868985,4869085,0,0,52,152
12772,4869032,4869032,4869151,0,0,0,119
12775,4869150,4869150,4869275,0,0,0,125
12777,4869226,4869275,4869319,0,0,49,93
12778,4869274,4869319,4869441,0,0,45,167
12780,4869372,4869441,4869510,0,0,69,138
12782,4869396,4869510,4869670,0,0,114,274
12785,4869532,4869670,4869761,0,0,138,229
12748,4852956,4852956,4869861,0,0,0,16905
12752,4865712,4865712,4870441,0,0,0,4729
12769,4868933,4870441,4870541,0,0,1508,1608
12771,4869032,4870441,4870542,0,0,1409,1510
12774,4869150,4870441,4870549,0,0,1291,1399
12779,4869274,4870441,4870563,0,0,1167,1289
12781,4869395,4870441,4870584,0,0,1046,1189
12792,4870069,4870549,4870596,0,0,480,527
12793,4870512,4870584,4875966,0,0,72,5454
12795,4871905,4875966,4877198,0,0,4061,5293
12796,4877798,4877798,4878015,0,0,0,217
12797,4880725,4880725,4881428,0,0,0,703
12753,4866544,4866544,4883433,0,0,0,16889
12757,4868417,4868417,4884231,0,0,0,15814
12754,4867482,4867482,4884232,0,0,0,16750
12776,4869191,4869191,4884290,0,0,0,15099
12763,4868709,4868709,4884292,0,0,0,15583
12773,4869083,4869083,4884353,0,0,0,15270
12788,4869611,4869861,4884538,0,0,250,14927
12787,4869556,4869761,4884558,0,0,205,15002
12791,4869793,4870549,4885041,0,0,756,15248
12790,4869783,4870542,4885046,0,0,759,15263
12784,4869485,4870441,4885183,0,0,956,15698
12789,4869618,4870542,4885273,0,0,924,15655
12786,4869556,4870541,4885278,0,0,985,15722
12783,4869417,4870441,4885317,0,0,1024,15900
12794,4871888,4884231,4886071,0,0,12343,14183
12800,4886526,4886526,4886560,0,0,0,34
12801,4886597,4886597,4886657,0,0,0,60
12802,4886633,4886633,4886658,0,0,0,25
12798,4884531,4884531,4887076,0,0,0,2545
12799,4886431,4886431,4887082,0,0,0,651
12803,4887322,4887322,4887382,0,0,0,60
12804,4887427,4887427,4887456,0,0,0,29
12806,4887508,4887508,4887529,0,0,0,21
12805,4887470,4887470,4887690,0,0,0,220
12809,4889078,4889078,4890425,0,0,0,1347
12810,4890421,4890421,4890453,0,0,0,32
12811,4890615,4890615,4890678,0,0,0,63
12812,4891134,4891134,4891177,0,0,0,43
12808,4888879,4888879,4892313,0,0,0,3434
12815,4892335,4892335,4893060,0,0,0,725
12818,4893554,4893554,4893660,0,0,0,106
12817,4893415,4893415,4893709,0,0,0,294
12819,4893719,4893719,4893734,0,0,0,15
12813,4891805,4891805,4894003,0,0,0,2198
12820,4893998,4893998,4894011,0,0,0,13
12821,4894364,4894364,4894435,0,0,0,71
12822,4894543,4894543,4894606,0,0,0,63
12824,4894717,4894717,4894825,0,0,0,108
12823,4894695,4894695,4894877,0,0,0,182
12825,4894943,4894943,4895049,0,0,0,106
12816,4893184,4893184,4895050,0,0,0,1866
12826,4895097,4895097,4895142,0,0,0,45
12807,4887726,4887726,4895351,0,0,0,7625
12827,4895243,4895243,4895351,0,0,0,108
12828,4895471,4895471,4895514,0,0,0,43
12829,4895477,4895477,4895571,0,0,0,94
12831,4895717,4895717,4895917,0,0,0,200
12833,4895895,4895895,4895920,0,0,0,25
12835,4896460,4896460,4896477,0,0,0,17
12834,4896414,4896414,4896564,0,0,0,150
12830,4895662,4895662,4897008,0,0,0,1346
12837,4897051,4897051,4897373,0,0,0,322
12814,4892116,4892116,4900630,0,0,0,8514
12840,4899203,4899203,4901170,0,0,0,1967
12842,4900464,4900630,4901351,0,0,166,887
12836,4896684,4896684,4903396,0,0,0,6712
12839,4897552,4897552,4904318,0,0,0,6766
12843,4901407,4903396,4905276,0,0,1989,3869
12838,4897137,4897137,4905726,0,0,0,8589
12844,4906284,4906284,4906674,0,0,0,390
12845,4906839,4906839,4907471,0,0,0,632
12847,4907886,4907886,4911639,0,0,0,3753
12841,4899310,4901170,4915317,0,0,1860,16007
12832,4895858,4895858,4918565,0,0,0,22707
12848,4913458,4913458,4927662,0,0,0,14204
12846,4907206,4907206,4928467,0,0,0,21261
12849,4924255,4924255,4929913,0,0,0,5658
12850,4924313,4924313,4929955,0,0,0,5642
12855,4932773,4932773,4932784,0,0,0,11
12856,4933048,4933048,4933153,0,0,0,105
12854,4932572,4932572,4933720,0,0,0,1148
12858,4934221,4934221,4934307,0,0,0,86
12857,4934019,4934019,4934524,0,0,0,505
12860,4934430,4934430,4934527,0,0,0,97
12861,4934568,4934568,4934799,0,0,0,231
12862,4934710,4934710,4934957,0,0,0,247
12852,4932375,4932375,4934971,0,0,0,2596
12865,4935128,4935128,4935180,0,0,0,52
12866,4935187,4935187,4935273,0,0,0,86
12867,4935289,4935289,4935398,0,0,0,109
12863,4934826,4934826,4935549,0,0,0,723
12871,4935544,4935544,4935637,0,0,0,93
12874,4935687,4935687,4936156,0,0,0,469
12877,4936173,4936173,4936285,0,0,0,112
12872,4935667,4935667,4936447,0,0,0,780
12878,4936303,4936303,4936473,0,0,0,170
12875,4935779,4935779,4936483,0,0,0,704
12881,4936532,4936532,4936568,0,0,0,36
12879,4936312,4936312,4936659,0,0,0,347
12876,4935809,4935809,4936742,0,0,0,933
12859,4934305,4934305,4936835,0,0,0,2530
12880,4936477,4936477,4936836,0,0,0,359
12885,4936763,4936763,4936836,0,0,0,73
12853,4932503,4932503,4937103,0,0,0,4600
12890,4937121,4937121,4937196,0,0,0,75
12891,4937188,4937196,4937242,0,0,8,54
12882,4936590,4936590,4937298,0,0,0,708
12893,4937433,4937433,4937546,0,0,0,113
12892,4937315,4937315,4937601,0,0,0,286
12895,4937830,4937830,4937896,0,0,0,66
12869,4935388,4935388,4937905,0,0,0,2517
12886,4936774,4936774,4937941,0,0,0,1167
12897,4938014,4938014,4938056,0,0,0,42
12883,4936738,4936738,4938186,0,0,0,1448
12896,4937843,4937896,4938330,0,0,53,487
12899,4938248,4938330,4938376,0,0,82,128
12884,4936758,4936758,4938469,0,0,0,1711
12901,4938560,4938560,4938848,0,0,0,288
12902,4938646,4938848,4938935,0,0,202,289
12903,4938961,4938961,4939006,0,0,0,45
12898,4938034,4938186,4939122,0,0,152,1088
12904,4939070,4939070,4939122,0,0,0,52
12905,4939188,4939188,4939237,0,0,0,49
12906,4939264,4939264,4939307,0,0,0,43
12907,4939474,4939474,4939517,0,0,0,43
12864,4935010,4935010,4939832,0,0,0,4822
12900,4938304,4938376,4939958,0,0,72,1654
12908,4939984,4939984,4940027,0,0,0,43
12909,4940252,4940252,4940295,0,0,0,43
12910,4940539,4940539,4940582,0,0,0,43
12911,4940912,4940912,4940955,0,0,0,43
12887,4936783,4936783,4941025,0,0,0,4242
12913,4941211,4941211,4941341,0,0,0,130
12914,4941354,4941354,4941423,0,0,0,69
12915,4941417,4941417,4941639,0,0,0,222
12851,4927665,4927665,4941854,0,0,0,14189
12870,4935434,4935434,4942039,0,0,0,6605
12873,4935678,4935678,4942434,0,0,0,6756
12868,4935345,4935345,4942435,0,0,0,7090
12919,4942465,4942465,4942513,0,0,0,48
12916,4941781,4941781,4942556,0,0,0,775
12888,4937043,4937043,4942644,0,0,0,5601
12920,4942694,4942694,4942721,0,0,0,27
12917,4941979,4941979,4942878,0,0,0,899
12921,4942741,4942741,4943332,0,0,0,591
12922,4943239,4943239,4943343,0,0,0,104
12918,4942020,4942020,4943365,0,0,0,1345
12912,4941003,4941003,4943381,0,0,0,2378
12889,4937115,4937115,4943406,0,0,0,6291
12923,4943539,4943539,4943555,0,0,0,16
12894,4937587,4937587,4943652,0,0,0,6065
12924,4943563,4943563,4944025,0,0,0,462
12926,4944033,4944033,4944048,0,0,0,15
12928,4946051,4946051,4946481,0,0,0,430
12930,4947660,4947660,4950264,0,0,0,2604
12925,4943726,4943726,4951949,0,0,0,8223
12934,4953040,4953040,4953068,0,0,0,28
12935,4953066,4953066,4953091,0,0,0,25
12937,4953125,4953125,4953250,0,0,0,125
12936,4953116,4953116,4953251,0,0,0,135
12938,4953138,4953138,4953251,0,0,0,113
12939,4953361,4953361,4953415,0,0,0,54
12940,4953508,4953508,4953554,0,0,0,46
12941,4953539,4953539,4953570,0,0,0,31
12943,4953686,4953686,4953766,0,0,0,80
12944,4953803,4953803,4953833,0,0,0,30
12945,4953852,4953852,4953876,0,0,0,24
12946,4954028,4954028,4954110,0,0,0,82
12942,4953634,4953634,4954130,0,0,0,496
12948,4954095,4954095,4954148,0,0,0,53
12947,4954077,4954077,4954182,0,0,0,105
12949,4954152,4954152,4954182,0,0,0,30
12951,4954210,4954210,4954285,0,0,0,75
12952,4954312,4954312,4954399,0,0,0,87
12953,4954379,4954379,4954422,0,0,0,43
12954,4954608,4954608,4954632,0,0,0,24
12955,4954893,4954893,4954923,0,0,0,30
12950,4954204,4954204,4955232,0,0,0,1028
12957,4955458,4955458,4955506,0,0,0,48
12960,4955744,4955744,4955764,0,0,0,20
12927,4944715,4944715,4955864,0,0,0,11149
12961,4956081,4956081,4956111,0,0,0,30
12962,4956180,4956180,4956226,0,0,0,46
12929,4946298,4946298,4956270,0,0,0,9972
12932,4949937,4949937,4956403,0,0,0,6466
12964,4956389,4956389,4956433,0,0,0,44
12958,4955575,4955575,4956470,0,0,0,895
12966,4956545,4956545,4956565,0,0,0,20
12967,4956552,4956565,4956613,0,0,13,61
12968,4956602,4956613,4956653,0,0,11,51
12969,4956687,4956687,4956727,0,0,0,40
12963,4956350,4956350,4956982,0,0,0,632
12971,4956861,4956982,4957030,0,0,121,169
12970,4956817,4956817,4957093,0,0,0,276
12974,4957368,4957368,4957384,0,0,0,16
12975,4957481,4957481,4957515,0,0,0,34
12973,4957228,4957228,4957523,0,0,0,295
12976,4957556,4957556,4957613,0,0,0,57
12977,4957807,4957807,4957876,0,0,0,69
12978,4957916,4957916,4957938,0,0,0,22
12979,4957923,4957923,4958030,0,0,0,107
12980,4958079,4958079,4958128,0,0,0,49
12982,4958241,4958241,4958287,0,0,0,46
12983,4958312,4958312,4958385,0,0,0,73
12984,4958349,4958385,4958439,0,0,36,90
12985,4958376,4958439,4958583,0,0,63,207
12986,4958516,4958583,4958651,0,0,67,135
12987,4958716,4958716,4958790,0,0,0,74
12988,4958810,4958810,4958827,0,0,0,17
12989,4958897,4958897,4958965,0,0,0,68
12991,4959272,4959272,4959339,0,0,0,67
12992,4959366,4959366,4959445,0,0,0,79
12981,4958210,4958210,4959498,0,0,0,1288
12993,4959595,4959595,4959641,0,0,0,46
12959,4955591,4955591,4959761,0,0,0,4170
12995,4959864,4959864,4959908,0,0,0,44
12933,4952089,4952089,4959984,0,0,0,7895
12931,4948694,4948694,4960073,0,0,0,11379
12990,4959160,4960073,4960339,0,0,913,1179
12999,4960265,4960265,4960340,0,0,0,75
12956,4955241,4955241,4960703,0,0,0,5462
12972,4957056,4957056,4960800,0,0,0,3744
13004,4960835,4960835,4960859,0,0,0,24
13003,4960822,4960822,4960893,0,0,0,71
13001,4960648,4960648,4960898,0,0,0,250
13002,4960681,4960681,4960990,0,0,0,309
13000,4960533,4960533,4961052,0,0,0,519
12997,4960162,4960162,4961244,0,0,0,1082
13007,4961252,4961252,4961272,0,0,0,20
13005,4961090,4961090,4961325,0,0,0,235
12965,4956417,4956470,4961711,0,0,53,5294
13009,4961693,4961693,4961713,0,0,0,20
13011,4961847,4961847,4961880,0,0,0,33
13012,4962302,4962302,4962341,0,0,0,39
13015,4962527,4962527,4962604,0,0,0,77
13008,4961611,4961711,4962694,0,0,100,1083
13013,4962375,4962694,4962769,0,0,319,394
13018,4962856,4962856,4962888,0,0,0,32
13019,4962881,4962881,4962967,0,0,0,86
13016,4962700,4962700,4962968,0,0,0,268
13021,4963001,4963001,4963224,0,0,0,223
13022,4963230,4963230,4963237,0,0,0,7
13023,4963248,4963248,4963255,0,0,0,7
13024,4963258,4963258,4963264,0,0,0,6
13025,4963328,4963328,4963380,0,0,0,52
13027,4963518,4963518,4963608,0,0,0,90
13028,4963615,4963615,4963776,0,0,0,161
12994,4959694,4959694,4963820,0,0,0,4126
13026,4963391,4963391,4964028,0,0,0,637
12998,4960225,4960225,4964039,0,0,0,3814
13031,4964058,4964058,4964181,0,0,0,123
13033,4964229,4964229,4964308,0,0,0,79
13032,4964206,4964206,4964402,0,0,0,196
13036,4964427,4964427,4964462,0,0,0,35
13038,4964585,4964585,4964639,0,0,0,54
13029,4963773,4963773,4965071,0,0,0,1298
13043,4965255,4965255,4965292,0,0,0,37
13045,4965478,4965478,4965783,0,0,0,305
13046,4965875,4965875,4965932,0,0,0,57
13035,4964362,4964362,4966142,0,0,0,1780
13041,4964770,4966142,4966184,0,0,1372,1414
13017,4962843,4962843,4966210,0,0,0,3367
13047,4966257,4966257,4966464,0,0,0,207
13050,4966408,4966408,4966468,0,0,0,60
12996,4959937,4959937,4966777,0,0,0,6840
13052,4966762,4966762,4966818,0,0,0,56
13010,4961768,4961768,4967386,0,0,0,5618
13044,4965448,4965448,4967582,0,0,0,2134
13054,4967571,4967571,4967642,0,0,0,71
13055,4967664,4967664,4967718,0,0,0,54
13053,4967183,4967386,4968196,0,0,203,1013
13057,4968231,4968231,4968270,0,0,0,39
13058,4968418,4968418,4968476,0,0,0,58
13059,4968539,4968539,4968578,0,0,0,39
13060,4968959,4968959,4968997,0,0,0,38
13061,4968995,4968995,4969044,0,0,0,49
13014,4962476,4962476,4969494,0,0,0,7018
13006,4961163,4961163,4970012,0,0,0,8849
13062,4970051,4970051,4970087,0,0,0,36
13030,4963818,4963818,4970328,0,0,0,6510
13056,4968082,4968082,4970407,0,0,0,2325
13020,4962970,4962970,4970415,0,0,0,7445
13065,4970330,4970330,4971306,0,0,0,976
13067,4971366,4971366,4971389,0,0,0,23
13066,4970741,4970741,4971450,0,0,0,709
13068,4971628,4971628,4971815,0,0,0,187
13069,4971954,4971954,4971998,0,0,0,44
13071,4972215,4972215,4972227,0,0,0,12
13070,4972181,4972181,4972334,0,0,0,153
13072,4972803,4972803,4972885,0,0,0,82
13074,4973156,4973156,4973174,0,0,0,18
13073,4973028,4973028,4973181,0,0,0,153
13075,4973402,4973402,4973440,0,0,0,38
13076,4973561,4973561,4973639,0,0,0,78
13077,4973571,4973571,4973771,0,0,0,200
13079,4974049,4974049,4974085,0,0,0,36
13078,4974042,4974042,4974247,0,0,0,205
13080,4974689,4974689,4974760,0,0,0,71
13064,4970296,4970296,4974977,0,0,0,4681
13082,4975009,4975009,4975055,0,0,0,46
13083,4975076,4975076,4975186,0,0,0,110
13037,4964479,4964479,4975226,0,0,0,10747
13085,4975359,4975359,4975397,0,0,0,38
13034,4964239,4964239,4975497,0,0,0,11258
13087,4975544,4975544,4975581,0,0,0,37
13086,4975461,4975461,4975603,0,0,0,142
13049,4966398,4966398,4975664,0,0,0,9266
13088,4975913,4975913,4975955,0,0,0,42
13089,4975939,4975939,4976054,0,0,0,115
13091,4976276,4976276,4976369,0,0,0,93
13063,4970058,4970058,4976492,0,0,0,6434
13093,4976620,4976620,4976680,0,0,0,60
13094,4976626,4976626,4976741,0,0,0,115
13095,4976871,4976871,4976884,0,0,0,13
13096,4977015,4977015,4977155,0,0,0,140
13097,4977404,4977404,4977635,0,0,0,231
13098,4977649,4977649,4977772,0,0,0,123
13081,4974979,4974979,4977899,0,0,0,2920
13100,4978002,4978002,4978045,0,0,0,43
13101,4978188,4978188,4978278,0,0,0,90
13102,4978738,4978738,4978838,0,0,0,100
13104,4979038,4979038,4979078,0,0,0,40
13105,4979381,4979381,4979439,0,0,0,58
13106,4979687,4979687,4979728,0,0,0,41
13107,4979703,4979703,4979820,0,0,0,117
13108,4979885,4979885,4979945,0,0,0,60
13110,4980117,4980117,4980188,0,0,0,71
13111,4980247,4980247,4980288,0,0,0,41
13112,4980563,4980563,4980621,0,0,0,58
13099,4977874,4977874,4980884,0,0,0,3010
13115,4980967,4980967,4981025,0,0,0,58
13114,4980924,4980924,4981095,0,0,0,171
13084,4975240,4975240,4981549,0,0,0,6309
13116,4981544,4981544,4981659,0,0,0,115
13118,4981930,4981930,4981970,0,0,0,40
13119,4982079,4982079,4982229,0,0,0,150
13092,4976488,4976488,4982242,0,0,0,5754
13039,4964715,4982242,4982278,0,0,17527,17563
13120,4982241,4982241,4982303,0,0,0,62
13122,4982905,4982905,4982951,0,0,0,46
13123,4983083,4983083,4983140,0,0,0,57
13103,4978985,4978985,4983640,0,0,0,4655
13121,4982776,4983640,4983714,0,0,864,938
13124,4983432,4983714,4983820,0,0,282,388
13125,4983851,4983851,4983906,0,0,0,55
13117,4981721,4981721,4984457,0,0,0,2736
13127,4984843,4984843,4984881,0,0,0,38
13113,4980863,4980863,4985129,0,0,0,4266
13109,4979983,4979983,4985516,0,0,0,5533
13040,4964757,4982278,4985737,0,0,17521,20980
13130,4985801,4985801,4985894,0,0,0,93
13131,4986428,4986428,4986458,0,0,0,30
13133,4986922,4986922,4986987,0,0,0,65
13134,4987575,4987575,4987667,0,0,0,92
13135,4987713,4987713,4987786,0,0,0,73
13128,4985112,4985112,4987861,0,0,0,2749
13137,4987865,4987865,4987910,0,0,0,45
13126,4984499,4984499,4988449,0,0,0,3950
13138,4988706,4988706,4988774,0,0,0,68
13140,4989208,4989208,4989273,0,0,0,65
13141,4989329,4989329,4989367,0,0,0,38
13048,4966393,4966818,4989505,0,0,425,23112
13142,4989725,4989725,4989784,0,0,0,59
13136,4987817,4987817,4990280,0,0,0,2463
13143,4990240,4990240,4990286,0,0,0,46
13145,4990595,4990595,4990659,0,0,0,64
13147,4991135,4991135,4991215,0,0,0,80
13148,4991554,4991554,4991573,0,0,0,19
13149,4991714,4991714,4991761,0,0,0,47
13150,4991818,4991818,4991831,0,0,0,13
13151,4992011,4992011,4992035,0,0,0,24
13152,4992063,4992063,4992114,0,0,0,51
13153,4992483,4992483,4992547,0,0,0,64
13154,4992594,4992594,4992638,0,0,0,44
13155,4992693,4992693,4992733,0,0,0,40
13144,4990279,4990279,4992734,0,0,0,2455
13158,4993715,4993715,4993737,0,0,0,22
13159,4995555,4995555,4995661,0,0,0,106
13161,4995805,4995805,4995828,0,0,0,23
13156,4992727,4992727,4995829,0,0,0,3102
13160,4995739,4995739,4995879,0,0,0,140
13163,4996039,4996039,4996054,0,0,0,15
13164,4996225,4996225,4996257,0,0,0,32
13165,4996371,4996371,4996407,0,0,0,36
13166,4996501,4996501,4996516,0,0,0,15
13167,4996593,4996593,4996609,0,0,0,16
13169,4997008,4997008,4997029,0,0,0,21
13168,4996995,4996995,4997082,0,0,0,87
13170,4997173,4997173,4997199,0,0,0,26
13171,4997312,4997312,4997324,0,0,0,12
13172,4997474,4997474,4997490,0,0,0,16
13173,4997589,4997589,4997608,0,0,0,19
13174,4997750,4997750,4997796,0,0,0,46
13175,4997901,4997901,4997926,0,0,0,25
13176,4998046,4998046,4998062,0,0,0,16
13177,4998156,4998156,4998171,0,0,0,15
13178,4998253,4998253,4998269,0,0,0,16
13179,4998487,4998487,4998502,0,0,0,15
13180,4998589,4998589,4998603,0,0,0,14
13181,4998622,4998622,4998660,0,0,0,38
13182,4998682,4998682,4998699,0,0,0,17
13183,4998728,4998728,4998758,0,0,0,30
13184,4998844,4998844,4998864,0,0,0,20
13185,4998930,4998930,4998944,0,0,0,14
13186,4999037,4999037,4999050,0,0,0,13
13157,4993686,4993686,4999101,0,0,0,5415
13187,4999183,4999183,4999198,0,0,0,15
13188,4999300,4999300,4999314,0,0,0,14
13189,4999402,4999402,4999420,0,0,0,18
13190,4999489,4999489,4999515,0,0,0,26
13042,4965003,4985737,4999545,0,0,20734,34542
13191,4999553,4999553,4999574,0,0,0,21
13162,4995813,4995813,4999813,0,0,0,4000
13051,4966453,4999545,5001445,0,0,33092,34992
13192,4999790,4999790,5002254,0,0,0,2464
13090,4976017,5001445,5003400,0,0,25428,27383
13193,5002233,5002233,5004560,0,0,0,2327
13132,4986541,5003400,5004863,0,0,16859,18322
13146,4990685,4990685,5005269,0,0,0,14584
13139,4989195,5004863,5006373,0,0,15668,17178
13194,5004532,5004532,5006867,0,0,0,2335
13129,4985278,4985278,5009178,0,0,0,23900
13195,5006874,5006874,5009225,0,0,0,2351
13196,5025433,5025433,5025821,0,0,0,388
13197,5033019,5033019,5036981,0,0,0,3962
13199,5038061,5038061,5038182,0,0,0,121
13200,5038061,5038061,5038182,0,0,0,121
13202,5038181,5038181,5038218,0,0,0,37
13211,5038217,5038218,5038252,0,0,1,35
13206,5038216,5038216,5038253,0,0,0,37
13205,5038181,5038181,5038254,0,0,0,73
13212,5038217,5038252,5038287,0,0,35,70
13207,5038216,5038253,5038290,0,0,37,74
13218,5038251,5038251,5038410,0,0,0,159
13213,5038217,5038287,5038848,0,0,70,631
13224,5038410,5038410,5039005,0,0,0,595
13216,5038250,5038848,5039211,0,0,598,961
13210,5038216,5038290,5039296,0,0,74,1080
13219,5038251,5039211,5039371,0,0,960,1120
13214,5038250,5039296,5039457,0,0,1046,1207
13217,5038250,5039457,5039820,0,0,1207,1570
13243,5039815,5039815,5039867,0,0,0,52
13201,5038180,5038180,5040206,0,0,0,2026
13203,5038181,5040206,5040243,0,0,2025,2062
13204,5038181,5040243,5040280,0,0,2062,2099
13208,5038216,5040280,5040317,0,0,2064,2101
13221,5038309,5039820,5040450,0,0,1511,2141
13226,5038551,5040450,5040512,0,0,1899,1961
13227,5038612,5040512,5040573,0,0,1900,1961
13228,5038612,5040573,5040634,0,0,1961,2022
13223,5038310,5040450,5040691,0,0,2140,2381
13231,5038673,5040634,5040694,0,0,1961,2021
13209,5038216,5040317,5040715,0,0,2101,2499
13215,5038250,5040715,5040877,0,0,2465,2627
13233,5038733,5040691,5040896,0,0,1958,2163
13235,5038760,5040694,5041934,0,0,1934,3174
13229,5038612,5041934,5042056,0,0,3322,3444
13232,5038733,5042056,5042083,0,0,3323,3350
13236,5038778,5042083,5042243,0,0,3305,3465
13222,5038309,5040877,5042319,0,0,2568,4010
13237,5038838,5042243,5042350,0,0,3405,3512
13230,5038612,5042319,5042441,0,0,3707,3829
13238,5038838,5042350,5042516,0,0,3512,3678
13234,5038733,5042441,5042647,0,0,3708,3914
13239,5038939,5042647,5042774,0,0,3708,3835
13241,5039061,5042774,5042897,0,0,3713,3836
13240,5038940,5042516,5043781,0,0,3576,4841
13242,5039179,5042897,5044283,0,0,3718,5104
13244,5042391,5042391,5046096,0,0,0,3705
13198,5034541,5034541,5048469,0,0,0,13928
13245,5045105,5045105,5048862,0,0,0,3757
13225,5038410,5038410,5052700,0,0,0,14290
13220,5038251,5039371,5053821,0,0,1120,15570
13247,5053166,5053166,5056393,0,0,0,3227
13257,5056483,5056483,5056547,0,0,0,64
13251,5054858,5054858,5056771,0,0,0,1913
13253,5055352,5056771,5056797,0,0,1419,1445
13248,5053193,5056393,5056807,0,0,3200,3614
13254,5055410,5056797,5056820,0,0,1387,1410
13255,5055777,5056820,5056841,0,0,1043,1064
13256,5055833,5056841,5056857,0,0,1008,1024
13258,5056507,5056857,5056878,0,0,350,371
13259,5056543,5056878,5056900,0,0,335,357
13260,5056927,5056927,5056962,0,0,0,35
13261,5057314,5057314,5057343,0,0,0,29
13262,5057385,5057385,5057403,0,0,0,18
13252,5055156,5055156,5057538,0,0,0,2382
13264,5057875,5057875,5057894,0,0,0,19
13265,5058180,5058180,5058243,0,0,0,63
13266,5058252,5058252,5058438,0,0,0,186
13268,5058752,5058752,5058772,0,0,0,20
13269,5058776,5058776,5058910,0,0,0,134
13270,5058811,5058910,5058925,0,0,99,114
13250,5053649,5056807,5059368,0,0,3158,5719
13249,5053355,5053355,5059759,0,0,0,6404
13263,5057500,5057500,5060038,0,0,0,2538
13274,5060330,5060330,5060533,0,0,0,203
13272,5059447,5059447,5061484,0,0,0,2037
13275,5061265,5061265,5061517,0,0,0,252
13277,5061727,5061727,5061863,0,0,0,136
13278,5062122,5062122,5062304,0,0,0,182
13273,5059974,5059974,5062697,0,0,0,2723
13280,5062670,5062670,5062697,0,0,0,27
13282,5062735,5062735,5062753,0,0,0,18
13279,5062576,5062576,5062833,0,0,0,257
13283,5063061,5063061,5063083,0,0,0,22
13285,5063304,5063304,5063326,0,0,0,22
13286,5063418,5063418,5063433,0,0,0,15
13287,5063693,5063693,5063828,0,0,0,135
13288,5063872,5063872,5063893,0,0,0,21
13289,5063927,5063927,5063944,0,0,0,17
13290,5064064,5064064,5064238,0,0,0,174
13292,5064544,5064544,5064566,0,0,0,22
13291,5064459,5064459,5064692,0,0,0,233
13294,5064753,5064753,5064771,0,0,0,18
13293,5064550,5064550,5064827,0,0,0,277
13296,5065404,5065404,5065456,0,0,0,52
13267,5058550,5059368,5065466,0,0,818,6916
13297,5065818,5065818,5065840,0,0,0,22
13298,5065856,5065856,5065931,0,0,0,75
13299,5066178,5066178,5066199,0,0,0,21
13300,5066213,5066213,5066293,0,0,0,80
13301,5066489,5066489,5066513,0,0,0,24
13302,5066502,5066502,5066564,0,0,0,62
13271,5059162,5059368,5066613,0,0,206,7451
13276,5061361,5061361,5066755,0,0,0,5394
13303,5066741,5066741,5066759,0,0,0,18
13304,5066785,5066785,5066854,0,0,0,69
13281,5062689,5062689,5066968,0,0,0,4279
13307,5067061,5067061,5067076,0,0,0,15
13306,5067036,5067036,5067099,0,0,0,63
13295,5064829,5064829,5067138,0,0,0,2309
13308,5067208,5067208,5067276,0,0,0,68
13309,5067317,5067317,5067335,0,0,0,18
13310,5067323,5067323,5067413,0,0,0,90
13311,5067506,5067506,5067531,0,0,0,25
13312,5067597,5067597,5067653,0,0,0,56
13313,5067988,5067988,5068074,0,0,0,86
13284,5063229,5066613,5068111,0,0,3384,4882
13315,5068436,5068436,5068655,0,0,0,219
13316,5068784,5068784,5068950,0,0,0,166
13317,5069092,5069092,5069231,0,0,0,139
13305,5066906,5066906,5069331,0,0,0,2425
13314,5068254,5068254,5069412,0,0,0,1158
13320,5069786,5069786,5070009,0,0,0,223
13322,5070437,5070437,5070501,0,0,0,64
13323,5070480,5070480,5070525,0,0,0,45
13321,5070116,5070116,5070773,0,0,0,657
13324,5070977,5070977,5071010,0,0,0,33
13325,5071029,5071029,5071042,0,0,0,13
13326,5071343,5071343,5071361,0,0,0,18
13327,5071408,5071408,5071428,0,0,0,20
13319,5069267,5069267,5071672,0,0,0,2405
13318,5069117,5069117,5071682,0,0,0,2565
13330,5071805,5071805,5071880,0,0,0,75
13332,5071917,5071917,5071953,0,0,0,36
13331,5071860,5071860,5072299,0,0,0,439
13333,5072456,5072456,5072523,0,0,0,67
13334,5072576,5072576,5072596,0,0,0,20
13335,5072673,5072673,5072690,0,0,0,17
13246,5049794,5049794,5072702,0,0,0,22908
13336,5072734,5072734,5073141,0,0,0,407
13337,5073258,5073258,5073309,0,0,0,51
13338,5073334,5073334,5073373,0,0,0,39
13340,5073739,5073739,5074115,0,0,0,376
13328,5071575,5071575,5074316,0,0,0,2741
13329,5071731,5071731,5075721,0,0,0,3990
13342,5075542,5075542,5075998,0,0,0,456
13343,5075766,5075766,5076563,0,0,0,797
13341,5074214,5074214,5076612,0,0,0,2398
13345,5077096,5077096,5077197,0,0,0,101
13346,5077496,5077496,5077611,0,0,0,115
13347,5078619,5078619,5078848,0,0,0,229
13344,5076533,5076533,5078932,0,0,0,2399
13349,5079707,5079707,5079872,0,0,0,165
13350,5080171,5080171,5080437,0,0,0,266
13351,5080622,5080622,5080924,0,0,0,302
13353,5081046,5081046,5081310,0,0,0,264
13348,5078877,5078877,5081432,0,0,0,2555
13352,5080707,5080707,5081456,0,0,0,749
13355,5081488,5081488,5081800,0,0,0,312
13356,5081885,5081885,5082261,0,0,0,376
13357,5083387,5083387,5083686,0,0,0,299
13354,5081369,5081369,5083688,0,0,0,2319
13360,5083886,5083886,5084372,0,0,0,486
13361,5084536,5084536,5085023,0,0,0,487
13359,5083720,5083720,5085361,0,0,0,1641
13362,5085168,5085168,5085595,0,0,0,427
13358,5083675,5083675,5086047,0,0,0,2372
13363,5085712,5085712,5086178,0,0,0,466
13365,5086235,5086235,5086822,0,0,0,587
13339,5073666,5073666,5087910,0,0,0,14244
13364,5085982,5085982,5088566,0,0,0,2584
13366,5088502,5088502,5090890,0,0,0,2388
13367,5090825,5090825,5093192,0,0,0,2367
13369,5094338,5094338,5095110,0,0,0,772
13368,5093130,5093130,5095541,0,0,0,2411
13370,5095477,5095477,5097846,0,0,0,2369
13371,5097782,5097782,5100137,0,0,0,2355
13372,5100072,5100072,5102497,0,0,0,2425
13373,5102435,5102435,5104806,0,0,0,2371
13376,5106440,5106440,5106683,0,0,0,243
13375,5104742,5104742,5107198,0,0,0,2456
13379,5107199,5107199,5107670,0,0,0,471
13381,5107336,5107336,5107814,0,0,0,478
13382,5107684,5107684,5108461,0,0,0,777
13377,5106759,5106759,5108700,0,0,0,1941
13387,5108999,5108999,5109035,0,0,0,36
13374,5102841,5102841,5109520,0,0,0,6679
13389,5109096,5109520,5109548,0,0,424,452
13388,5109059,5109059,5109602,0,0,0,543
13390,5109447,5109447,5109674,0,0,0,227
13394,5109925,5109925,5109958,0,0,0,33
13393,5109875,5109875,5109985,0,0,0,110
13396,5110036,5110036,5110065,0,0,0,29
13398,5110254,5110254,5110349,0,0,0,95
13399,5110412,5110412,5110487,0,0,0,75
13392,5109627,5109627,5110548,0,0,0,921
13395,5109974,5109974,5110607,0,0,0,633
13401,5110767,5110767,5110792,0,0,0,25
13400,5110755,5110755,5110831,0,0,0,76
13403,5110944,5110944,5111022,0,0,0,78
13404,5111097,5111097,5111136,0,0,0,39
13386,5108722,5109520,5111277,0,0,798,2555
13405,5111336,5111336,5111363,0,0,0,27
13406,5111444,5111444,5111463,0,0,0,19
13407,5111544,5111544,5111568,0,0,0,24
13408,5111600,5111600,5111669,0,0,0,69
13410,5111857,5111857,5111892,0,0,0,35
13409,5111661,5111661,5111953,0,0,0,292
13411,5111945,5111945,5111971,0,0,0,26
13385,5108591,5108591,5112861,0,0,0,4270
13415,5112082,5112861,5112882,0,0,779,800
13417,5112200,5112882,5112909,0,0,682,709
13418,5112505,5112909,5112929,0,0,404,424
13419,5112579,5112929,5112946,0,0,350,367
13383,5108137,5108137,5113142,0,0,0,5005
13422,5112807,5113142,5113178,0,0,335,371
13425,5113391,5113391,5113450,0,0,0,59
13420,5112607,5112946,5113514,0,0,339,907
13424,5112950,5113142,5113672,0,0,192,722
13428,5113567,5113672,5113772,0,0,105,205
13378,5107190,5107190,5114258,0,0,0,7068
13426,5113493,5114258,5114273,0,0,765,780
13427,5113534,5114273,5114285,0,0,739,751
13429,5113734,5114285,5114304,0,0,551,570
13431,5114026,5114304,5114320,0,0,278,294
13432,5114102,5114320,5114348,0,0,218,246
13430,5113760,5113772,5114415,0,0,12,655
13435,5114465,5114465,5114536,0,0,0,71
13380,5107243,5107243,5114556,0,0,0,7313
13434,5114294,5114556,5114572,0,0,262,278
13437,5114557,5114557,5114577,0,0,0,20
13438,5114632,5114632,5114782,0,0,0,150
13421,5112651,5112946,5115194,0,0,295,2543
13439,5114930,5115194,5115211,0,0,264,281
13440,5115318,5115318,5115346,0,0,0,28
13414,5112048,5112048,5115790,0,0,0,3742
13442,5115522,5115790,5115814,0,0,268,292
13443,5115854,5115854,5115877,0,0,0,23
13412,5111982,5111982,5115911,0,0,0,3929
13444,5115974,5115974,5115992,0,0,0,18
13445,5116002,5116002,5116104,0,0,0,102
13446,5116170,5116170,5116198,0,0,0,28
13416,5112110,5112110,5116243,0,0,0,4133
13447,5116463,5116463,5116510,0,0,0,47
13441,5115360,5115360,5116540,0,0,0,1180
13449,5117041,5117041,5117133,0,0,0,92
13451,5117128,5117128,5117151,0,0,0,23
13452,5117182,5117182,5117209,0,0,0,27
13453,5117512,5117512,5117562,0,0,0,50
13454,5117616,5117616,5117705,0,0,0,89
13448,5116728,5116728,5117792,0,0,0,1064
13384,5108470,5108470,5118111,0,0,0,9641
13457,5118267,5118267,5118364,0,0,0,97
13458,5118412,5118412,5118529,0,0,0,117
13456,5117779,5117779,5118570,0,0,0,791
13459,5118566,5118566,5118657,0,0,0,91
13461,5118714,5118714,5118760,0,0,0,46
13462,5119099,5119099,5119223,0,0,0,124
13463,5119201,5119201,5119262,0,0,0,61
13464,5119270,5119270,5119320,0,0,0,50
13465,5119548,5119548,5119591,0,0,0,43
13433,5114252,5114348,5119686,0,0,96,5434
13467,5119886,5119886,5119934,0,0,0,48
13469,5120255,5120255,5120307,0,0,0,52
13470,5120602,5120602,5120648,0,0,0,46
13468,5120193,5120193,5120671,0,0,0,478
13471,5120971,5120971,5121017,0,0,0,46
13472,5121047,5121047,5121175,0,0,0,128
13455,5117770,5117770,5121180,0,0,0,3410
13473,5121311,5121311,5121354,0,0,0,43
13475,5121424,5121424,5121575,0,0,0,151
13476,5121556,5121556,5121598,0,0,0,42
13477,5121725,5121725,5122090,0,0,0,365
13397,5110231,5110231,5122200,0,0,0,11969
13479,5121888,5121888,5122552,0,0,0,664
13402,5110838,5111277,5122683,0,0,439,11845
13474,5121388,5121388,5123260,0,0,0,1872
13483,5123008,5123008,5123326,0,0,0,318
13436,5114540,5114577,5123513,0,0,37,8973
13484,5123074,5123074,5123800,0,0,0,726
13482,5122970,5122970,5124100,0,0,0,1130
13489,5124209,5124209,5124285,0,0,0,76
13488,5124154,5124154,5124427,0,0,0,273
13487,5123648,5123648,5124436,0,0,0,788
13466,5119570,5119570,5125201,0,0,0,5631
13423,5112818,5113514,5125281,0,0,696,12463
13494,5125472,5125472,5125571,0,0,0,99
13486,5123528,5123528,5126149,0,0,0,2621
13496,5126046,5126046,5126584,0,0,0,538
13495,5125727,5125727,5126778,0,0,0,1051
13492,5124477,5124477,5127869,0,0,0,3392
13497,5129212,5129212,5130171,0,0,0,959
13460,5118707,5118707,5131797,0,0,0,13090
13505,5132075,5132075,5132233,0,0,0,158
13478,5121747,5121747,5132345,0,0,0,10598
13507,5132243,5132243,5133353,0,0,0,1110
13493,5125138,5125201,5133354,0,0,63,8216
13498,5129408,5129408,5133413,0,0,0,4005
13512,5133098,5133413,5133513,0,0,315,415
13511,5133069,5133353,5133713,0,0,284,644
13491,5124392,5124392,5134520,0,0,0,10128
13513,5133131,5133513,5134555,0,0,382,1424
13490,5124295,5124295,5134571,0,0,0,10276
13485,5123431,5123431,5134927,0,0,0,11496
13517,5134851,5134851,5135179,0,0,0,328
13503,5131911,5132345,5135248,0,0,434,3337
13501,5130854,5130854,5135384,0,0,0,4530
13499,5129750,5129750,5135385,0,0,0,5635
13521,5135467,5135467,5136798,0,0,0,1331
13519,5135019,5135019,5137286,0,0,0,2267
13480,5121899,5122200,5137321,0,0,301,15422
13481,5122241,5122683,5137482,0,0,442,15241
13529,5137108,5137108,5137631,0,0,0,523
13515,5134325,5134325,5137769,0,0,0,3444
13510,5132943,5133354,5137988,0,0,411,5045
13533,5139034,5139034,5139234,0,0,0,200
13523,5136050,5136050,5139544,0,0,0,3494
13536,5140166,5140166,5140213,0,0,0,47
13514,5133253,5134520,5140305,0,0,1267,7052
13537,5140610,5140610,5140656,0,0,0,46
13504,5132016,5132016,5140707,0,0,0,8691
13509,5132299,5132299,5140707,0,0,0,8408
13539,5140844,5140844,5140940,0,0,0,96
13541,5141138,5141138,5141200,0,0,0,62
13518,5134947,5134947,5143717,0,0,0,8770
13535,5139619,5139619,5143764,0,0,0,4145
13545,5142501,5143717,5143823,0,0,1216,1322
13502,5131812,5131812,5145101,0,0,0,13289
13528,5137061,5137061,5148427,0,0,0,11366
13546,5149448,5149448,5149466,0,0,0,18
13506,5132159,5137482,5150399,0,0,5323,18240
13547,5150976,5150976,5156901,0,0,0,5925
13391,5109469,5150399,5157393,0,0,40930,47924
13548,5152313,5156901,5157978,0,0,4588,5665
13413,5112044,5157393,5157987,0,0,45349,45943
13549,5157317,5157978,5161757,0,0,661,4440
13550,5161304,5161757,5161896,0,0,453,592
13450,5117073,5157987,5164660,0,0,40914,47587
13500,5130270,5164660,5165139,0,0,34390,34869
13508,5132260,5165139,5166900,0,0,32879,34640
13516,5134446,5166900,5167866,0,0,32454,33420
13520,5135392,5167866,5169200,0,0,32474,33808
13522,5135474,5169200,5176559,0,0,33726,41085
13524,5136665,5176559,5176585,0,0,39894,39920
13525,5136749,5176585,5176788,0,0,39836,40039
13526,5136800,5176788,5176847,0,0,39988,40047
13527,5136954,5176847,5177096,0,0,39893,40142
13530,5137148,5177096,5177282,0,0,39948,40134
13532,5137398,5177282,5177576,0,0,39884,40178
13551,5362310,5362310,5364144,0,0,0,1834
13552,5367886,5367886,5368378,0,0,0,492
13534,5139580,5139580,5377185,0,0,0,237605
13540,5141002,5141002,5377186,0,0,0,236184
13538,5140834,5140834,5377187,0,0,0,236353
13542,5141550,5141550,5377211,0,0,0,235661
13531,5137387,5137387,5377279,0,0,0,239892
13554,5378589,5378589,5378656,0,0,0,67
13544,5142309,5143717,5378680,0,0,1408,236371
13555,5379021,5379021,5379126,0,0,0,105
13556,5379028,5379028,5379128,0,0,0,100
13543,5141756,5143717,5379239,0,0,1961,237483
13559,5379272,5379272,5379330,0,0,0,58
13560,5379547,5379547,5379585,0,0,0,38
13561,5379615,5379615,5379671,0,0,0,56
13562,5379775,5379775,5379827,0,0,0,52
13564,5379970,5379970,5380112,0,0,0,142
13565,5380218,5380218,5380295,0,0,0,77
13566,5380301,5380301,5380350,0,0,0,49
13567,5380479,5380479,5380535,0,0,0,56
13569,5381001,5381001,5381056,0,0,0,55
13570,5381063,5381063,5381217,0,0,0,154
13572,5381241,5381241,5381294,0,0,0,53
13568,5380856,5380856,5381372,0,0,0,516
13573,5381491,5381491,5381579,0,0,0,88
13563,5379919,5379919,5381691,0,0,0,1772
13575,5381653,5381653,5381753,0,0,0,100
13576,5381762,5381762,5382155,0,0,0,393
13577,5382149,5382149,5382204,0,0,0,55
13574,5381569,5381569,5382275,0,0,0,706
13579,5382362,5382362,5382409,0,0,0,47
13578,5382271,5382271,5382624,0,0,0,353
13580,5382610,5382610,5382667,0,0,0,57
13571,5381070,5381070,5382683,0,0,0,1613
13581,5382734,5382734,5382788,0,0,0,54
13582,5382807,5382807,5382923,0,0,0,116
13585,5383124,5383124,5383170,0,0,0,46
13587,5383155,5383155,5383340,0,0,0,185
13588,5383275,5383275,5383391,0,0,0,116
13586,5383135,5383135,5383409,0,0,0,274
13589,5383516,5383516,5383652,0,0,0,136
13590,5383633,5383633,5383691,0,0,0,58
13591,5383826,5383826,5384200,0,0,0,374
13593,5383853,5384200,5384493,0,0,347,640
13594,5383979,5384493,5384565,0,0,514,586
13584,5383114,5383114,5384745,0,0,0,1631
13557,5379076,5379076,5384853,0,0,0,5777
13595,5384340,5384565,5384892,0,0,225,552
13599,5384917,5384917,5385039,0,0,0,122
13601,5385486,5385486,5385734,0,0,0,248
13553,5378065,5378065,5385974,0,0,0,7909
13602,5385867,5385867,5386172,0,0,0,305
13604,5386267,5386267,5386377,0,0,0,110
13608,5386788,5386788,5386881,0,0,0,93
13606,5386690,5386690,5386943,0,0,0,253
13609,5387049,5387049,5387106,0,0,0,57
13610,5387094,5387094,5387176,0,0,0,82
13611,5387116,5387116,5387340,0,0,0,224
13612,5387227,5387227,5387404,0,0,0,177
13614,5387451,5387451,5387494,0,0,0,43
13616,5387520,5387520,5387611,0,0,0,91
13615,5387512,5387512,5387788,0,0,0,276
13603,5385887,5385887,5387952,0,0,0,2065
13618,5387920,5387920,5388055,0,0,0,135
13617,5387860,5387860,5388201,0,0,0,341
13620,5388211,5388211,5388268,0,0,0,57
13619,5388194,5388194,5388506,0,0,0,312
13621,5388454,5388454,5388529,0,0,0,75
13622,5388523,5388523,5388633,0,0,0,110
13626,5388969,5388969,5389097,0,0,0,128
13625,5388954,5388954,5389187,0,0,0,233
13627,5389004,5389097,5389359,0,0,93,355
13628,5389306,5389306,5389476,0,0,0,170
13632,5389608,5389608,5389781,0,0,0,173
13633,5389768,5389781,5389832,0,0,13,64
13634,5389804,5389832,5390047,0,0,28,243
13635,5389936,5390047,5390146,0,0,111,210
13636,5390207,5390207,5390372,0,0,0,165
13629,5389332,5389359,5390450,0,0,27,1118
13637,5390501,5390501,5390716,0,0,0,215
13630,5389450,5390450,5390812,0,0,1000,1362
13638,5390508,5390716,5390828,0,0,208,320
13639,5390793,5390828,5391040,0,0,35,247
13631,5389598,5390812,5391252,0,0,1214,1654
13641,5390875,5391040,5391255,0,0,165,380
13642,5390891,5391255,5391333,0,0,364,442
13643,5391163,5391333,5391361,0,0,170,198
13644,5391289,5391361,5391739,0,0,72,450
13640,5390860,5391252,5391747,0,0,392,887
13647,5391479,5391747,5391761,0,0,268,282
13645,5391354,5391739,5391765,0,0,385,411
13646,5391402,5391747,5391767,0,0,345,365
13649,5391559,5391765,5391783,0,0,206,224
13650,5391607,5391767,5391817,0,0,160,210
13651,5391644,5391783,5391823,0,0,139,179
13652,5391670,5391817,5391873,0,0,147,203
13653,5391678,5391823,5391886,0,0,145,208
13648,5391505,5391761,5391915,0,0,256,410
13654,5391785,5391873,5391928,0,0,88,143
13655,5391803,5391886,5391993,0,0,83,190
13656,5392065,5392065,5392111,0,0,0,46
13658,5392092,5392111,5392176,0,0,19,84
13657,5392076,5392076,5392177,0,0,0,101
13583,5382831,5382831,5392307,0,0,0,9476
13660,5392307,5392307,5392415,0,0,0,108
13663,5392529,5392529,5392609,0,0,0,80
13662,5392486,5392486,5392619,0,0,0,133
13659,5392287,5392287,5392659,0,0,0,372
13664,5392672,5392672,5392698,0,0,0,26
13665,5392763,5392763,5392796,0,0,0,33
13666,5392802,5392802,5392960,0,0,0,158
13667,5392873,5392873,5392976,0,0,0,103
13668,5393102,5393102,5393228,0,0,0,126
13623,5388770,5388770,5393231,0,0,0,4461
13669,5393162,5393162,5393233,0,0,0,71
13558,5379216,5379216,5393427,0,0,0,14211
13670,5393370,5393370,5393557,0,0,0,187
13672,5393390,5393390,5393563,0,0,0,173
13673,5393452,5393452,5393564,0,0,0,112
13675,5393636,5393636,5393719,0,0,0,83
13676,5393778,5393778,5393837,0,0,0,59
13678,5393874,5393874,5393959,0,0,0,85
13674,5393616,5393616,5394087,0,0,0,471
13671,5393384,5393384,5394090,0,0,0,706
13677,5393864,5393864,5394150,0,0,0,286
13679,5394216,5394216,5394265,0,0,0,49
13681,5394517,5394517,5394558,0,0,0,41
13683,5394630,5394630,5394727,0,0,0,97
13685,5394873,5394873,5394906,0,0,0,33
13686,5394996,5394996,5395032,0,0,0,36
13682,5394524,5394524,5395041,0,0,0,517
13597,5384792,5384792,5395044,0,0,0,10252
13688,5395124,5395124,5395172,0,0,0,48
13690,5395313,5395313,5395363,0,0,0,50
13680,5394502,5394502,5395835,0,0,0,1333
13693,5395550,5395835,5395922,0,0,285,372
13694,5395727,5395922,5396003,0,0,195,276
13695,5395958,5396003,5396087,0,0,45,129
13696,5396223,5396223,5396337,0,0,0,114
13697,5396416,5396416,5396495,0,0,0,79
13598,5384885,5395044,5396731,0,0,10159,11846
13698,5396687,5396687,5396791,0,0,0,104
13684,5394635,5394635,5396805,0,0,0,2170
13689,5395295,5396805,5396902,0,0,1510,1607
13699,5396924,5396924,5397011,0,0,0,87
13701,5397167,5397167,5397213,0,0,0,46
13700,5396957,5396957,5397346,0,0,0,389
13596,5384661,5384745,5397416,0,0,84,12755
13592,5383841,5383841,5397595,0,0,0,13754
13703,5397517,5397517,5397934,0,0,0,417
13692,5395441,5395441,5398178,0,0,0,2737
13707,5398192,5398192,5398237,0,0,0,45
13708,5398333,5398333,5398442,0,0,0,109
13709,5398552,5398552,5398758,0,0,0,206
13710,5398955,5398955,5398999,0,0,0,44
13661,5392431,5392431,5399813,0,0,0,7382
13713,5399832,5399832,5400404,0,0,0,572
13714,5400786,5400786,5400861,0,0,0,75
13715,5401496,5401496,5401525,0,0,0,29
13716,5402852,5402852,5403775,0,0,0,923
13600,5385050,5396731,5404414,0,0,11681,19364
13687,5395046,5397416,5405493,0,0,2370,10447
13720,5405404,5405493,5405514,0,0,89,110
13702,5397342,5397595,5405613,0,0,253,8271
13719,5404358,5405493,5405866,0,0,1135,1508
13605,5386570,5404414,5406100,0,0,17844,19530
13607,5386717,5406100,5406121,0,0,19383,19404
13613,5387372,5387372,5407223,0,0,0,19851
13718,5404211,5405493,5407268,0,0,1282,3057
13624,5388881,5406121,5407727,0,0,17240,18846
13717,5403120,5403775,5407875,0,0,655,4755
13722,5407771,5407875,5409304,0,0,104,1533
13723,5409531,5409531,5409596,0,0,0,65
13724,5409731,5409731,5409927,0,0,0,196
13725,5409978,5409978,5410127,0,0,0,149
13726,5410361,5410361,5410488,0,0,0,127
13728,5411479,5411479,5411532,0,0,0,53
13729,5411651,5411651,5411743,0,0,0,92
13730,5411910,5411910,5411922,0,0,0,12
13731,5412237,5412237,5412261,0,0,0,24
13732,5412426,5412426,5412618,0,0,0,192
13721,5407161,5407161,5413775,0,0,0,6614
13691,5395436,5407727,5414943,0,0,12291,19507
13704,5397558,5414943,5416493,0,0,17385,18935
13705,5397598,5416493,5416553,0,0,18895,18955
13711,5399111,5416553,5416597,0,0,17442,17486
13712,5399157,5416597,5418438,0,0,17440,19281
13733,5414840,5418438,5418525,0,0,3598,3685
13734,5416593,5418438,5420629,0,0,1845,4036
13706,5397927,5407268,5420910,0,0,9341,22983
13735,5419575,5419575,5423765,0,0,0,4190
13736,5421403,5421403,5435694,0,0,0,14291
13737,5435559,5435559,5435740,0,0,0,181
13739,5436000,5436000,5436254,0,0,0,254
13727,5411111,5413775,5436473,0,0,2664,25362
13740,5436386,5436386,5436855,0,0,0,469
13741,5440437,5440437,5442755,0,0,0,2318
13738,5435668,5435668,5449882,0,0,0,14214
13742,5503175,5503175,5505483,0,0,0,2308
13744,5505066,5505066,5505697,0,0,0,631
13747,5505887,5505887,5506154,0,0,0,267
13748,5507111,5507111,5507324,0,0,0,213
13749,5507287,5507287,5507919,0,0,0,632
13745,5505456,5505456,5507997,0,0,0,2541
13751,5508000,5508000,5508260,0,0,0,260
13746,5505486,5505486,5508592,0,0,0,3106
13753,5508605,5508605,5508644,0,0,0,39
13743,5505037,5505037,5508963,0,0,0,3926
13754,5509296,5509296,5509601,0,0,0,305
13755,5510111,5510111,5510134,0,0,0,23
13750,5507943,5507943,5510339,0,0,0,2396
13757,5511500,5511500,5511515,0,0,0,15
13756,5510275,5510275,5512619,0,0,0,2344
13758,5512472,5512472,5512798,0,0,0,326
13761,5513277,5513277,5513508,0,0,0,231
13760,5513081,5513081,5514301,0,0,0,1220
13752,5508440,5508963,5515558,0,0,523,7118
13759,5512556,5512556,5515563,0,0,0,3007
13763,5515225,5515225,5516109,0,0,0,884
13765,5516291,5516291,5517343,0,0,0,1052
13764,5515554,5515554,5518754,0,0,0,3200
13766,5518691,5518691,5521042,0,0,0,2351
13767,5520976,5520976,5523330,0,0,0,2354
13768,5523268,5523268,5525625,0,0,0,2357
13769,5525564,5525564,5528061,0,0,0,2497
13762,5515037,5515037,5529269,0,0,0,14232
13770,5527996,5527996,5530404,0,0,0,2408
13772,5530341,5530341,5532737,0,0,0,2396
13773,5532672,5532672,5535256,0,0,0,2584
13774,5534602,5534602,5536266,0,0,0,1664
13775,5535192,5535192,5537581,0,0,0,2389
13777,5536271,5536271,5537864,0,0,0,1593
13780,5537645,5537645,5538125,0,0,0,480
13781,5537726,5537726,5538346,0,0,0,620
13783,5538578,5538578,5539171,0,0,0,593
13788,5539750,5539750,5539780,0,0,0,30
13786,5539616,5539616,5539837,0,0,0,221
13784,5538670,5538670,5539898,0,0,0,1228
13779,5537517,5537517,5540457,0,0,0,2940
13789,5539918,5539918,5540689,0,0,0,771
13787,5539742,5539742,5541257,0,0,0,1515
13794,5541326,5541326,5541378,0,0,0,52
13796,5541473,5541473,5541725,0,0,0,252
13797,5541617,5541617,5542007,0,0,0,390
13795,5541338,5541338,5542222,0,0,0,884
13798,5542060,5542060,5542241,0,0,0,181
13800,5542286,5542286,5542335,0,0,0,49
13799,5542234,5542234,5542652,0,0,0,418
13801,5542355,5542355,5542757,0,0,0,402
13803,5542462,5542462,5543427,0,0,0,965
13808,5543525,5543525,5543551,0,0,0,26
13771,5529268,5529268,5543605,0,0,0,14337
13809,5543535,5543535,5543605,0,0,0,70
13811,5543671,5543671,5543754,0,0,0,83
13802,5542372,5542372,5544909,0,0,0,2537
13776,5535433,5535433,5545113,0,0,0,9680
13812,5544279,5544279,5545330,0,0,0,1051
13815,5545337,5545337,5545427,0,0,0,90
13817,5545503,5545503,5545654,0,0,0,151
13819,5545701,5545701,5545834,0,0,0,133
13814,5545041,5545041,5546186,0,0,0,1145
13823,5546565,5546565,5546676,0,0,0,111
13824,5546820,5546820,5546967,0,0,0,147
13791,5540396,5540396,5546969,0,0,0,6573
13822,5546439,5546439,5547130,0,0,0,691
13826,5547241,5547241,5547588,0,0,0,347
13790,5540238,5540238,5548314,0,0,0,8076
13828,5547619,5547619,5548450,0,0,0,831
13818,5545605,5545605,5548656,0,0,0,3051
13832,5548632,5548632,5548714,0,0,0,82
13834,5548851,5548851,5548924,0,0,0,73
13835,5549034,5549034,5549108,0,0,0,74
13836,5549218,5549218,5549295,0,0,0,77
13816,5545367,5545367,5549634,0,0,0,4267
13827,5547494,5547494,5549791,0,0,0,2297
13839,5549876,5549876,5549906,0,0,0,30
13820,5546019,5546019,5550064,0,0,0,4045
13840,5549885,5549885,5550769,0,0,0,884
13842,5550893,5550893,5550946,0,0,0,53
13844,5551733,5551733,5551805,0,0,0,72
13845,5551740,5551740,5552016,0,0,0,276
13847,5551833,5551833,5552319,0,0,0,486
13848,5551851,5551851,5552347,0,0,0,496
13841,5550152,5550152,5552530,0,0,0,2378
13831,5548459,5548459,5552616,0,0,0,4157
13846,5551791,5551791,5552727,0,0,0,936
13851,5552530,5552530,5552780,0,0,0,250
13850,5552145,5552319,5552958,0,0,174,813
13854,5553247,5553247,5553644,0,0,0,397
13855,5553539,5553539,5553902,0,0,0,363
13856,5553595,5553595,5554024,0,0,0,429
13858,5553941,5553941,5554122,0,0,0,181
13825,5546960,5546960,5554126,0,0,0,7166
13857,5553868,5553868,5554195,0,0,0,327
13843,5551514,5551514,5554522,0,0,0,3008
13778,5537014,5537864,5555091,0,0,850,18077
13862,5554574,5555091,5555149,0,0,517,575
13853,5553117,5553117,5556475,0,0,0,3358
13852,5552562,5552562,5556476,0,0,0,3914
13838,5549507,5549507,5556477,0,0,0,6970
13865,5556706,5556706,5556755,0,0,0,49
13863,5556256,5556256,5556772,0,0,0,516
13866,5556784,5556784,5556845,0,0,0,61
13867,5556847,5556847,5556915,0,0,0,68
13861,5554563,5555091,5557004,0,0,528,2441
13868,5556947,5556947,5557144,0,0,0,197
13864,5556506,5556506,5557145,0,0,0,639
13860,5554222,5554522,5557191,0,0,300,2969
13872,5557396,5557396,5557466,0,0,0,70
13873,5557449,5557466,5557549,0,0,17,100
13874,5557536,5557549,5557600,0,0,13,64
13810,5543615,5543615,5557918,0,0,0,14303
13879,5558113,5558113,5558128,0,0,0,15
13878,5558054,5558054,5558130,0,0,0,76
13880,5558140,5558140,5558330,0,0,0,190
13882,5558417,5558417,5558429,0,0,0,12
13833,5548651,5548651,5558484,0,0,0,9833
13859,5554122,5554122,5558505,0,0,0,4383
13885,5558594,5558594,5558601,0,0,0,7
13804,5542658,5542658,5558694,0,0,0,16036
13805,5542763,5542763,5558696,0,0,0,15933
13782,5537869,5557191,5558788,0,0,19322,20919
13889,5558783,5558783,5558797,0,0,0,14
13849,5551959,5552016,5558822,0,0,57,6863
13890,5558806,5558806,5558832,0,0,0,26
13887,5558634,5558634,5558844,0,0,0,210
13869,5557101,5557101,5559105,0,0,0,2004
13893,5558998,5559105,5559116,0,0,107,118
13881,5558172,5558832,5559126,0,0,660,954
13897,5559054,5559116,5559281,0,0,62,227
13883,5558427,5558427,5559317,0,0,0,890
13891,5558863,5559317,5559330,0,0,454,467
13871,5557257,5557257,5559395,0,0,0,2138
13876,5557992,5557992,5559543,0,0,0,1551
13892,5558880,5558880,5559559,0,0,0,679
13902,5559774,5559774,5559799,0,0,0,25
13895,5559019,5559330,5559970,0,0,311,951
13906,5559968,5559968,5560061,0,0,0,93
13896,5559025,5559543,5560175,0,0,518,1150
13899,5559675,5560175,5560190,0,0,500,515
13886,5558625,5559126,5560195,0,0,501,1570
13901,5559686,5560190,5560214,0,0,504,528
13910,5560407,5560407,5560499,0,0,0,92
13785,5539464,5558788,5560525,0,0,19324,21061
13900,5559681,5560195,5560658,0,0,514,977
13877,5558043,5558043,5560710,0,0,0,2667
13905,5559895,5560658,5560712,0,0,763,817
13904,5559864,5560658,5560747,0,0,794,883
13913,5560891,5560891,5560949,0,0,0,58
13911,5560711,5560711,5561099,0,0,0,388
13916,5561165,5561165,5561221,0,0,0,56
13909,5560401,5560658,5561427,0,0,257,1026
13918,5561380,5561380,5561439,0,0,0,59
13915,5561007,5561007,5561577,0,0,0,570
13921,5561668,5561668,5561716,0,0,0,48
13884,5558481,5558481,5561722,0,0,0,3241
13923,5561723,5561723,5561790,0,0,0,67
13926,5561792,5561792,5561890,0,0,0,98
13925,5561786,5561786,5561953,0,0,0,167
13928,5562024,5562024,5562121,0,0,0,97
13792,5541206,5560525,5562134,0,0,19319,20928
13793,5541259,5562134,5562194,0,0,20875,20935
13920,5561546,5561546,5562302,0,0,0,756
13927,5561986,5561986,5562370,0,0,0,384
13930,5562403,5562403,5562518,0,0,0,115
13929,5562390,5562390,5562523,0,0,0,133
13931,5562652,5562652,5562766,0,0,0,114
13932,5562678,5562678,5562807,0,0,0,129
13924,5561761,5561761,5562853,0,0,0,1092
13934,5562824,5562824,5562989,0,0,0,165
13903,5559839,5560214,5563014,0,0,375,3175
13935,5563082,5563082,5563129,0,0,0,47
13933,5562707,5562707,5563311,0,0,0,604
13936,5563295,5563295,5563343,0,0,0,48
13938,5563658,5563658,5563710,0,0,0,52
13939,5563731,5563731,5563781,0,0,0,50
13806,5542821,5562194,5563867,0,0,19373,21046
13898,5559359,5559970,5563895,0,0,611,4536
13807,5542870,5563867,5563899,0,0,20997,21029
13940,5563987,5563987,5564021,0,0,0,34
13908,5560194,5563311,5564044,0,0,3117,3850
13941,5564036,5564036,5564067,0,0,0,31
13942,5564081,5564081,5564115,0,0,0,34
13943,5564113,5564115,5564159,0,0,2,46
13945,5564189,5564189,5564213,0,0,0,24
13912,5560878,5560878,5564505,0,0,0,3627
13914,5560915,5564044,5564510,0,0,3129,3595
13946,5564303,5564303,5564663,0,0,0,360
13937,5563426,5563895,5565076,0,0,469,1650
13948,5564869,5565076,5565106,0,0,207,237
13950,5565153,5565153,5565181,0,0,0,28
13813,5544493,5563899,5565505,0,0,19406,21012
13951,5565183,5565183,5565875,0,0,0,692
13917,5561311,5561311,5566332,0,0,0,5021
13953,5565200,5566332,5566386,0,0,1132,1186
13954,5565328,5566332,5566597,0,0,1004,1269
13956,5565901,5566597,5566975,0,0,696,1074
13957,5566042,5566975,5567079,0,0,933,1037
13958,5566058,5567079,5567096,0,0,1021,1038
13821,5546103,5565505,5567179,0,0,19402,21076
13959,5566097,5567096,5567640,0,0,999,1543
13922,5561710,5561710,5567659,0,0,0,5949
13952,5565195,5565875,5568330,0,0,680,3135
13944,5564157,5564510,5568804,0,0,353,4647
13962,5566371,5568330,5568862,0,0,1959,2491
13963,5566660,5568330,5568932,0,0,1670,2272
13965,5567591,5568804,5568988,0,0,1213,1397
13969,5568002,5568988,5569144,0,0,986,1142
13972,5568511,5569144,5569158,0,0,633,647
13973,5568538,5569158,5569169,0,0,620,631
13967,5567659,5568862,5569596,0,0,1203,1937
13968,5567720,5568932,5569603,0,0,1212,1883
13975,5568612,5569596,5569813,0,0,984,1201
13964,5567555,5568804,5569953,0,0,1249,2398
13979,5569633,5569813,5570238,0,0,180,605
13978,5569082,5569603,5570517,0,0,521,1435
13961,5566363,5567640,5570951,0,0,1277,4588
13984,5571308,5571308,5571716,0,0,0,408
13955,5565526,5566386,5572019,0,0,860,6493
13982,5570181,5570517,5572089,0,0,336,1908
13981,5570132,5570238,5572566,0,0,106,2434
13829,5547640,5567179,5573881,0,0,19539,26241
13971,5568235,5572566,5573997,0,0,4331,5762
13830,5547772,5573881,5575476,0,0,26109,27704
13837,5549407,5575476,5575517,0,0,26069,26110
13870,5557192,5575517,5575994,0,0,18325,18802
13875,5557851,5575994,5576590,0,0,18143,18739
13888,5558647,5576590,5576988,0,0,17943,18341
13966,5567645,5572019,5577274,0,0,4374,9629
13980,5569847,5569953,5577453,0,0,106,7606
13894,5559017,5576988,5577656,0,0,17971,18639
13976,5568619,5573997,5577944,0,0,5378,9325
13960,5566347,5567659,5578021,0,0,1312,11674
13977,5568885,5577274,5578057,0,0,8389,9172
13947,5564624,5564663,5578221,0,0,39,13597
13907,5560050,5577656,5578708,0,0,17606,18658
13991,5573815,5578057,5578833,0,0,4242,5018
13994,5575322,5578057,5578939,0,0,2735,3617
14002,5577352,5578939,5579069,0,0,1587,1717
14000,5576937,5578833,5579084,0,0,1896,2147
13989,5573557,5578021,5579171,0,0,4464,5614
14005,5578312,5579069,5579212,0,0,757,900
13990,5573697,5577453,5579657,0,0,3756,5960
13998,5576290,5579171,5579765,0,0,2881,3475
14006,5579563,5579657,5579852,0,0,94,289
13999,5576380,5579212,5579924,0,0,2832,3544
14001,5577198,5579765,5580422,0,0,2567,3224
14003,5577962,5579924,5580585,0,0,1962,2623
13974,5568605,5569169,5580775,0,0,564,12170
14007,5579733,5580585,5580972,0,0,852,1239
14008,5580701,5580701,5581003,0,0,0,302
14012,5581722,5581722,5581770,0,0,0,48
14014,5582422,5582422,5582563,0,0,0,141
14015,5582633,5582633,5582663,0,0,0,30
14011,5581303,5581303,5582755,0,0,0,1452
14016,5582867,5582867,5583007,0,0,0,140
14017,5583013,5583013,5583035,0,0,0,22
13988,5572873,5577944,5583140,0,0,5071,10267
14004,5578042,5580422,5583430,0,0,2380,5388
14010,5581033,5581033,5583451,0,0,0,2418
14019,5583814,5583814,5585552,0,0,0,1738
14018,5583428,5583430,5585786,0,0,2,2358
14020,5585632,5585632,5586086,0,0,0,454
14022,5585983,5586086,5586116,0,0,103,133
13949,5565111,5578221,5586153,0,0,13110,21042
14024,5586434,5586434,5586453,0,0,0,19
14023,5586199,5586199,5586706,0,0,0,507
14025,5586767,5586767,5587330,0,0,0,563
14026,5587347,5587347,5587366,0,0,0,19
14027,5587526,5587526,5587547,0,0,0,21
13919,5561417,5578708,5587670,0,0,17291,26253
13983,5570369,5587670,5588149,0,0,17301,17780
13985,5571429,5588149,5588525,0,0,16720,17096
13986,5572411,5588525,5588894,0,0,16114,16483
14030,5588922,5588922,5588957,0,0,0,35
14021,5585753,5585786,5589026,0,0,33,3273
14033,5589492,5589492,5589533,0,0,0,41
14032,5589416,5589416,5589996,0,0,0,580
14036,5590189,5590189,5590240,0,0,0,51
14028,5588291,5588291,5590568,0,0,0,2277
14035,5590158,5590158,5590739,0,0,0,581
14037,5590939,5590939,5590980,0,0,0,41
14039,5591701,5591701,5591738,0,0,0,37
14038,5591418,5591418,5591870,0,0,0,452
14031,5588958,5588958,5591995,0,0,0,3037
13970,5568136,5578221,5592435,0,0,10085,24299
14041,5592265,5592265,5592706,0,0,0,441
14042,5593490,5593490,5593941,0,0,0,451
14040,5591967,5591967,5594816,0,0,0,2849
14043,5594419,5594419,5594862,0,0,0,443
14045,5595595,5595595,5596050,0,0,0,455
14046,5596652,5596652,5597104,0,0,0,452
14013,5582361,5583140,5597472,0,0,779,15111
14044,5594796,5594796,5597560,0,0,0,2764
14049,5598227,5598227,5598691,0,0,0,464
14048,5597557,5597557,5600173,0,0,0,2616
14051,5600142,5600142,5604214,0,0,0,4072
14050,5599601,5599601,5607060,0,0,0,7459
14052,5604208,5604208,5607968,0,0,0,3760
14053,5607935,5607935,5610367,0,0,0,2432
14047,5596694,5596694,5610915,0,0,0,14221
14009,5580851,5588894,5610970,0,0,8043,30119
13987,5572451,5588894,5611296,0,0,16443,38845
13992,5573929,5610970,5611740,0,0,37041,37811
13993,5574751,5611740,5612090,0,0,36989,37339
13995,5575661,5612090,5612309,0,0,36429,36648
13996,5576014,5612309,5612396,0,0,36295,36382
14054,5610337,5610337,5612675,0,0,0,2338
13997,5576035,5612396,5614483,0,0,36361,38448
14056,5612667,5612667,5615033,0,0,0,2366
14029,5588829,5614483,5615168,0,0,25654,26339
14058,5616491,5616491,5616557,0,0,0,66
14059,5616896,5616896,5616927,0,0,0,31
14057,5615010,5615010,5617368,0,0,0,2358
14061,5617541,5617541,5617578,0,0,0,37
14062,5617966,5617966,5618004,0,0,0,38
14063,5618232,5618232,5618292,0,0,0,60
14064,5619004,5619004,5619041,0,0,0,37
14060,5617338,5617338,5619702,0,0,0,2364
14066,5620145,5620145,5620206,0,0,0,61
14067,5620174,5620174,5620208,0,0,0,34
14069,5621498,5621498,5621534,0,0,0,36
14070,5621528,5621528,5621554,0,0,0,26
14071,5621857,5621857,5621893,0,0,0,36
14065,5619675,5619675,5622038,0,0,0,2363
14073,5622168,5622168,5622201,0,0,0,33
14074,5622263,5622263,5622274,0,0,0,11
14068,5621313,5621313,5622559,0,0,0,1246
14055,5610918,5610918,5622634,0,0,0,11716
14075,5622690,5622690,5622708,0,0,0,18
14077,5623641,5623641,5623958,0,0,0,317
14080,5624027,5624027,5624046,0,0,0,19
14078,5623873,5623873,5624146,0,0,0,273
14084,5624512,5624512,5624549,0,0,0,37
14082,5624167,5624167,5624726,0,0,0,559
14072,5622010,5622010,5625321,0,0,0,3311
14087,5625693,5625693,5626319,0,0,0,626
14089,5626518,5626518,5626540,0,0,0,22
14076,5623384,5623384,5627040,0,0,0,3656
14090,5627242,5627242,5627669,0,0,0,427
14088,5626053,5626053,5628006,0,0,0,1953
14091,5628375,5628375,5628420,0,0,0,45
14092,5628411,5628411,5628449,0,0,0,38
14093,5628633,5628633,5629058,0,0,0,425
14095,5629272,5629272,5629347,0,0,0,75
14096,5629285,5629285,5629701,0,0,0,416
14086,5625486,5625486,5629737,0,0,0,4251
14098,5629635,5629701,5629783,0,0,66,148
14097,5629325,5629347,5630179,0,0,22,854
14081,5624122,5624122,5633115,0,0,0,8993
14101,5629875,5633115,5633152,0,0,3240,3277
14085,5625276,5625276,5633196,0,0,0,7920
14104,5630479,5633152,5633316,0,0,2673,2837
14106,5631235,5633196,5633362,0,0,1961,2127
14100,5629818,5630179,5633436,0,0,361,3618
14110,5632480,5633316,5633490,0,0,836,1010
14113,5633257,5633362,5633538,0,0,105,281
14103,5630457,5633152,5633616,0,0,2695,3159
14109,5632232,5633196,5634089,0,0,964,1857
14114,5634072,5634072,5634114,0,0,0,42
14116,5635216,5635216,5635246,0,0,0,30
14117,5635323,5635323,5635482,0,0,0,159
14094,5629240,5629240,5635895,0,0,0,6655
14118,5635868,5635868,5635901,0,0,0,33
14121,5636034,5636034,5636094,0,0,0,60
14120,5635911,5635911,5636259,0,0,0,348
14122,5636256,5636256,5636306,0,0,0,50
14124,5636671,5636671,5636724,0,0,0,53
14125,5636842,5636842,5636892,0,0,0,50
14079,5623908,5623908,5638151,0,0,0,14243
14127,5637233,5637233,5639152,0,0,0,1919
14128,5637330,5639152,5639210,0,0,1822,1880
14129,5637929,5639210,5639266,0,0,1281,1337
14034,5589575,5615168,5639837,0,0,25593,50262
14126,5636898,5636898,5640043,0,0,0,3145
14133,5638608,5640043,5640059,0,0,1435,1451
14083,5624212,5639837,5640078,0,0,15625,15866
14134,5639222,5640059,5640112,0,0,837,890
14130,5637974,5639266,5640735,0,0,1292,2761
14136,5639348,5640735,5640765,0,0,1387,1417
14135,5639337,5640112,5641175,0,0,775,1838
14137,5639471,5640765,5641337,0,0,1294,1866
14139,5640265,5641337,5641384,0,0,1072,1119
14140,5640325,5641384,5641405,0,0,1059,1080
14141,5640360,5641405,5641426,0,0,1045,1066
14142,5640398,5641426,5641448,0,0,1028,1050
14143,5640483,5641448,5641496,0,0,965,1013
14144,5640884,5641496,5641520,0,0,612,636
14145,5640999,5641520,5641545,0,0,521,546
14146,5641323,5641545,5641578,0,0,222,255
14102,5630075,5635895,5641711,0,0,5820,11636
14149,5642002,5642002,5642054,0,0,0,52
14150,5642094,5642094,5642105,0,0,0,11
14123,5636509,5640078,5642110,0,0,3569,5601
14132,5638544,5642110,5642137,0,0,3566,3593
14151,5642113,5642113,5642155,0,0,0,42
14099,5629786,5629786,5644115,0,0,0,14329
14111,5633180,5633436,5644432,0,0,256,11252
14112,5633231,5633538,5644455,0,0,307,11224
14154,5642346,5644432,5644488,0,0,2086,2142
14156,5642631,5644432,5644488,0,0,1801,1857
14158,5642982,5644455,5644489,0,0,1473,1507
14157,5642867,5644455,5644508,0,0,1588,1641
14159,5643208,5644488,5644522,0,0,1280,1314
14163,5643731,5644508,5644565,0,0,777,834
14138,5640170,5641175,5645185,0,0,1005,5015
14161,5643517,5644488,5645188,0,0,971,1671
14153,5642325,5642325,5645220,0,0,0,2895
14167,5644467,5645188,5645240,0,0,721,773
14169,5644854,5645240,5645249,0,0,386,395
14162,5643702,5644489,5645271,0,0,787,1569
14168,5644691,5645220,5645274,0,0,529,583
14166,5644436,5645185,5645277,0,0,749,841
14170,5644906,5645249,5645290,0,0,343,384
14171,5644938,5645271,5645314,0,0,333,376
14173,5645235,5645277,5645360,0,0,42,125
14172,5645088,5645274,5645412,0,0,186,324
14174,5645457,5645457,5645517,0,0,0,60
14148,5641944,5644115,5645654,0,0,2171,3710
14152,5642151,5645654,5645848,0,0,3503,3697
14119,5635890,5640078,5645913,0,0,4188,10023
14175,5645767,5645913,5645956,0,0,146,189
14105,5630596,5638151,5646082,0,0,7555,15486
14176,5645848,5645913,5646182,0,0,65,334
14177,5646294,5646294,5646357,0,0,0,63
14178,5646309,5646309,5646362,0,0,0,53
14182,5646562,5646562,5646623,0,0,0,61
14184,5646643,5646643,5646673,0,0,0,30
14165,5644361,5644565,5646674,0,0,204,2313
14186,5646842,5646842,5646900,0,0,0,58
14187,5646912,5646912,5646938,0,0,0,26
14188,5647104,5647104,5647139,0,0,0,35
14190,5647372,5647372,5647426,0,0,0,54
14185,5646670,5646673,5648039,0,0,3,1369
14179,5646316,5646316,5648040,0,0,0,1724
14193,5647717,5648039,5648081,0,0,322,364
14194,5647759,5648040,5648098,0,0,281,339
14195,5648071,5648081,5648110,0,0,10,39
14192,5647605,5647605,5648225,0,0,0,620
14164,5644230,5644522,5648237,0,0,292,4007
14191,5647483,5648225,5648280,0,0,742,797
14198,5648261,5648261,5648312,0,0,0,51
14196,5648089,5648098,5648332,0,0,9,243
14147,5641705,5642137,5649072,0,0,432,7367
14180,5646376,5646376,5649298,0,0,0,2922
14203,5648970,5649298,5649352,0,0,328,382
14202,5648745,5649298,5649361,0,0,553,616
14189,5647323,5649072,5649379,0,0,1749,2056
14206,5649319,5649361,5649382,0,0,42,63
14197,5648212,5648280,5649390,0,0,68,1178
14155,5642379,5645848,5649406,0,0,3469,7027
14208,5649477,5649477,5649526,0,0,0,49
14204,5649105,5649352,5649551,0,0,247,446
14200,5648344,5649379,5649633,0,0,1035,1289
14209,5649655,5649655,5649704,0,0,0,49
14131,5638532,5641711,5649732,0,0,3179,11200
14108,5631988,5639837,5651181,0,0,7849,19193
14215,5650604,5651181,5651205,0,0,577,601
14210,5649795,5651181,5651207,0,0,1386,1412
14211,5650365,5651181,5651233,0,0,816,868
14217,5650852,5651205,5651234,0,0,353,382
14216,5650824,5651181,5651253,0,0,357,429
14212,5650486,5651181,5651254,0,0,695,768
14219,5651085,5651233,5651255,0,0,148,170
14218,5651026,5651207,5651257,0,0,181,231
14221,5651990,5651990,5652066,0,0,0,76
14213,5650537,5651181,5652278,0,0,644,1741
14214,5650568,5651181,5652315,0,0,613,1747
14181,5646517,5649732,5652574,0,0,3215,6057
14223,5652634,5652634,5652653,0,0,0,19
14225,5652692,5652692,5652740,0,0,0,48
14222,5652591,5652591,5653089,0,0,0,498
14199,5648337,5648337,5653181,0,0,0,4844
14226,5653391,5653391,5653463,0,0,0,72
14228,5653714,5653714,5653736,0,0,0,22
14227,5653522,5653522,5653887,0,0,0,365
14230,5653891,5653891,5653919,0,0,0,28
14160,5643273,5645314,5654216,0,0,2041,10943
14233,5654241,5654241,5654315,0,0,0,74
14234,5654412,5654412,5654444,0,0,0,32
14232,5654151,5654151,5654662,0,0,0,511
14207,5649362,5649551,5654868,0,0,189,5506
14236,5654691,5654691,5655056,0,0,0,365
14229,5653832,5653832,5655482,0,0,0,1650
14231,5654112,5654112,5655536,0,0,0,1424
14238,5655550,5655550,5655841,0,0,0,291
14240,5655921,5655921,5656321,0,0,0,400
14243,5656597,5656597,5656629,0,0,0,32
14183,5646579,5646579,5656794,0,0,0,10215
14239,5655827,5655827,5656988,0,0,0,1161
14241,5655943,5655943,5657590,0,0,0,1647
14245,5656912,5656912,5657658,0,0,0,746
14248,5658665,5658665,5658703,0,0,0,38
14224,5652685,5652685,5658738,0,0,0,6053
14220,5651878,5651878,5659586,0,0,0,7708
14201,5648605,5649406,5659607,0,0,801,11002
14252,5659567,5659567,5659609,0,0,0,42
14242,5655982,5655982,5659749,0,0,0,3767
14237,5655278,5655278,5660328,0,0,0,5050
14247,5658218,5658218,5660992,0,0,0,2774
14249,5658735,5658735,5661785,0,0,0,3050
14258,5661581,5661785,5661810,0,0,204,229
14261,5662267,5662267,5662300,0,0,0,33
14262,5662275,5662275,5662319,0,0,0,44
14265,5663042,5663042,5663076,0,0,0,34
14264,5662984,5662984,5663410,0,0,0,426
14266,5663415,5663415,5663583,0,0,0,168
14267,5663882,5663882,5663926,0,0,0,44
14268,5664172,5664172,5664270,0,0,0,98
14270,5664656,5664656,5664701,0,0,0,45
14273,5666787,5666787,5666856,0,0,0,69
14274,5667188,5667188,5667275,0,0,0,87
14257,5661570,5661785,5667638,0,0,215,6068
14271,5664842,5664842,5667699,0,0,0,2857
14275,5668065,5668065,5668111,0,0,0,46
14235,5654681,5654681,5668334,0,0,0,13653
14272,5664957,5664957,5668608,0,0,0,3651
14250,5659089,5659089,5669821,0,0,0,10732
14279,5670466,5670466,5670491,0,0,0,25
14276,5668244,5668244,5670643,0,0,0,2399
14282,5671820,5671820,5671844,0,0,0,24
14244,5656800,5656800,5672412,0,0,0,15612
14280,5670613,5670613,5672983,0,0,0,2370
14259,5661819,5672412,5673007,0,0,10593,11188
14286,5673212,5673212,5673244,0,0,0,32
14288,5673561,5673561,5673584,0,0,0,23
14255,5660324,5660992,5673859,0,0,668,13535
14289,5673796,5673796,5673864,0,0,0,68
14290,5674590,5674590,5674697,0,0,0,107
14277,5668920,5668920,5674829,0,0,0,5909
14254,5659769,5660328,5674938,0,0,559,15169
14292,5675132,5675132,5675187,0,0,0,55
14263,5662382,5674938,5675234,0,0,12556,12852
14293,5675399,5675399,5675420,0,0,0,21
14285,5672948,5672983,5675510,0,0,35,2562
14295,5675564,5675564,5675584,0,0,0,20
14297,5675724,5675724,5675742,0,0,0,18
14298,5675921,5675921,5675943,0,0,0,22
14299,5676047,5676047,5676072,0,0,0,25
14300,5676161,5676161,5676185,0,0,0,24
14301,5676281,5676281,5676302,0,0,0,21
14294,5675455,5675455,5677814,0,0,0,2359
14303,5677780,5677780,5680125,0,0,0,2345
14278,5669541,5669541,5680441,0,0,0,10900
14284,5672417,5673859,5680660,0,0,1442,8243
14253,5659660,5659660,5682039,0,0,0,22379
14308,5681535,5681535,5682367,0,0,0,832
14309,5682442,5682442,5682463,0,0,0,21
14307,5680887,5680887,5683146,0,0,0,2259
14310,5682722,5682722,5683759,0,0,0,1037
14107,5631533,5682039,5684255,0,0,50506,52722
14311,5683695,5683695,5684976,0,0,0,1281
14305,5680121,5680121,5684981,0,0,0,4860
14313,5684322,5684976,5686031,0,0,654,1709
14312,5683936,5683936,5686096,0,0,0,2160
14115,5634587,5684255,5687818,0,0,49668,53231
14314,5684974,5684981,5691461,0,0,7,6487
14306,5680557,5680557,5692957,0,0,0,12400
14205,5649293,5687818,5693101,0,0,38525,43808
14260,5661830,5673007,5693870,0,0,11177,32040
14246,5657055,5693101,5693892,0,0,36046,36837
14315,5685791,5686031,5694148,0,0,240,8357
14251,5659420,5693892,5694698,0,0,34472,35278
14317,5691427,5691427,5696004,0,0,0,4577
14256,5661036,5694698,5698300,0,0,33662,37264
14269,5664619,5698300,5698848,0,0,33681,34229
14281,5671067,5698848,5699445,0,0,27781,28378
14283,5672241,5699445,5699981,0,0,27204,27740
14319,5695979,5695979,5700351,0,0,0,4372
14287,5673284,5699981,5700667,0,0,26697,27383
14291,5675050,5700667,5701098,0,0,25617,26048
14296,5675696,5701098,5701560,0,0,25402,25864
14302,5676658,5701560,5701840,0,0,24902,25182
14320,5700330,5700330,5703785,0,0,0,3455
14322,5703760,5703760,5706135,0,0,0,2375
14318,5693995,5693995,5706266,0,0,0,12271
14316,5688609,5692957,5707212,0,0,4348,18603
14326,5707338,5707338,5708394,0,0,0,1056
14324,5706103,5706135,5709457,0,0,32,3354
14331,5709561,5709561,5711310,0,0,0,1749
14333,5710640,5711310,5711982,0,0,670,1342
14334,5711230,5711982,5712517,0,0,752,1287
14336,5711933,5712517,5712780,0,0,584,847
14328,5709167,5709167,5714335,0,0,0,5168
14338,5712307,5714335,5714587,0,0,2028,2280
14340,5713317,5714587,5714785,0,0,1270,1468
14337,5711941,5712780,5714862,0,0,839,2921
14342,5714015,5714862,5714877,0,0,847,862
14329,5709393,5709457,5714933,0,0,64,5540
14323,5705250,5705250,5715010,0,0,0,9760
14332,5710313,5714933,5715431,0,0,4620,5118
14345,5714570,5715431,5715936,0,0,861,1366
14349,5715924,5715924,5715985,0,0,0,61
14321,5702863,5702863,5717050,0,0,0,14187
14341,5713589,5714785,5717577,0,0,1196,3988
14351,5716129,5717577,5717588,0,0,1448,1459
14353,5716330,5717588,5717599,0,0,1258,1269
14343,5714093,5714877,5717903,0,0,784,3810
14355,5716717,5717903,5717916,0,0,1186,1199
14344,5714468,5717050,5717931,0,0,2582,3463
14356,5716803,5717916,5717974,0,0,1113,1171
14357,5717327,5717974,5717990,0,0,647,663
14358,5717557,5717990,5718003,0,0,433,446
14359,5717694,5718003,5718014,0,0,309,320
14360,5717712,5718014,5718251,0,0,302,539
14361,5717957,5718251,5718261,0,0,294,304
14362,5718291,5718291,5718304,0,0,0,13
14363,5718389,5718389,5718399,0,0,0,10
14364,5718524,5718524,5719002,0,0,0,478
14365,5718536,5719002,5719017,0,0,466,481
14366,5718682,5719017,5719031,0,0,335,349
14367,5718862,5719031,5719046,0,0,169,184
14368,5719000,5719046,5719058,0,0,46,58
14335,5711850,5715010,5719063,0,0,3160,7213
14370,5719150,5719150,5719160,0,0,0,10
14372,5719271,5719271,5719283,0,0,0,12
14354,5716421,5717599,5719351,0,0,1178,2930
14350,5716121,5719351,5722248,0,0,3230,6127
14346,5714847,5715985,5722355,0,0,1138,7508
14374,5719557,5722355,5722366,0,0,2798,2809
14373,5719443,5722355,5722368,0,0,2912,2925
14375,5719704,5722366,5722378,0,0,2662,2674
14377,5720287,5722378,5722537,0,0,2091,2250
14378,5720538,5722537,5722994,0,0,1999,2456
14379,5720840,5722994,5723086,0,0,2154,2246
14380,5721005,5723086,5723142,0,0,2081,2137
14382,5721404,5723142,5723195,0,0,1738,1791
14383,5721473,5723195,5723207,0,0,1722,1734
14384,5721496,5723207,5723234,0,0,1711,1738
14376,5720259,5722368,5724350,0,0,2109,4091
14389,5722286,5724350,5724418,0,0,2064,2132
14391,5722803,5724418,5724474,0,0,1615,1671
14392,5722922,5724474,5724855,0,0,1552,1933
14393,5723003,5724855,5724956,0,0,1852,1953
14394,5723401,5724956,5725009,0,0,1555,1608
14397,5723747,5725009,5725104,0,0,1262,1357
14398,5723833,5725104,5725364,0,0,1271,1531
14400,5724075,5725364,5725427,0,0,1289,1352
14401,5724135,5725427,5725441,0,0,1292,1306
14402,5724324,5725441,5725490,0,0,1117,1166
14404,5724398,5725490,5725503,0,0,1092,1105
14405,5724565,5725503,5725560,0,0,938,995
14406,5724618,5725560,5725578,0,0,942,960
14407,5724775,5725578,5725630,0,0,803,855
14408,5724850,5725630,5725677,0,0,780,827
14386,5721736,5723234,5725691,0,0,1498,3955
14409,5724862,5725677,5725692,0,0,815,830
14412,5725082,5725692,5725706,0,0,610,624
14413,5725117,5725706,5725750,0,0,589,633
14348,5715879,5719063,5725780,0,0,3184,9901
14414,5725179,5725750,5725801,0,0,571,622
14415,5725210,5725801,5725817,0,0,591,607
14416,5725340,5725817,5725832,0,0,477,492
14417,5725458,5725832,5725846,0,0,374,388
14418,5725486,5725846,5725863,0,0,360,377
14419,5725607,5725863,5725876,0,0,256,269
14420,5725636,5725876,5725887,0,0,240,251
14421,5725664,5725887,5725896,0,0,223,232
14422,5725692,5725896,5725906,0,0,204,214
14423,5725725,5725906,5725915,0,0,181,190
14424,5725859,5725915,5725929,0,0,56,70
14425,5725894,5725929,5725939,0,0,35,45
14426,5725912,5725939,5725948,0,0,27,36
14427,5726013,5726013,5726029,0,0,0,16
14428,5726045,5726045,5726055,0,0,0,10
14429,5726066,5726066,5726077,0,0,0,11
14430,5726167,5726167,5726181,0,0,0,14
14431,5726192,5726192,5726201,0,0,0,9
14304,5679731,5701840,5726267,0,0,22109,46536
14347,5715225,5717931,5726345,0,0,2706,11120
14325,5707328,5707328,5726396,0,0,0,19068
14433,5726436,5726436,5726449,0,0,0,13
14399,5723915,5726345,5726523,0,0,2430,2608
14435,5726545,5726545,5726559,0,0,0,14
14436,5726570,5726570,5726582,0,0,0,12
14437,5726708,5726708,5726721,0,0,0,13
14438,5726731,5726731,5726740,0,0,0,9
14439,5726749,5726749,5726759,0,0,0,10
14442,5726970,5726970,5728388,0,0,0,1418
14443,5727190,5728388,5728407,0,0,1198,1217
14444,5727344,5728407,5728421,0,0,1063,1077
14445,5727464,5728421,5728436,0,0,957,972
14447,5727654,5728436,5728452,0,0,782,798
14448,5727734,5728452,5728466,0,0,718,732
14449,5727855,5728466,5728486,0,0,611,631
14450,5727999,5728486,5728501,0,0,487,502
14451,5728035,5728501,5728510,0,0,466,475
14452,5728221,5728510,5728526,0,0,289,305
14453,5728252,5728526,5728536,0,0,274,284
14455,5728382,5728536,5728567,0,0,154,185
14456,5728451,5728567,5728581,0,0,116,130
14352,5716163,5725780,5728583,0,0,9617,12420
14387,5722066,5728583,5730106,0,0,6517,8040
14388,5722171,5730106,5730501,0,0,7935,8330
14330,5709507,5726267,5735837,0,0,16760,26330
14339,5712687,5735837,5736999,0,0,23150,24312
14327,5708732,5708732,5740326,0,0,0,31594
14458,5728565,5740326,5740343,0,0,11761,11778
14459,5728761,5740326,5740346,0,0,11565,11585
14460,5728802,5740343,5740355,0,0,11541,11553
14461,5728830,5740346,5740358,0,0,11516,11528
14434,5726468,5726523,5740382,0,0,55,13914
14462,5728852,5740355,5740384,0,0,11503,11532
14464,5728927,5740358,5740405,0,0,11431,11478
14457,5728511,5728581,5740453,0,0,70,11942
14466,5728992,5740382,5740503,0,0,11390,11511
14410,5724904,5725691,5741133,0,0,787,16229
14403,5724331,5726396,5742390,0,0,2065,18059
14476,5740644,5742390,5742421,0,0,1746,1777
14477,5740655,5742421,5742490,0,0,1766,1835
14478,5740735,5742490,5742539,0,0,1755,1804
14479,5740747,5742539,5742577,0,0,1792,1830
14474,5733265,5742390,5742743,0,0,9125,9478
14371,5719191,5722248,5743382,0,0,3057,24191
14470,5730045,5740453,5744377,0,0,10408,14332
14471,5730416,5740503,5744454,0,0,10087,14038
14454,5728340,5744454,5744731,0,0,16114,16391
14473,5731451,5741133,5745041,0,0,9682,13590
14381,5721190,5726345,5745481,0,0,5155,24291
14484,5745053,5745053,5745530,0,0,0,477
14475,5740344,5742743,5746604,0,0,2399,6260
14485,5745170,5745481,5746684,0,0,311,1514
14488,5746662,5746662,5746693,0,0,0,31
14489,5746727,5746727,5747357,0,0,0,630
14490,5747201,5747201,5747492,0,0,0,291
14487,5746265,5746604,5747504,0,0,339,1239
14390,5722574,5730501,5748199,0,0,7927,25625
14480,5740849,5748199,5748312,0,0,7350,7463
14493,5748849,5748849,5749450,0,0,0,601
14469,5729464,5740405,5751281,0,0,10941,21817
14468,5729329,5740384,5751397,0,0,11055,22068
14492,5747986,5751397,5751581,0,0,3411,3595
14496,5749618,5749618,5751594,0,0,0,1976
14494,5748973,5751581,5751603,0,0,2608,2630
14495,5749221,5751603,5751619,0,0,2382,2398
14497,5749632,5751619,5751641,0,0,1987,2009
14465,5728954,5740382,5751812,0,0,11428,22858
14501,5751740,5751740,5751840,0,0,0,100
14499,5749871,5751840,5752156,0,0,1969,2285
14500,5750539,5752156,5752714,0,0,1617,2175
14502,5752302,5752714,5753379,0,0,412,1077
14503,5752396,5753379,5753400,0,0,983,1004
14396,5723644,5736999,5753627,0,0,13355,29983
14395,5723592,5736999,5753679,0,0,13407,30087
14385,5721592,5735837,5754467,0,0,14245,32875
14506,5753111,5754467,5754498,0,0,1356,1387
14508,5753369,5754467,5754498,0,0,1098,1129
14509,5753639,5754498,5754526,0,0,859,887
14510,5753788,5754498,5754533,0,0,710,745
14511,5754121,5754526,5754737,0,0,405,616
14513,5754670,5754737,5754774,0,0,67,104
14498,5749726,5751641,5754823,0,0,1915,5097
14512,5754347,5754533,5755097,0,0,186,750
14514,5755227,5755227,5755828,0,0,0,601
14463,5728879,5744731,5756124,0,0,15852,27245
14504,5752898,5753400,5756246,0,0,502,3348
14491,5747554,5753679,5756527,0,0,6125,8973
14472,5730967,5747504,5756803,0,0,16537,25836
14483,5743860,5748312,5757095,0,0,4452,13235
14516,5756058,5756058,5757185,0,0,0,1127
14517,5757337,5757337,5757356,0,0,0,19
14505,5752913,5754467,5757857,0,0,1554,4944
14515,5755717,5755717,5758206,0,0,0,2489
14518,5758184,5758184,5760494,0,0,0,2310
14369,5719060,5757857,5761211,0,0,38797,42151
14486,5745214,5753627,5761322,0,0,8413,16108
14411,5724966,5761211,5761957,0,0,36245,36991
14432,5726367,5761957,5761989,0,0,35590,35622
14440,5726763,5761989,5762415,0,0,35226,35652
14519,5760462,5760462,5762780,0,0,0,2318
14441,5726964,5762415,5764015,0,0,35451,37051
14521,5763893,5763893,5764809,0,0,0,916
14520,5762758,5762758,5765277,0,0,0,2519
14522,5764366,5764366,5765643,0,0,0,1277
14525,5766490,5766490,5767060,0,0,0,570
14523,5765248,5765248,5768327,0,0,0,3079
14527,5767782,5768327,5768343,0,0,545,561
14524,5766147,5766147,5769134,0,0,0,2987
14528,5768127,5768343,5772594,0,0,216,4467
14529,5768309,5769134,5774170,0,0,825,5861
14446,5727542,5764015,5775377,0,0,36473,47835
14530,5769359,5772594,5776082,0,0,3235,6723
14531,5773034,5774170,5776568,0,0,1136,3534
14467,5729295,5775377,5777085,0,0,46082,47790
14507,5753346,5756246,5778844,0,0,2900,25498
14533,5776743,5776743,5779230,0,0,0,2487
14532,5773326,5776082,5779522,0,0,2756,6196
14535,5779207,5779207,5781556,0,0,0,2349
14526,5767615,5767615,5781761,0,0,0,14146
14538,5781532,5781532,5783889,0,0,0,2357
14540,5783861,5783861,5786223,0,0,0,2362
14542,5786205,5786205,5788558,0,0,0,2353
14545,5788528,5788528,5790891,0,0,0,2363
14547,5790860,5790860,5793224,0,0,0,2364
14550,5793205,5793205,5795541,0,0,0,2336
14553,5795523,5795523,5797990,0,0,0,2467
14554,5795748,5795748,5799544,0,0,0,3796
14556,5797969,5797969,5800374,0,0,0,2405
14562,5800089,5800089,5801804,0,0,0,1715
14481,5740960,5777085,5802153,0,0,36125,61193
14563,5800371,5800374,5803989,0,0,3,3618
14568,5803528,5803989,5804009,0,0,461,481
14569,5803657,5803989,5804050,0,0,332,393
14570,5803798,5804009,5804174,0,0,211,376
14573,5804090,5804090,5804185,0,0,0,95
14558,5798709,5798709,5804539,0,0,0,5830
14560,5799561,5804539,5804574,0,0,4978,5013
14574,5804422,5804574,5804608,0,0,152,186
14565,5802140,5802140,5805252,0,0,0,3112
14576,5804836,5805252,5805294,0,0,416,458
14578,5805238,5805252,5805305,0,0,14,67
14548,5791537,5791537,5805849,0,0,0,14312
14580,5806519,5806519,5806560,0,0,0,41
14559,5799549,5799549,5806667,0,0,0,7118
14581,5806668,5806668,5806689,0,0,0,21
14579,5806343,5806343,5806735,0,0,0,392
14584,5806836,5806836,5806851,0,0,0,15
14572,5803958,5804185,5807148,0,0,227,3190
14583,5806763,5806763,5807300,0,0,0,537
14586,5806932,5807148,5807317,0,0,216,385
14588,5807355,5807355,5808005,0,0,0,650
14482,5741503,5802153,5808820,0,0,60650,67317
14589,5808327,5808327,5808973,0,0,0,646
14591,5808978,5808978,5809023,0,0,0,45
14585,5806893,5806893,5809238,0,0,0,2345
14594,5809574,5809574,5809629,0,0,0,55
14592,5809097,5809097,5810429,0,0,0,1332
14534,5778129,5808820,5810461,0,0,30691,32332
14593,5809211,5809211,5811688,0,0,0,2477
14575,5804518,5804608,5811714,0,0,90,7196
14599,5811995,5811995,5812013,0,0,0,18
14536,5779773,5810461,5812041,0,0,30688,32268
14601,5812055,5812055,5812065,0,0,0,10
14602,5812072,5812072,5812090,0,0,0,18
14603,5812098,5812098,5812109,0,0,0,11
14605,5812272,5812272,5812286,0,0,0,14
14606,5812294,5812294,5812304,0,0,0,10
14607,5812312,5812312,5812322,0,0,0,10
14608,5812499,5812499,5812547,0,0,0,48
14609,5812545,5812545,5812560,0,0,0,15
14610,5812690,5812690,5812705,0,0,0,15
14611,5812907,5812907,5812922,0,0,0,15
14612,5812938,5812938,5812950,0,0,0,12
14614,5813221,5813221,5813238,0,0,0,17
14537,5781356,5812041,5813841,0,0,30685,32485
14600,5812001,5812001,5813946,0,0,0,1945
14616,5813846,5813846,5814853,0,0,0,1007
14597,5811663,5811663,5814918,0,0,0,3255
14613,5813089,5813946,5815052,0,0,857,1963
14582,5806674,5806674,5815227,0,0,0,8553
14619,5815343,5815343,5815375,0,0,0,32
14539,5783160,5813841,5815419,0,0,30681,32259
14604,5812156,5812156,5815788,0,0,0,3632
14620,5815816,5815816,5815837,0,0,0,21
14621,5815893,5815893,5815935,0,0,0,42
14596,5811601,5811601,5816619,0,0,0,5018
14541,5784740,5815419,5817053,0,0,30679,32313
14617,5814887,5814918,5817283,0,0,31,2396
14543,5786378,5817053,5818628,0,0,30675,32250
14624,5817232,5817232,5819652,0,0,0,2420
14622,5816591,5816619,5819962,0,0,28,3371
14544,5787956,5818628,5820787,0,0,30672,32831
14629,5819504,5819962,5820935,0,0,458,1431
14630,5819634,5819634,5822003,0,0,0,2369
14546,5790117,5820787,5822370,0,0,30670,32253
14549,5791702,5822370,5824012,0,0,30668,32310
14636,5821970,5821970,5824337,0,0,0,2367
14551,5793348,5824012,5825593,0,0,30664,32245
14640,5825305,5825305,5825669,0,0,0,364
14641,5825759,5825759,5825778,0,0,0,19
14642,5825785,5825785,5825797,0,0,0,12
14643,5825851,5825851,5825993,0,0,0,142
14645,5826127,5826127,5826144,0,0,0,17
14646,5826176,5826176,5826453,0,0,0,277
14566,5802490,5815227,5826553,0,0,12737,24063
14631,5819924,5820935,5826967,0,0,1011,7043
14625,5817650,5826553,5827050,0,0,8903,9400
14638,5824304,5824304,5827174,0,0,0,2870
14650,5826403,5827174,5827188,0,0,771,785
14651,5826593,5827174,5827188,0,0,581,595
14653,5826743,5827188,5827204,0,0,445,461
14654,5826927,5827188,5827205,0,0,261,278
14655,5827092,5827204,5827220,0,0,112,128
14657,5827200,5827205,5827220,0,0,5,20
14552,5794931,5825593,5827357,0,0,30662,32426
14627,5818735,5827050,5827706,0,0,8315,8971
14633,5820526,5826967,5827805,0,0,6441,7279
14652,5826670,5827220,5828148,0,0,550,1478
14555,5796698,5827357,5828965,0,0,30659,32267
14649,5826397,5826453,5830141,0,0,56,3744
14658,5827271,5830141,5830154,0,0,2870,2883
14659,5827367,5830141,5830157,0,0,2774,2790
14661,5827603,5830157,5830168,0,0,2554,2565
14660,5827579,5830154,5830169,0,0,2575,2590
14662,5827624,5830168,5830180,0,0,2544,2556
14663,5827722,5830169,5830186,0,0,2447,2464
14664,5827743,5830180,5830192,0,0,2437,2449
14665,5827760,5830186,5830202,0,0,2426,2442
14667,5827897,5830192,5830208,0,0,2295,2311
14668,5828014,5830202,5830218,0,0,2188,2204
14671,5828134,5830208,5830221,0,0,2074,2087
14672,5828258,5830218,5830234,0,0,1960,1976
14673,5828415,5830221,5830237,0,0,1806,1822
14674,5828547,5830234,5830249,0,0,1687,1702
14675,5828574,5830237,5830249,0,0,1663,1675
14666,5827764,5830249,5830512,0,0,2485,2748
14557,5798309,5828965,5830694,0,0,30656,32385
14670,5828054,5830512,5831506,0,0,2458,3452
14634,5821387,5827805,5831644,0,0,6418,10257
14677,5829077,5831506,5832104,0,0,2429,3027
14561,5800041,5830694,5832320,0,0,30653,32279
14656,5827146,5828148,5833044,0,0,1002,5898
14683,5832104,5833044,5833123,0,0,940,1019
14681,5831781,5833044,5833161,0,0,1263,1380
14564,5801670,5832320,5833882,0,0,30650,32212
14644,5825925,5831644,5834764,0,0,5719,8839
14647,5826288,5834764,5834796,0,0,8476,8508
14567,5803235,5833882,5835518,0,0,30647,32283
14571,5803803,5835518,5835996,0,0,31715,32193
14577,5804874,5835996,5837576,0,0,31122,32702
14676,5829025,5834796,5838100,0,0,5771,9075
14682,5832039,5833161,5838154,0,0,1122,6115
14628,5819415,5827706,5839046,0,0,8291,19631
14587,5806936,5837576,5839203,0,0,30640,32267
14679,5829733,5832104,5839467,0,0,2371,9734
14687,5833508,5839046,5840884,0,0,5538,7376
14590,5808565,5839203,5840925,0,0,30638,32360
14693,5837000,5839467,5841945,0,0,2467,4945
14684,5832295,5838100,5841976,0,0,5805,9681
14686,5833501,5838154,5842164,0,0,4653,8663
14695,5840764,5842164,5842444,0,0,1400,1680
14595,5810289,5840925,5842563,0,0,30636,32274
14696,5841010,5841010,5842579,0,0,0,1569
14697,5842682,5842682,5842703,0,0,0,21
14694,5839452,5840884,5842831,0,0,1432,3379
14598,5811931,5842563,5844138,0,0,30632,32207
14698,5843099,5843099,5845325,0,0,0,2226
14615,5813508,5844138,5845711,0,0,30630,32203
14692,5836166,5839046,5845802,0,0,2880,9636
14699,5844187,5844187,5847194,0,0,0,3007
14618,5815085,5845711,5847352,0,0,30626,32267
14623,5816729,5847352,5848946,0,0,30623,32217
14626,5818326,5848946,5850605,0,0,30620,32279
14632,5819988,5850605,5852181,0,0,30617,32193
14701,5849871,5849871,5852686,0,0,0,2815
14700,5847294,5847294,5852913,0,0,0,5619
14635,5821566,5852181,5853827,0,0,30615,32261
14637,5823214,5853827,5855402,0,0,30613,32188
14703,5853012,5853012,5856296,0,0,0,3284
14639,5824791,5855402,5856995,0,0,30611,32204
14704,5857684,5857684,5858344,0,0,0,660
14648,5826389,5856995,5858622,0,0,30606,32233
14705,5858610,5858610,5858855,0,0,0,245
14669,5828019,5858622,5860194,0,0,30603,32175
14678,5829593,5860194,5861863,0,0,30601,32270
14690,5835117,5838154,5862114,0,0,3037,26997
14680,5831264,5861863,5863442,0,0,30599,32178
14708,5862848,5862848,5864622,0,0,0,1774
14685,5832847,5863442,5865067,0,0,30595,32220
14702,5850468,5852686,5866859,0,0,2218,16391
14711,5864893,5864893,5867542,0,0,0,2649
14710,5864714,5867542,5869605,0,0,2828,4891
14706,5861923,5861923,5869860,0,0,0,7937
14688,5834199,5865067,5871760,0,0,30868,37561
14689,5834475,5871760,5873339,0,0,37285,38864
14691,5836056,5873339,5873446,0,0,37283,37390
14707,5862447,5873446,5873779,0,0,10999,11332
14712,5868986,5873779,5873858,0,0,4793,4872
14713,5869239,5873858,5874065,0,0,4619,4826
14715,5870130,5870130,5875974,0,0,0,5844
14714,5869495,5874065,5876467,0,0,4570,6972
14709,5864630,5864630,5879011,0,0,0,14381
14716,5872324,5876467,5880172,0,0,4143,7848
14717,5885457,5885457,5889172,0,0,0,3715
14721,5889416,5889416,5889446,0,0,0,30
14723,5890987,5890987,5891024,0,0,0,37
14718,5885483,5885483,5891196,0,0,0,5713
14725,5891861,5891861,5891881,0,0,0,20
14726,5891984,5891984,5892000,0,0,0,16
14727,5892106,5892106,5892122,0,0,0,16
14728,5892237,5892237,5892254,0,0,0,17
14729,5892418,5892418,5892434,0,0,0,16
14730,5892538,5892538,5892555,0,0,0,17
14731,5892655,5892655,5892670,0,0,0,15
14722,5889940,5889940,5892707,0,0,0,2767
14732,5892858,5892858,5892872,0,0,0,14
14733,5892885,5892885,5892895,0,0,0,10
14734,5892901,5892901,5892911,0,0,0,10
14735,5892916,5892916,5892926,0,0,0,10
14736,5893217,5893217,5893268,0,0,0,51
14737,5893331,5893331,5893344,0,0,0,13
14738,5893516,5893516,5893529,0,0,0,13
14719,5886708,5886708,5893648,0,0,0,6940
14740,5893655,5893655,5893671,0,0,0,16
14742,5893753,5893753,5893763,0,0,0,10
14739,5893546,5893546,5893777,0,0,0,231
14743,5893776,5893776,5893786,0,0,0,10
14744,5893909,5893909,5893922,0,0,0,13
14745,5893929,5893929,5893939,0,0,0,10
14746,5894015,5894015,5894036,0,0,0,21
14720,5888696,5888696,5895244,0,0,0,6548
14748,5894041,5895244,5895253,0,0,1203,1212
14749,5894057,5895244,5895254,0,0,1187,1197
14752,5894426,5895244,5895254,0,0,818,828
14753,5894442,5895244,5895254,0,0,802,812
14750,5894073,5895244,5895255,0,0,1171,1182
14751,5894402,5895244,5895261,0,0,842,859
14724,5891173,5891173,5896890,0,0,0,5717
14757,5896607,5896890,5896955,0,0,283,348
14756,5895715,5896890,5896964,0,0,1175,1249
14747,5894030,5894036,5898624,0,0,6,4594
14754,5895234,5895261,5900707,0,0,27,5473
14761,5899203,5900707,5900771,0,0,1504,1568
14762,5901052,5901052,5901079,0,0,0,27
14758,5896719,5896964,5902090,0,0,245,5371
14741,5893659,5893659,5902206,0,0,0,8547
14763,5901526,5901526,5902422,0,0,0,896
14766,5902887,5902887,5902911,0,0,0,24
14760,5897532,5902206,5905187,0,0,4674,7655
14764,5901924,5901924,5905692,0,0,0,3768
14769,5905860,5905860,5906539,0,0,0,679
14771,5906784,5906784,5906986,0,0,0,202
14772,5907038,5907038,5907258,0,0,0,220
14773,5907225,5907225,5907373,0,0,0,148
14774,5907358,5907358,5907420,0,0,0,62
14775,5907811,5907811,5907918,0,0,0,107
14776,5907939,5907939,5908036,0,0,0,97
14759,5896862,5900707,5908207,0,0,3845,11345
14777,5907957,5907957,5908342,0,0,0,385
14778,5908066,5908066,5908372,0,0,0,306
14780,5908769,5908769,5909137,0,0,0,368
14779,5908592,5908592,5909351,0,0,0,759
14781,5909092,5909092,5909660,0,0,0,568
14755,5895695,5898624,5909843,0,0,2929,14148
14784,5909403,5909843,5909878,0,0,440,475
14785,5909926,5909926,5909988,0,0,0,62
14782,5909198,5909198,5911117,0,0,0,1919
14768,5904338,5905187,5911159,0,0,849,6821
14770,5906076,5906076,5911415,0,0,0,5339
14765,5902210,5905187,5912364,0,0,2977,10154
14788,5910744,5910744,5912594,0,0,0,1850
14787,5910726,5910726,5914433,0,0,0,3707
14792,5914342,5914342,5914452,0,0,0,110
14793,5914780,5914780,5914886,0,0,0,106
14794,5915006,5915006,5915152,0,0,0,146
14795,5915446,5915446,5915482,0,0,0,36
14786,5910293,5910293,5915985,0,0,0,5692
14783,5909392,5909392,5916386,0,0,0,6994
14767,5903744,5911415,5916850,0,0,7671,13106
14791,5913573,5913573,5917617,0,0,0,4044
14790,5913522,5916386,5918193,0,0,2864,4671
14800,5921166,5921166,5921448,0,0,0,282
14796,5915954,5915954,5921733,0,0,0,5779
14789,5913444,5913444,5921984,0,0,0,8540
14801,5921560,5921560,5922109,0,0,0,549
14799,5917849,5917849,5922111,0,0,0,4262
14798,5917010,5917010,5922320,0,0,0,5310
14805,5922212,5922212,5922342,0,0,0,130
14802,5921608,5921608,5922620,0,0,0,1012
14806,5923137,5923137,5923268,0,0,0,131
14807,5923579,5923579,5923737,0,0,0,158
14808,5923770,5923770,5923796,0,0,0,26
14797,5916391,5916850,5923864,0,0,459,7473
14809,5925151,5925151,5925280,0,0,0,129
14803,5921712,5921712,5925467,0,0,0,3755
14812,5927242,5927242,5927414,0,0,0,172
14814,5927335,5927335,5927415,0,0,0,80
14813,5927328,5927328,5927973,0,0,0,645
14815,5927374,5927374,5927980,0,0,0,606
14816,5927446,5927446,5929734,0,0,0,2288
14817,5928099,5928099,5930732,0,0,0,2633
14810,5925452,5925452,5931217,0,0,0,5765
14818,5929711,5929711,5932019,0,0,0,2308
14819,5932001,5932001,5933311,0,0,0,1310
14820,5936958,5936958,5938114,0,0,0,1156
14811,5926593,5926593,5938342,0,0,0,11749
14822,5938219,5938219,5938672,0,0,0,453
14823,5938225,5938225,5939509,0,0,0,1284
14804,5921935,5921935,5944350,0,0,0,22415
14821,5937855,5937855,5945047,0,0,0,7192
14824,5960798,5960798,5963268,0,0,0,2470
14825,5963249,5963249,5965590,0,0,0,2341
14826,5965565,5965565,5967907,0,0,0,2342
14829,5968367,5968367,5968890,0,0,0,523
14831,5970545,5970545,5970564,0,0,0,19
14827,5967877,5967877,5970613,0,0,0,2736
14833,5970843,5970843,5971024,0,0,0,181
14834,5970878,5970878,5971878,0,0,0,1000
14838,5972537,5972537,5972606,0,0,0,69
14839,5972786,5972786,5972818,0,0,0,32
14840,5972914,5972914,5973371,0,0,0,457
14841,5972936,5972936,5973456,0,0,0,520
14842,5973365,5973371,5973523,0,0,6,158
14844,5973869,5973869,5973972,0,0,0,103
14843,5973718,5973718,5974104,0,0,0,386
14837,5972368,5972368,5974191,0,0,0,1823
14846,5974392,5974392,5974878,0,0,0,486
14832,5970591,5970591,5974881,0,0,0,4290
14848,5975010,5975010,5975310,0,0,0,300
14845,5974210,5974210,5975326,0,0,0,1116
14850,5975435,5975435,5975498,0,0,0,63
14852,5975502,5975502,5975688,0,0,0,186
14851,5975473,5975473,5975997,0,0,0,524
14853,5975574,5975688,5976144,0,0,114,570
14836,5971424,5971424,5976164,0,0,0,4740
14830,5969314,5969314,5976669,0,0,0,7355
14854,5976950,5976950,5977255,0,0,0,305
14857,5978103,5978103,5978121,0,0,0,18
14856,5977923,5977923,5978198,0,0,0,275
14858,5978239,5978239,5978255,0,0,0,16
14860,5978267,5978267,5978277,0,0,0,10
14859,5978250,5978250,5978379,0,0,0,129
14862,5978424,5978424,5978474,0,0,0,50
14863,5978467,5978467,5978529,0,0,0,62
14864,5978536,5978536,5978564,0,0,0,28
14847,5974856,5974856,5978709,0,0,0,3853
14855,5977346,5977346,5978816,0,0,0,1470
14869,5978798,5978798,5978891,0,0,0,93
14870,5978904,5978904,5978984,0,0,0,80
14866,5978618,5978618,5979209,0,0,0,591
14828,5968168,5968168,5979447,0,0,0,11279
14876,5980294,5980294,5980664,0,0,0,370
14877,5980877,5980877,5980931,0,0,0,54
14878,5980959,5980959,5981025,0,0,0,66
14879,5981186,5981186,5981211,0,0,0,25
14875,5979952,5979952,5981390,0,0,0,1438
14880,5981437,5981437,5981477,0,0,0,40
14881,5981516,5981516,5981540,0,0,0,24
14882,5981538,5981538,5981576,0,0,0,38
14884,5981573,5981576,5981686,0,0,3,113
14885,5981764,5981764,5981811,0,0,0,47
14861,5978325,5978325,5981939,0,0,0,3614
14886,5981961,5981961,5982008,0,0,0,47
14888,5982055,5982055,5982083,0,0,0,28
14889,5982209,5982209,5982257,0,0,0,48
14887,5982025,5982025,5982268,0,0,0,243
14891,5982605,5982605,5982662,0,0,0,57
14894,5982831,5982831,5982881,0,0,0,50
14895,5982928,5982928,5983007,0,0,0,79
14835,5970900,5970900,5983332,0,0,0,12432
14897,5983442,5983442,5983511,0,0,0,69
14867,5978642,5978642,5983587,0,0,0,4945
14890,5982423,5983332,5983630,0,0,909,1207
14899,5983587,5983587,5983678,0,0,0,91
14849,5975077,5975077,5983773,0,0,0,8696
14900,5983753,5983753,5983844,0,0,0,91
14903,5984246,5984246,5984368,0,0,0,122
14904,5984327,5984368,5984418,0,0,41,91
14905,5984443,5984443,5984551,0,0,0,108
14906,5984548,5984551,5984637,0,0,3,89
14907,5984830,5984830,5984935,0,0,0,105
14872,5979076,5979076,5984971,0,0,0,5895
14868,5978715,5979447,5984993,0,0,732,6278
14893,5982819,5983630,5985871,0,0,811,3052
14902,5983900,5983900,5986010,0,0,0,2110
14909,5986179,5986179,5986211,0,0,0,32
14896,5983267,5983773,5986548,0,0,506,3281
14908,5985827,5985827,5986615,0,0,0,788
14865,5978551,5979447,5987440,0,0,896,8889
14912,5986879,5986879,5987477,0,0,0,598
14883,5981569,5981569,5987583,0,0,0,6014
14911,5986425,5986425,5987617,0,0,0,1192
14901,5983779,5984993,5988255,0,0,1214,4476
14898,5983549,5983549,5988326,0,0,0,4777
14873,5979137,5979137,5989460,0,0,0,10323
14910,5986364,5986364,5989625,0,0,0,3261
14913,5987824,5987824,5990805,0,0,0,2981
14892,5982781,5987440,5991432,0,0,4659,8651
14916,5989986,5990805,5993458,0,0,819,3472
14914,5989672,5991432,5993541,0,0,1760,3869
14926,5992726,5993458,5993791,0,0,732,1065
14919,5990727,5993541,5993968,0,0,2814,3241
14920,5991135,5993968,5994035,0,0,2833,2900
14871,5978984,5979447,5994209,0,0,463,15225
14927,5992743,5993541,5994657,0,0,798,1914
14935,5993919,5994657,5995060,0,0,738,1141
14936,5994087,5995060,5995169,0,0,973,1082
14937,5994289,5995169,5995262,0,0,880,973
14930,5993245,5994657,5995268,0,0,1412,2023
14922,5991294,5991294,5995297,0,0,0,4003
14939,5994488,5995262,5995341,0,0,774,853
14915,5989887,5989887,5995492,0,0,0,5605
14942,5994686,5995341,5995695,0,0,655,1009
14944,5995207,5995695,5995855,0,0,488,648
14946,5995412,5995855,5995915,0,0,443,503
14921,5991192,5994035,5995933,0,0,2843,4741
14948,5995914,5995915,5996032,0,0,1,118
14949,5996135,5996135,5996235,0,0,0,100
14951,5996281,5996281,5996341,0,0,0,60
14952,5996445,5996445,5996507,0,0,0,62
14953,5996473,5996507,5996566,0,0,34,93
14940,5994531,5995268,5996585,0,0,737,2054
14874,5979624,5989460,5996604,0,0,9836,16980
14954,5996575,5996575,5996848,0,0,0,273
14955,5996708,5996708,5996925,0,0,0,217
14950,5996265,5996925,5997262,0,0,660,997
14959,5997092,5997262,5997549,0,0,170,457
14964,5997503,5997549,5997766,0,0,46,263
14966,5997767,5997767,5997887,0,0,0,120
14938,5994482,5995492,5998192,0,0,1010,3710
14918,5990573,5993541,5998249,0,0,2968,7676
14963,5997472,5997472,5998557,0,0,0,1085
14967,5997821,5997887,5998619,0,0,66,798
14975,5998560,5998619,5998696,0,0,59,136
14931,5993266,5995933,5998884,0,0,2667,5618
14974,5998370,5998557,5999002,0,0,187,632
14971,5998091,5998249,5999161,0,0,158,1070
14977,5999312,5999312,5999387,0,0,0,75
14923,5991793,5994209,5999596,0,0,2416,7803
14968,5997857,5998249,5999636,0,0,392,1779
14981,5999710,5999710,5999763,0,0,0,53
14933,5993654,5998884,6000361,0,0,5230,6707
14941,5994668,5995297,6000562,0,0,629,5894
14961,5997173,5998192,6000627,0,0,1019,3454
14984,6000513,6000513,6000946,0,0,0,433
14983,6000496,6000496,6001043,0,0,0,547
14917,5990443,5996604,6001253,0,0,6161,10810
14925,5992184,6001253,6001379,0,0,9069,9195
14924,5991968,6001253,6001477,0,0,9285,9509
14932,5993426,6001477,6001546,0,0,8051,8120
14947,5995499,6000361,6001607,0,0,4862,6108
14956,5996812,6001546,6001770,0,0,4734,4958
14960,5997107,6001770,6001798,0,0,4663,4691
14979,5999545,5999545,6001883,0,0,0,2338
14965,5997573,6001798,6001934,0,0,4225,4361
14969,5997987,6001934,6001961,0,0,3947,3974
14958,5997066,6001043,6001993,0,0,3977,4927
14970,5998086,6001961,6002065,0,0,3875,3979
14928,5992951,5993791,6002205,0,0,840,9254
14991,6001186,6001883,6002230,0,0,697,1044
14990,6001152,6001883,6002233,0,0,731,1081
14993,6001229,6002230,6002282,0,0,1001,1053
14972,5998195,6002065,6002304,0,0,3870,4109
14976,5998737,6002304,6002330,0,0,3567,3593
14997,6001752,6002282,6002336,0,0,530,584
14978,5999419,6002330,6002354,0,0,2911,2935
15000,6002062,6002336,6002398,0,0,274,336
15001,6002305,6002398,6002529,0,0,93,224
15002,6002358,6002529,6002566,0,0,171,208
14995,6001435,6002233,6002580,0,0,798,1145
14992,6001194,6002205,6002614,0,0,1011,1420
14985,6000527,6000562,6002637,0,0,35,2110
14980,5999678,6002354,6002756,0,0,2676,3078
14973,5998316,6001993,6002776,0,0,3677,4460
14986,6000579,6002756,6002887,0,0,2177,2308
14988,6001040,6002887,6002907,0,0,1847,1867
14989,6001068,6002907,6002932,0,0,1839,1864
14994,6001355,6002932,6003066,0,0,1577,1711
15003,6002964,6002964,6003073,0,0,0,109
14996,6001547,6003066,6003084,0,0,1519,1537
14999,6001953,6003084,6003101,0,0,1131,1148
15005,6003069,6003069,6003115,0,0,0,46
15004,6002977,6003101,6003201,0,0,124,224
15006,6003200,6003200,6003253,0,0,0,53
15007,6003553,6003553,6003570,0,0,0,17
15008,6004033,6004033,6004099,0,0,0,66
15010,6004203,6004203,6004240,0,0,0,37
14929,5993037,6001379,6004380,0,0,8342,11343
14943,5995076,6004380,6004415,0,0,9304,9339
14945,5995393,6004415,6004445,0,0,9022,9052
14957,5997003,6004445,6004601,0,0,7442,7598
14998,6001820,6002580,6004860,0,0,760,3040
15012,6004563,6004860,6004917,0,0,297,354
15013,6004777,6004917,6006067,0,0,140,1290
15014,6004993,6006067,6006134,0,0,1074,1141
15009,6004044,6004044,6007103,0,0,0,3059
15015,6005167,6007103,6007170,0,0,1936,2003
15016,6005268,6007170,6007600,0,0,1902,2332
15026,6007039,6007600,6009207,0,0,561,2168
15030,6008781,6009207,6009233,0,0,426,452
15032,6009373,6009373,6009617,0,0,0,244
15017,6005428,6006067,6010056,0,0,639,4628
15022,6006044,6006134,6010128,0,0,90,4084
15019,6005729,6010128,6010935,0,0,4399,5206
14962,5997179,6001607,6012369,0,0,4428,15190
15021,6005955,6012369,6012391,0,0,6414,6436
15023,6006570,6012391,6012802,0,0,5821,6232
14934,5993752,5999596,6012923,0,0,5844,19171
14987,6000759,6002756,6024116,0,0,1997,23357
15038,6011179,6024116,6024150,0,0,12937,12971
15039,6011208,6024116,6024161,0,0,12908,12953
15041,6011604,6024150,6024184,0,0,12546,12580
15040,6011308,6024161,6024199,0,0,12853,12891
15043,6011696,6024199,6024258,0,0,12503,12562
15042,6011684,6024184,6024340,0,0,12500,12656
15034,6010224,6024116,6024341,0,0,13892,14117
15046,6013927,6024340,6024368,0,0,10413,10441
15028,6007938,6012923,6024388,0,0,4985,16450
15048,6016293,6024368,6024420,0,0,8075,8127
15050,6017986,6024388,6024422,0,0,6402,6436
15047,6015651,6024341,6024439,0,0,8690,8788
15056,6019432,6024439,6024476,0,0,5007,5044
15053,6018444,6024420,6024479,0,0,5976,6035
15049,6016788,6024388,6024480,0,0,7600,7692
15060,6020745,6024480,6024504,0,0,3735,3759
15058,6020382,6024479,6024505,0,0,4097,4123
15057,6019872,6024476,6024509,0,0,4604,4637
15054,6018652,6024422,6024512,0,0,5770,5860
15062,6021022,6024504,6024526,0,0,3482,3504
15064,6021257,6024509,6024527,0,0,3252,3270
15063,6021100,6024505,6024530,0,0,3405,3430
15052,6018431,6024388,6024543,0,0,5957,6112
15051,6018150,6024388,6024549,0,0,6238,6399
15067,6021829,6024527,6024549,0,0,2698,2720
15066,6021712,6024526,6024551,0,0,2814,2839
15068,6022041,6024530,6024551,0,0,2489,2510
15069,6022141,6024543,6024566,0,0,2402,2425
15070,6022236,6024549,6024567,0,0,2313,2331
15065,6021421,6024512,6024598,0,0,3091,3177
15044,6012328,6024199,6024972,0,0,11871,12644
15027,6007121,6012802,6026125,0,0,5681,19004
15045,6013029,6024258,6026351,0,0,11229,13322
15020,6005942,6010935,6027116,0,0,4993,21174
15071,6022743,6024551,6029163,0,0,1808,6420
14982,6000276,6004601,6029565,0,0,4325,29289
15024,6006919,6029565,6029655,0,0,22646,22736
15011,6004474,6029163,6029919,0,0,24689,25445
15025,6007011,6029655,6030307,0,0,22644,23296
15018,6005623,6029565,6030517,0,0,23942,24894
15033,6009931,6030517,6030536,0,0,20586,20605
15035,6010306,6030536,6030553,0,0,20230,20247
15031,6008902,6030307,6030556,0,0,21405,21654
15037,6010531,6030556,6030592,0,0,20025,20061
15061,6020966,6030592,6030621,0,0,9626,9655
15029,6008046,6029919,6030654,0,0,21873,22608
15055,6019345,6024598,6033884,0,0,5253,14539
15036,6010520,6030553,6036047,0,0,20033,25527
15072,6023891,6030621,6037640,0,0,6730,13749
15059,6020451,6026125,6037945,0,0,5674,17494
15073,6030907,6030907,6037947,0,0,0,7040
15075,6037955,6037955,6044958,0,0,0,7003
15077,6047346,6047346,6049825,0,0,0,2479
15080,6050671,6050671,6050713,0,0,0,42
15074,6036444,6036444,6050809,0,0,0,14365
15082,6050875,6050875,6050934,0,0,0,59
15076,6044958,6044958,6052007,0,0,0,7049
15078,6049760,6049760,6053983,0,0,0,4223
15083,6051509,6051509,6058742,0,0,0,7233
15090,6056659,6058742,6058816,0,0,2083,2157
15084,6052014,6052014,6059097,0,0,0,7083
15095,6057413,6059097,6059198,0,0,1684,1785
15096,6057825,6059097,6059204,0,0,1272,1379
15086,6053918,6053983,6059281,0,0,65,5363
15097,6058170,6059198,6059365,0,0,1028,1195
15099,6058581,6059281,6059546,0,0,700,965
15079,6050301,6050301,6059563,0,0,0,9262
15102,6059085,6059281,6059603,0,0,196,518
15105,6059299,6059365,6059624,0,0,66,325
15098,6058554,6059204,6059646,0,0,650,1092
15106,6059445,6059546,6059703,0,0,101,258
15085,6053174,6058742,6059803,0,0,5568,6629
15109,6059648,6059703,6059954,0,0,55,306
15111,6059959,6059959,6060136,0,0,0,177
15112,6059992,6059992,6060373,0,0,0,381
15113,6060134,6060134,6060464,0,0,0,330
15114,6060459,6060459,6060523,0,0,0,64
15115,6060556,6060556,6060989,0,0,0,433
15089,6056606,6058742,6061721,0,0,2136,5115
15107,6059570,6059803,6061778,0,0,233,2208
15121,6061097,6061721,6061848,0,0,624,751
15122,6061108,6061721,6062031,0,0,613,923
15123,6061484,6061778,6062239,0,0,294,755
15127,6062292,6062292,6062495,0,0,0,203
15126,6062184,6062184,6062673,0,0,0,489
15130,6062713,6062713,6062882,0,0,0,169
15092,6056872,6058816,6062947,0,0,1944,6075
15128,6062548,6062548,6063657,0,0,0,1109
15135,6063590,6063590,6064054,0,0,0,464
15108,6059631,6059646,6064453,0,0,15,4822
15088,6054893,6058742,6064746,0,0,3849,9853
15081,6050812,6050812,6065205,0,0,0,14393
15119,6060955,6065205,6065239,0,0,4250,4284
15116,6060781,6064054,6065248,0,0,3273,4467
15129,6062619,6062619,6065281,0,0,0,2662
15136,6064571,6064571,6065382,0,0,0,811
15138,6064938,6065382,6065423,0,0,444,485
15125,6061825,6065239,6065451,0,0,3414,3626
15140,6065187,6065423,6065675,0,0,236,488
15087,6054272,6058742,6065676,0,0,4470,11404
15104,6059198,6059624,6065682,0,0,426,6484
15101,6058885,6059563,6065714,0,0,678,6829
15142,6065257,6065675,6065734,0,0,418,477
15137,6064740,6065281,6065745,0,0,541,1005
15147,6065449,6065714,6065771,0,0,265,322
15148,6065553,6065734,6065777,0,0,181,224
15131,6062737,6065248,6065957,0,0,2511,3220
15149,6065617,6065745,6065960,0,0,128,343
15145,6065397,6065676,6065966,0,0,279,569
15134,6063496,6065957,6065978,0,0,2461,2482
15153,6066018,6066018,6066065,0,0,0,47
15154,6066105,6066105,6066245,0,0,0,140
15156,6066298,6066298,6066546,0,0,0,248
15139,6065013,6065978,6066595,0,0,965,1582
15120,6060999,6060999,6066676,0,0,0,5677
15146,6065414,6065714,6066758,0,0,300,1344
15161,6066687,6066758,6066875,0,0,71,188
15094,6057272,6059097,6067008,0,0,1825,9736
15152,6065880,6065960,6067321,0,0,80,1441
15163,6067446,6067446,6067476,0,0,0,30
15158,6066468,6066676,6068117,0,0,208,1649
15165,6068399,6068399,6068465,0,0,0,66
15164,6067598,6067598,6068509,0,0,0,911
15166,6068821,6068821,6068886,0,0,0,65
15168,6069623,6069623,6069638,0,0,0,15
15150,6065702,6065771,6069683,0,0,69,3981
15170,6069692,6069692,6069844,0,0,0,152
15172,6070219,6070219,6070251,0,0,0,32
15117,6060793,6060793,6070261,0,0,0,9468
15141,6065243,6065682,6070423,0,0,439,5180
15173,6070778,6070778,6070819,0,0,0,41
15174,6070796,6070796,6070930,0,0,0,134
15175,6070923,6070923,6071491,0,0,0,568
15162,6066967,6066967,6071594,0,0,0,4627
15171,6069962,6069962,6072539,0,0,0,2577
15179,6073211,6073211,6073330,0,0,0,119
15180,6073408,6073408,6073520,0,0,0,112
15177,6072944,6072944,6073538,0,0,0,594
15157,6066368,6066546,6073623,0,0,178,7255
15151,6065748,6065777,6073778,0,0,29,8030
15184,6073879,6073879,6074002,0,0,0,123
15144,6065298,6066595,6074135,0,0,1297,8837
15160,6066533,6067008,6074224,0,0,475,7691
15186,6074284,6074284,6074408,0,0,0,124
15189,6074413,6074413,6074502,0,0,0,89
15193,6074568,6074568,6074637,0,0,0,69
15191,6074514,6074514,6075136,0,0,0,622
15091,6056704,6058742,6075164,0,0,2038,18460
15197,6074965,6075136,6075167,0,0,171,202
15198,6075148,6075167,6075282,0,0,19,134
15194,6074666,6074666,6075367,0,0,0,701
15176,6072531,6072531,6075507,0,0,0,2976
15093,6057053,6059097,6075579,0,0,2044,18526
15190,6074473,6075164,6075641,0,0,691,1168
15202,6075521,6075641,6075664,0,0,120,143
15199,6075438,6075507,6075717,0,0,69,279
15203,6075657,6075664,6075791,0,0,7,134
15205,6075847,6075847,6076019,0,0,0,172
15206,6075868,6075868,6076167,0,0,0,299
15207,6076128,6076128,6076386,0,0,0,258
15185,6074057,6074135,6076395,0,0,78,2338
15182,6073559,6073559,6076687,0,0,0,3128
15210,6076641,6076687,6076741,0,0,46,100
15211,6076729,6076741,6076803,0,0,12,74
15204,6075790,6076395,6076863,0,0,605,1073
15209,6076580,6076580,6076864,0,0,0,284
15196,6074941,6075579,6076949,0,0,638,2008
15178,6073195,6073195,6077012,0,0,0,3817
15213,6076838,6076864,6077021,0,0,26,183
15215,6076925,6076949,6077256,0,0,24,331
15217,6077200,6077200,6077260,0,0,0,60
15118,6060904,6064746,6077358,0,0,3842,16454
15216,6077188,6077188,6077474,0,0,0,286
15218,6077321,6077321,6077577,0,0,0,256
15214,6076900,6076949,6077689,0,0,49,789
15195,6074895,6075367,6077828,0,0,472,2933
15221,6077670,6077670,6077829,0,0,0,159
15223,6077746,6077746,6077839,0,0,0,93
15220,6077603,6077839,6078145,0,0,236,542
15222,6077703,6078145,6078222,0,0,442,519
15132,6063477,6065451,6078294,0,0,1974,14817
15188,6074368,6074368,6078329,0,0,0,3961
15225,6077927,6078222,6078378,0,0,295,451
15226,6077960,6078294,6078384,0,0,334,424
15228,6078029,6078222,6078464,0,0,193,435
15192,6074554,6074554,6078488,0,0,0,3934
15224,6077871,6078222,6078523,0,0,351,652
15232,6078604,6078604,6078762,0,0,0,158
15235,6078781,6078781,6078848,0,0,0,67
15233,6078617,6078617,6078900,0,0,0,283
15239,6078935,6078935,6079048,0,0,0,113
15200,6075491,6075641,6079091,0,0,150,3600
15183,6073617,6073623,6079093,0,0,6,5476
15229,6078170,6078222,6079124,0,0,52,954
15240,6079019,6079048,6079144,0,0,29,125
15242,6079088,6079091,6079205,0,0,3,117
15241,6079081,6079091,6079350,0,0,10,269
15236,6078792,6078792,6079432,0,0,0,640
15230,6078254,6078329,6079494,0,0,75,1240
15243,6079191,6079191,6079507,0,0,0,316
15247,6079526,6079526,6079593,0,0,0,67
15231,6078300,6078329,6079596,0,0,29,1296
15245,6079367,6079367,6079611,0,0,0,244
15248,6079654,6079654,6079702,0,0,0,48
15249,6079668,6079702,6079858,0,0,34,190
15244,6079206,6079206,6079949,0,0,0,743
15250,6079723,6079858,6080018,0,0,135,295
15212,6076801,6076803,6080549,0,0,2,3748
15252,6079863,6080018,6080553,0,0,155,690
15255,6079962,6080553,6080591,0,0,591,629
15253,6079895,6080549,6080612,0,0,654,717
15181,6073525,6073538,6080897,0,0,13,7372
15256,6079974,6080591,6080904,0,0,617,930
15234,6078749,6079596,6080955,0,0,847,2206
15227,6077995,6078384,6081395,0,0,389,3400
15251,6079820,6079949,6081454,0,0,129,1634
15237,6078922,6080897,6081684,0,0,1975,2762
15262,6080339,6081684,6081726,0,0,1345,1387
15266,6080528,6081726,6081783,0,0,1198,1255
15264,6080467,6081684,6081898,0,0,1217,1431
15267,6080548,6081783,6082017,0,0,1235,1469
15246,6079444,6079444,6082092,0,0,0,2648
15261,6080299,6081684,6082142,0,0,1385,1843
15269,6080763,6082017,6082197,0,0,1254,1434
15259,6080232,6081395,6082486,0,0,1163,2254
15257,6079988,6080612,6082550,0,0,624,2562
15274,6080924,6082550,6082630,0,0,1626,1706
15260,6080260,6081454,6082640,0,0,1194,2380
15276,6081079,6082640,6082705,0,0,1561,1626
15201,6075519,6075519,6082712,0,0,0,7193
15268,6080637,6081898,6082801,0,0,1261,2164
15272,6080870,6082486,6082822,0,0,1616,1952
15280,6081408,6082822,6082850,0,0,1414,1442
15279,6081328,6082801,6082899,0,0,1473,1571
15277,6081101,6082705,6082939,0,0,1604,1838
15283,6081478,6082899,6082953,0,0,1421,1475
15273,6080885,6082197,6082970,0,0,1312,2085
15275,6081011,6082630,6083042,0,0,1619,2031
15289,6082232,6082970,6083216,0,0,738,984
15254,6079954,6080955,6083395,0,0,1001,3441
15287,6082136,6082953,6083567,0,0,817,1431
15278,6081166,6082712,6083621,0,0,1546,2455
15258,6080043,6080904,6083655,0,0,861,3612
15295,6082664,6083567,6083656,0,0,903,992
15281,6081444,6082822,6083662,0,0,1378,2218
15284,6081778,6082939,6083772,0,0,1161,1994
15301,6083317,6083662,6083799,0,0,345,482
15298,6082841,6083655,6083836,0,0,814,995
15304,6083848,6083848,6084466,0,0,0,618
15103,6059098,6077474,6084536,0,0,18376,25438
15305,6083906,6083906,6084757,0,0,0,851
15306,6084526,6084526,6084829,0,0,0,303
15299,6082906,6083656,6085039,0,0,750,2133
15263,6080421,6081684,6085103,0,0,1263,4682
15285,6081862,6083395,6085250,0,0,1533,3388
15286,6082035,6085103,6085316,0,0,3068,3281
15303,6083785,6083785,6085558,0,0,0,1773
15309,6085712,6085712,6085882,0,0,0,170
15238,6078930,6078930,6085940,0,0,0,7010
15297,6082825,6083621,6086365,0,0,796,3540
15282,6081454,6082850,6086460,0,0,1396,5006
15311,6085793,6086365,6086510,0,0,572,717
15270,6080798,6082142,6086523,0,0,1344,5725
15313,6085979,6086460,6086532,0,0,481,553
15314,6086052,6086510,6086606,0,0,458,554
15316,6086077,6086532,6086694,0,0,455,617
15291,6082352,6083042,6086728,0,0,690,4376
15294,6082571,6083216,6086875,0,0,645,4304
15317,6086136,6086606,6086901,0,0,470,765
15265,6080521,6082092,6086905,0,0,1571,6384
15321,6086613,6086728,6086968,0,0,115,355
15322,6086700,6086875,6087049,0,0,175,349
15319,6086394,6086694,6087060,0,0,300,666
15310,6085757,6085882,6087102,0,0,125,1345
15325,6087121,6087121,6087149,0,0,0,28
15326,6087192,6087192,6087261,0,0,0,69
15315,6086058,6086523,6087284,0,0,465,1226
15323,6086848,6086901,6087459,0,0,53,611
15208,6076334,6076863,6087608,0,0,529,11274
15292,6082384,6087284,6087768,0,0,4900,5384
15328,6087322,6087459,6088912,0,0,137,1590
15329,6087345,6088912,6088923,0,0,1567,1578
15290,6082245,6085316,6089226,0,0,3071,6981
15300,6082920,6089226,6089773,0,0,6306,6853
15331,6087385,6088923,6089842,0,0,1538,2457
15302,6083762,6089773,6090279,0,0,6011,6517
15332,6087499,6089842,6090370,0,0,2343,2871
15307,6085107,6090279,6090747,0,0,5172,5640
15334,6087591,6090370,6090927,0,0,2779,3336
15324,6086952,6086968,6090950,0,0,16,3998
15340,6087845,6090950,6090983,0,0,3105,3138
15318,6086156,6090747,6091277,0,0,4591,5121
15308,6085674,6085940,6091291,0,0,266,5617
15296,6082687,6087768,6091409,0,0,5081,8722
15293,6082502,6087608,6091487,0,0,5106,8985
15338,6087714,6090927,6091528,0,0,3213,3814
15330,6087368,6091487,6091567,0,0,4119,4199
15333,6087514,6091567,6091836,0,0,4053,4322
15344,6088207,6091528,6091907,0,0,3321,3700
15312,6085931,6086905,6091937,0,0,974,6006
15339,6087837,6091836,6092482,0,0,3999,4645
15346,6088649,6092482,6092586,0,0,3833,3937
15345,6088489,6091907,6093146,0,0,3418,4657
15348,6088852,6091937,6093190,0,0,3085,4338
15350,6089108,6091937,6093687,0,0,2829,4579
15351,6089503,6093146,6093708,0,0,3643,4205
15271,6080862,6082486,6093889,0,0,1624,13027
15347,6088713,6092586,6093909,0,0,3873,5196
15356,6090715,6093909,6094057,0,0,3194,3342
15358,6090937,6093909,6094104,0,0,2972,3167
15354,6090269,6093708,6094332,0,0,3439,4063
15337,6087652,6091291,6094407,0,0,3639,6755
15355,6090499,6093889,6094561,0,0,3390,4062
15353,6090166,6093687,6094578,0,0,3521,4412
15369,6093817,6094561,6094615,0,0,744,798
15372,6094212,6094578,6094616,0,0,366,404
15360,6091140,6094057,6094807,0,0,2917,3667
15364,6091933,6094332,6095120,0,0,2399,3187
15361,6091292,6094104,6095126,0,0,2812,3834
15288,6082210,6085250,6095384,0,0,3040,13174
15357,6090877,6093909,6095546,0,0,3032,4669
15110,6059887,6084536,6095811,0,0,24649,35924
15366,6092599,6094561,6095981,0,0,1962,3382
15367,6093545,6095384,6096253,0,0,1839,2708
15362,6091655,6094407,6096289,0,0,2752,4634
15352,6089873,6093190,6097167,0,0,3317,7294
15341,6087899,6090983,6097492,0,0,3084,9593
15327,6087274,6091409,6098552,0,0,4135,11278
15381,6098226,6098552,6099564,0,0,326,1338
15382,6099712,6099712,6099763,0,0,0,51
15383,6099916,6099916,6099952,0,0,0,36
15384,6099929,6099929,6099955,0,0,0,26
15159,6066489,6095811,6100127,0,0,29322,33638
15385,6100224,6100224,6100263,0,0,0,39
15320,6086412,6091277,6100476,0,0,4865,14064
15373,6094422,6096253,6100748,0,0,1831,6326
15342,6087938,6100476,6104592,0,0,12538,16654
15386,6100833,6100833,6105020,0,0,0,4187
15376,6094983,6095126,6105113,0,0,143,10130
15378,6095833,6095981,6105119,0,0,148,9286
15375,6094720,6095120,6105369,0,0,400,10649
15371,6094158,6094616,6105428,0,0,458,11270
15392,6106028,6106028,6106038,0,0,0,10
15393,6106168,6106168,6106175,0,0,0,7
15343,6088114,6104592,6106471,0,0,16478,18357
15394,6106458,6106458,6106497,0,0,0,39
15187,6074323,6100127,6107199,0,0,25804,32876
15374,6094525,6107199,6107222,0,0,12674,12697
15390,6105625,6105625,6108684,0,0,0,3059
15370,6094006,6106471,6109313,0,0,12465,15307
15349,6088868,6105119,6112193,0,0,16251,23325
15400,6112207,6112207,6112228,0,0,0,21
15402,6112322,6112322,6112509,0,0,0,187
15398,6110390,6112193,6112842,0,0,1803,2452
15397,6108905,6112193,6112847,0,0,3288,3942
15403,6112933,6112933,6113581,0,0,0,648
15389,6105085,6107222,6114330,0,0,2137,9245
15404,6113890,6113890,6117968,0,0,0,4078
15396,6108855,6108855,6119361,0,0,0,10506
15401,6112311,6114330,6121764,0,0,2019,9453
15405,6116972,6117968,6121881,0,0,996,4909
15379,6096534,6097492,6123584,0,0,958,27050
15395,6108372,6108372,6124086,0,0,0,15714
15100,6058723,6124086,6126585,0,0,65363,67862
15124,6061723,6126585,6127746,0,0,64862,66023
15391,6105823,6109313,6127810,0,0,3490,21987
15133,6063489,6127746,6128943,0,0,64257,65454
15143,6065269,6128943,6130352,0,0,63674,65083
15406,6119515,6121764,6136151,0,0,2249,16636
15407,6134215,6134215,6136594,0,0,0,2379
15155,6066163,6130352,6137995,0,0,64189,71832
15399,6110412,6112193,6138292,0,0,1781,27880
15408,6136531,6136531,6138906,0,0,0,2375
15411,6140235,6140235,6140258,0,0,0,23
15410,6138826,6138826,6141167,0,0,0,2341
15414,6141184,6141184,6141249,0,0,0,65
15415,6141494,6141494,6141832,0,0,0,338
15419,6144180,6144180,6146212,0,0,0,2032
15420,6145680,6146212,6146378,0,0,532,698
15422,6146234,6146378,6149154,0,0,144,2920
15421,6145987,6146378,6149179,0,0,391,3192
15426,6149438,6149438,6150705,0,0,0,1267
15167,6069142,6137995,6151109,0,0,68853,81967
15169,6069635,6151109,6151165,0,0,81474,81530
15427,6152765,6152765,6152884,0,0,0,119
15423,6146917,6149154,6153086,0,0,2237,6169
15219,6077427,6151165,6154174,0,0,73738,76747
15335,6087605,6154174,6154803,0,0,66569,67198
15336,6087649,6154803,6155141,0,0,67154,67492
15359,6091122,6155141,6155242,0,0,64019,64120
15363,6091717,6155242,6155575,0,0,63525,63858
15365,6092145,6155575,6156046,0,0,63430,63901
15368,6093615,6156046,6158254,0,0,62431,64639
15428,6155602,6155602,6159574,0,0,0,3972
15377,6095620,6158254,6160229,0,0,62634,64609
15430,6160578,6160578,6163383,0,0,0,2805
15431,6161204,6163383,6163427,0,0,2179,2223
15409,6138250,6138250,6164262,0,0,0,26012
15413,6141168,6141168,6164409,0,0,0,23241
15416,6141646,6141646,6164409,0,0,0,22763
15417,6141804,6141832,6164428,0,0,28,22624
15429,6160565,6160565,6164527,0,0,0,3962
15433,6164639,6164639,6164699,0,0,0,60
15436,6164735,6164735,6164785,0,0,0,50
15437,6164999,6164999,6165316,0,0,0,317
15441,6165451,6165451,6165544,0,0,0,93
15435,6164727,6164727,6166018,0,0,0,1291
15425,6149364,6164409,6166174,0,0,15045,16810
15443,6165684,6165684,6166278,0,0,0,594
15445,6165833,6166278,6166428,0,0,445,595
15446,6165887,6166428,6166731,0,0,541,844
15380,6097825,6160229,6166776,0,0,62404,68951
15447,6165913,6166731,6166860,0,0,818,947
15448,6166019,6166860,6167146,0,0,841,1127
15449,6166048,6167146,6167456,0,0,1098,1408
15450,6166470,6167456,6167622,0,0,986,1152
15451,6166704,6167622,6168047,0,0,918,1343
15452,6166920,6168047,6168202,0,0,1127,1282
15453,6167002,6168202,6168462,0,0,1200,1460
15434,6164708,6164708,6168692,0,0,0,3984
15455,6167389,6168692,6168842,0,0,1303,1453
15456,6167561,6168842,6168953,0,0,1281,1392
15458,6167793,6168953,6169036,0,0,1160,1243
15459,6167971,6169036,6169124,0,0,1065,1153
15460,6168123,6169124,6169214,0,0,1001,1091
15432,6164515,6166174,6170347,0,0,1659,5832
15454,6167355,6168462,6170392,0,0,1107,3037
15464,6168857,6170347,6170430,0,0,1490,1573
15469,6169310,6170392,6170433,0,0,1082,1123
15463,6168838,6170347,6170634,0,0,1509,1796
15462,6168570,6169214,6170750,0,0,644,2180
15474,6169626,6170750,6170812,0,0,1124,1186
15473,6169617,6170634,6170826,0,0,1017,1209
15477,6170523,6170826,6171031,0,0,303,508
15476,6169935,6170812,6171403,0,0,877,1468
15439,6165214,6170347,6171417,0,0,5133,6203
15466,6169233,6171417,6171446,0,0,2184,2213
15472,6169551,6170433,6171527,0,0,882,1976
15481,6170655,6171527,6171850,0,0,872,1195
15471,6169472,6170430,6172155,0,0,958,2683
15480,6170640,6171403,6172165,0,0,763,1525
15483,6171125,6172155,6172450,0,0,1030,1325
15487,6171401,6172450,6172848,0,0,1049,1447
15488,6171421,6172848,6173957,0,0,1427,2536
15489,6171742,6173957,6173985,0,0,2215,2243
15440,6165297,6170347,6174284,0,0,5050,8987
15482,6171051,6171850,6174448,0,0,799,3397
15491,6171811,6173985,6174665,0,0,2174,2854
15494,6172413,6174665,6174738,0,0,2252,2325
15496,6172536,6174738,6174810,0,0,2202,2274
15497,6172550,6174810,6175167,0,0,2260,2617
15498,6172640,6175167,6175229,0,0,2527,2589
15499,6173493,6175229,6175278,0,0,1736,1785
15501,6173583,6175278,6175796,0,0,1695,2213
15438,6165161,6165161,6175975,0,0,0,10814
15492,6171988,6174448,6176277,0,0,2460,4289
15502,6173760,6175796,6176309,0,0,2036,2549
15442,6165564,6170347,6176576,0,0,4783,11012
15506,6174589,6176309,6176780,0,0,1720,2191
15507,6174802,6176780,6176800,0,0,1978,1998
15504,6174144,6176277,6176818,0,0,2133,2674
15508,6175154,6176800,6177045,0,0,1646,1891
15509,6175374,6176818,6177433,0,0,1444,2059
15511,6175454,6177045,6177472,0,0,1591,2018
15503,6174063,6175975,6177518,0,0,1912,3455
15512,6175477,6177433,6177526,0,0,1956,2049
15479,6170549,6171031,6177579,0,0,482,7030
15519,6176219,6177579,6177637,0,0,1360,1418
15520,6176238,6177637,6177790,0,0,1399,1552
15444,6165703,6166018,6177829,0,0,315,12126
15521,6176331,6177790,6177897,0,0,1459,1566
15522,6176462,6177829,6177942,0,0,1367,1480
15515,6176003,6177518,6177953,0,0,1515,1950
15524,6176669,6177897,6178048,0,0,1228,1379
15467,6169265,6171446,6178214,0,0,2181,8949
15470,6169450,6174284,6178252,0,0,4834,8802
15529,6178175,6178175,6178267,0,0,0,92
15486,6171254,6177953,6178786,0,0,6699,7532
15478,6170535,6176576,6179273,0,0,6041,8738
15514,6175974,6177472,6179500,0,0,1498,3526
15518,6176196,6177526,6180131,0,0,1330,3935
15530,6180666,6180666,6180701,0,0,0,35
15531,6180833,6180833,6182124,0,0,0,1291
15485,6171182,6172165,6182524,0,0,983,11342
15532,6180860,6182124,6183370,0,0,1264,2510
15418,6142619,6164262,6185973,0,0,21643,43354
15533,6183957,6183957,6186784,0,0,0,2827
15537,6186410,6186410,6186857,0,0,0,447
15510,6175405,6178214,6188072,0,0,2809,12667
15457,6167597,6179500,6189301,0,0,11903,21704
15548,6191068,6191068,6191136,0,0,0,68
15540,6187066,6187066,6191152,0,0,0,4086
15465,6169058,6189301,6191371,0,0,20243,22313
15461,6168528,6185973,6191636,0,0,17445,23108
15387,6101816,6166776,6191807,0,0,64960,89991
15550,6192333,6192333,6192388,0,0,0,55
15528,6177554,6178786,6192571,0,0,1232,15017
15551,6193041,6193041,6193097,0,0,0,56
15516,6176033,6178252,6193556,0,0,2219,17523
15388,6104200,6191807,6193844,0,0,87607,89644
15552,6193660,6193660,6194091,0,0,0,431
15553,6194329,6194329,6195015,0,0,0,686
15555,6194980,6194980,6195143,0,0,0,163
15556,6195137,6195137,6195207,0,0,0,70
15544,6187804,6187804,6196580,0,0,0,8776
15560,6195798,6196580,6198506,0,0,782,2708
15561,6196267,6198506,6199097,0,0,2239,2830
15475,6169682,6191636,6199210,0,0,21954,29528
15562,6196281,6199097,6199680,0,0,2816,3399
15484,6171175,6192571,6208591,0,0,21396,37416
15517,6176084,6199210,6213058,0,0,23126,36974
15527,6177274,6213058,6213120,0,0,35784,35846
15539,6186936,6213120,6213237,0,0,26184,26301
15541,6187108,6213237,6213254,0,0,26129,26146
15543,6187617,6213254,6215050,0,0,25637,27433
15412,6141043,6193844,6216972,0,0,52801,75929
15545,6189901,6215050,6219708,0,0,25149,29807
15546,6189925,6219708,6219773,0,0,29783,29848
15526,6177263,6208591,6221225,0,0,31328,43962
15547,6190384,6219773,6221259,0,0,29389,30875
15549,6191988,6221225,6222425,0,0,29237,30437
15468,6169293,6191371,6224698,0,0,22078,55405
15424,6148582,6216972,6229564,0,0,68390,80982
15490,6171806,6229564,6233148,0,0,57758,61342
15557,6195228,6195228,6233658,0,0,0,38430
15558,6195524,6195524,6233659,0,0,0,38135
15493,6172238,6233148,6235087,0,0,60910,62849
15495,6172451,6235087,6235192,0,0,62636,62741
15569,6229256,6233659,6235198,0,0,4403,5942
15500,6173540,6235087,6235269,0,0,61547,61729
15563,6196871,6199680,6236407,0,0,2809,39536
15505,6174393,6235192,6236736,0,0,60799,62343
15570,6230874,6235198,6236891,0,0,4324,6017
15523,6176663,6236736,6237499,0,0,60073,60836
15534,6184647,6237499,6237580,0,0,52852,52933
15535,6185059,6237580,6237659,0,0,52521,52600
15572,6231358,6236891,6238394,0,0,5533,7036
15573,6233676,6238394,6238420,0,0,4718,4744
15575,6234168,6238420,6238476,0,0,4252,4308
15576,6234230,6238476,6238547,0,0,4246,4317
15536,6185997,6237659,6239483,0,0,51662,53486
15577,6234260,6238547,6239747,0,0,4287,5487
15579,6234299,6239747,6239952,0,0,5448,5653
15580,6234363,6239952,6240028,0,0,5589,5665
15513,6175524,6235269,6240754,0,0,59745,65230
15566,6199215,6240754,6241369,0,0,41539,42154
15568,6220738,6241369,6241390,0,0,20631,20652
15571,6230989,6236407,6241532,0,0,5418,10543
15586,6235066,6241532,6241616,0,0,6466,6550
15587,6235337,6241532,6241619,0,0,6195,6282
15590,6235746,6241619,6241869,0,0,5873,6123
15593,6235940,6241869,6242433,0,0,5929,6493
15538,6186852,6239483,6242932,0,0,52631,56080
15584,6234875,6242932,6243174,0,0,8057,8299
15591,6235863,6243174,6243417,0,0,7311,7554
15598,6236671,6243417,6243508,0,0,6746,6837
15594,6236010,6242433,6243536,0,0,6423,7526
15600,6236922,6243508,6243537,0,0,6586,6615
15601,6236996,6243536,6243570,0,0,6540,6574
15603,6237053,6243537,6243590,0,0,6484,6537
15578,6234274,6241390,6243739,0,0,7116,9465
15588,6235612,6242932,6244008,0,0,7320,8396
15595,6236538,6243417,6244293,0,0,6879,7755
15581,6234579,6240028,6244327,0,0,5449,9748
15596,6236547,6243739,6244338,0,0,7192,7791
15606,6237201,6244293,6244348,0,0,7092,7147
15610,6237387,6244338,6244400,0,0,6951,7013
15607,6237272,6244327,6244406,0,0,7055,7134
15612,6237746,6244400,6244455,0,0,6654,6709
15613,6237933,6244406,6244652,0,0,6473,6719
15608,6237281,6244338,6244689,0,0,7057,7408
15618,6238478,6244652,6244699,0,0,6174,6221
15620,6238612,6244699,6244860,0,0,6087,6248
15621,6238650,6244860,6245124,0,0,6210,6474
15589,6235633,6241616,6245510,0,0,5983,9877
15615,6238000,6244455,6246025,0,0,6455,8025
15597,6236663,6244008,6246057,0,0,7345,9394
15625,6238877,6245510,6246193,0,0,6633,7316
15628,6239689,6246193,6246285,0,0,6504,6596
15599,6236733,6246057,6246330,0,0,9324,9597
15624,6238824,6245124,6246366,0,0,6300,7542
15627,6239196,6246025,6246423,0,0,6829,7227
15630,6239786,6246366,6246425,0,0,6580,6639
15602,6237033,6246330,6246688,0,0,9297,9655
15632,6239958,6246425,6246731,0,0,6467,6773
15634,6239978,6246688,6246989,0,0,6710,7011
15582,6234607,6241390,6247129,0,0,6783,12522
15592,6235924,6243417,6247174,0,0,7493,11250
15639,6240451,6246989,6247183,0,0,6538,6732
15641,6240582,6247174,6247189,0,0,6592,6607
15609,6237308,6246688,6247248,0,0,9380,9940
15644,6240792,6247248,6247317,0,0,6456,6525
15643,6240760,6247183,6247369,0,0,6423,6609
15647,6241247,6247248,6247394,0,0,6001,6147
15648,6241494,6247317,6247447,0,0,5823,5953
15631,6239902,6246423,6247524,0,0,6521,7622
15652,6242000,6247394,6247528,0,0,5394,5528
15658,6242819,6247528,6247630,0,0,4709,4811
15655,6242477,6247524,6247676,0,0,5047,5199
15660,6242934,6247676,6247732,0,0,4742,4798
15659,6242848,6247630,6247761,0,0,4782,4913
15663,6243115,6247761,6247832,0,0,4646,4717
15661,6242943,6247732,6247836,0,0,4789,4893
15649,6241745,6247369,6248013,0,0,5624,6268
15666,6243347,6247836,6248026,0,0,4489,4679
15605,6237123,6243590,6248064,0,0,6467,10941
15673,6244095,6248064,6248231,0,0,3969,4136
15674,6244324,6248231,6248323,0,0,3907,3999
15669,6243479,6248026,6248738,0,0,4547,5259
15665,6243202,6247832,6248829,0,0,4630,5627
15678,6244642,6248829,6248945,0,0,4187,4303
15681,6245191,6248945,6249083,0,0,3754,3892
15683,6245356,6249083,6249127,0,0,3727,3771
15637,6240082,6246731,6249729,0,0,6649,9647
15654,6242469,6247447,6249746,0,0,4978,7277
15686,6245619,6249746,6249783,0,0,4127,4164
15684,6245424,6249127,6249952,0,0,3703,4528
15689,6245892,6249952,6249992,0,0,4060,4100
15690,6246179,6249992,6250152,0,0,3813,3973
15687,6245639,6249783,6250181,0,0,4144,4542
15691,6246452,6250152,6250268,0,0,3700,3816
15692,6246605,6250181,6250268,0,0,3576,3663
15693,6246804,6250268,6250310,0,0,3464,3506
15611,6237401,6244348,6250322,0,0,6947,12921
15574,6233954,6241390,6250677,0,0,7436,16723
15619,6238536,6244689,6250713,0,0,6153,12177
15697,6247333,6250713,6250758,0,0,3380,3425
15694,6246852,6250268,6250900,0,0,3416,4048
15703,6248920,6250900,6250918,0,0,1980,1998
15676,6244507,6248323,6251529,0,0,3816,7022
15695,6246881,6250310,6251980,0,0,3429,5099
15696,6246915,6250322,6252704,0,0,3407,5789
15705,6249052,6251529,6253555,0,0,2477,4503
15685,6245449,6249729,6253824,0,0,4280,8375
15712,6250007,6253555,6253943,0,0,3548,3936
15714,6250792,6253943,6254053,0,0,3151,3261
15713,6250757,6253824,6254076,0,0,3067,3319
15716,6251278,6254053,6255198,0,0,2775,3920
15719,6252605,6255198,6255253,0,0,2593,2648
15718,6252541,6254076,6255326,0,0,1535,2785
15604,6237102,6243570,6255406,0,0,6468,18304
15706,6249119,6251980,6255524,0,0,2861,6405
15724,6253035,6255524,6255611,0,0,2489,2576
15629,6239703,6246285,6255656,0,0,6582,15953
15727,6253326,6255656,6255679,0,0,2330,2353
15708,6249202,6252704,6256040,0,0,3502,6838
15733,6254281,6255679,6256140,0,0,1398,1859
15704,6248928,6250918,6256598,0,0,1990,7670
15640,6240490,6247129,6256607,0,0,6639,16117
15737,6254519,6256140,6256856,0,0,1621,2337
15642,6240630,6247189,6256954,0,0,6559,16324
15742,6254804,6256856,6257229,0,0,2052,2425
15739,6254617,6256598,6257388,0,0,1981,2771
15743,6254982,6257229,6257595,0,0,2247,2613
15746,6255270,6257388,6257659,0,0,2118,2389
15720,6252694,6255253,6258082,0,0,2559,5388
15748,6255428,6257595,6258459,0,0,2167,3031
15750,6255627,6258082,6258517,0,0,2455,2890
15645,6240999,6256954,6258746,0,0,15955,17747
15677,6244529,6248738,6258854,0,0,4209,14325
15753,6256203,6258854,6258953,0,0,2651,2750
15752,6256186,6258517,6259086,0,0,2331,2900
15760,6256765,6259086,6259234,0,0,2321,2469
15762,6257008,6259234,6259300,0,0,2226,2292
15763,6257196,6259300,6259389,0,0,2104,2193
15766,6257845,6259389,6259455,0,0,1544,1610
15767,6257869,6259455,6259534,0,0,1586,1665
15768,6258075,6259534,6259589,0,0,1459,1514
15554,6194880,6221259,6259914,0,0,26379,65034
15736,6254495,6256040,6259996,0,0,1545,5501
15770,6258151,6259589,6260179,0,0,1438,2028
15565,6198059,6224698,6260234,0,0,26639,62175
15559,6195695,6222425,6260265,0,0,26730,64570
15616,6238099,6259914,6260436,0,0,21815,22337
15726,6253210,6255611,6260457,0,0,2401,7247
15668,6243450,6248013,6260476,0,0,4563,17026
15771,6258217,6259996,6260522,0,0,1779,2305
15777,6259049,6260522,6260628,0,0,1473,1579
15778,6259622,6260628,6260752,0,0,1006,1130
15622,6238708,6260265,6260754,0,0,21557,22046
15782,6259935,6260752,6260854,0,0,817,919
15773,6258769,6260179,6260954,0,0,1410,2185
15636,6240016,6246688,6261031,0,0,6672,21015
15785,6260535,6261031,6261077,0,0,496,542
15784,6260326,6260954,6261221,0,0,628,895
15700,6247530,6250758,6261280,0,0,3228,13750
15564,6196881,6224698,6261413,0,0,27817,64532
15656,6242785,6258746,6261439,0,0,15961,18654
15790,6261128,6261280,6261458,0,0,152,330
15787,6260719,6261221,6261467,0,0,502,748
15751,6255672,6258459,6261496,0,0,2787,5824
15783,6260182,6260854,6261559,0,0,672,1377
15682,6245284,6261413,6261704,0,0,16129,16420
15794,6261647,6261647,6261705,0,0,0,58
15795,6261682,6261705,6261775,0,0,23,93
15774,6258783,6260457,6261887,0,0,1674,3104
15786,6260623,6261077,6262388,0,0,454,1765
15798,6261932,6262388,6262440,0,0,456,508
15800,6262125,6262440,6262621,0,0,315,496
15801,6262184,6262621,6262699,0,0,437,515
15802,6262264,6262699,6262789,0,0,435,525
15757,6256427,6258953,6262832,0,0,2526,6405
15803,6262609,6262789,6262881,0,0,180,272
15804,6262667,6262832,6262896,0,0,165,229
15805,6262737,6262881,6262968,0,0,144,231
15807,6263038,6263038,6263128,0,0,0,90
15702,6248646,6261496,6263321,0,0,12850,14675
15808,6263368,6263368,6263420,0,0,0,52
15623,6238764,6260436,6263639,0,0,21672,24875
15728,6253405,6263321,6263670,0,0,9916,10265
15729,6253988,6263670,6263730,0,0,9682,9742
15638,6240439,6263639,6264072,0,0,23200,23633
15749,6255455,6257659,6264163,0,0,2204,8708
15667,6243374,6260234,6264190,0,0,16860,20816
15811,6263577,6264163,6264214,0,0,586,637
15813,6263774,6264214,6264263,0,0,440,489
15814,6263835,6264263,6264393,0,0,428,558
15646,6241205,6264072,6264462,0,0,22867,23257
15657,6242800,6264462,6264495,0,0,21662,21695
15815,6263863,6264393,6264517,0,0,530,654
15738,6254606,6263730,6264557,0,0,9124,9951
15816,6263967,6264517,6264607,0,0,550,640
15817,6264214,6264607,6264659,0,0,393,445
15709,6249399,6261887,6264694,0,0,12488,15295
15723,6252899,6255406,6264709,0,0,2507,11810
15818,6264418,6264659,6264709,0,0,241,291
15664,6243179,6264495,6264748,0,0,21316,21569
15819,6264635,6264709,6264761,0,0,74,126
15820,6264653,6264709,6264831,0,0,56,178
15614,6237987,6250677,6264931,0,0,12690,26944
15707,6249143,6261704,6265028,0,0,12561,15885
15675,6244451,6264931,6265048,0,0,20480,20597
15679,6244892,6265048,6265066,0,0,20156,20174
15688,6245658,6261439,6265455,0,0,15781,19797
15788,6260960,6264831,6265793,0,0,3871,4833
15822,6264851,6265793,6265882,0,0,942,1031
15825,6265618,6265882,6265960,0,0,264,342
15823,6265143,6265793,6265976,0,0,650,833
15826,6265641,6265960,6266050,0,0,319,409
15827,6265806,6265976,6266064,0,0,170,258
15828,6265947,6266050,6266105,0,0,103,158
15829,6265984,6266064,6266154,0,0,80,170
15833,6266319,6266319,6266370,0,0,0,51
15835,6266394,6266394,6266452,0,0,0,58
15834,6266352,6266352,6266471,0,0,0,119
15836,6266400,6266452,6266523,0,0,52,123
15567,6200782,6233658,6266649,0,0,32876,65867
15837,6266641,6266641,6266691,0,0,0,50
15775,6258846,6260476,6266768,0,0,1630,7922
15810,6263531,6263531,6266826,0,0,0,3295
15838,6266823,6266826,6266880,0,0,3,57
15806,6262814,6262896,6266966,0,0,82,4152
15626,6238913,6260754,6266987,0,0,21841,28074
15841,6266990,6266990,6267067,0,0,0,77
15843,6267260,6267260,6267311,0,0,0,51
15711,6249865,6266987,6267426,0,0,17122,17561
15698,6247350,6266768,6267485,0,0,19418,20135
15722,6252846,6267426,6267537,0,0,14580,14691
15792,6261257,6265028,6267620,0,0,3771,6363
15845,6267618,6267618,6267668,0,0,0,50
15745,6255252,6264557,6267715,0,0,9305,12463
15741,6254712,6256607,6267782,0,0,1895,13070
15846,6267822,6267822,6267873,0,0,0,51
15721,6252725,6255326,6267934,0,0,2601,15209
15842,6267213,6267213,6267954,0,0,0,741
15725,6253169,6267485,6268035,0,0,14316,14866
15848,6268001,6268001,6268051,0,0,0,50
15740,6254680,6268035,6268212,0,0,13355,13532
15849,6268141,6268141,6268224,0,0,0,83
15847,6267945,6267945,6268306,0,0,0,361
15583,6234795,6241390,6268347,0,0,6595,33552
15851,6268372,6268372,6268422,0,0,0,50
15853,6268920,6268920,6268936,0,0,0,16
15854,6268944,6268944,6268959,0,0,0,15
15855,6268984,6268984,6269034,0,0,0,50
15744,6255151,6264190,6269096,0,0,9039,13945
15797,6261885,6265455,6269136,0,0,3570,7251
15856,6269160,6269160,6269213,0,0,0,53
15857,6269199,6269199,6269213,0,0,0,14
15754,6256244,6269096,6269321,0,0,12852,13077
15859,6269506,6269506,6269526,0,0,0,20
15858,6269423,6269423,6269565,0,0,0,142
15860,6269566,6269566,6269582,0,0,0,16
15861,6270096,6270096,6270156,0,0,0,60
15864,6270997,6270997,6271010,0,0,0,13
15863,6270920,6270920,6271296,0,0,0,376
15866,6271315,6271315,6271364,0,0,0,49
15755,6256341,6264694,6271531,0,0,8353,15190
15850,6268224,6268224,6271651,0,0,0,3427
15868,6271646,6271651,6271698,0,0,5,52
15867,6271547,6271651,6271701,0,0,104,154
15869,6271790,6271790,6271815,0,0,0,25
15870,6271845,6271845,6271893,0,0,0,48
15872,6271966,6271966,6272013,0,0,0,47
15735,6254468,6267715,6272106,0,0,13247,17638
15873,6272108,6272108,6272121,0,0,0,13
15874,6272120,6272120,6272178,0,0,0,58
15759,6256572,6271531,6272248,0,0,14959,15676
15875,6272144,6272144,6272278,0,0,0,134
15877,6272266,6272278,6272292,0,0,12,26
15878,6272479,6272479,6272493,0,0,0,14
15879,6272524,6272524,6272534,0,0,0,10
15776,6258893,6272106,6272632,0,0,13213,13739
15781,6259831,6272248,6272799,0,0,12417,12968
15880,6272859,6272859,6272876,0,0,0,17
15881,6273012,6273012,6273107,0,0,0,95
15882,6273193,6273193,6273218,0,0,0,25
15883,6273214,6273218,6273267,0,0,4,53
15884,6273411,6273411,6273466,0,0,0,55
15885,6273425,6273466,6273486,0,0,41,61
15886,6273574,6273574,6273639,0,0,0,65
15888,6273725,6273725,6273774,0,0,0,49
15889,6273855,6273855,6273904,0,0,0,49
15891,6273995,6273995,6274043,0,0,0,48
15758,6256463,6269321,6274181,0,0,12858,17718
15892,6274134,6274134,6274182,0,0,0,48
15831,6266232,6274181,6274202,0,0,7949,7970
15893,6274273,6274273,6274320,0,0,0,47
15894,6274401,6274401,6274452,0,0,0,51
15747,6255389,6268212,6274506,0,0,12823,19117
15895,6274559,6274559,6274607,0,0,0,48
15896,6274737,6274737,6274788,0,0,0,51
15897,6274853,6274853,6274913,0,0,0,60
15898,6274896,6274896,6274949,0,0,0,53
15865,6271018,6271018,6275007,0,0,0,3989
15890,6273959,6274202,6275251,0,0,243,1292
15900,6275025,6275251,6275304,0,0,226,279
15903,6275126,6275304,6275366,0,0,178,240
15904,6275154,6275366,6275425,0,0,212,271
15876,6272202,6272202,6275468,0,0,0,3266
15906,6275344,6275425,6275477,0,0,81,133
15907,6275471,6275471,6275527,0,0,0,56
15731,6254193,6267537,6277467,0,0,13344,23274
15908,6275541,6277467,6277514,0,0,1926,1973
15912,6276393,6277467,6277515,0,0,1074,1122
15909,6275778,6277467,6277520,0,0,1689,1742
15911,6276212,6277467,6277520,0,0,1255,1308
15917,6276953,6277520,6277546,0,0,567,593
15916,6276850,6277520,6277549,0,0,670,699
15913,6276569,6277514,6277571,0,0,945,1002
15914,6276698,6277515,6277576,0,0,817,878
15918,6277093,6277546,6277603,0,0,453,510
15922,6277781,6277781,6277828,0,0,0,47
15919,6277380,6277549,6277940,0,0,169,560
15901,6275060,6275527,6277977,0,0,467,2917
15923,6278030,6278030,6278081,0,0,0,51
15924,6278174,6278174,6278224,0,0,0,50
15921,6277620,6277940,6278249,0,0,320,629
15925,6278358,6278358,6278415,0,0,0,57
15927,6278562,6278562,6278597,0,0,0,35
15929,6278653,6278653,6278685,0,0,0,32
15899,6275020,6275251,6279197,0,0,231,4177
15920,6277543,6277576,6279844,0,0,33,2301
15585,6234966,6275007,6280508,0,0,40041,45542
15651,6241915,6280508,6281558,0,0,38593,39643
15830,6266218,6272799,6281927,0,0,6581,15709
15928,6278642,6278642,6282324,0,0,0,3682
15680,6245081,6265066,6282501,0,0,19985,37420
15821,6264694,6272632,6283284,0,0,7938,18590
15791,6261186,6261458,6283544,0,0,272,22358
15662,6242952,6281558,6283614,0,0,38606,40662
15934,6280393,6281927,6283715,0,0,1534,3322
15930,6279852,6279852,6283810,0,0,0,3958
15931,6279918,6279918,6283877,0,0,0,3959
15671,6243634,6264748,6285374,0,0,21114,41740
15699,6247468,6283544,6286812,0,0,36076,39344
15756,6256417,6286812,6287138,0,0,30395,30721
15942,6284377,6284377,6287268,0,0,0,2891
15761,6256941,6287138,6287286,0,0,30197,30345
15764,6257318,6287286,6287415,0,0,29968,30097
15769,6258133,6287415,6287507,0,0,29282,29374
15772,6258702,6287507,6287802,0,0,28805,29100
15789,6260993,6287802,6287866,0,0,26809,26873
15947,6287821,6287821,6287914,0,0,0,93
15933,6280376,6280376,6287927,0,0,0,7551
15796,6261766,6287866,6288025,0,0,26100,26259
15715,6251222,6283614,6288027,0,0,32392,36805
15799,6262026,6287927,6288238,0,0,25901,26212
15832,6266272,6288027,6289101,0,0,21755,22829
15902,6275082,6289101,6289655,0,0,14019,14573
15935,6281021,6282501,6290042,0,0,1480,9021
15948,6287969,6287969,6290156,0,0,0,2187
15950,6289465,6290042,6290190,0,0,577,725
15953,6290168,6290168,6290291,0,0,0,123
15812,6263652,6288025,6290631,0,0,24373,26979
15936,6281386,6290631,6290703,0,0,9245,9317
15910,6276159,6289655,6290706,0,0,13496,14547
15941,6283733,6283733,6290913,0,0,0,7180
15944,6285779,6290706,6291705,0,0,4927,5926
15954,6290784,6290784,6292726,0,0,0,1942
15844,6267354,6288238,6294464,0,0,20884,27110
15937,6281756,6290703,6294767,0,0,8947,13011
15525,6176779,6292726,6294849,0,0,115947,118070
15958,6294315,6294767,6294891,0,0,452,576
15542,6187551,6294849,6294937,0,0,107298,107386
15957,6293161,6294464,6296224,0,0,1303,3063
15617,6238203,6294937,6296707,0,0,56734,58504
15635,6239997,6296707,6296731,0,0,56710,56734
15633,6239976,6296224,6298113,0,0,56248,58137
15650,6241868,6296731,6298725,0,0,54863,56857
15670,6243593,6298725,6302447,0,0,55132,58854
15672,6243857,6302447,6304662,0,0,58590,60805
15701,6247924,6304662,6306197,0,0,56738,58273
15710,6249792,6306197,6308335,0,0,56405,58543
15717,6251902,6308335,6310529,0,0,56433,58627
15730,6254148,6310529,6310558,0,0,56381,56410
15732,6254232,6310558,6310694,0,0,56326,56462
15734,6254370,6310694,6312714,0,0,56324,58344
15765,6257760,6312714,6314580,0,0,54954,56820
15779,6259634,6314580,6316571,0,0,54946,56937
15780,6259691,6316571,6316631,0,0,56880,56940
15793,6261627,6316631,6318420,0,0,55004,56793
15809,6263431,6318420,6320147,0,0,54989,56716
15824,6265160,6320147,6321880,0,0,54987,56720
15653,6242401,6298113,6323315,0,0,55712,80914
15840,6266955,6323315,6323347,0,0,56360,56392
15839,6266896,6321880,6323528,0,0,54984,56632
15852,6268547,6323347,6324986,0,0,54800,56439
15862,6270188,6323528,6325249,0,0,53340,55061
15871,6271909,6324986,6326667,0,0,53077,54758
15887,6273595,6325249,6326915,0,0,51654,53320
15905,6275263,6326667,6328249,0,0,51404,52986
15915,6276840,6326915,6328554,0,0,50075,51714
15926,6278490,6328249,6329865,0,0,49759,51375
15932,6280109,6328554,6330214,0,0,48445,50105
15938,6281773,6329865,6331432,0,0,48092,49659
15940,6283340,6331432,6333031,0,0,48092,49691
15943,6284942,6333031,6334724,0,0,48089,49782
15945,6286281,6334724,6336513,0,0,48443,50232
15946,6286639,6336513,6338115,0,0,49874,51476
15949,6288245,6338115,6339775,0,0,49870,51530
15951,6289908,6339775,6341379,0,0,49867,51471
15952,6289966,6341379,6341439,0,0,51413,51473
15939,6281969,6330214,6341775,0,0,48245,59806
15955,6291515,6341439,6343072,0,0,49924,51557
15956,6293152,6341775,6343345,0,0,48623,50193
15959,6294724,6343072,6344699,0,0,48348,49975
15960,6296355,6343345,6344922,0,0,46990,48567
15961,6297935,6344699,6346269,0,0,46764,48334
15962,6299509,6344922,6346553,0,0,45413,47044
15963,6301144,6346269,6347852,0,0,45125,46708
15964,6302729,6346553,6348223,0,0,43824,45494
15965,6304402,6347852,6349420,0,0,43450,45018
15968,6306546,6349420,6349671,0,0,42874,43125
15966,6305972,6348223,6349838,0,0,42251,43866
15972,6310322,6349420,6350036,0,0,39098,39714
15974,6311040,6349671,6350622,0,0,38631,39582
15970,6307590,6349838,6351395,0,0,42248,43805
15978,6313599,6350036,6351493,0,0,36437,37894
15979,6313756,6350622,6351840,0,0,36866,38084
15969,6307166,6349420,6352645,0,0,42254,45479
15971,6309150,6351395,6352965,0,0,42245,43815
15975,6312635,6352645,6353489,0,0,40010,40854
15976,6313492,6353489,6353492,0,0,39997,40000
15977,6313594,6353492,6353494,0,0,39898,39900
15980,6314123,6353494,6354242,0,0,39371,40119
15973,6310723,6352965,6354369,0,0,42242,43646
15982,6314968,6354369,6354406,0,0,39401,39438
15990,6317145,6354406,6354418,0,0,37261,37273
15993,6318036,6354406,6354443,0,0,36370,36407
15997,6318525,6354406,6354536,0,0,35881,36011
15994,6318110,6354406,6354545,0,0,36296,36435
15987,6316304,6354369,6354550,0,0,38065,38246
15988,6316807,6354369,6354550,0,0,37562,37743
15984,6315514,6351840,6354660,0,0,36326,39146
15999,6318863,6354536,6354664,0,0,35673,35801
16004,6319330,6354550,6354724,0,0,35220,35394
15967,6306471,6349420,6354825,0,0,42949,48354
16001,6319012,6354550,6354828,0,0,35538,35816
16010,6320584,6354828,6354894,0,0,34244,34310
16011,6320771,6354894,6354911,0,0,34123,34140
16007,6319794,6354825,6354962,0,0,35031,35168
16012,6320781,6354911,6355000,0,0,34130,34219
16005,6319466,6354664,6355031,0,0,35198,35565
16014,6321067,6355000,6355071,0,0,33933,34004
16009,6320244,6354825,6355093,0,0,34581,34849
16016,6321320,6355071,6355152,0,0,33751,33832
16018,6321688,6355093,6355165,0,0,33405,33477
16019,6321824,6355152,6355188,0,0,33328,33364
16022,6322156,6355188,6355225,0,0,33032,33069
16008,6320069,6354825,6355255,0,0,34756,35186
16015,6321203,6355031,6355287,0,0,33828,34084
15996,6318448,6354418,6355295,0,0,35970,36847
16024,6322470,6355287,6355344,0,0,32817,32874
16026,6322667,6355344,6355407,0,0,32677,32740
15986,6316021,6354369,6355471,0,0,38348,39450
15995,6318359,6354418,6355473,0,0,36059,37114
16030,6323090,6355473,6355490,0,0,32383,32400
16032,6323282,6355490,6355508,0,0,32208,32226
16029,6322962,6355471,6355524,0,0,32509,32562
16033,6323433,6355508,6355529,0,0,32075,32096
16035,6323569,6355529,6355546,0,0,31960,31977
16021,6322104,6355255,6355549,0,0,33151,33445
16027,6322871,6355407,6355553,0,0,32536,32682
16038,6323813,6355546,6355570,0,0,31733,31757
16013,6320836,6354962,6355594,0,0,34126,34758
16041,6324105,6355570,6355596,0,0,31465,31491
16042,6324275,6355594,6355613,0,0,31319,31338
16044,6324426,6355596,6355621,0,0,31170,31195
16046,6324609,6355621,6355644,0,0,31012,31035
15991,6317384,6354369,6355779,0,0,36985,38395
16040,6324057,6355553,6355841,0,0,31496,31784
16049,6324918,6355841,6355869,0,0,30923,30951
16050,6325112,6355869,6355888,0,0,30757,30776
16051,6325284,6355888,6355906,0,0,30604,30622
16037,6323786,6355779,6355995,0,0,31993,32209
16056,6325627,6355995,6356017,0,0,30368,30390
16053,6325519,6355906,6356021,0,0,30387,30502
16058,6325806,6356021,6356039,0,0,30215,30233
16059,6325979,6356039,6356067,0,0,30060,30088
16061,6326014,6356067,6356085,0,0,30053,30071
16002,6319105,6354660,6356125,0,0,35555,37020
16020,6321955,6355165,6356183,0,0,33210,34228
15998,6318644,6354443,6356219,0,0,35799,37575
16045,6324574,6355613,6356229,0,0,31039,31655
16065,6326263,6356183,6356231,0,0,29920,29968
16066,6326281,6356219,6356237,0,0,29938,29956
16063,6326178,6356085,6356255,0,0,29907,30077
16070,6326499,6356237,6356259,0,0,29738,29760
16072,6326564,6356259,6356280,0,0,29695,29716
16073,6326579,6356280,6356298,0,0,29701,29719
16074,6326602,6356298,6356315,0,0,29696,29713
16075,6326625,6356315,6356339,0,0,29690,29714
16071,6326529,6356255,6356346,0,0,29726,29817
16068,6326373,6356229,6356507,0,0,29856,30134
16079,6326823,6356507,6356528,0,0,29684,29705
16080,6326856,6356528,6356542,0,0,29672,29686
16081,6326953,6356542,6356557,0,0,29589,29604
16082,6327003,6356557,6356567,0,0,29554,29564
16084,6327197,6356567,6356605,0,0,29370,29408
16086,6327259,6356605,6356723,0,0,29346,29464
16077,6326669,6356339,6356817,0,0,29670,30148
16087,6327451,6356723,6356823,0,0,29272,29372
16089,6327741,6356817,6356836,0,0,29076,29095
16090,6327770,6356823,6356842,0,0,29053,29072
16093,6327885,6356842,6356859,0,0,28957,28974
16094,6327958,6356859,6356903,0,0,28901,28945
16091,6327778,6356836,6356924,0,0,29058,29146
16095,6328017,6356903,6356931,0,0,28886,28914
16096,6328072,6356924,6356937,0,0,28852,28865
16100,6328325,6356937,6356963,0,0,28612,28638
16101,6328361,6356963,6356979,0,0,28602,28618
16036,6323617,6355549,6357022,0,0,31932,33405
16102,6328605,6356979,6357050,0,0,28374,28445
16103,6328682,6357050,6357141,0,0,28368,28459
16105,6328875,6357141,6357176,0,0,28266,28301
16099,6328179,6356931,6357298,0,0,28752,29119
16057,6325699,6356017,6357323,0,0,30318,31624
16108,6329581,6357323,6357362,0,0,27742,27781
16109,6329749,6357362,6357409,0,0,27613,27660
16034,6323481,6355524,6357473,0,0,32043,33992
16111,6330131,6357473,6357507,0,0,27342,27376
16110,6329971,6357409,6357513,0,0,27438,27542
16114,6330891,6357513,6357539,0,0,26622,26648
16112,6330243,6357507,6357581,0,0,27264,27338
16023,6322268,6355225,6357609,0,0,32957,35341
16115,6330925,6357539,6357614,0,0,26614,26689
16106,6328947,6357176,6357800,0,0,28229,28853
16028,6322918,6355471,6357984,0,0,32553,35066
16006,6319619,6354724,6357987,0,0,35105,38368
16133,6341800,6357987,6358078,0,0,16187,16278
16055,6325558,6356125,6358092,0,0,30567,32534
16025,6322589,6355295,6358539,0,0,32706,35950
16069,6326397,6356231,6358695,0,0,29834,32298
16054,6325548,6355995,6359015,0,0,30447,33467
16136,6344706,6358695,6359059,0,0,13989,14353
16048,6324865,6355644,6359193,0,0,30779,34328
16123,6332079,6357800,6359656,0,0,25721,27577
15985,6315991,6354369,6359699,0,0,38378,43708
15983,6315074,6351493,6360007,0,0,36419,44933
15992,6317660,6354406,6360182,0,0,36746,42522
16145,6345781,6360182,6360201,0,0,14401,14420
16137,6344752,6359015,6360495,0,0,14263,15743
16085,6327226,6360007,6360611,0,0,32781,33385
16113,6330798,6360611,6360669,0,0,29813,29871
16116,6330959,6360669,6360685,0,0,29710,29726
16117,6331146,6360685,6360699,0,0,29539,29553
16148,6346378,6360495,6360769,0,0,14117,14391
16150,6346804,6360769,6360822,0,0,13965,14018
16153,6347423,6360822,6360907,0,0,13399,13484
16000,6318969,6354545,6361006,0,0,35576,42037
16157,6348889,6361006,6361087,0,0,12117,12198
16158,6349737,6361087,6361200,0,0,11350,11463
16146,6345814,6360201,6361982,0,0,14387,16168
16167,6352322,6361982,6362066,0,0,9660,9744
16168,6352514,6362066,6362501,0,0,9552,9987
16143,6345254,6359699,6362579,0,0,14445,17325
16141,6345140,6359193,6362685,0,0,14053,17545
16170,6353949,6362579,6362700,0,0,8630,8751
16171,6355161,6362685,6362703,0,0,7524,7542
16173,6356068,6362703,6362715,0,0,6635,6647
16172,6355841,6362700,6362718,0,0,6859,6877
16174,6356319,6362715,6362728,0,0,6396,6409
16175,6356591,6362718,6362731,0,0,6127,6140
16176,6356990,6362728,6362753,0,0,5738,5763
16179,6358807,6362731,6362792,0,0,3924,3985
16169,6353758,6362501,6362818,0,0,8743,9060
16180,6359690,6362753,6362848,0,0,3063,3158
16184,6362313,6362792,6362863,0,0,479,550
16067,6326359,6358539,6363351,0,0,32180,36992
16159,6350324,6363351,6363373,0,0,13027,13049
16160,6350506,6363373,6363390,0,0,12867,12884
16162,6350773,6363390,6363401,0,0,12617,12628
16163,6350943,6363401,6363413,0,0,12458,12470
16161,6350540,6361200,6363651,0,0,10660,13111
16164,6350979,6363413,6364038,0,0,12434,13059
16181,6359738,6364038,6364083,0,0,4300,4345
16132,6338169,6357984,6364839,0,0,19815,26670
16182,6360543,6364083,6365033,0,0,3540,4490
16165,6351057,6363651,6365193,0,0,12594,14136
16039,6323881,6365193,6365335,0,0,41312,41454
16043,6324382,6365335,6365472,0,0,40953,41090
16047,6324789,6365472,6365508,0,0,40683,40719
16139,6344796,6359059,6365584,0,0,14263,20788
16052,6325515,6365508,6365597,0,0,39993,40082
16060,6326001,6365597,6365622,0,0,39596,39621
15981,6314955,6354242,6365785,0,0,39287,50830
15989,6316821,6354369,6366163,0,0,37548,49342
16076,6326647,6365622,6366198,0,0,38975,39551
16142,6345176,6359656,6366384,0,0,14480,21208
16092,6327831,6366198,6366799,0,0,38367,38968
16135,6344687,6362848,6367029,0,0,18161,22342
16134,6344117,6358078,6367130,0,0,13961,23013
16104,6328817,6366799,6367395,0,0,37982,38578
16154,6347842,6360907,6368544,0,0,13065,20702
16124,6332274,6368544,6368916,0,0,36270,36642
16088,6327612,6365785,6369009,0,0,38173,41397
16122,6331817,6367395,6369747,0,0,35578,37930
16127,6334316,6369009,6369821,0,0,34693,35505
16125,6333352,6368916,6369879,0,0,35564,36527
16130,6336008,6369879,6370113,0,0,33871,34105
16128,6335064,6369747,6370412,0,0,34683,35348
16131,6336090,6370113,6370448,0,0,34023,34358
16121,6331647,6357614,6370735,0,0,25967,39088
16120,6331602,6357609,6370776,0,0,26007,39174
16119,6331220,6357581,6371056,0,0,26361,39836
16107,6329042,6357298,6373023,0,0,28256,43981
16147,6345908,6370448,6373562,0,0,24540,27654
16118,6331163,6360699,6374173,0,0,29536,43010
16097,6328099,6366384,6374221,0,0,38285,46122
16187,6374003,6374173,6374289,0,0,170,286
16186,6373407,6374173,6374301,0,0,766,894
16078,6326696,6356346,6374417,0,0,29650,47721
16189,6374751,6374751,6374774,0,0,0,23
16083,6327080,6365785,6374836,0,0,38705,47756
16188,6374480,6374480,6375111,0,0,0,631
16191,6375298,6375298,6375421,0,0,0,123
16192,6375422,6375422,6375455,0,0,0,33
16062,6326106,6357022,6375555,0,0,30916,49449
16064,6326196,6358092,6376534,0,0,31896,50338
16138,6344776,6370412,6376582,0,0,25636,31806
16193,6376849,6376849,6376892,0,0,0,43
16031,6323219,6355473,6376941,0,0,32254,53722
16126,6333827,6376941,6377777,0,0,43114,43950
16129,6335969,6369821,6378414,0,0,33852,42445
16194,6378736,6378736,6378757,0,0,0,21
16156,6348513,6377777,6379005,0,0,29264,30492
16195,6380105,6380105,6380168,0,0,0,63
16196,6380693,6380693,6380713,0,0,0,20
16197,6381745,6381745,6381766,0,0,0,21
16155,6348002,6373562,6383635,0,0,25560,35633
16178,6358079,6374836,6384839,0,0,16757,26760
16166,6351331,6374221,6385275,0,0,22890,33944
16190,6374966,6375555,6385912,0,0,589,10946
16177,6357011,6379005,6386667,0,0,21994,29656
16003,6319155,6386667,6387249,0,0,67512,68094
16185,6362974,6383635,6388227,0,0,20661,25253
16151,6347084,6373023,6388323,0,0,25939,41239
16017,6321675,6387249,6390058,0,0,65574,68383
16140,6345091,6390058,6390067,0,0,44967,44976
16144,6345517,6390067,6390553,0,0,44550,45036
16149,6346387,6390553,6391421,0,0,44166,45034
16098,6328145,6388323,6403841,0,0,60178,75696
16152,6347417,6391421,6404952,0,0,44004,57535
16183,6361327,6403841,6405871,0,0,42514,44544
16198,6398284,6404952,6406480,0,0,6668,8196
16203,6403032,6406480,6406518,0,0,3448,3486
16201,6402452,6404952,6407772,0,0,2500,5320
16206,6404594,6407772,6408173,0,0,3178,3579
16205,6404381,6407772,6408963,0,0,3391,4582
16210,6408712,6408712,6409268,0,0,0,556
16208,6406551,6409268,6410158,0,0,2717,3607
16202,6403020,6406480,6410490,0,0,3460,7470
16204,6403091,6406518,6410518,0,0,3427,7427
16207,6406504,6407772,6415611,0,0,1268,9107
16199,6400150,6404952,6416750,0,0,4802,16600
16217,6416453,6416453,6417081,0,0,0,628
16200,6401100,6405871,6417317,0,0,4771,16217
16213,6413323,6415611,6417675,0,0,2288,4352
16219,6417478,6417478,6417949,0,0,0,471
16209,6407257,6410158,6418694,0,0,2901,11437
16211,6412613,6412613,6419197,0,0,0,6584
16220,6418357,6418357,6419413,0,0,0,1056
16212,6412648,6412648,6419414,0,0,0,6766
16222,6419010,6419010,6419779,0,0,0,769
16226,6420325,6420325,6420623,0,0,0,298
16225,6420250,6420250,6421181,0,0,0,931
16229,6421330,6421330,6421346,0,0,0,16
16223,6419252,6419252,6421481,0,0,0,2229
16230,6421396,6421396,6421553,0,0,0,157
16233,6422027,6422027,6422113,0,0,0,86
16234,6422164,6422164,6422313,0,0,0,149
16232,6421892,6421892,6422456,0,0,0,564
16214,6414280,6416750,6422617,0,0,2470,8337
16239,6423282,6423282,6423324,0,0,0,42
16240,6423412,6423412,6423477,0,0,0,65
16237,6422884,6422884,6423727,0,0,0,843
16231,6421565,6421565,6424215,0,0,0,2650
16216,6415797,6417317,6424222,0,0,1520,8425
16215,6414526,6417317,6424283,0,0,2791,9757
16238,6423077,6424222,6424660,0,0,1145,1583
16241,6424148,6424283,6424799,0,0,135,651
16235,6422488,6422488,6425051,0,0,0,2563
16243,6424622,6424660,6425096,0,0,38,474
16224,6420081,6420081,6425990,0,0,0,5909
16227,6420532,6420532,6426111,0,0,0,5579
16244,6425329,6426111,6426442,0,0,782,1113
16245,6425616,6426442,6426832,0,0,826,1216
16218,6417049,6425096,6426835,0,0,8047,9786
16221,6418945,6426835,6427368,0,0,7890,8423
16248,6427331,6427331,6427621,0,0,0,290
16236,6422708,6422708,6427816,0,0,0,5108
16242,6424234,6424234,6428627,0,0,0,4393
16251,6429523,6429523,6429545,0,0,0,22
16250,6427821,6427821,6431253,0,0,0,3432
16249,6427525,6427621,6431454,0,0,96,3929
16228,6420909,6420909,6433033,0,0,0,12124
16247,6426904,6433033,6458179,0,0,6129,31275
16256,6435838,6458179,6458198,0,0,22341,22360
16258,6436004,6458198,6458544,0,0,22194,22540
16262,6444757,6458198,6458632,0,0,13441,13875
16252,6434249,6458179,6460728,0,0,23930,26479
16260,6436550,6460728,6460915,0,0,24178,24365
16265,6454759,6458198,6463284,0,0,3439,8525
16261,6438242,6460915,6463859,0,0,22673,25617
16263,6445394,6463859,6466681,0,0,18465,21287
16266,6499044,6499044,6499172,0,0,0,128
16267,6499329,6499329,6499428,0,0,0,99
16268,6499611,6499611,6499708,0,0,0,97
16269,6499942,6499942,6500042,0,0,0,100
16270,6500158,6500158,6500256,0,0,0,98
16271,6500359,6500359,6500456,0,0,0,97
16246,6426854,6427368,6509440,0,0,514,82586
16272,6507561,6507561,6517535,0,0,0,9974
16275,6515156,6517535,6517555,0,0,2379,2399
16276,6515928,6517555,6517673,0,0,1627,1745
16277,6516972,6517673,6517802,0,0,701,830
16278,6517676,6517802,6517861,0,0,126,185
16279,6517724,6517861,6517942,0,0,137,218
16273,6512896,6512896,6519922,0,0,0,7026
16274,6513586,6519922,6519965,0,0,6336,6379
16254,6434489,6509440,6520767,0,0,74951,86278
16281,6523598,6523598,6523621,0,0,0,23
16264,6454510,6520767,6523728,0,0,66257,69218
16282,6524181,6524181,6525484,0,0,0,1303
16280,6519924,6519965,6527011,0,0,41,7087
16288,6527266,6527266,6527789,0,0,0,523
16283,6524258,6524258,6528022,0,0,0,3764
16290,6528105,6528105,6528159,0,0,0,54
16291,6528886,6528886,6529478,0,0,0,592
16289,6528083,6528083,6529638,0,0,0,1555
16293,6529769,6529769,6530682,0,0,0,913
16292,6529729,6529729,6531192,0,0,0,1463
16259,6436135,6458179,6531209,0,0,22044,95074
16257,6435946,6458179,6531398,0,0,22233,95452
16255,6435710,6458179,6531783,0,0,22469,96073
16295,6532397,6532397,6532447,0,0,0,50
16253,6434335,6458179,6533010,0,0,23844,98675
16296,6533484,6533484,6533604,0,0,0,120
16286,6526972,6526972,6534002,0,0,0,7030
16299,6534595,6534595,6534625,0,0,0,30
16284,6524469,6524469,6534888,0,0,0,10419
16301,6537073,6537073,6537104,0,0,0,31
16302,6537935,6537935,6537972,0,0,0,37
16294,6531268,6531268,6539551,0,0,0,8283
16298,6534539,6534539,6540536,0,0,0,5997
16304,6540838,6540838,6540861,0,0,0,23
16297,6534004,6534004,6541036,0,0,0,7032
16303,6540749,6540749,6541167,0,0,0,418
16287,6527260,6527260,6541649,0,0,0,14389
16309,6541925,6541925,6542363,0,0,0,438
16310,6542027,6542027,6542815,0,0,0,788
16300,6534887,6534887,6544836,0,0,0,9949
16307,6541257,6541257,6545203,0,0,0,3946
16312,6545374,6545374,6545550,0,0,0,176
16313,6545757,6545757,6545929,0,0,0,172
16314,6547489,6547489,6547865,0,0,0,376
16306,6541036,6541036,6548073,0,0,0,7037
16305,6540973,6540973,6548268,0,0,0,7295
16315,6547947,6547947,6548610,0,0,0,663
16317,6550001,6550001,6550039,0,0,0,38
16316,6548628,6548628,6552083,0,0,0,3455
16318,6552611,6552611,6552639,0,0,0,28
16319,6553374,6553374,6553400,0,0,0,26
16311,6544840,6544840,6554743,0,0,0,9903
16308,6541586,6541586,6555961,0,0,0,14375
16320,6554744,6554744,6564935,0,0,0,10191
16323,6569374,6569374,6569415,0,0,0,41
16325,6569648,6569648,6569741,0,0,0,93
16326,6569766,6569766,6569976,0,0,0,210
16330,6572282,6572282,6573056,0,0,0,774
16285,6525541,6525541,6573771,0,0,0,48230
16328,6570980,6573771,6574151,0,0,2791,3171
16327,6569991,6569991,6574536,0,0,0,4545
16322,6564936,6564936,6574890,0,0,0,9954
16332,6575727,6575727,6575759,0,0,0,32
16329,6571458,6574151,6576418,0,0,2693,4960
16338,6577317,6577317,6577616,0,0,0,299
16321,6563258,6563258,6577678,0,0,0,14420
16340,6577800,6577800,6577932,0,0,0,132
16341,6577965,6577965,6578023,0,0,0,58
16335,6576464,6577678,6578034,0,0,1214,1570
16342,6578052,6578052,6578096,0,0,0,44
16336,6576613,6577678,6578155,0,0,1065,1542
16337,6576928,6578034,6578364,0,0,1106,1436
16331,6574266,6574266,6578819,0,0,0,4553
16345,6578277,6578819,6578896,0,0,542,619
16346,6578615,6578896,6578936,0,0,281,321
16324,6569498,6569498,6589274,0,0,0,19776
16352,6584474,6589274,6589313,0,0,4800,4839
16333,6576437,6576437,6589360,0,0,0,12923
16349,6579391,6589274,6589375,0,0,9883,9984
16334,6576450,6576450,6589494,0,0,0,13044
16344,6578265,6578265,6589571,0,0,0,11306
16343,6578172,6578364,6589685,0,0,192,11513
16347,6578667,6578936,6589914,0,0,269,11247
16355,6589617,6589617,6589943,0,0,0,326
16357,6590000,6590000,6590093,0,0,0,93
16339,6577531,6578155,6590101,0,0,624,12570
16358,6590218,6590218,6590302,0,0,0,84
16359,6590317,6590317,6590387,0,0,0,70
16360,6590410,6590410,6590433,0,0,0,23
16361,6590438,6590438,6590523,0,0,0,85
16362,6590520,6590520,6590543,0,0,0,23
16363,6590641,6590641,6590677,0,0,0,36
16351,6582743,6589360,6590706,0,0,6617,7963
16364,6590897,6590897,6590932,0,0,0,35
16366,6590941,6590941,6591020,0,0,0,79
16356,6589715,6589715,6591041,0,0,0,1326
16367,6591064,6591064,6591151,0,0,0,87
16369,6591131,6591131,6591160,0,0,0,29
16371,6591165,6591165,6591210,0,0,0,45
16374,6591380,6591380,6591400,0,0,0,20
16368,6591097,6591097,6591418,0,0,0,321
16375,6591427,6591427,6591504,0,0,0,77
16376,6591441,6591441,6591606,0,0,0,165
16365,6590922,6590922,6591619,0,0,0,697
16377,6591571,6591571,6591647,0,0,0,76
16370,6591153,6591153,6591710,0,0,0,557
16372,6591172,6591710,6591746,0,0,538,574
16380,6591987,6591987,6592026,0,0,0,39
16379,6591714,6591714,6592218,0,0,0,504
16381,6592026,6592026,6592234,0,0,0,208
16353,6586544,6589274,6592268,0,0,2730,5724
16382,6592053,6592234,6592271,0,0,181,218
16378,6591592,6591592,6592628,0,0,0,1036
16373,6591304,6591304,6592734,0,0,0,1430
16386,6592762,6592762,6592820,0,0,0,58
16388,6592881,6592881,6592912,0,0,0,31
16389,6592920,6592920,6593033,0,0,0,113
16390,6593054,6593054,6593186,0,0,0,132
16387,6592779,6592779,6593226,0,0,0,447
16350,6582685,6589274,6593257,0,0,6589,10572
16396,6593548,6593548,6593700,0,0,0,152
16398,6593619,6593700,6594485,0,0,81,866
16394,6593125,6593257,6595022,0,0,132,1897
16400,6593740,6595022,6595084,0,0,1282,1344
16401,6593825,6595022,6595116,0,0,1197,1291
16399,6593704,6594485,6595134,0,0,781,1430
16402,6593855,6595022,6595138,0,0,1167,1283
16405,6594220,6595022,6595159,0,0,802,939
16383,6592311,6592311,6595508,0,0,0,3197
16406,6594290,6595022,6595709,0,0,732,1419
16407,6594437,6595116,6595788,0,0,679,1351
16410,6595385,6595709,6595922,0,0,324,537
16412,6595716,6595788,6595923,0,0,72,207
16397,6593612,6593612,6595925,0,0,0,2313
16384,6592409,6592409,6595926,0,0,0,3517
16413,6595836,6595923,6595933,0,0,87,97
16414,6595851,6595926,6595933,0,0,75,82
16415,6595867,6595933,6595940,0,0,66,73
16416,6595880,6595933,6595942,0,0,53,62
16417,6595893,6595940,6595947,0,0,47,54
16418,6595906,6595942,6595951,0,0,36,45
16408,6594940,6595159,6595975,0,0,219,1035
16422,6596067,6596067,6596152,0,0,0,85
16421,6596019,6596019,6596194,0,0,0,175
16423,6596161,6596161,6596203,0,0,0,42
16404,6594195,6595022,6596405,0,0,827,2210
16424,6596508,6596508,6596644,0,0,0,136
16427,6596604,6596604,6596663,0,0,0,59
16385,6592755,6592755,6596684,0,0,0,3929
16426,6596562,6596644,6596710,0,0,82,148
16420,6596013,6596013,6596759,0,0,0,746
16430,6596809,6596809,6596994,0,0,0,185
16425,6596543,6596543,6597054,0,0,0,511
16432,6596966,6596994,6597105,0,0,28,139
16433,6597194,6597194,6597361,0,0,0,167
16434,6597205,6597205,6597474,0,0,0,269
16435,6597483,6597483,6597616,0,0,0,133
16429,6596769,6596769,6597651,0,0,0,882
16436,6597620,6597620,6597700,0,0,0,80
16391,6593061,6593061,6597763,0,0,0,4702
16393,6593077,6593077,6597901,0,0,0,4824
16403,6593953,6595022,6597960,0,0,1069,4007
16441,6597999,6597999,6598117,0,0,0,118
16443,6598126,6598126,6598355,0,0,0,229
16446,6598404,6598404,6598497,0,0,0,93
16445,6598181,6598181,6598635,0,0,0,454
16440,6597949,6597949,6598644,0,0,0,695
16448,6598599,6598635,6598701,0,0,36,102
16451,6598696,6598696,6598788,0,0,0,92
16450,6598680,6598680,6598807,0,0,0,127
16452,6598818,6598818,6598921,0,0,0,103
16442,6598118,6598118,6599243,0,0,0,1125
16444,6598137,6598137,6599368,0,0,0,1231
16395,6593274,6595022,6599593,0,0,1748,6319
16354,6589446,6589446,6599644,0,0,0,10198
16460,6599619,6599644,6599716,0,0,25,97
16453,6598908,6598908,6599747,0,0,0,839
16348,6578822,6589274,6600019,0,0,10452,21197
16462,6599788,6600019,6600341,0,0,231,553
16461,6599734,6599734,6600379,0,0,0,645
16457,6599141,6599368,6600390,0,0,227,1249
16463,6599800,6600341,6600406,0,0,541,606
16467,6600235,6600390,6600499,0,0,155,264
16468,6600248,6600406,6600499,0,0,158,251
16471,6600488,6600499,6600531,0,0,11,43
16469,6600449,6600499,6600575,0,0,50,126
16458,6599407,6600575,6600678,0,0,1168,1271
16464,6599806,6600379,6600685,0,0,573,879
16454,6598957,6599747,6600809,0,0,790,1852
16465,6600100,6600809,6600882,0,0,709,782
16472,6600594,6600685,6600945,0,0,91,351
16459,6599410,6600678,6601050,0,0,1268,1640
16470,6600456,6601050,6601264,0,0,594,808
16473,6600876,6600945,6601304,0,0,69,428
16475,6600965,6601304,6601355,0,0,339,390
16476,6600981,6601355,6601572,0,0,374,591
16439,6597846,6599593,6601664,0,0,1747,3818
16478,6601366,6601572,6601797,0,0,206,431
16483,6601724,6601724,6601877,0,0,0,153
16456,6599044,6599243,6602093,0,0,199,3049
16487,6602105,6602105,6602115,0,0,0,10
16480,6601498,6601664,6602425,0,0,166,927
16489,6602334,6602334,6602467,0,0,0,133
16455,6598972,6598972,6602482,0,0,0,3510
16484,6601990,6601990,6602557,0,0,0,567
16490,6602418,6602425,6602589,0,0,7,171
16493,6602653,6602653,6602820,0,0,0,167
16494,6602680,6602680,6602969,0,0,0,289
16491,6602501,6602501,6603012,0,0,0,511
16481,6601624,6601664,6603066,0,0,40,1442
16486,6602099,6603066,6603077,0,0,967,978
16474,6600951,6601264,6603185,0,0,313,2234
16496,6603231,6603231,6603379,0,0,0,148
16488,6602151,6603077,6603529,0,0,926,1378
16411,6595574,6595574,6603587,0,0,0,8013
16497,6603611,6603611,6603836,0,0,0,225
16479,6601456,6601664,6603839,0,0,208,2383
16447,6598468,6598497,6603861,0,0,29,5393
16419,6595913,6595947,6604024,0,0,34,8111
16482,6601649,6601664,6604268,0,0,15,2619
16485,6602055,6602055,6604385,0,0,0,2330
16502,6604369,6604369,6604444,0,0,0,75
16492,6602603,6603529,6604461,0,0,926,1858
16503,6604477,6604477,6604661,0,0,0,184
16466,6600168,6600882,6604855,0,0,714,4687
16504,6604686,6604686,6604877,0,0,0,191
16506,6604898,6604898,6604988,0,0,0,90
16499,6603818,6603836,6605287,0,0,18,1469
16507,6604995,6604995,6605591,0,0,0,596
16508,6605464,6605464,6605641,0,0,0,177
16511,6605728,6605728,6605853,0,0,0,125
16509,6605524,6605524,6606026,0,0,0,502
16498,6603723,6603723,6606374,0,0,0,2651
16516,6606303,6606303,6606393,0,0,0,90
16519,6606490,6606490,6606897,0,0,0,407
16505,6604755,6604755,6607253,0,0,0,2498
16524,6607069,6607253,6607300,0,0,184,231
16431,6596863,6596863,6607303,0,0,0,10440
16520,6606707,6606897,6607316,0,0,190,609
16515,6606275,6606275,6607400,0,0,0,1125
16523,6607013,6607253,6607454,0,0,240,441
16513,6606062,6606062,6607772,0,0,0,1710
16512,6606018,6606018,6607853,0,0,0,1835
16392,6593071,6593071,6607963,0,0,0,14892
16531,6607956,6607956,6608185,0,0,0,229
16527,6607319,6607319,6608271,0,0,0,952
16518,6606449,6606449,6608400,0,0,0,1951
16522,6606977,6607253,6608663,0,0,276,1686
16535,6608134,6608134,6608699,0,0,0,565
16537,6608503,6608503,6609009,0,0,0,506
16539,6609034,6609034,6609182,0,0,0,148
16501,6604076,6604076,6609324,0,0,0,5248
16541,6609264,6609264,6609399,0,0,0,135
16536,6608279,6608279,6609401,0,0,0,1122
16525,6607293,6607293,6609678,0,0,0,2385
16543,6609517,6609517,6609697,0,0,0,180
16540,6609040,6609399,6609779,0,0,359,739
16438,6597645,6597645,6610031,0,0,0,12386
16514,6606116,6606116,6610066,0,0,0,3950
16546,6610126,6610126,6610189,0,0,0,63
16521,6606947,6607253,6610233,0,0,306,3286
16533,6607998,6607998,6610397,0,0,0,2399
16548,6610424,6610424,6610469,0,0,0,45
16549,6610451,6610451,6610496,0,0,0,45
16550,6610597,6610597,6610652,0,0,0,55
16552,6610841,6610841,6610917,0,0,0,76
16544,6609547,6609779,6610922,0,0,232,1375
16538,6608725,6608725,6611166,0,0,0,2441
16555,6611348,6611348,6611424,0,0,0,76
16551,6610697,6610697,6611468,0,0,0,771
16558,6611532,6611532,6611630,0,0,0,98
16557,6611370,6611370,6611717,0,0,0,347
16556,6611358,6611358,6611796,0,0,0,438
16553,6611080,6611080,6612150,0,0,0,1070
16559,6612487,6612487,6612564,0,0,0,77
16560,6612640,6612640,6612668,0,0,0,28
16554,6611336,6611336,6612998,0,0,0,1662
16500,6603962,6604024,6613090,0,0,62,9128
16564,6613155,6613155,6613266,0,0,0,111
16561,6612956,6612956,6613289,0,0,0,333
16562,6612988,6612988,6613296,0,0,0,308
16566,6613274,6613274,6613334,0,0,0,60
16517,6606349,6606349,6613672,0,0,0,7323
16568,6613559,6613559,6614411,0,0,0,852
16569,6613738,6613738,6615277,0,0,0,1539
16570,6613746,6613746,6615292,0,0,0,1546
16530,6607952,6607952,6615765,0,0,0,7813
16534,6608067,6609009,6615962,0,0,942,7895
16574,6615348,6615348,6616084,0,0,0,736
16526,6607309,6607309,6616200,0,0,0,8891
16572,6614858,6615277,6616355,0,0,419,1497
16577,6616225,6616225,6617183,0,0,0,958
16578,6617190,6617190,6617230,0,0,0,40
16547,6610282,6610282,6617350,0,0,0,7068
16579,6617270,6617270,6617450,0,0,0,180
16563,6613004,6613004,6617574,0,0,0,4570
16567,6613380,6613380,6618095,0,0,0,4715
16565,6613165,6613165,6618167,0,0,0,5002
16581,6617987,6617987,6618182,0,0,0,195
16582,6618242,6618242,6618619,0,0,0,377
16583,6619050,6619050,6619090,0,0,0,40
16571,6614795,6614795,6619169,0,0,0,4374
16584,6619634,6619634,6620181,0,0,0,547
16588,6620435,6620435,6620455,0,0,0,20
16587,6620382,6620382,6620977,0,0,0,595
16590,6621780,6621780,6621843,0,0,0,63
16591,6622413,6622413,6622548,0,0,0,135
16575,6615822,6618167,6623470,0,0,2345,7648
16593,6623800,6623800,6623908,0,0,0,108
16586,6620218,6620218,6623981,0,0,0,3763
16573,6614942,6615962,6625069,0,0,1020,10127
16589,6621246,6621246,6625752,0,0,0,4506
16596,6626273,6626273,6626361,0,0,0,88
16576,6616205,6616205,6626546,0,0,0,10341
16580,6617546,6617546,6626824,0,0,0,9278
16585,6619815,6619815,6627302,0,0,0,7487
16598,6627591,6627591,6627650,0,0,0,59
16409,6595042,6626824,6628428,0,0,31782,33386
16428,6596649,6628428,6630081,0,0,31779,33432
16437,6597642,6630081,6631071,0,0,32439,33429
16449,6598606,6631071,6632769,0,0,32465,34163
16477,6601080,6632769,6633802,0,0,31689,32722
16600,6634961,6634961,6635030,0,0,0,69
16601,6636550,6636550,6636619,0,0,0,69
16495,6602885,6633802,6637286,0,0,30917,34401
16595,6625841,6625841,6637336,0,0,0,11495
16510,6605660,6637286,6638879,0,0,31626,33219
16528,6607588,6638879,6638922,0,0,31291,31334
16529,6607668,6638922,6638990,0,0,31254,31322
16532,6607964,6638990,6640628,0,0,31026,32664
16592,6623077,6623077,6641869,0,0,0,18792
16599,6631968,6637336,6651589,0,0,5368,19621
16605,6654906,6654906,6654965,0,0,0,59
16604,6654905,6654905,6654966,0,0,0,61
16606,6655085,6655085,6655147,0,0,0,62
16607,6655086,6655086,6655147,0,0,0,61
16608,6655147,6655147,6655266,0,0,0,119
16609,6655147,6655147,6655266,0,0,0,119
16611,6655266,6655266,6655325,0,0,0,59
16610,6655265,6655266,6655327,0,0,1,62
16612,6655325,6655325,6655387,0,0,0,62
16613,6655325,6655327,6655389,0,0,2,64
16615,6655387,6655387,6655506,0,0,0,119
16614,6655385,6655389,6655510,0,0,4,125
16617,6655506,6655506,6655565,0,0,0,59
16616,6655505,6655510,6655571,0,0,5,66
16618,6655565,6655565,6655626,0,0,0,61
16619,6655565,6655571,6655633,0,0,6,68
16620,6655626,6655626,6655747,0,0,0,121
16621,6655626,6655633,6655755,0,0,7,129
16622,6655747,6655747,6655805,0,0,0,58
16623,6655747,6655755,6655814,0,0,8,67
16624,6655805,6655805,6655866,0,0,0,61
16625,6655805,6655814,6655875,0,0,9,70
16626,6655866,6655866,6655986,0,0,0,120
16627,6655866,6655875,6655995,0,0,9,129
16629,6655986,6655986,6656047,0,0,0,61
16628,6655985,6655995,6656058,0,0,10,73
16634,6656106,6656106,6656166,0,0,0,60
16630,6656047,6656047,6656167,0,0,0,120
16631,6656047,6656058,6656178,0,0,11,131
16638,6656166,6656167,6656350,0,0,1,184
16635,6656106,6656166,6656411,0,0,60,305
16639,6656166,6656350,6656533,0,0,184,367
16642,6656348,6656533,6656591,0,0,185,243
16632,6656105,6656178,6656599,0,0,73,494
16643,6656348,6656591,6656649,0,0,243,301
16645,6656348,6656649,6656888,0,0,301,540
16640,6656166,6656411,6656892,0,0,245,726
16647,6656406,6656888,6656949,0,0,482,543
16648,6656406,6656892,6657072,0,0,486,666
16651,6656525,6656949,6657130,0,0,424,605
16633,6656105,6656599,6657141,0,0,494,1036
16542,6609355,6640628,6657203,0,0,31273,47848
16653,6656586,6657072,6657253,0,0,486,667
16636,6656165,6657141,6657326,0,0,976,1161
16659,6656766,6657253,6657372,0,0,487,606
16637,6656165,6657326,6657512,0,0,1161,1347
16660,6656885,6657372,6657552,0,0,487,667
16655,6656586,6657130,6657730,0,0,544,1144
16641,6656347,6657512,6657752,0,0,1165,1405
16644,6656348,6657752,6657811,0,0,1404,1463
16665,6657306,6657730,6657850,0,0,424,544
16646,6656405,6657811,6657873,0,0,1406,1468
16649,6656465,6657873,6657933,0,0,1408,1468
16666,6657426,6657850,6657974,0,0,424,548
16650,6656525,6657933,6657994,0,0,1408,1469
16669,6657550,6657974,6658089,0,0,424,539
16652,6656525,6657994,6658175,0,0,1469,1650
16670,6657665,6658089,6658272,0,0,424,607
16654,6656586,6658175,6658356,0,0,1589,1770
16673,6657848,6658272,6658390,0,0,424,542
16656,6656646,6658356,6658476,0,0,1710,1830
16674,6657965,6658390,6658511,0,0,425,546
16677,6658086,6658511,6658631,0,0,425,545
16678,6658266,6658631,6658752,0,0,365,486
16545,6609900,6657203,6658843,0,0,47303,48943
16657,6656647,6658476,6659014,0,0,1829,2367
16658,6656765,6659014,6659135,0,0,2249,2370
16661,6656885,6659135,6659315,0,0,2250,2430
16603,6650227,6650227,6664484,0,0,0,14257
16663,6657305,6664484,6664605,0,0,7179,7300
16667,6657426,6664484,6664608,0,0,7058,7182
16668,6657547,6664605,6664724,0,0,7058,7177
16671,6657665,6664608,6664791,0,0,6943,7126
16672,6657847,6664724,6664843,0,0,6877,6996
16675,6657965,6664791,6664912,0,0,6826,6947
16676,6658085,6664843,6664964,0,0,6758,6879
16679,6658266,6664912,6665033,0,0,6646,6767
16681,6658385,6664964,6665145,0,0,6579,6760
16683,6658386,6665145,6665207,0,0,6759,6821
16685,6658386,6665145,6665325,0,0,6759,6939
16688,6658387,6665325,6665385,0,0,6938,6998
16686,6658386,6665207,6665507,0,0,6821,7121
16682,6658385,6665033,6665574,0,0,6648,7189
16689,6658447,6665385,6665623,0,0,6938,7176
16684,6658386,6665574,6665636,0,0,7188,7250
16693,6658566,6665623,6665923,0,0,7057,7357
16694,6658685,6665923,6666044,0,0,7238,7359
16695,6658685,6666044,6666165,0,0,7359,7480
16691,6658447,6665507,6666226,0,0,7060,7779
16699,6658806,6666226,6666346,0,0,7420,7540
16687,6658386,6665636,6666356,0,0,7250,7970
16700,6658806,6666346,6666588,0,0,7540,7782
16690,6658447,6666356,6666595,0,0,7909,8148
16692,6658565,6666595,6666897,0,0,8030,8332
16703,6658866,6666588,6666948,0,0,7722,8082
16696,6658747,6666897,6667016,0,0,8150,8269
16706,6658925,6666948,6667309,0,0,8023,8384
16708,6659048,6667309,6667963,0,0,8261,8915
16697,6658747,6667016,6668945,0,0,8269,10198
16701,6658865,6668945,6669005,0,0,10080,10140
16702,6658865,6669005,6669367,0,0,10140,10502
16704,6658925,6669367,6669490,0,0,10442,10565
16705,6658925,6669490,6669730,0,0,10565,10805
16707,6659047,6669730,6670032,0,0,10683,10985
16709,6659105,6670032,6671602,0,0,10927,12497
16710,6659106,6671602,6672198,0,0,12496,13092
16597,6626479,6658843,6672703,0,0,32364,46224
16712,6659226,6672198,6673521,0,0,12972,14295
16713,6659226,6672198,6673521,0,0,12972,14295
16717,6659701,6673521,6673901,0,0,13820,14200
16720,6659702,6673901,6673959,0,0,14199,14257
16715,6659286,6673521,6673995,0,0,14235,14709
16721,6659759,6673959,6674281,0,0,14200,14522
16722,6659759,6673995,6674509,0,0,14236,14750
16724,6659820,6674281,6674541,0,0,14461,14721
16726,6660080,6674509,6674582,0,0,14429,14502
16727,6660080,6674541,6674674,0,0,14461,14594
16728,6660153,6674582,6674762,0,0,14429,14609
16729,6660213,6674674,6675939,0,0,14461,15726
16738,6663356,6674762,6678406,0,0,11406,15050
16714,6659285,6678406,6678882,0,0,19121,19597
16716,6659701,6678882,6678941,0,0,19181,19240
16718,6659701,6678941,6680059,0,0,19240,20358
16719,6659701,6680059,6681297,0,0,20358,21596
16723,6659759,6681297,6681928,0,0,21538,22169
16725,6659820,6681928,6682846,0,0,22108,23026
16730,6660737,6682846,6682928,0,0,22109,22191
16731,6660819,6682928,6682987,0,0,22109,22168
16732,6660878,6682987,6683047,0,0,22109,22169
16733,6660938,6683047,6683107,0,0,22109,22169
16594,6624698,6624698,6684188,0,0,0,59490
16737,6663228,6684188,6684222,0,0,20960,20994
16739,6663838,6684222,6684337,0,0,20384,20499
16736,6663170,6684188,6685495,0,0,21018,22325
16602,6642055,6672703,6686108,0,0,30648,44053
16664,6657305,6657552,6694361,0,0,247,37056
16742,6694109,6694109,6694410,0,0,0,301
16680,6658326,6658752,6694496,0,0,426,36170
16743,6694549,6694549,6694677,0,0,0,128
16744,6695333,6695333,6695586,0,0,0,253
16745,6695564,6695564,6695769,0,0,0,205
16662,6657247,6659315,6696098,0,0,2068,38851
16747,6696308,6696308,6696593,0,0,0,285
16749,6696624,6696624,6696945,0,0,0,321
16741,6691854,6691854,6697128,0,0,0,5274
16750,6697502,6697502,6697563,0,0,0,61
16748,6696350,6696350,6697972,0,0,0,1622
16751,6699211,6699211,6699271,0,0,0,60
16740,6689464,6689464,6699638,0,0,0,10174
16752,6699278,6699278,6699880,0,0,0,602
16753,6699497,6699497,6700252,0,0,0,755
16755,6700537,6700537,6700587,0,0,0,50
16754,6700388,6700388,6700907,0,0,0,519
16698,6658747,6666165,6701531,0,0,7418,42784
16711,6659106,6667963,6702970,0,0,8857,43864
16757,6701168,6701531,6703145,0,0,363,1977
16759,6701819,6702970,6703161,0,0,1151,1342
16758,6701766,6703145,6703669,0,0,1379,1903
16760,6702807,6703145,6703684,0,0,338,877
16763,6704257,6704257,6704300,0,0,0,43
16746,6696149,6696149,6705187,0,0,0,9038
16756,6701122,6701122,6705194,0,0,0,4072
16764,6705989,6705989,6706033,0,0,0,44
16766,6707441,6707441,6707483,0,0,0,42
16767,6707549,6707549,6707579,0,0,0,30
16768,6707650,6707650,6708572,0,0,0,922
16772,6709459,6709459,6709478,0,0,0,19
16774,6709838,6709838,6709880,0,0,0,42
16775,6710299,6710299,6710407,0,0,0,108
16761,6703247,6703247,6711848,0,0,0,8601
16779,6711571,6711848,6711859,0,0,277,288
16780,6711774,6711848,6711860,0,0,74,86
16778,6711380,6711848,6711891,0,0,468,511
16781,6711956,6711956,6711970,0,0,0,14
16782,6711960,6711960,6711983,0,0,0,23
16783,6712129,6712129,6712142,0,0,0,13
16785,6712475,6712475,6712518,0,0,0,43
16786,6712652,6712652,6712672,0,0,0,20
16769,6708423,6708423,6713941,0,0,0,5518
16788,6714153,6714153,6714362,0,0,0,209
16762,6704188,6704188,6714440,0,0,0,10252
16789,6714578,6714578,6714788,0,0,0,210
16765,6707322,6707322,6714883,0,0,0,7561
16734,6660938,6683107,6716199,0,0,22169,55261
16770,6708938,6714883,6716457,0,0,5945,7519
16771,6708978,6716457,6716517,0,0,7479,7539
16735,6661593,6684188,6716613,0,0,22595,55020
16793,6716930,6716930,6717138,0,0,0,208
16790,6714595,6714595,6717751,0,0,0,3156
16796,6718077,6718077,6718096,0,0,0,19
16776,6710517,6716517,6718143,0,0,6000,7626
16795,6717976,6717976,6718185,0,0,0,209
16797,6718517,6718517,6718537,0,0,0,20
16798,6718879,6718879,6718896,0,0,0,17
16799,6719494,6719494,6719512,0,0,0,18
16773,6709746,6709746,6719688,0,0,0,9942
16784,6712145,6718143,6719752,0,0,5998,7607
16801,6719942,6719942,6719960,0,0,0,18
16802,6720307,6720307,6720326,0,0,0,19
16805,6720716,6720716,6720750,0,0,0,34
16806,6720958,6720958,6720991,0,0,0,33
16777,6710752,6710752,6721044,0,0,0,10292
16787,6713754,6719752,6721380,0,0,5998,7626
16807,6721669,6721669,6721705,0,0,0,36
16808,6722037,6722037,6722074,0,0,0,37
16791,6715386,6721380,6722945,0,0,5994,7559
16809,6723018,6723018,6723065,0,0,0,47
16811,6723536,6723536,6724893,0,0,0,1357
16810,6723423,6723423,6725186,0,0,0,1763
16813,6725064,6725064,6725584,0,0,0,520
16804,6720334,6720334,6727225,0,0,0,6891
16814,6725412,6725412,6727286,0,0,0,1874
16800,6719688,6719688,6729667,0,0,0,9979
16815,6727560,6727560,6730801,0,0,0,3241
16803,6720323,6720323,6734619,0,0,0,14296
16817,6730913,6730913,6734626,0,0,0,3713
16812,6723544,6723544,6735305,0,0,0,11761
16819,6735202,6735202,6738944,0,0,0,3742
16792,6715818,6722945,6739576,0,0,7127,23758
16816,6729666,6729666,6739883,0,0,0,10217
16794,6716955,6739576,6741198,0,0,22621,24243
16822,6740461,6740461,6743272,0,0,0,2811
16823,6743332,6743332,6743834,0,0,0,502
16825,6743653,6743653,6744208,0,0,0,555
16826,6743890,6744208,6744233,0,0,318,343
16824,6743624,6743624,6747319,0,0,0,3695
16830,6747602,6747602,6747920,0,0,0,318
16818,6734560,6734560,6748987,0,0,0,14427
16820,6735214,6735305,6749067,0,0,91,13853
16832,6748975,6748987,6749200,0,0,12,225
16831,6748507,6748987,6749288,0,0,480,781
16834,6749268,6749268,6749347,0,0,0,79
16833,6749261,6749261,6749470,0,0,0,209
16821,6739888,6739888,6749796,0,0,0,9908
16835,6749846,6749846,6749989,0,0,0,143
16827,6745829,6745829,6749990,0,0,0,4161
16837,6750229,6750229,6750284,0,0,0,55
16836,6750161,6750161,6750361,0,0,0,200
16838,6750429,6750429,6750548,0,0,0,119
16840,6750574,6750574,6750822,0,0,0,248
16829,6747379,6747379,6750925,0,0,0,3546
16841,6750910,6750910,6750992,0,0,0,82
16843,6750985,6750985,6751011,0,0,0,26
16844,6751253,6751253,6751324,0,0,0,71
16845,6751277,6751277,6751435,0,0,0,158
16847,6751461,6751461,6751471,0,0,0,10
16849,6751911,6751911,6752010,0,0,0,99
16850,6752115,6752115,6752179,0,0,0,64
16848,6751526,6751526,6752398,0,0,0,872
16851,6752408,6752408,6752504,0,0,0,96
16852,6752447,6752447,6752572,0,0,0,125
16839,6750438,6750438,6752574,0,0,0,2136
16853,6752583,6752583,6752735,0,0,0,152
16855,6752639,6752639,6752855,0,0,0,216
16859,6753263,6753263,6753435,0,0,0,172
16856,6752891,6752891,6753515,0,0,0,624
16854,6752612,6752612,6753554,0,0,0,942
16860,6753287,6753435,6753591,0,0,148,304
16828,6747219,6749067,6753790,0,0,1848,6571
16861,6753333,6753515,6754092,0,0,182,759
16858,6753248,6753248,6754322,0,0,0,1074
16862,6753458,6753554,6754529,0,0,96,1071
16869,6754796,6754796,6755056,0,0,0,260
16871,6754983,6755056,6755408,0,0,73,425
16870,6754830,6754830,6756393,0,0,0,1563
16873,6755073,6756393,6757071,0,0,1320,1998
16868,6754189,6754189,6757428,0,0,0,3239
16875,6756301,6757071,6757604,0,0,770,1303
16876,6756325,6757428,6757633,0,0,1103,1308
16878,6756720,6757633,6757694,0,0,913,974
16842,6750961,6750961,6758576,0,0,0,7615
16865,6753634,6753790,6758814,0,0,156,5180
16881,6757904,6758814,6758883,0,0,910,979
16882,6758234,6758883,6758948,0,0,649,714
16877,6756417,6757604,6759123,0,0,1187,2706
16884,6758409,6758948,6759151,0,0,539,742
16886,6758718,6759151,6759180,0,0,433,462
16880,6757637,6758814,6759285,0,0,1177,1648
16889,6759281,6759281,6759301,0,0,0,20
16879,6756891,6757694,6759393,0,0,803,2502
16890,6759321,6759393,6759531,0,0,72,210
16892,6759531,6759531,6759640,0,0,0,109
16874,6755578,6758814,6759711,0,0,3236,4133
16887,6758972,6759301,6759733,0,0,329,761
16863,6753475,6758576,6759855,0,0,5101,6380
16872,6755057,6755408,6759911,0,0,351,4854
16894,6759737,6759737,6759968,0,0,0,231
16895,6759964,6759964,6759988,0,0,0,24
16883,6758311,6759733,6760349,0,0,1422,2038
16846,6751395,6751395,6760413,0,0,0,9018
16866,6754043,6759855,6760453,0,0,5812,6410
16888,6759260,6760349,6760490,0,0,1089,1230
16897,6760466,6760490,6760837,0,0,24,371
16893,6759565,6760453,6760930,0,0,888,1365
16891,6759437,6760413,6761175,0,0,976,1738
16898,6760792,6760792,6761209,0,0,0,417
16899,6760933,6760933,6761324,0,0,0,391
16900,6761563,6761563,6761610,0,0,0,47
16901,6761634,6761634,6761651,0,0,0,17
16902,6761703,6761703,6761845,0,0,0,142
16903,6761731,6761731,6762113,0,0,0,382
16905,6762064,6762064,6762524,0,0,0,460
16906,6762584,6762584,6762843,0,0,0,259
16907,6762749,6762749,6762892,0,0,0,143
16857,6753146,6753790,6763656,0,0,644,10510
16912,6764077,6764077,6764304,0,0,0,227
16911,6763894,6763894,6764434,0,0,0,540
16914,6764304,6764434,6764471,0,0,130,167
16867,6754163,6754163,6764959,0,0,0,10796
16917,6765027,6765027,6765037,0,0,0,10
16916,6764935,6764935,6765285,0,0,0,350
16921,6765704,6765704,6765830,0,0,0,126
16904,6761885,6761885,6765998,0,0,0,4113
16922,6765989,6765989,6766335,0,0,0,346
16864,6753589,6758576,6766393,0,0,4987,12804
16920,6765613,6766393,6766422,0,0,780,809
16926,6766326,6766326,6766490,0,0,0,164
16928,6766428,6766428,6766490,0,0,0,62
16924,6766186,6766186,6766771,0,0,0,585
16919,6765133,6765133,6766815,0,0,0,1682
16885,6758445,6759123,6766940,0,0,678,8495
16929,6766757,6766757,6766949,0,0,0,192
16925,6766240,6766422,6767251,0,0,182,1011
16931,6767075,6767075,6767322,0,0,0,247
16932,6767085,6767085,6767393,0,0,0,308
16934,6767572,6767572,6767959,0,0,0,387
16935,6768200,6768200,6769197,0,0,0,997
16937,6768570,6768570,6769436,0,0,0,866
16923,6766071,6766071,6769558,0,0,0,3487
16939,6768670,6768670,6769675,0,0,0,1005
16938,6768578,6768578,6769707,0,0,0,1129
16896,6760348,6760453,6769812,0,0,105,9464
16940,6769620,6769620,6769899,0,0,0,279
16930,6766936,6766936,6770277,0,0,0,3341
16946,6770097,6770277,6770300,0,0,180,203
16943,6769910,6769910,6770375,0,0,0,465
16944,6769943,6770277,6770772,0,0,334,829
16942,6769834,6769834,6771020,0,0,0,1186
16950,6771784,6771784,6771880,0,0,0,96
16951,6771999,6771999,6772014,0,0,0,15
16953,6772157,6772157,6772173,0,0,0,16
16949,6770871,6770871,6772336,0,0,0,1465
16948,6770427,6770427,6772339,0,0,0,1912
16954,6772334,6772336,6772731,0,0,2,397
16952,6772055,6772055,6772789,0,0,0,734
16936,6768217,6768217,6772886,0,0,0,4669
16955,6772364,6772731,6773435,0,0,367,1071
16958,6773404,6773404,6773636,0,0,0,232
16956,6772472,6772472,6773646,0,0,0,1174
16959,6773683,6773683,6773729,0,0,0,46
16960,6773739,6773739,6773890,0,0,0,151
16945,6770079,6770079,6774016,0,0,0,3937
16957,6773094,6773094,6774550,0,0,0,1456
16910,6763706,6763706,6774708,0,0,0,11002
16961,6774218,6774550,6775069,0,0,332,851
16947,6770289,6770289,6775210,0,0,0,4921
16909,6763106,6775069,6775820,0,0,11963,12714
16915,6764426,6775820,6775896,0,0,11394,11470
16908,6763016,6763016,6776273,0,0,0,13257
16918,6765076,6775896,6777161,0,0,10820,12085
16927,6766343,6777161,6778106,0,0,10818,11763
16913,6764254,6764434,6779874,0,0,180,15620
16962,6775092,6776273,6780592,0,0,1181,5500
16965,6777527,6780592,6780667,0,0,3065,3140
16969,6778169,6780667,6780705,0,0,2498,2536
16970,6778508,6780705,6780743,0,0,2197,2235
16941,6769675,6769675,6780796,0,0,0,11121
16964,6776722,6780592,6781033,0,0,3870,4311
16974,6779035,6781033,6781069,0,0,1998,2034
16966,6777730,6780592,6781679,0,0,2862,3949
16971,6778840,6780743,6781850,0,0,1903,3010
16968,6777800,6780796,6781994,0,0,2996,4194
16973,6779030,6781679,6782099,0,0,2649,3069
16979,6780496,6781850,6782324,0,0,1354,1828
16978,6780458,6782099,6782371,0,0,1641,1913
16967,6777737,6780592,6782445,0,0,2855,4708
16983,6781004,6782371,6782446,0,0,1367,1442
16987,6781604,6782446,6782530,0,0,842,926
16988,6781753,6782530,6782552,0,0,777,799
16984,6781163,6782371,6782589,0,0,1208,1426
16977,6780422,6782445,6783502,0,0,2023,3080
16933,6767289,6778106,6784716,0,0,10817,17427
16990,6783747,6784716,6784743,0,0,969,996
16975,6779476,6781069,6785020,0,0,1593,5544
16985,6781467,6784716,6785206,0,0,3249,3739
16991,6784200,6784743,6785414,0,0,543,1214
16993,6784300,6785020,6785518,0,0,720,1218
16994,6785410,6785410,6785617,0,0,0,207
16989,6781999,6782552,6785677,0,0,553,3678
16995,6786077,6786077,6786100,0,0,0,23
16996,6786097,6786097,6786307,0,0,0,210
16997,6786464,6786464,6786674,0,0,0,210
16998,6786884,6786884,6787187,0,0,0,303
16986,6781525,6785518,6787306,0,0,3993,5781
16981,6780985,6782324,6787423,0,0,1339,6438
17000,6788647,6788647,6788862,0,0,0,215
16992,6784229,6787306,6789013,0,0,3077,4784
16982,6780996,6784716,6791258,0,0,3720,10262
17002,6791259,6791259,6791523,0,0,0,264
17003,6792812,6792812,6793022,0,0,0,210
16963,6776626,6779874,6793100,0,0,3248,16474
17004,6793224,6793224,6793398,0,0,0,174
16972,6778990,6781994,6793784,0,0,3004,14794
16980,6780731,6783502,6793934,0,0,2771,13203
16999,6787194,6793784,6793944,0,0,6590,6750
17005,6794453,6794453,6794525,0,0,0,72
17001,6791105,6791105,6797047,0,0,0,5942
17008,6795459,6797047,6797905,0,0,1588,2446
17006,6794684,6794684,6799155,0,0,0,4471
17010,6796015,6799155,6799600,0,0,3140,3585
17012,6796023,6799600,6799991,0,0,3577,3968
17007,6794833,6794833,6801516,0,0,0,6683
17011,6796017,6797047,6802776,0,0,1030,6759
17013,6805040,6805040,6805076,0,0,0,36
17014,6805301,6805301,6805332,0,0,0,31
17016,6805616,6805616,6805630,0,0,0,14
17017,6805816,6805816,6805828,0,0,0,12
17018,6805922,6805922,6805933,0,0,0,11
17019,6806054,6806054,6806066,0,0,0,12
17020,6806445,6806445,6806462,0,0,0,17
17021,6806886,6806886,6806914,0,0,0,28
17022,6807043,6807043,6807059,0,0,0,16
17009,6795950,6797047,6807260,0,0,1097,11310
17023,6807341,6807341,6807353,0,0,0,12
16976,6779713,6784716,6807679,0,0,5003,27966
17024,6810617,6810617,6814399,0,0,0,3782
17015,6805532,6805532,6819970,0,0,0,14438
17025,6813969,6813969,6823907,0,0,0,9938
17027,6823908,6823908,6834065,0,0,0,10157
17026,6819967,6819967,6834333,0,0,0,14366
17029,6833632,6833632,6834338,0,0,0,706
17031,6835282,6835282,6835362,0,0,0,80
17034,6836106,6836106,6836379,0,0,0,273
17035,6836439,6836439,6836459,0,0,0,20
17033,6836048,6836048,6836479,0,0,0,431
17037,6836646,6836646,6836671,0,0,0,25
17032,6835891,6835891,6836882,0,0,0,991
17040,6837033,6837033,6837071,0,0,0,38
17038,6836805,6836805,6837096,0,0,0,291
17041,6837087,6837087,6837310,0,0,0,223
17036,6836497,6836497,6838568,0,0,0,2071
17042,6837923,6837923,6838745,0,0,0,822
17045,6838335,6838335,6838763,0,0,0,428
17047,6838816,6838816,6839004,0,0,0,188
17030,6835069,6835069,6839196,0,0,0,4127
17043,6837981,6837981,6839300,0,0,0,1319
17048,6839028,6839028,6839356,0,0,0,328
17028,6832797,6832797,6839367,0,0,0,6570
17051,6839451,6839451,6839476,0,0,0,25
17050,6839316,6839316,6839692,0,0,0,376
17053,6839698,6839698,6839742,0,0,0,44
17054,6839797,6839797,6839822,0,0,0,25
17055,6839877,6839877,6839898,0,0,0,21
17056,6840004,6840004,6840034,0,0,0,30
17057,6840566,6840566,6841563,0,0,0,997
17060,6840945,6841563,6841596,0,0,618,651
17061,6841047,6841596,6841671,0,0,549,624
17058,6840607,6840607,6841754,0,0,0,1147
17062,6841130,6841671,6841890,0,0,541,760
17065,6841389,6841890,6841926,0,0,501,537
17066,6841444,6841926,6842282,0,0,482,838
17067,6841456,6842282,6842362,0,0,826,906
17068,6841462,6842362,6842416,0,0,900,954
17071,6841642,6842416,6842465,0,0,774,823
17073,6841857,6842465,6842603,0,0,608,746
17059,6840802,6841563,6844881,0,0,761,4079
17075,6842240,6844881,6845001,0,0,2641,2761
17044,6838080,6838745,6845132,0,0,665,7052
17076,6842310,6845001,6845419,0,0,2691,3109
17077,6842425,6845419,6845609,0,0,2994,3184
17078,6842475,6845609,6845637,0,0,3134,3162
17052,6839609,6839609,6845688,0,0,0,6079
17063,6841255,6845132,6845696,0,0,3877,4441
17082,6842565,6845688,6845880,0,0,3123,3315
17081,6842559,6845637,6845922,0,0,3078,3363
17084,6842897,6845922,6846105,0,0,3025,3208
17087,6843302,6846105,6846119,0,0,2803,2817
17088,6843335,6846119,6846207,0,0,2784,2872
17069,6841529,6845696,6846530,0,0,4167,5001
17074,6842056,6842603,6846541,0,0,547,4485
17046,6838799,6839196,6846647,0,0,397,7848
17092,6843559,6846541,6846728,0,0,2982,3169
17080,6842550,6846530,6846827,0,0,3980,4277
17090,6843445,6846827,6846887,0,0,3382,3442
17070,6841585,6846530,6846970,0,0,4945,5385
17089,6843354,6846207,6847123,0,0,2853,3769
17096,6844139,6846728,6847334,0,0,2589,3195
17039,6836876,6839367,6847680,0,0,2491,10804
17085,6843170,6847680,6847710,0,0,4510,4540
17097,6844323,6847123,6847727,0,0,2800,3404
17095,6844123,6847710,6847738,0,0,3587,3615
17093,6843863,6846970,6847773,0,0,3107,3910
17108,6846031,6847773,6847795,0,0,1742,1764
17107,6845991,6847773,6847812,0,0,1782,1821
17110,6846439,6847812,6847835,0,0,1373,1396
17079,6842529,6847680,6848048,0,0,5151,5519
17105,6845461,6847738,6848168,0,0,2277,2707
17103,6845332,6847710,6848256,0,0,2378,2924
17116,6847670,6848256,6848266,0,0,586,596
17109,6846332,6847795,6848267,0,0,1463,1935
17111,6846473,6847835,6848275,0,0,1362,1802
17094,6844021,6847680,6848354,0,0,3659,4333
17117,6847786,6848266,6848430,0,0,480,644
17119,6848077,6848275,6848457,0,0,198,380
17118,6848068,6848267,6848523,0,0,199,455
17091,6843520,6846887,6848620,0,0,3367,5100
17101,6844690,6848354,6848664,0,0,3664,3974
17102,6845311,6847710,6848809,0,0,2399,3498
17115,6847418,6848168,6848984,0,0,750,1566
17113,6847095,6848168,6849021,0,0,1073,1926
17099,6844406,6847334,6849059,0,0,2928,4653
17098,6844330,6848048,6849598,0,0,3718,5268
17123,6848967,6848984,6849624,0,0,17,657
17124,6849269,6849624,6849923,0,0,355,654
17122,6848840,6849059,6850007,0,0,219,1167
17104,6845437,6848664,6850296,0,0,3227,4859
17125,6849717,6849923,6850307,0,0,206,590
17121,6848818,6849598,6850600,0,0,780,1782
17128,6850333,6850333,6850650,0,0,0,317
17129,6850413,6850600,6850814,0,0,187,401
17130,6850834,6850834,6851082,0,0,0,248
17131,6850857,6850857,6851146,0,0,0,289
17126,6849949,6850007,6851257,0,0,58,1308
17132,6851291,6851291,6851683,0,0,0,392
17083,6842798,6845880,6851738,0,0,3082,8940
17064,6841362,6841754,6851760,0,0,392,10398
17133,6851801,6851801,6852066,0,0,0,265
17127,6849978,6850296,6852271,0,0,318,2293
17134,6851824,6852066,6852325,0,0,242,501
17135,6852002,6852271,6852351,0,0,269,349
17137,6852740,6852740,6852784,0,0,0,44
17114,6847392,6848457,6853699,0,0,1065,6307
17138,6853053,6853053,6853801,0,0,0,748
17140,6853778,6853778,6853952,0,0,0,174
17139,6853211,6853211,6854115,0,0,0,904
17049,6839183,6845132,6854185,0,0,5949,15002
17144,6854228,6854228,6854292,0,0,0,64
17142,6853971,6853971,6854570,0,0,0,599
17148,6854617,6854617,6855258,0,0,0,641
17149,6854722,6855258,6855338,0,0,536,616
17147,6854597,6854597,6855646,0,0,0,1049
17146,6854590,6854590,6855787,0,0,0,1197
17106,6845700,6847727,6855821,0,0,2027,10121
17150,6854763,6855258,6855839,0,0,495,1076
17136,6852553,6852553,6855898,0,0,0,3345
17154,6855647,6855647,6855898,0,0,0,251
17153,6855629,6855646,6856229,0,0,17,600
17141,6853821,6853821,6856792,0,0,0,2971
17145,6854567,6854567,6856963,0,0,0,2396
17143,6854219,6854219,6857739,0,0,0,3520
17155,6856131,6856131,6858839,0,0,0,2708
17120,6848176,6848809,6859471,0,0,633,11295
17159,6860541,6860541,6860750,0,0,0,209
17156,6857128,6857128,6860776,0,0,0,3648
17086,6843294,6847680,6860800,0,0,4386,17506
17160,6860901,6860901,6861460,0,0,0,559
17158,6860529,6860529,6861611,0,0,0,1082
17164,6861282,6861460,6861636,0,0,178,354
17169,6861486,6861636,6861670,0,0,150,184
17072,6841790,6846647,6861701,0,0,4857,19911
17165,6861295,6861460,6861714,0,0,165,419
17170,6861702,6861702,6861819,0,0,0,117
17172,6861862,6861862,6861919,0,0,0,57
17163,6861231,6861460,6861962,0,0,229,731
17173,6861874,6861874,6862011,0,0,0,137
17100,6844678,6851738,6862346,0,0,7060,17668
17167,6861466,6862346,6863110,0,0,880,1644
17179,6862784,6863110,6863138,0,0,326,354
17161,6860934,6860934,6863246,0,0,0,2312
17178,6862423,6863110,6863327,0,0,687,904
17177,6862414,6863110,6863352,0,0,696,938
17182,6863246,6863246,6863441,0,0,0,195
17151,6854993,6858839,6863615,0,0,3846,8622
17176,6862249,6863110,6863711,0,0,861,1462
17187,6863635,6863635,6863778,0,0,0,143
17188,6863806,6863806,6863869,0,0,0,63
17186,6863498,6863498,6864020,0,0,0,522
17171,6861856,6861856,6864199,0,0,0,2343
17175,6862152,6863110,6864436,0,0,958,2284
17190,6864140,6864436,6864447,0,0,296,307
17191,6864250,6864447,6864576,0,0,197,326
17192,6864338,6864576,6864584,0,0,238,246
17193,6864555,6864584,6864661,0,0,29,106
17183,6863324,6863615,6864775,0,0,291,1451
17195,6864631,6864775,6864798,0,0,144,167
17197,6864773,6864798,6864815,0,0,25,42
17194,6864620,6864620,6865059,0,0,0,439
17184,6863334,6863334,6865165,0,0,0,1831
17199,6864966,6864966,6865166,0,0,0,200
17203,6865189,6865189,6865212,0,0,0,23
17200,6865132,6865132,6865245,0,0,0,113
17204,6865197,6865212,6865253,0,0,15,56
17202,6865184,6865184,6865288,0,0,0,104
17205,6865325,6865325,6865342,0,0,0,17
17201,6865150,6865150,6865426,0,0,0,276
17206,6865402,6865402,6865427,0,0,0,25
17209,6865470,6865470,6865572,0,0,0,102
17207,6865438,6865438,6865690,0,0,0,252
17174,6862080,6862080,6865733,0,0,0,3653
17198,6864849,6864849,6866019,0,0,0,1170
17210,6866249,6866249,6866674,0,0,0,425
17211,6866679,6866679,6866718,0,0,0,39
17162,6860997,6860997,6867731,0,0,0,6734
17212,6867181,6867181,6867794,0,0,0,613
17168,6861473,6861611,6867809,0,0,138,6336
17214,6867937,6867937,6868072,0,0,0,135
17216,6868082,6868082,6868220,0,0,0,138
17181,6863148,6863148,6868268,0,0,0,5120
17213,6867852,6867852,6868270,0,0,0,418
17189,6863951,6863951,6868328,0,0,0,4377
17196,6864677,6864677,6868692,0,0,0,4015
17180,6863039,6863615,6869086,0,0,576,6047
17218,6868930,6868930,6869117,0,0,0,187
17217,6868641,6869086,6869288,0,0,445,647
17222,6869795,6869795,6870075,0,0,0,280
17157,6860478,6860478,6870197,0,0,0,9719
17219,6869073,6869117,6872388,0,0,44,3315
17221,6869559,6869559,6873248,0,0,0,3689
17223,6871988,6871988,6874250,0,0,0,2262
17208,6865444,6865444,6876051,0,0,0,10607
17112,6846554,6868270,6877790,0,0,21716,31236
17224,6876501,6876501,6880187,0,0,0,3686
17226,6877169,6880187,6880294,0,0,3018,3125
17185,6863473,6863473,6880428,0,0,0,16955
17152,6855279,6877790,6881423,0,0,22511,26144
17228,6880297,6880297,6882697,0,0,0,2400
17227,6879677,6879677,6884371,0,0,0,4694
17230,6881633,6881633,6884799,0,0,0,3166
17232,6886865,6886865,6887432,0,0,0,567
17233,6887182,6887182,6887536,0,0,0,354
17234,6887636,6887636,6888145,0,0,0,509
17235,6887827,6887827,6890214,0,0,0,2387
17166,6861312,6881423,6891089,0,0,20111,29777
17231,6882515,6882515,6892712,0,0,0,10197
17220,6869418,6876051,6899209,0,0,6633,29791
17215,6867951,6891089,6901259,0,0,23138,33308
17237,6892713,6892713,6902627,0,0,0,9914
17236,6888979,6888979,6903387,0,0,0,14408
17225,6877070,6901259,6906009,0,0,24189,28939
17238,6900192,6900192,6907824,0,0,0,7632
17239,6902628,6902628,6912828,0,0,0,10200
17243,6915714,6915714,6915745,0,0,0,31
17244,6915754,6915754,6915784,0,0,0,30
17240,6903387,6903387,6917691,0,0,0,14304
17245,6919283,6919283,6919310,0,0,0,27
17247,6919317,6919317,6919342,0,0,0,25
17248,6919348,6919348,6919372,0,0,0,24
17249,6919379,6919379,6919410,0,0,0,31
17229,6881162,6906009,6920285,0,0,24847,39123
17251,6920881,6920881,6920915,0,0,0,34
17252,6920890,6920890,6921053,0,0,0,163
17250,6920316,6920316,6921154,0,0,0,838
17253,6920932,6920932,6921156,0,0,0,224
17255,6921951,6921951,6921974,0,0,0,23
17242,6912832,6912832,6922734,0,0,0,9902
17257,6922697,6922734,6923583,0,0,37,886
17258,6922945,6923583,6924433,0,0,638,1488
17261,6925638,6925638,6925871,0,0,0,233
17262,6925713,6925713,6925977,0,0,0,264
17263,6926065,6926065,6926084,0,0,0,19
17256,6922377,6922377,6926195,0,0,0,3818
17265,6926323,6926323,6926335,0,0,0,12
17254,6921573,6921573,6929212,0,0,0,7639
17264,6926202,6926202,6932615,0,0,0,6413
17268,6927549,6932615,6932678,0,0,5066,5129
17273,6928848,6932678,6932739,0,0,3830,3891
17270,6928209,6932615,6932752,0,0,4406,4543
17275,6929181,6932752,6932768,0,0,3571,3587
17277,6929248,6932768,6932784,0,0,3520,3536
17271,6928575,6932615,6932816,0,0,4040,4241
17278,6929368,6932784,6932831,0,0,3416,3463
17279,6929626,6932816,6932834,0,0,3190,3208
17280,6929800,6932831,6932862,0,0,3031,3062
17282,6930486,6932834,6932899,0,0,2348,2413
17274,6928949,6932739,6932928,0,0,3790,3979
17281,6930075,6932899,6933535,0,0,2824,3460
17286,6932859,6933535,6933754,0,0,676,895
17241,6907828,6920285,6934027,0,0,12457,26199
17246,6919302,6934027,6934927,0,0,14725,15625
17266,6926481,6926481,6934954,0,0,0,8473
17259,6924262,6934927,6935012,0,0,10665,10750
17267,6927546,6929212,6935384,0,0,1666,7838
17287,6932907,6933754,6936724,0,0,847,3817
17294,6937116,6937116,6937291,0,0,0,175
17260,6924460,6935012,6937562,0,0,10552,13102
17295,6937394,6937394,6937658,0,0,0,264
17296,6938454,6938454,6938850,0,0,0,396
17283,6931734,6934954,6941297,0,0,3220,9563
17284,6931796,6941297,6941371,0,0,9501,9575
17288,6934069,6936724,6941465,0,0,2655,7396
17300,6939786,6941465,6941705,0,0,1679,1919
17272,6928647,6932615,6941749,0,0,3968,13102
17301,6940109,6941705,6942009,0,0,1596,1900
17306,6941730,6942009,6942039,0,0,279,309
17297,6939283,6939283,6942171,0,0,0,2888
17307,6942156,6942156,6942311,0,0,0,155
17269,6927954,6937562,6945074,0,0,9608,17120
17289,6934476,6945074,6946891,0,0,10598,12415
17285,6932622,6941371,6948078,0,0,8749,15456
17291,6934824,6942311,6948291,0,0,7487,13467
17299,6939744,6948291,6948413,0,0,8547,8669
17302,6940368,6948413,6949217,0,0,8045,8849
17303,6941417,6949217,6949295,0,0,7800,7878
17304,6941529,6949295,6949406,0,0,7766,7877
17305,6941701,6949406,6950207,0,0,7705,8506
17308,6942496,6950207,6950225,0,0,7711,7729
17310,6943128,6950225,6950240,0,0,7097,7112
17322,6950119,6950240,6950314,0,0,121,195
17309,6942771,6950207,6950449,0,0,7436,7678
17316,6946720,6950449,6951435,0,0,3729,4715
17318,6948030,6951435,6951801,0,0,3405,3771
17319,6949732,6951801,6951869,0,0,2069,2137
17315,6944677,6950240,6952029,0,0,5563,7352
17320,6949893,6951869,6952183,0,0,1976,2290
17323,6950195,6950314,6952226,0,0,119,2031
17321,6949969,6952183,6952240,0,0,2214,2271
17276,6929225,6935384,6952300,0,0,6159,23075
17298,6939336,6948078,6952337,0,0,8742,13001
17324,6950263,6952029,6952373,0,0,1766,2110
17326,6950648,6952226,6953958,0,0,1578,3310
17337,6953048,6953048,6956041,0,0,0,2993
17311,6943236,6952300,6957449,0,0,9064,14213
17290,6934793,6946891,6957703,0,0,12098,22910
17312,6943603,6952337,6959553,0,0,8734,15950
17327,6951580,6959553,6959562,0,0,7973,7982
17328,6951597,6959562,6959569,0,0,7965,7972
17329,6951610,6959569,6959576,0,0,7959,7966
17330,6951623,6959576,6959582,0,0,7953,7959
17331,6951636,6959582,6959589,0,0,7946,7953
17332,6951649,6959589,6959596,0,0,7940,7947
17333,6951662,6959596,6959603,0,0,7934,7941
17317,6947412,6957449,6960627,0,0,10037,13215
17334,6951700,6959603,6963310,0,0,7903,11610
17338,6955415,6960627,6963992,0,0,5212,8577
17340,6963057,6963992,6964215,0,0,935,1158
17313,6944073,6956041,6964260,0,0,11968,20187
17339,6958791,6963310,6966685,0,0,4519,7894
17292,6935469,6957703,6966964,0,0,22234,31495
17325,6950345,6957449,6967195,0,0,7104,16850
17293,6936737,6966964,6968345,0,0,30227,31608
17344,6967392,6967392,6969241,0,0,0,1849
17343,6967309,6967309,6969443,0,0,0,2134
17342,6967006,6967006,6970537,0,0,0,3531
17314,6944648,6968345,6970774,0,0,23697,26126
17346,6970672,6970672,6972118,0,0,0,1446
17347,6970755,6970755,6972250,0,0,0,1495
17336,6952438,6970774,6973226,0,0,18336,20788
17341,6966103,6973226,6973325,0,0,7123,7222
17349,6972684,6972684,6974165,0,0,0,1481
17348,6972633,6972633,6974197,0,0,0,1564
17352,6974567,6974567,6976768,0,0,0,2201
17345,6968631,6968631,6978513,0,0,0,9882
17335,6952320,6964260,6979759,0,0,11940,27439
17354,6979320,6979759,6979836,0,0,439,516
17350,6972973,6973325,6981273,0,0,352,8300
17351,6973077,6973077,6987411,0,0,0,14334
17353,6978517,6978517,6988673,0,0,0,10156
17355,6988673,6988673,6998553,0,0,0,9880
17358,6999194,6999194,7001795,0,0,0,2601
17357,6998553,6998553,7008733,0,0,0,10180
17359,7005421,7005421,7008801,0,0,0,3380
17356,6997112,6997112,7011462,0,0,0,14350
17363,7011420,7011420,7011721,0,0,0,301
17362,7008807,7008807,7012174,0,0,0,3367
17365,7012193,7012193,7012254,0,0,0,61
17366,7013145,7013145,7013442,0,0,0,297
17364,7012180,7012180,7015544,0,0,0,3364
17368,7016162,7016162,7017456,0,0,0,1294
17369,7016276,7016276,7017679,0,0,0,1403
17361,7008735,7008735,7018620,0,0,0,9885
17360,7007387,7007387,7018875,0,0,0,11488
17367,7015551,7015551,7018936,0,0,0,3385
17372,7025198,7025198,7027051,0,0,0,1853
17373,7027122,7027122,7027156,0,0,0,34
17374,7027620,7027620,7027786,0,0,0,166
17370,7018623,7018623,7028462,0,0,0,9839
17377,7029037,7029037,7030297,0,0,0,1260
17371,7019354,7019354,7030897,0,0,0,11543
17375,7028465,7028465,7038602,0,0,0,10137
17376,7028527,7028527,7040543,0,0,0,12016
17379,7038604,7038604,7048485,0,0,0,9881
17380,7040550,7040550,7050919,0,0,0,10369
17378,7034398,7034398,7057430,0,0,0,23032
17381,7048488,7048488,7058658,0,0,0,10170
17382,7050924,7050924,7068438,0,0,0,17514
17384,7058658,7058658,7068484,0,0,0,9826
17385,7059522,7059522,7073863,0,0,0,14341
17386,7068439,7068439,7078467,0,0,0,10028
17387,7068541,7068541,7078543,0,0,0,10002
17383,7057717,7057717,7080723,0,0,0,23006
17388,7073864,7073864,7088139,0,0,0,14275
17390,7078493,7078493,7088689,0,0,0,10196
17389,7078469,7078469,7095640,0,0,0,17171
17392,7088689,7088689,7098591,0,0,0,9902
17395,7100244,7100244,7100685,0,0,0,441
17396,7100692,7100692,7101536,0,0,0,844
17397,7101903,7101903,7101953,0,0,0,50
17398,7101959,7101959,7101970,0,0,0,11
17399,7101977,7101977,7101988,0,0,0,11
17401,7101994,7101994,7102006,0,0,0,12
17402,7102012,7102012,7102024,0,0,0,12
17403,7102030,7102030,7102041,0,0,0,11
17404,7102047,7102047,7102059,0,0,0,12
17391,7088142,7088142,7102368,0,0,0,14226
17405,7102398,7102398,7102796,0,0,0,398
17406,7102413,7102413,7102796,0,0,0,383
17407,7102830,7102830,7102911,0,0,0,81
17408,7103418,7103418,7103507,0,0,0,89
17409,7104002,7104002,7104231,0,0,0,229
17410,7105171,7105171,7108547,0,0,0,3376
17394,7098594,7098594,7108679,0,0,0,10085
17393,7095644,7095644,7110087,0,0,0,14443
17414,7109343,7110087,7110106,0,0,744,763
17413,7108744,7108744,7111215,0,0,0,2471
17415,7109977,7110106,7111426,0,0,129,1449
17411,7108554,7108554,7111908,0,0,0,3354
17418,7111914,7111914,7115303,0,0,0,3389
17423,7115323,7115323,7115383,0,0,0,60
17422,7115310,7115310,7118774,0,0,0,3464
17412,7108741,7108741,7118927,0,0,0,10186
17425,7118522,7118522,7119099,0,0,0,577
17429,7119546,7119546,7119668,0,0,0,122
17431,7121154,7121154,7121398,0,0,0,244
17426,7118784,7118784,7122232,0,0,0,3448
17433,7122254,7122254,7122332,0,0,0,78
17434,7122701,7122701,7122809,0,0,0,108
17416,7110089,7111426,7123412,0,0,1337,13323
17400,7101984,7101984,7124975,0,0,0,22991
17417,7111544,7124975,7124994,0,0,13431,13450
17435,7123051,7123051,7125145,0,0,0,2094
17419,7112068,7124994,7125544,0,0,12926,13476
17432,7122241,7122241,7125642,0,0,0,3401
17438,7125661,7125661,7125723,0,0,0,62
17420,7112634,7125544,7125950,0,0,12910,13316
17421,7113582,7125950,7127086,0,0,12368,13504
17436,7125063,7125063,7127259,0,0,0,2196
17424,7118031,7127086,7128484,0,0,9055,10453
17427,7118933,7118933,7129045,0,0,0,10112
17437,7125649,7125649,7129081,0,0,0,3432
17428,7119242,7128484,7129137,0,0,9242,9895
17430,7120100,7129137,7130615,0,0,9037,10515
17440,7134193,7134193,7137249,0,0,0,3056
17439,7128991,7128991,7139163,0,0,0,10172
17441,7139166,7139166,7149058,0,0,0,9892
17442,7145337,7145337,7157593,0,0,0,12256
17444,7149118,7149118,7159252,0,0,0,10134
17443,7145771,7145771,7160063,0,0,0,14292
17445,7157593,7157593,7165604,0,0,0,8011
17446,7159255,7159255,7169104,0,0,0,9849
17447,7160065,7160065,7174423,0,0,0,14358
17449,7169105,7169105,7179049,0,0,0,9944
17448,7165609,7165609,7179820,0,0,0,14211
17451,7177836,7177836,7180924,0,0,0,3088
17455,7181187,7181187,7181217,0,0,0,30
17457,7182584,7182584,7182602,0,0,0,18
17454,7180858,7180858,7183987,0,0,0,3129
17459,7184001,7184001,7184020,0,0,0,19
17460,7186570,7186570,7186588,0,0,0,18
17458,7183926,7183926,7186969,0,0,0,3043
17453,7179822,7179822,7187766,0,0,0,7944
17464,7188505,7188505,7188524,0,0,0,19
17450,7174480,7174480,7188870,0,0,0,14390
17452,7178991,7178991,7189225,0,0,0,10234
17461,7186906,7186906,7189939,0,0,0,3033
17466,7189875,7189939,7193047,0,0,64,3172
17456,7182020,7182020,7193981,0,0,0,11961
17469,7195881,7195881,7195954,0,0,0,73
17468,7192919,7193047,7196048,0,0,128,3129
17471,7196967,7196967,7197048,0,0,0,81
17472,7198381,7198381,7198418,0,0,0,37
17470,7195896,7196048,7199101,0,0,152,3205
17465,7189227,7189227,7199177,0,0,0,9950
17475,7201017,7201017,7201044,0,0,0,27
17478,7201985,7201985,7202019,0,0,0,34
17473,7198884,7199101,7202198,0,0,217,3314
17479,7202767,7202767,7202785,0,0,0,18
17462,7187769,7188870,7202912,0,0,1101,15143
17463,7187936,7202912,7203397,0,0,14976,15461
17467,7191001,7193981,7204800,0,0,2980,13799
17480,7204985,7204985,7205011,0,0,0,26
17477,7201959,7202198,7205358,0,0,239,3399
17482,7205765,7205765,7205793,0,0,0,28
17483,7205899,7205899,7205926,0,0,0,27
17484,7206174,7206174,7206200,0,0,0,26
17485,7206534,7206534,7207024,0,0,0,490
17481,7205056,7205056,7208084,0,0,0,3028
17474,7199176,7199176,7209400,0,0,0,10224
17486,7208016,7208016,7211131,0,0,0,3115
17476,7201823,7203397,7211354,0,0,1574,9531
17491,7211975,7211975,7212716,0,0,0,741
17492,7213645,7213645,7214145,0,0,0,500
17489,7211068,7211131,7214198,0,0,63,3130
17494,7215638,7215638,7216376,0,0,0,738
17496,7216554,7216554,7217108,0,0,0,554
17495,7215738,7215738,7217210,0,0,0,1472
17493,7214071,7214198,7217236,0,0,127,3165
17498,7218284,7218284,7218780,0,0,0,496
17487,7209409,7209409,7219479,0,0,0,10070
17490,7211170,7211354,7220495,0,0,184,9325
17488,7209794,7209794,7222719,0,0,0,12925
17499,7225865,7225865,7231061,0,0,0,5196
17497,7217091,7217236,7231368,0,0,145,14277
17500,7227313,7231061,7251044,0,0,3748,23731
17501,7245557,7245557,7259917,0,0,0,14360
17504,7266954,7266954,7267493,0,0,0,539
17503,7266589,7266589,7268101,0,0,0,1512
17502,7259917,7259917,7274365,0,0,0,14448
17505,7278516,7278516,7278778,0,0,0,262
17507,7278787,7278787,7278905,0,0,0,118
17508,7278912,7278912,7278924,0,0,0,12
17506,7278649,7278649,7278929,0,0,0,280
17512,7279407,7279407,7279608,0,0,0,201
17509,7278931,7278931,7279667,0,0,0,736
17511,7279154,7279154,7279692,0,0,0,538
17515,7280045,7280045,7280582,0,0,0,537
17513,7279715,7279715,7281163,0,0,0,1448
17516,7280770,7280770,7281200,0,0,0,430
17518,7281914,7281914,7282167,0,0,0,253
17510,7278955,7278955,7282615,0,0,0,3660
17514,7279756,7279756,7283143,0,0,0,3387
17517,7281606,7281606,7283207,0,0,0,1601
17520,7283409,7283409,7283938,0,0,0,529
17522,7283869,7283869,7285309,0,0,0,1440
17524,7285330,7285330,7285364,0,0,0,34
17519,7283148,7283148,7286526,0,0,0,3378
17523,7284378,7285309,7286742,0,0,931,2364
17527,7286546,7286742,7286765,0,0,196,219
17528,7286566,7286742,7286781,0,0,176,215
17532,7287507,7287507,7287547,0,0,0,40
17529,7286963,7286963,7287843,0,0,0,880
17533,7288666,7288666,7288848,0,0,0,182
17530,7287258,7287258,7288853,0,0,0,1595
17531,7287411,7288853,7288977,0,0,1442,1566
17534,7289827,7289827,7289950,0,0,0,123
17526,7286534,7286534,7290096,0,0,0,3562
17536,7290085,7290085,7290373,0,0,0,288
17525,7285924,7285924,7290564,0,0,0,4640
17535,7290077,7290077,7291718,0,0,0,1641
17543,7291661,7291718,7291862,0,0,57,201
17542,7290956,7291718,7291922,0,0,762,966
17544,7291905,7291905,7292079,0,0,0,174
17545,7291954,7291954,7292131,0,0,0,177
17546,7292353,7292353,7292377,0,0,0,24
17547,7292475,7292475,7292525,0,0,0,50
17548,7292663,7292663,7292683,0,0,0,20
17549,7292883,7292883,7293058,0,0,0,175
17552,7293096,7293096,7293116,0,0,0,20
17541,7290773,7291718,7293180,0,0,945,2407
17521,7283765,7283765,7295527,0,0,0,11762
17540,7290753,7291718,7295706,0,0,965,4953
17556,7296881,7296881,7296901,0,0,0,20
17557,7296912,7296912,7298124,0,0,0,1212
17537,7290104,7290104,7298329,0,0,0,8225
17560,7298353,7298353,7298413,0,0,0,60
17563,7300026,7300026,7300100,0,0,0,74
17565,7300516,7300516,7300605,0,0,0,89
17566,7300814,7300814,7300844,0,0,0,30
17538,7290261,7290564,7301023,0,0,303,10762
17539,7290507,7291718,7301401,0,0,1211,10894
17567,7302095,7302095,7302168,0,0,0,73
17568,7302513,7302513,7302548,0,0,0,35
17558,7297698,7297698,7302608,0,0,0,4910
17555,7295196,7295527,7303300,0,0,331,8104
17551,7293085,7293085,7303425,0,0,0,10340
17550,7292917,7303425,7303476,0,0,10508,10559
17562,7299667,7299667,7303777,0,0,0,4110
17570,7304299,7304299,7304331,0,0,0,32
17559,7298340,7298340,7304694,0,0,0,6354
17572,7304822,7304822,7304855,0,0,0,33
17553,7293114,7303476,7305088,0,0,10362,11974
17554,7295062,7305088,7306553,0,0,10026,11491
17573,7306199,7306199,7306662,0,0,0,463
17574,7307017,7307017,7307469,0,0,0,452
17561,7298844,7306553,7308012,0,0,7709,9168
17571,7304706,7304706,7308353,0,0,0,3647
17575,7309490,7309490,7309526,0,0,0,36
17576,7309774,7309774,7309813,0,0,0,39
17577,7310518,7310518,7310752,0,0,0,234
17579,7313542,7313542,7313578,0,0,0,36
17580,7315262,7315262,7315721,0,0,0,459
17569,7304101,7308012,7320268,0,0,3911,16167
17564,7300454,7301023,7324114,0,0,569,23660
17582,7317121,7324114,7324575,0,0,6993,7454
17584,7318304,7324114,7324577,0,0,5810,6273
17586,7319512,7324114,7324623,0,0,4602,5111
17588,7321587,7324577,7325022,0,0,2990,3435
17587,7320442,7324575,7325026,0,0,4133,4584
17589,7322721,7324623,7325090,0,0,1902,2369
17590,7324005,7325022,7325478,0,0,1017,1473
17591,7325233,7325233,7325678,0,0,0,445
17592,7326375,7326375,7326851,0,0,0,476
17581,7317081,7317081,7327418,0,0,0,10337
17583,7317219,7324114,7334034,0,0,6895,16815
17593,7327079,7327079,7336990,0,0,0,9911
17585,7319087,7324114,7338520,0,0,5027,19433
17578,7310969,7320268,7343691,0,0,9299,32722
17595,7337823,7337823,7345496,0,0,0,7673
17594,7336991,7336991,7347232,0,0,0,10241
17599,7347657,7347657,7347745,0,0,0,88
17600,7347833,7347833,7347951,0,0,0,118
17601,7349019,7349019,7349141,0,0,0,122
17602,7349876,7349876,7349997,0,0,0,121
17603,7350659,7350659,7350779,0,0,0,120
17605,7351480,7351480,7351643,0,0,0,163
17607,7351897,7351897,7352033,0,0,0,136
17610,7354637,7354637,7354658,0,0,0,21
17604,7351244,7351244,7354792,0,0,0,3548
17611,7354745,7354745,7354958,0,0,0,213
17613,7355117,7355117,7355348,0,0,0,231
17597,7345499,7345499,7355474,0,0,0,9975
17614,7355409,7355409,7355627,0,0,0,218
17616,7355918,7355918,7356129,0,0,0,211
17598,7347232,7347232,7357152,0,0,0,9920
17596,7343178,7343178,7357592,0,0,0,14414
17620,7357329,7357592,7357635,0,0,263,306
17621,7357592,7357635,7357667,0,0,43,75
17618,7356720,7356720,7360478,0,0,0,3758
17624,7362624,7362624,7363194,0,0,0,570
17623,7362278,7362278,7363501,0,0,0,1223
17626,7363972,7363972,7364048,0,0,0,76
17631,7365406,7365406,7365555,0,0,0,149
17606,7351497,7354792,7366325,0,0,3295,14828
17619,7357151,7357151,7367349,0,0,0,10198
17627,7364666,7364666,7368476,0,0,0,3810
17628,7364770,7364770,7368575,0,0,0,3805
17622,7358640,7358640,7370190,0,0,0,11550
17625,7363493,7370190,7370234,0,0,6697,6741
17629,7364951,7370234,7370277,0,0,5283,5326
17632,7365519,7370277,7370321,0,0,4758,4802
17636,7368429,7370321,7370356,0,0,1892,1927
17637,7369510,7370356,7370502,0,0,846,992
17609,7354399,7366325,7371388,0,0,11926,16989
17638,7369564,7370502,7374899,0,0,938,5335
17639,7369801,7374899,7375030,0,0,5098,5229
17646,7373670,7373670,7375046,0,0,0,1376
17640,7370057,7375030,7375261,0,0,4973,5204
17641,7370515,7375261,7375505,0,0,4746,4990
17642,7370926,7375505,7375745,0,0,4579,4819
17608,7354147,7355474,7375859,0,0,1327,21712
17643,7372829,7375745,7375994,0,0,2916,3165
17644,7373119,7375994,7376236,0,0,2875,3117
17645,7373548,7376236,7376286,0,0,2688,2738
17612,7354772,7375859,7376774,0,0,21087,22002
17649,7376396,7376396,7377317,0,0,0,921
17634,7367354,7367354,7377617,0,0,0,10263
17654,7378104,7378104,7378205,0,0,0,101
17650,7377109,7377109,7379164,0,0,0,2055
17647,7374278,7376286,7379707,0,0,2008,5429
17656,7379869,7379869,7380421,0,0,0,552
17657,7380437,7380437,7380509,0,0,0,72
17652,7377711,7379707,7383139,0,0,1996,5428
17630,7365257,7371388,7383431,0,0,6131,18174
17655,7379858,7379858,7383828,0,0,0,3970
17660,7384623,7384623,7385315,0,0,0,692
17662,7385958,7385958,7386353,0,0,0,395
17663,7386689,7386689,7387215,0,0,0,526
17651,7377613,7377613,7387822,0,0,0,10209
17664,7387543,7387543,7388076,0,0,0,533
17670,7389785,7389785,7390585,0,0,0,800
17658,7380951,7383139,7391182,0,0,2188,10231
17635,7368075,7383431,7391426,0,0,15356,23351
17672,7391134,7391134,7391992,0,0,0,858
17673,7393381,7393381,7394409,0,0,0,1028
17615,7355475,7376774,7394829,0,0,21299,39354
17617,7356262,7394829,7394848,0,0,38567,38586
17659,7381153,7391182,7394851,0,0,10029,13698
17661,7384832,7391426,7394888,0,0,6594,10056
17667,7388312,7394851,7394911,0,0,6539,6599
17675,7394756,7394756,7395625,0,0,0,869
17633,7366214,7394848,7395721,0,0,28634,29507
17666,7388300,7391426,7395909,0,0,3126,7609
17676,7397205,7397205,7397669,0,0,0,464
17665,7387827,7387827,7398052,0,0,0,10225
17674,7394256,7394911,7398250,0,0,655,3994
17668,7389134,7394888,7398540,0,0,5754,9406
17680,7402395,7402395,7402442,0,0,0,47
17681,7403780,7403780,7404208,0,0,0,428
17669,7389483,7398052,7405886,0,0,8569,16403
17682,7405384,7405384,7405926,0,0,0,542
17678,7398061,7398250,7408222,0,0,189,10161
17648,7374473,7395721,7409852,0,0,21248,35379
17653,7377719,7409852,7410714,0,0,32133,32995
17683,7406543,7406543,7413033,0,0,0,6490
17685,7408034,7408034,7418230,0,0,0,10196
17677,7397330,7405886,7421274,0,0,8556,23944
17684,7407141,7407141,7421513,0,0,0,14372
17687,7418231,7418231,7428160,0,0,0,9929
17671,7390847,7410714,7431026,0,0,19867,40179
17688,7428161,7428161,7438105,0,0,0,9944
17691,7437376,7438105,7441435,0,0,729,4059
17695,7441905,7441905,7442020,0,0,0,115
17679,7399959,7421274,7442644,0,0,21315,42685
17686,7412721,7431026,7443418,0,0,18305,30697
17694,7440724,7443418,7443439,0,0,2694,2715
17689,7433067,7433067,7447438,0,0,0,14371
17702,7447964,7447964,7448053,0,0,0,89
17700,7447072,7447072,7448161,0,0,0,1089
17705,7448614,7448614,7448705,0,0,0,91
17693,7440712,7443418,7448768,0,0,2706,8056
17704,7448377,7448768,7448902,0,0,391,525
17697,7442364,7443418,7448971,0,0,1054,6607
17707,7448990,7448990,7449074,0,0,0,84
17708,7449110,7449110,7449216,0,0,0,106
17706,7448752,7448752,7449428,0,0,0,676
17709,7449522,7449522,7449554,0,0,0,32
17710,7449697,7449697,7449788,0,0,0,91
17712,7450319,7450319,7450370,0,0,0,51
17699,7446069,7446069,7450549,0,0,0,4480
17701,7447121,7447438,7450663,0,0,317,3542
17711,7450034,7450034,7451134,0,0,0,1100
17714,7450557,7450557,7451482,0,0,0,925
17718,7451389,7451389,7451484,0,0,0,95
17692,7438107,7441435,7451640,0,0,3328,13533
17716,7450716,7451482,7452873,0,0,766,2157
17722,7453203,7453203,7453806,0,0,0,603
17719,7451523,7452873,7456871,0,0,1350,5348
17717,7450955,7451134,7458158,0,0,179,7203
17703,7448352,7448352,7458318,0,0,0,9966
17724,7454691,7454691,7459681,0,0,0,4990
17725,7454720,7459681,7459922,0,0,4961,5202
17721,7451776,7456871,7460339,0,0,5095,8563
17727,7455555,7459922,7462429,0,0,4367,6874
17735,7459754,7459754,7462651,0,0,0,2897
17737,7459973,7462651,7463688,0,0,2678,3715
17726,7455251,7460339,7463922,0,0,5088,8671
17729,7456307,7463922,7464166,0,0,7615,7859
17728,7456300,7462429,7464260,0,0,6129,7960
17730,7457792,7464166,7464422,0,0,6374,6630
17739,7461140,7463688,7465378,0,0,2548,4238
17690,7434775,7442644,7465973,0,0,7869,31198
17731,7458201,7464260,7467195,0,0,6059,8994
17745,7462987,7465378,7467195,0,0,2391,4208
17734,7459387,7467195,7467516,0,0,7808,8129
17733,7458841,7464422,7468130,0,0,5581,9289
17736,7459774,7468130,7468371,0,0,8356,8597
17732,7458292,7458292,7468466,0,0,0,10174
17738,7460687,7468371,7468631,0,0,7684,7944
17740,7461532,7468631,7468897,0,0,7099,7365
17741,7461561,7467516,7470259,0,0,5955,8698
17753,7464976,7470259,7470609,0,0,5283,5633
17750,7464408,7470259,7470780,0,0,5851,6372
17746,7463098,7467195,7471255,0,0,4097,8157
17747,7463117,7468466,7472872,0,0,5349,9755
17769,7473338,7473338,7473677,0,0,0,339
17723,7453440,7465973,7473760,0,0,12533,20320
17743,7462568,7473760,7473820,0,0,11192,11252
17748,7463849,7473820,7473846,0,0,9971,9997
17696,7441973,7450663,7474016,0,0,8690,32043
17744,7462861,7473760,7474021,0,0,10899,11160
17752,7464903,7474021,7474394,0,0,9118,9491
17742,7462556,7468897,7474520,0,0,6341,11964
17758,7466911,7474520,7474946,0,0,7609,8035
17762,7468038,7474394,7475627,0,0,6356,7589
17754,7465123,7474394,7475643,0,0,9271,10520
17755,7465415,7470609,7476393,0,0,5194,10978
17757,7465642,7470780,7476668,0,0,5138,11026
17766,7471536,7475627,7477157,0,0,4091,5621
17749,7464133,7473846,7477234,0,0,9713,13101
17767,7471651,7477234,7477494,0,0,5583,5843
17698,7445182,7474016,7478937,0,0,28834,33755
17764,7468185,7476393,7480294,0,0,8208,12109
17768,7472093,7477494,7480855,0,0,5401,8762
17765,7468523,7471255,7481620,0,0,2732,13097
17760,7467184,7474946,7481682,0,0,7762,14498
17751,7464639,7481682,7482451,0,0,17043,17812
17773,7480264,7480264,7482585,0,0,0,2321
17771,7477467,7480294,7483603,0,0,2827,6136
17713,7450388,7478937,7485323,0,0,28549,34935
17775,7480801,7480801,7485656,0,0,0,4855
17777,7483173,7483173,7488196,0,0,0,5023
17756,7465463,7482451,7488588,0,0,16988,23125
17778,7486060,7486060,7488616,0,0,0,2556
17772,7478828,7478828,7489082,0,0,0,10254
17779,7488369,7488369,7491219,0,0,0,2850
17715,7450563,7485323,7496552,0,0,34760,45989
17720,7451679,7496552,7496670,0,0,44873,44991
17759,7467107,7488588,7499037,0,0,21481,31930
17780,7489085,7489085,7499243,0,0,0,10158
17783,7491507,7491507,7505839,0,0,0,14332
17770,7476827,7499037,7507981,0,0,22210,31154
17784,7499327,7499327,7509246,0,0,0,9919
17761,7467345,7496670,7513348,0,0,29325,46003
17776,7482050,7507981,7515893,0,0,25931,33843
17763,7468103,7513348,7519304,0,0,45245,51201
17785,7509189,7509189,7519418,0,0,0,10229
17786,7509859,7509859,7524169,0,0,0,14310
17774,7480312,7519304,7525658,0,0,38992,45346
17790,7523664,7524169,7527486,0,0,505,3822
17791,7525966,7525966,7528711,0,0,0,2745
17792,7526350,7526350,7529075,0,0,0,2725
17787,7519420,7519420,7529407,0,0,0,9987
17794,7529010,7529010,7529945,0,0,0,935
17789,7522239,7522239,7530117,0,0,0,7878
17793,7526987,7527486,7530788,0,0,499,3801
17799,7530297,7530788,7531185,0,0,491,888
17801,7530659,7531185,7531399,0,0,526,740
17795,7529190,7529190,7531941,0,0,0,2751
17802,7530720,7531941,7532421,0,0,1221,1701
17803,7531086,7531185,7532794,0,0,99,1708
17807,7532808,7532808,7532917,0,0,0,109
17797,7530112,7530112,7533016,0,0,0,2904
17810,7533998,7533998,7534068,0,0,0,70
17809,7533938,7533938,7535065,0,0,0,1127
17781,7490781,7525658,7535470,0,0,34877,44689
17798,7530123,7530123,7537929,0,0,0,7806
17813,7535399,7535399,7538410,0,0,0,3011
17808,7533561,7537929,7538443,0,0,4368,4882
17816,7536206,7538410,7538481,0,0,2204,2275
17804,7531258,7532421,7538518,0,0,1163,7260
17820,7537317,7538518,7538593,0,0,1201,1276
17818,7536574,7538518,7538610,0,0,1944,2036
17811,7535138,7538443,7538894,0,0,3305,3756
17822,7537538,7538593,7538901,0,0,1055,1363
17819,7536670,7538894,7538945,0,0,2224,2275
17812,7535235,7535235,7539020,0,0,0,3785
17814,7535560,7538410,7539180,0,0,2850,3620
17796,7529409,7529409,7539351,0,0,0,9942
17815,7535669,7538518,7539485,0,0,2849,3816
17830,7539497,7539497,7539507,0,0,0,10
17831,7539570,7539570,7539577,0,0,0,7
17825,7538537,7538610,7539754,0,0,73,1217
17832,7539648,7539648,7540168,0,0,0,520
17817,7536564,7538481,7540227,0,0,1917,3663
17827,7539017,7540227,7540495,0,0,1210,1478
17833,7540208,7540495,7540758,0,0,287,550
17835,7540432,7540758,7541081,0,0,326,649
17834,7540344,7540758,7541190,0,0,414,846
17836,7540783,7541081,7541385,0,0,298,602
17839,7541095,7541190,7541392,0,0,95,297
17841,7541724,7541724,7541741,0,0,0,17
17842,7541918,7541918,7541934,0,0,0,16
17805,7531485,7537929,7541972,0,0,6444,10487
17826,7538599,7538894,7541998,0,0,295,3399
17840,7541305,7541385,7542190,0,0,80,885
17844,7542174,7542174,7542220,0,0,0,46
17838,7540978,7542220,7542256,0,0,1242,1278
17821,7537362,7538945,7542542,0,0,1583,5180
17845,7542270,7542270,7542568,0,0,0,298
17828,7539072,7539180,7542927,0,0,108,3855
17846,7542815,7542927,7544486,0,0,112,1671
17847,7542886,7544486,7544815,0,0,1600,1929
17837,7540966,7541972,7545421,0,0,1006,4455
17849,7543514,7545421,7545698,0,0,1907,2184
17843,7542094,7542094,7546104,0,0,0,4010
17853,7546050,7546104,7546391,0,0,54,341
17855,7546236,7546391,7546535,0,0,155,299
17856,7546554,7546554,7547009,0,0,0,455
17857,7546828,7547009,7547207,0,0,181,379
17806,7532784,7542568,7548066,0,0,9784,15282
17852,7545541,7545541,7548561,0,0,0,3020
17860,7547292,7548561,7548792,0,0,1269,1500
17848,7543325,7544486,7549133,0,0,1161,5808
17850,7544421,7545698,7549194,0,0,1277,4773
17869,7548922,7549133,7549352,0,0,211,430
17851,7545020,7549194,7549469,0,0,4174,4449
17829,7539384,7539384,7549627,0,0,0,10243
17861,7547564,7549469,7549743,0,0,1905,2179
17865,7547958,7549743,7549767,0,0,1785,1809
17858,7547032,7549469,7549878,0,0,2437,2846
17870,7549106,7549352,7550056,0,0,246,950
17862,7547776,7548792,7550185,0,0,1016,2409
17866,7547993,7549767,7550719,0,0,1774,2726
17859,7547056,7547207,7550970,0,0,151,3914
17871,7549116,7549878,7551181,0,0,762,2065
17863,7547821,7551181,7551449,0,0,3360,3628
17880,7550814,7550814,7551769,0,0,0,955
17882,7551517,7551769,7552187,0,0,252,670
17873,7549372,7550185,7553156,0,0,813,3784
17887,7552773,7553156,7553471,0,0,383,698
17889,7553675,7553675,7554037,0,0,0,362
17890,7554958,7554958,7555074,0,0,0,116
17883,7551525,7552187,7555649,0,0,662,4124
17864,7547925,7551449,7555832,0,0,3524,7907
17823,7537932,7548066,7556037,0,0,10134,18105
17868,7548249,7556037,7556056,0,0,7788,7807
17875,7549882,7556056,7556096,0,0,6174,6214
17867,7548234,7555832,7556099,0,0,7598,7865
17877,7550429,7556099,7556141,0,0,5670,5712
17878,7550443,7556141,7556179,0,0,5698,5736
17872,7549185,7556037,7556310,0,0,6852,7125
17876,7550334,7556096,7556420,0,0,5762,6086
17886,7552338,7556420,7556696,0,0,4082,4358
17892,7555761,7556696,7557010,0,0,935,1249
17897,7556320,7557010,7557879,0,0,690,1559
17884,7552244,7553156,7557899,0,0,912,5655
17888,7553106,7555649,7558166,0,0,2543,5060
17900,7557810,7558166,7558402,0,0,356,592
17902,7558590,7558590,7558646,0,0,0,56
17782,7490800,7535470,7558662,0,0,44670,67862
17899,7557375,7557899,7558696,0,0,524,1321
17896,7556242,7556696,7559239,0,0,454,2997
17874,7549598,7549627,7559558,0,0,29,9960
17885,7552314,7556310,7560361,0,0,3996,8047
17898,7556819,7557879,7560725,0,0,1060,3906
17893,7555813,7556696,7561330,0,0,883,5517
17879,7550491,7556179,7561504,0,0,5688,11013
17901,7558161,7560361,7563675,0,0,2200,5514
17906,7561494,7563675,7563751,0,0,2181,2257
17905,7561482,7561504,7564812,0,0,22,3330
17788,7520347,7558662,7565549,0,0,38315,45202
17907,7564800,7564800,7568111,0,0,0,3311
17904,7559533,7559533,7569851,0,0,0,10318
17881,7551406,7568111,7575907,0,0,16705,24501
17894,7556067,7559239,7579282,0,0,3172,23215
17912,7569853,7569853,7579777,0,0,0,9924
17917,7579867,7579867,7579917,0,0,0,50
17800,7530310,7565549,7583565,0,0,35239,53255
17903,7559207,7575907,7583677,0,0,16700,24470
17909,7565087,7583677,7583696,0,0,18590,18609
17824,7538185,7583565,7584047,0,0,45380,45862
17854,7546071,7584047,7584069,0,0,37976,37998
17916,7579783,7579783,7589707,0,0,0,9924
17910,7565431,7583696,7591349,0,0,18265,25918
17915,7579073,7579282,7593588,0,0,209,14515
17891,7555219,7584069,7593770,0,0,28850,38551
17895,7556203,7593770,7593790,0,0,37567,37587
17908,7565030,7593790,7594970,0,0,28760,29940
17913,7572728,7594970,7595034,0,0,22242,22306
17919,7589712,7589712,7600007,0,0,0,10295
17911,7566982,7591349,7607790,0,0,24367,40808
17921,7600007,7600007,7609948,0,0,0,9941
17914,7574663,7595034,7611953,0,0,20371,37290
17918,7585138,7611953,7614744,0,0,26815,29606
17925,7610141,7614744,7614765,0,0,4603,4624
17929,7613448,7614765,7614840,0,0,1317,1392
17922,7606651,7609948,7617888,0,0,3297,11237
17933,7616766,7617888,7617950,0,0,1122,1184
17924,7610129,7614744,7618045,0,0,4615,7916
17928,7613437,7614744,7618055,0,0,1307,4618
17935,7618598,7618598,7618745,0,0,0,147
17934,7617502,7617950,7618786,0,0,448,1284
17936,7618740,7618740,7619015,0,0,0,275
17926,7610160,7619015,7619076,0,0,8855,8916
17937,7619081,7619081,7619223,0,0,0,142
17932,7616754,7616754,7620097,0,0,0,3343
17941,7621147,7621147,7621289,0,0,0,142
17927,7611380,7619076,7621895,0,0,7696,10515
17942,7621827,7621827,7621968,0,0,0,141
17944,7622339,7622339,7622481,0,0,0,142
17920,7591103,7607790,7623336,0,0,16687,32233
17938,7619168,7623336,7623547,0,0,4168,4379
17923,7609952,7614744,7625052,0,0,4792,15100
17947,7626647,7626647,7626713,0,0,0,66
17948,7626815,7626815,7626890,0,0,0,75
17949,7628008,7628008,7628045,0,0,0,37
17950,7628254,7628254,7628269,0,0,0,15
17939,7619385,7623547,7628423,0,0,4162,9038
17952,7628718,7628718,7628736,0,0,0,18
17953,7628836,7628836,7628852,0,0,0,16
17954,7629163,7629163,7629180,0,0,0,17
17955,7629307,7629307,7629352,0,0,0,45
17957,7629500,7629500,7629536,0,0,0,36
17940,7620260,7620260,7630168,0,0,0,9908
17946,7624295,7630168,7630191,0,0,5873,5896
17951,7628389,7630191,7630863,0,0,1802,2474
17945,7624282,7628423,7632258,0,0,4141,7976
17963,7630995,7632258,7632271,0,0,1263,1276
17965,7631316,7632258,7632271,0,0,942,955
17966,7631441,7632258,7632272,0,0,817,831
17970,7631984,7632272,7632284,0,0,288,300
17964,7631123,7632258,7632295,0,0,1135,1172
17961,7630775,7632258,7632296,0,0,1483,1521
17967,7631569,7632258,7632296,0,0,689,727
17956,7629410,7630863,7632300,0,0,1453,2890
17960,7630256,7632258,7632301,0,0,2002,2045
17968,7631781,7632271,7632308,0,0,490,527
17969,7631894,7632271,7632308,0,0,377,414
17971,7632558,7632558,7632575,0,0,0,17
17962,7630955,7632300,7634769,0,0,1345,3814
17930,7614195,7621895,7636126,0,0,7700,21931
17959,7630214,7632258,7642164,0,0,2044,11950
17973,7647292,7647292,7647799,0,0,0,507
17974,7648239,7648239,7648748,0,0,0,509
17972,7640082,7640082,7650226,0,0,0,10144
17975,7649321,7649321,7650530,0,0,0,1209
17931,7614592,7636126,7654660,0,0,21534,40068
17943,7622233,7654660,7659193,0,0,32427,36960
17976,7650274,7650274,7660193,0,0,0,9919
17977,7650556,7650556,7662045,0,0,0,11489
17958,7629672,7659193,7664701,0,0,29521,35029
17978,7651506,7664701,7669305,0,0,13195,17799
17979,7660151,7660151,7670346,0,0,0,10195
17983,7668553,7668553,7673431,0,0,0,4878
17980,7661622,7669305,7673853,0,0,7683,12231
17982,7666173,7673853,7678363,0,0,7680,12190
17981,7664335,7664335,7678670,0,0,0,14335
17984,7668957,7668957,7679419,0,0,0,10462
17985,7670347,7670347,7680210,0,0,0,9863
17986,7670686,7678363,7683106,0,0,7677,12420
17989,7679419,7679419,7686966,0,0,0,7547
17991,7680271,7680271,7690205,0,0,0,9934
17993,7686969,7686969,7694405,0,0,0,7436
17999,7695243,7695243,7695522,0,0,0,279
17995,7690146,7690146,7700402,0,0,0,10256
17998,7694408,7694408,7701953,0,0,0,7545
17987,7672807,7683106,7704645,0,0,10299,31838
17988,7675431,7704645,7709237,0,0,29214,33806
18004,7704498,7704498,7709499,0,0,0,5001
18001,7700406,7700406,7710612,0,0,0,10206
18002,7701956,7701956,7710777,0,0,0,8821
17990,7680026,7709237,7713814,0,0,29211,33788
17992,7684606,7713814,7718339,0,0,29208,33733
18007,7710780,7710780,7721194,0,0,0,10414
18006,7710665,7710665,7721261,0,0,0,10596
17994,7689134,7718339,7722867,0,0,29205,33733
18016,7730293,7730293,7730684,0,0,0,391
18010,7721211,7721211,7731462,0,0,0,10251
18009,7721197,7721197,7731780,0,0,0,10583
18015,7728666,7728666,7734068,0,0,0,5402
17996,7692002,7722867,7734210,0,0,30865,42208
18019,7731525,7731525,7735299,0,0,0,3774
17997,7693665,7734210,7738723,0,0,40545,45058
18018,7731475,7731475,7741630,0,0,0,10155
18000,7698181,7738723,7743291,0,0,40542,45110
18003,7702752,7743291,7748097,0,0,40539,45345
18020,7731782,7731782,7749123,0,0,0,17341
18024,7750849,7750849,7751783,0,0,0,934
18028,7752591,7752591,7752748,0,0,0,157
18027,7752077,7752077,7753176,0,0,0,1099
18005,7707456,7748097,7754557,0,0,40641,47101
18023,7741631,7749123,7759348,0,0,7492,17717
18008,7714121,7754557,7759371,0,0,40436,45250
18026,7751857,7751857,7761745,0,0,0,9888
18022,7734108,7741630,7764067,0,0,7522,29959
18011,7725384,7759371,7764229,0,0,33987,38845
18012,7725447,7764229,7764286,0,0,38782,38839
18013,7725776,7764286,7764701,0,0,38510,38925
18014,7728010,7764701,7765248,0,0,36691,37238
18029,7753547,7761745,7765663,0,0,8198,12116
18017,7730617,7765248,7769914,0,0,34631,39297
18021,7732711,7769914,7770319,0,0,37203,37608
18032,7761746,7764067,7774277,0,0,2321,12531
18035,7774324,7774324,7774373,0,0,0,49
18036,7774717,7774717,7774763,0,0,0,46
18037,7775071,7775071,7775121,0,0,0,50
18033,7762727,7765663,7776324,0,0,2936,13597
18034,7771959,7771959,7781859,0,0,0,9900
18030,7756078,7781859,7782782,0,0,25781,26704
18031,7758901,7782782,7787309,0,0,23881,28408
18038,7782066,7787309,7787325,0,0,5243,5259
18025,7751394,7770319,7788831,0,0,18925,37437
18039,7782085,7788831,7793340,0,0,6746,11255
18040,7786144,7787309,7795016,0,0,1165,8872
18045,7795447,7795447,7795491,0,0,0,44
18046,7796117,7796117,7796132,0,0,0,15
18049,7797180,7797180,7797202,0,0,0,22
18050,7797336,7797336,7797402,0,0,0,66
18051,7797487,7797487,7797499,0,0,0,12
18052,7797631,7797631,7797693,0,0,0,62
18053,7797743,7797743,7797808,0,0,0,65
18041,7786914,7793340,7797865,0,0,6426,10951
18054,7798094,7798094,7798161,0,0,0,67
18055,7798822,7798822,7798893,0,0,0,71
18056,7799332,7799332,7799401,0,0,0,69
18047,7796257,7796257,7799713,0,0,0,3456
18058,7799651,7799651,7799733,0,0,0,82
18057,7799604,7799604,7800075,0,0,0,471
18059,7800030,7800030,7800101,0,0,0,71
18042,7789601,7789601,7801136,0,0,0,11535
18060,7800696,7800696,7801412,0,0,0,716
18043,7791756,7797865,7802361,0,0,6109,10605
18063,7802374,7802374,7803117,0,0,0,743
18064,7804274,7804274,7804310,0,0,0,36
18065,7804510,7804510,7804605,0,0,0,95
18066,7804890,7804890,7804957,0,0,0,67
18067,7805032,7805032,7805129,0,0,0,97
18068,7805192,7805192,7806138,0,0,0,946
18069,7805518,7806138,7806231,0,0,620,713
18044,7793873,7802361,7807411,0,0,8488,13538
18061,7801315,7801315,7808978,0,0,0,7663
18062,7801336,7808978,7813585,0,0,7642,12249
18048,7796333,7807411,7818822,0,0,11078,22489
18073,7815520,7818822,7819485,0,0,3302,3965
18072,7813679,7818822,7819518,0,0,5143,5839
18074,7817098,7818822,7819907,0,0,1724,2809
18070,7810136,7813585,7825486,0,0,3449,15350
18071,7813072,7818822,7826409,0,0,5750,13337
18077,7820760,7820760,7828355,0,0,0,7595
18076,7819625,7828355,7829321,0,0,8730,9696
18075,7817309,7825486,7830307,0,0,8177,12998
18079,7833002,7833002,7835394,0,0,0,2392
18081,7834621,7834621,7835650,0,0,0,1029
18082,7835471,7835471,7835752,0,0,0,281
18078,7828357,7829321,7836915,0,0,964,8558
18080,7834543,7834543,7836994,0,0,0,2451
18084,7838007,7838007,7839154,0,0,0,1147
18085,7839818,7839818,7840892,0,0,0,1074
18086,7844506,7844506,7848474,0,0,0,3968
18087,7844611,7848474,7849329,0,0,3863,4718
18088,7845995,7848474,7851937,0,0,2479,5942
18083,7835954,7836915,7855074,0,0,961,19120
18091,7868566,7868566,7869398,0,0,0,832
18089,7855380,7855380,7870875,0,0,0,15495
18094,7873088,7873088,7873126,0,0,0,38
18093,7871202,7871202,7873779,0,0,0,2577
18096,7873772,7873772,7873871,0,0,0,99
18097,7873923,7873923,7873969,0,0,0,46
18098,7874246,7874246,7874292,0,0,0,46
18099,7874304,7874304,7874347,0,0,0,43
18100,7874880,7874880,7874941,0,0,0,61
18101,7875496,7875496,7875566,0,0,0,70
18090,7863881,7863881,7878684,0,0,0,14803
18103,7877651,7877651,7881439,0,0,0,3788
18106,7881228,7881439,7881647,0,0,211,419
18108,7881581,7881647,7881687,0,0,66,106
18109,7881905,7881905,7881935,0,0,0,30
18102,7877125,7877125,7882460,0,0,0,5335
18107,7881511,7881647,7883079,0,0,136,1568
18113,7882797,7883079,7883741,0,0,282,944
18095,7873120,7878684,7884533,0,0,5564,11413
18111,7882616,7884533,7884633,0,0,1917,2017
18092,7870885,7870885,7884966,0,0,0,14081
18114,7885175,7885175,7885408,0,0,0,233
18112,7882780,7884533,7885660,0,0,1753,2880
18104,7877830,7877830,7885757,0,0,0,7927
18110,7882474,7884533,7887811,0,0,2059,5337
18115,7885765,7885765,7889607,0,0,0,3842
18117,7889726,7889726,7889807,0,0,0,81
18118,7889934,7889934,7889988,0,0,0,54
18120,7890419,7890419,7890478,0,0,0,59
18121,7890509,7890509,7890648,0,0,0,139
18119,7890239,7890239,7891046,0,0,0,807
18124,7891097,7891097,7891169,0,0,0,72
18123,7890724,7890724,7891265,0,0,0,541
18125,7891502,7891502,7891590,0,0,0,88
18126,7891884,7891884,7891964,0,0,0,80
18105,7878436,7882460,7892348,0,0,4024,13912
18116,7886808,7886808,7892397,0,0,0,5589
18130,7892551,7892551,7892610,0,0,0,59
18128,7892141,7892141,7892902,0,0,0,761
18131,7892874,7892874,7893628,0,0,0,754
18127,7892099,7892099,7893641,0,0,0,1542
18132,7892947,7893628,7894899,0,0,681,1952
18137,7894468,7894899,7894971,0,0,431,503
18133,7894071,7894071,7895138,0,0,0,1067
18134,7894105,7895138,7895177,0,0,1033,1072
18139,7895030,7895030,7895319,0,0,0,289
18136,7894304,7895177,7896064,0,0,873,1760
18141,7895310,7896064,7896105,0,0,754,795
18140,7895259,7895259,7896173,0,0,0,914
18122,7890526,7890526,7896564,0,0,0,6038
18138,7894891,7896564,7896668,0,0,1673,1777
18147,7896424,7896668,7896726,0,0,244,302
18148,7896883,7896883,7896938,0,0,0,55
18146,7896400,7896668,7897095,0,0,268,695
18144,7895744,7896105,7897573,0,0,361,1829
18145,7895779,7896173,7897588,0,0,394,1809
18142,7895626,7896668,7897979,0,0,1042,2353
18150,7897489,7897489,7898029,0,0,0,540
18155,7898171,7898171,7898184,0,0,0,13
18152,7897567,7897567,7898936,0,0,0,1369
18151,7897551,7897551,7899002,0,0,0,1451
18149,7897230,7898936,7899031,0,0,1706,1801
18156,7898970,7899002,7899052,0,0,32,82
18153,7897927,7897927,7899105,0,0,0,1178
18129,7892475,7892475,7899192,0,0,0,6717
18154,7897943,7899031,7899220,0,0,1088,1277
18158,7899195,7899220,7900362,0,0,25,1167
18143,7895669,7896064,7902498,0,0,395,6829
18160,7899567,7902498,7902750,0,0,2931,3183
18161,7900136,7902750,7902928,0,0,2614,2792
18159,7899203,7899220,7903052,0,0,17,3849
18162,7900861,7900861,7903341,0,0,0,2480
18166,7903955,7903955,7904024,0,0,0,69
18171,7905044,7905044,7905067,0,0,0,23
18172,7905386,7905386,7905406,0,0,0,20
18167,7904056,7904056,7905622,0,0,0,1566
18175,7905682,7905682,7905706,0,0,0,24
18176,7906003,7906003,7906936,0,0,0,933
18157,7899030,7899192,7907103,0,0,162,8073
18135,7894254,7894254,7907555,0,0,0,13301
18174,7905619,7905619,7907735,0,0,0,2116
18165,7903941,7903941,7907913,0,0,0,3972
18173,7905612,7905612,7909671,0,0,0,4059
18177,7908522,7908522,7909867,0,0,0,1345
18178,7908543,7909671,7910092,0,0,1128,1549
18164,7903290,7903290,7911444,0,0,0,8154
18180,7911016,7911016,7911445,0,0,0,429
18163,7903044,7903044,7911690,0,0,0,8646
18181,7911116,7911445,7911893,0,0,329,777
18182,7911432,7911432,7912356,0,0,0,924
18183,7911699,7911699,7912635,0,0,0,936
18184,7912409,7912409,7912893,0,0,0,484
18185,7912446,7912446,7912933,0,0,0,487
18168,7904407,7907735,7916537,0,0,3328,12130
18170,7904969,7916537,7916597,0,0,11568,11628
18169,7904714,7912933,7917493,0,0,8219,12779
18186,7914267,7917493,7917585,0,0,3226,3318
18187,7915147,7917493,7917628,0,0,2346,2481
18188,7915382,7917585,7918077,0,0,2203,2695
18189,7915420,7917628,7918127,0,0,2208,2707
18192,7917580,7918127,7918214,0,0,547,634
18193,7918140,7918214,7918312,0,0,74,172
18191,7916741,7917585,7918490,0,0,844,1749
18196,7918849,7918849,7918880,0,0,0,31
18190,7916642,7917585,7919006,0,0,943,2364
18179,7909459,7916597,7921156,0,0,7138,11697
18195,7918314,7921156,7921227,0,0,2842,2913
18199,7920521,7920521,7921650,0,0,0,1129
18198,7920288,7921227,7922780,0,0,939,2492
18200,7922614,7922614,7922922,0,0,0,308
18202,7923763,7923763,7923931,0,0,0,168
18203,7924385,7924385,7924553,0,0,0,168
18204,7924581,7924581,7925632,0,0,0,1051
18205,7925730,7925730,7925897,0,0,0,167
18206,7926552,7926552,7926719,0,0,0,167
18201,7922809,7922809,7927333,0,0,0,4524
18209,7928340,7928340,7928513,0,0,0,173
18194,7918311,7918312,7928712,0,0,1,10401
18197,7918880,7918880,7933222,0,0,0,14342
18212,7933156,7933156,7933329,0,0,0,173
18207,7927127,7927333,7936162,0,0,206,9035
18208,7928204,7936162,7936174,0,0,7958,7970
18210,7928707,7928712,7936273,0,0,5,7566
18211,7928914,7936174,7940797,0,0,7260,11883
18215,7936272,7936273,7943818,0,0,1,7546
18214,7933540,7940797,7945315,0,0,7257,11775
18213,7933210,7933222,7947598,0,0,12,14388
18217,7946892,7946892,7951389,0,0,0,4497
18216,7943821,7943821,7951395,0,0,0,7574
18221,7952197,7952197,7952337,0,0,0,140
18222,7952648,7952648,7954764,0,0,0,2116
18220,7951402,7951402,7955994,0,0,0,4592
18224,7955019,7955994,7956426,0,0,975,1407
18226,7958292,7958292,7958307,0,0,0,15
18225,7956001,7956426,7960977,0,0,425,4976
18218,7948673,7948673,7963064,0,0,0,14391
18219,7951397,7951397,7963670,0,0,0,12273
18223,7953051,7954764,7965528,0,0,1713,12477
18231,7965698,7965698,7965887,0,0,0,189
18232,7965938,7965938,7966293,0,0,0,355
18234,7966460,7966460,7966658,0,0,0,198
18235,7966713,7966713,7966950,0,0,0,237
18236,7966772,7966772,7967254,0,0,0,482
18227,7959482,7960977,7968014,0,0,1495,8532
18229,7961272,7968014,7968029,0,0,6742,6757
18239,7968358,7968358,7968395,0,0,0,37
18238,7968236,7968236,7968436,0,0,0,200
18240,7968400,7968400,7968458,0,0,0,58
18237,7968028,7968028,7968511,0,0,0,483
18242,7968467,7968467,7968664,0,0,0,197
18241,7968431,7968431,7968976,0,0,0,545
18228,7959621,7963670,7968988,0,0,4049,9367
18230,7965583,7968029,7969694,0,0,2446,4111
18244,7968794,7968794,7969816,0,0,0,1022
18233,7966207,7966207,7969823,0,0,0,3616
18246,7968927,7968976,7970065,0,0,49,1138
18248,7970007,7970007,7970496,0,0,0,489
18249,7970367,7970367,7970826,0,0,0,459
18245,7968905,7968905,7971345,0,0,0,2440
18243,7968493,7968493,7971522,0,0,0,3029
18252,7971647,7971647,7971995,0,0,0,348
18250,7971113,7971113,7972084,0,0,0,971
18255,7972882,7972882,7973277,0,0,0,395
18257,7973701,7973701,7973842,0,0,0,141
18247,7969873,7969873,7974652,0,0,0,4779
18258,7975666,7975666,7975896,0,0,0,230
18260,7976275,7976275,7976349,0,0,0,74
18261,7976719,7976719,7976845,0,0,0,126
18254,7972799,7974652,7977379,0,0,1853,4580
18262,7977479,7977479,7977709,0,0,0,230
18263,7977503,7977503,7977713,0,0,0,210
18265,7978232,7978232,7978279,0,0,0,47
18264,7977974,7977974,7978311,0,0,0,337
18267,7978340,7978340,7978572,0,0,0,232
18266,7978320,7978320,7978658,0,0,0,338
18256,7973483,7973483,7979397,0,0,0,5914
18270,7979221,7979221,7979533,0,0,0,312
18271,7979391,7979391,7979643,0,0,0,252
18273,7979655,7979655,7979784,0,0,0,129
18269,7978753,7978753,7979809,0,0,0,1056
18268,7978740,7978740,7979823,0,0,0,1083
18274,7979732,7979732,7979960,0,0,0,228
18276,7980018,7980018,7980049,0,0,0,31
18278,7980119,7980119,7980358,0,0,0,239
18279,7980366,7980366,7980403,0,0,0,37
18280,7980376,7980376,7980599,0,0,0,223
18283,7980829,7980829,7980862,0,0,0,33
18284,7981089,7981089,7981123,0,0,0,34
18281,7980743,7980743,7981367,0,0,0,624
18275,7979907,7979907,7982008,0,0,0,2101
18285,7981705,7981705,7982037,0,0,0,332
18287,7981725,7982037,7982466,0,0,312,741
18288,7981726,7982466,7982536,0,0,740,810
18291,7982532,7982532,7982565,0,0,0,33
18289,7982192,7982536,7982606,0,0,344,414
18290,7982426,7982606,7982678,0,0,180,252
18277,7980103,7980103,7982898,0,0,0,2795
18292,7982593,7982678,7982945,0,0,85,352
18294,7983003,7983003,7983036,0,0,0,33
18295,7983046,7983046,7983089,0,0,0,43
18297,7983141,7983141,7983177,0,0,0,36
18296,7983117,7983117,7983288,0,0,0,171
18300,7983403,7983403,7983436,0,0,0,33
18298,7983213,7983213,7983492,0,0,0,279
18272,7979416,7979416,7983534,0,0,0,4118
18301,7983488,7983488,7983538,0,0,0,50
18303,7983569,7983569,7983599,0,0,0,30
18304,7983609,7983609,7983637,0,0,0,28
18286,7981714,7981714,7983709,0,0,0,1995
18306,7983693,7983693,7983727,0,0,0,34
18307,7983831,7983831,7983860,0,0,0,29
18302,7983554,7983554,7983864,0,0,0,310
18309,7983922,7983922,7984013,0,0,0,91
18310,7984023,7984023,7984056,0,0,0,33
18311,7984123,7984123,7984152,0,0,0,29
18313,7984263,7984263,7984308,0,0,0,45
18308,7983876,7983876,7984310,0,0,0,434
18314,7984429,7984429,7984478,0,0,0,49
18312,7984199,7984199,7984545,0,0,0,346
18315,7984541,7984541,7984586,0,0,0,45
18316,7984601,7984601,7984720,0,0,0,119
18259,7976129,7977379,7984922,0,0,1250,8793
18253,7971856,7971856,7985100,0,0,0,13244
18319,7985102,7985102,7985152,0,0,0,50
18318,7984854,7984854,7985168,0,0,0,314
18322,7985212,7985212,7985304,0,0,0,92
18317,7984818,7984818,7985632,0,0,0,814
18326,7985565,7985565,7985654,0,0,0,89
18327,7985610,7985610,7985745,0,0,0,135
18325,7985525,7985745,7985846,0,0,220,321
18328,7985794,7985846,7985894,0,0,52,100
18329,7985887,7985887,7985932,0,0,0,45
18320,7985194,7985194,7986001,0,0,0,807
18333,7985992,7986001,7986092,0,0,9,100
18323,7985279,7985279,7986207,0,0,0,928
18332,7985981,7985981,7986335,0,0,0,354
18334,7986328,7986328,7986458,0,0,0,130
18321,7985202,7985202,7986525,0,0,0,1323
18336,7986377,7986377,7986557,0,0,0,180
18331,7985972,7985972,7986586,0,0,0,614
18337,7986671,7986671,7986737,0,0,0,66
18340,7986833,7986833,7986906,0,0,0,73
18341,7986880,7986880,7986927,0,0,0,47
18338,7986758,7986758,7986968,0,0,0,210
18343,7987069,7987069,7987200,0,0,0,131
18342,7986963,7986963,7987247,0,0,0,284
18344,7987202,7987202,7987274,0,0,0,72
18339,7986819,7986819,7987414,0,0,0,595
18345,7987380,7987380,7987434,0,0,0,54
18347,7987493,7987493,7987540,0,0,0,47
18350,7987611,7987611,7987660,0,0,0,49
18348,7987536,7987536,7987664,0,0,0,128
18346,7987432,7987432,7987731,0,0,0,299
18349,7987543,7987543,7987771,0,0,0,228
18354,7987977,7987977,7988066,0,0,0,89
18352,7987885,7987885,7988094,0,0,0,209
18353,7987966,7987966,7988384,0,0,0,418
18351,7987653,7987653,7988655,0,0,0,1002
18358,7989069,7989069,7989119,0,0,0,50
18359,7989155,7989155,7989459,0,0,0,304
18330,7985964,7985964,7989947,0,0,0,3983
18360,7989622,7989622,7990095,0,0,0,473
18335,7986364,7986364,7990337,0,0,0,3973
18361,7990331,7990331,7990769,0,0,0,438
18363,7990519,7990519,7990873,0,0,0,354
18305,7983666,7983709,7991100,0,0,43,7434
18362,7990368,7990368,7991259,0,0,0,891
18366,7991224,7991224,7991570,0,0,0,346
18368,7991365,7991365,7991727,0,0,0,362
18251,7971307,7971307,7991997,0,0,0,20690
18369,7991662,7991727,7992113,0,0,65,451
18355,7988270,7988270,7992240,0,0,0,3970
18370,7992262,7992262,7992622,0,0,0,360
18371,7992722,7992722,7992801,0,0,0,79
18372,7992881,7992881,7992904,0,0,0,23
18374,7993970,7993970,7994037,0,0,0,67
18373,7993950,7993950,7994072,0,0,0,122
18375,7994105,7994105,7994536,0,0,0,431
18376,7994145,7994145,7995240,0,0,0,1095
18377,7995928,7995928,7996185,0,0,0,257
18378,7995950,7995950,7996498,0,0,0,548
18380,7996034,7996034,7996525,0,0,0,491
18379,7995993,7995993,7996713,0,0,0,720
18381,7996776,7996776,7997164,0,0,0,388
18367,7991298,7991298,7997210,0,0,0,5912
18357,7988810,7988810,7997235,0,0,0,8425
18383,7997959,7997959,7998423,0,0,0,464
18365,7991066,7991100,7998465,0,0,34,7399
18382,7997455,7997455,7998479,0,0,0,1024
18385,7998437,7998437,7998947,0,0,0,510
18386,7998550,7998550,8002878,0,0,0,4328
18282,7980824,7980824,8003298,0,0,0,22474
18293,7982783,7997210,8008737,0,0,14427,25954
18387,7999573,8002878,8011691,0,0,3305,12118
18390,8005833,8011691,8011750,0,0,5858,5917
18391,8006536,8011750,8011814,0,0,5214,5278
18389,8005168,8011691,8011924,0,0,6523,6756
18394,8007241,8011924,8012079,0,0,4683,4838
18396,8007800,8012079,8012167,0,0,4279,4367
18397,8008180,8012167,8012260,0,0,3987,4080
18398,8008958,8012260,8012346,0,0,3302,3388
18399,8010073,8012346,8012429,0,0,2273,2356
18400,8010411,8012429,8012487,0,0,2018,2076
18388,8000768,8003298,8012666,0,0,2530,11898
18401,8011468,8012487,8012680,0,0,1019,1212
18299,7983384,8008737,8013373,0,0,25353,29989
18324,7985402,8013373,8013481,0,0,27971,28079
18408,8014196,8014196,8014315,0,0,0,119
18356,7988716,8013481,8014360,0,0,24765,25644
18384,7998432,7998465,8014406,0,0,33,15974
18405,8012401,8014406,8014585,0,0,2005,2184
18406,8013371,8014406,8014586,0,0,1035,1215
18403,8012350,8012487,8014754,0,0,137,2404
18410,8014534,8014534,8014759,0,0,0,225
18407,8013747,8014406,8014942,0,0,659,1195
18411,8014847,8014942,8015465,0,0,95,618
18392,8006605,8011814,8015552,0,0,5209,8947
18413,8016476,8016476,8016584,0,0,0,108
18414,8016663,8016663,8017044,0,0,0,381
18412,8016210,8016210,8017370,0,0,0,1160
18364,7990755,8014360,8018890,0,0,23605,28135
18416,8017607,8017607,8021490,0,0,0,3883
18402,8011958,8012666,8026930,0,0,708,14972
18409,8014483,8014759,8029853,0,0,276,15370
18393,8007101,8018890,8030437,0,0,11789,23336
18418,8029578,8029578,8031056,0,0,0,1478
18395,8007700,8030437,8035018,0,0,22737,27318
18404,8012392,8035018,8039516,0,0,22626,27124
18419,8029761,8029853,8039575,0,0,92,9814
18415,8016890,8039516,8044038,0,0,22626,27148
18417,8021418,8039575,8044100,0,0,18157,22682
18421,8044115,8044115,8044582,0,0,0,467
18420,8037495,8044038,8047155,0,0,6543,9660
18423,8045006,8047155,8047556,0,0,2149,2550
18426,8047259,8047556,8048586,0,0,297,1327
18432,8048577,8048586,8049002,0,0,9,425
18434,8048891,8049002,8049096,0,0,111,205
18435,8048906,8049002,8049590,0,0,96,684
18422,8044182,8044582,8050465,0,0,400,6283
18445,8051560,8051560,8051797,0,0,0,237
18440,8049509,8049509,8052199,0,0,0,2690
18441,8049887,8052199,8053687,0,0,2312,3800
18428,8047642,8047642,8054230,0,0,0,6588
18430,8048122,8054230,8054249,0,0,6108,6127
18431,8048219,8054249,8054266,0,0,6030,6047
18433,8048803,8054266,8054309,0,0,5463,5506
18429,8047919,8054230,8054664,0,0,6311,6745
18427,8047583,8047583,8057274,0,0,0,9691
18425,8045706,8050465,8061997,0,0,4759,16291
18446,8051850,8053687,8062802,0,0,1837,10952
18447,8052382,8062802,8063831,0,0,10420,11449
18424,8045247,8047556,8064140,0,0,2309,18893
18451,8053521,8064140,8064244,0,0,10619,10723
18456,8054263,8064244,8064393,0,0,9981,10130
18457,8054451,8064393,8064423,0,0,9942,9972
18458,8054520,8064423,8064550,0,0,9903,10030
18452,8053656,8064140,8064692,0,0,10484,11036
18459,8055171,8064550,8064723,0,0,9379,9552
18460,8055595,8064692,8064863,0,0,9097,9268
18449,8052695,8063831,8064931,0,0,11136,12236
18461,8055621,8064723,8065158,0,0,9102,9537
18462,8055921,8064863,8065184,0,0,8942,9263
18464,8056442,8065158,8065200,0,0,8716,8758
18466,8057143,8065184,8065214,0,0,8041,8071
18471,8057603,8065200,8065234,0,0,7597,7631
18437,8049359,8061997,8065310,0,0,12638,15951
18480,8060399,8065214,8065328,0,0,4815,4929
18481,8060568,8065234,8065363,0,0,4666,4795
18438,8049378,8065310,8065411,0,0,15932,16033
18482,8060716,8065328,8065450,0,0,4612,4734
18486,8061100,8065450,8065689,0,0,4350,4589
18465,8056823,8065411,8065857,0,0,8588,9034
18484,8060774,8065363,8066503,0,0,4589,5729
18489,8061947,8066503,8066843,0,0,4556,4896
18448,8052441,8062802,8067488,0,0,10361,15047
18454,8054220,8065411,8067489,0,0,11191,13269
18463,8056093,8064931,8067595,0,0,8838,11502
18469,8057549,8067489,8067689,0,0,9940,10140
18492,8062347,8067488,8067937,0,0,5141,5590
18450,8053346,8065310,8067952,0,0,11964,14606
18501,8064403,8067937,8067996,0,0,3534,3593
18468,8057463,8067952,8068044,0,0,10489,10581
18508,8065747,8067996,8068056,0,0,2249,2309
18495,8062987,8067595,8068098,0,0,4608,5111
18512,8066463,8068098,8068135,0,0,1635,1672
18476,8059008,8067689,8068150,0,0,8681,9142
18477,8059931,8068044,8068307,0,0,8113,8376
18510,8066124,8068056,8068350,0,0,1932,2226
18514,8066912,8068350,8068371,0,0,1438,1459
18515,8067292,8068371,8068473,0,0,1079,1181
18478,8060095,8068150,8068509,0,0,8055,8414
18474,8058472,8068044,8068513,0,0,9572,10041
18497,8063506,8068509,8068652,0,0,5003,5146
18488,8061564,8068513,8068736,0,0,6949,7172
18493,8062432,8068736,8068814,0,0,6304,6382
18498,8063605,8068652,8068934,0,0,5047,5329
18485,8061006,8068307,8069035,0,0,7301,8029
18502,8064466,8069035,8069046,0,0,4569,4580
18436,8049110,8054309,8069150,0,0,5199,20040
18496,8063046,8068814,8069151,0,0,5768,6105
18490,8062125,8068307,8069185,0,0,6182,7060
18520,8069161,8069161,8069319,0,0,0,158
18487,8061108,8065689,8069390,0,0,4581,8282
18503,8064742,8069151,8069411,0,0,4409,4669
18439,8049384,8054664,8069433,0,0,5280,20049
18491,8062329,8066843,8070606,0,0,4514,8277
18499,8063740,8068934,8070680,0,0,5194,6940
18513,8066584,8068135,8070801,0,0,1551,4217
18444,8050326,8057274,8070804,0,0,6948,20478
18522,8069539,8070606,8070812,0,0,1067,1273
18519,8069105,8070680,8070900,0,0,1575,1795
18525,8070354,8070900,8071044,0,0,546,690
18504,8065375,8069411,8071053,0,0,4036,5678
18516,8067382,8071053,8071147,0,0,3671,3765
18524,8070315,8070812,8071236,0,0,497,921
18511,8066373,8070804,8071313,0,0,4431,4940
18517,8068043,8071147,8071561,0,0,3104,3518
18505,8065482,8069046,8071571,0,0,3564,6089
18527,8070738,8071236,8071598,0,0,498,860
18530,8071495,8071598,8071747,0,0,103,252
18521,8069439,8071561,8071814,0,0,2122,2375
18532,8071942,8071942,8072175,0,0,0,233
18523,8069958,8071814,8072202,0,0,1856,2244
18470,8057596,8067689,8072239,0,0,10093,14643
18534,8072250,8072250,8072327,0,0,0,77
18529,8071177,8072202,8072491,0,0,1025,1314
18533,8072177,8072177,8072616,0,0,0,439
18531,8071893,8072491,8072711,0,0,598,818
18506,8065515,8069185,8072807,0,0,3670,7292
18535,8072257,8072616,8072852,0,0,359,595
18475,8058829,8072852,8072966,0,0,14023,14137
18479,8060292,8072966,8074020,0,0,12674,13728
18507,8065537,8069390,8074660,0,0,3853,9123
18528,8070822,8071571,8074971,0,0,749,4149
18526,8070669,8071044,8075393,0,0,375,4724
18537,8075159,8075159,8076171,0,0,0,1012
18467,8057272,8065857,8076880,0,0,8585,19608
18539,8076520,8076880,8079145,0,0,360,2625
18540,8078038,8079145,8079555,0,0,1107,1517
18538,8076183,8076183,8079962,0,0,0,3779
18542,8078143,8079962,8080000,0,0,1819,1857
18543,8078668,8080000,8080032,0,0,1332,1364
18509,8066105,8069433,8080704,0,0,3328,14599
18518,8068238,8071313,8080983,0,0,3075,12745
18500,8064154,8069150,8081168,0,0,4996,17014
18545,8080035,8080704,8081823,0,0,669,1788
18544,8078754,8080032,8083263,0,0,1278,4509
18547,8083805,8083805,8083847,0,0,0,42
18548,8083950,8083950,8084396,0,0,0,446
18546,8082315,8082315,8086234,0,0,0,3919
18536,8073524,8074660,8086458,0,0,1136,12934
18541,8078066,8079555,8086570,0,0,1489,8504
18494,8062787,8074020,8090434,0,0,11233,27647
18442,8050083,8086458,8090623,0,0,36375,40540
18443,8050122,8090623,8090684,0,0,40501,40562
18453,8053776,8090684,8090694,0,0,36908,36918
18549,8085022,8085022,8091309,0,0,0,6287
18551,8086704,8090434,8091827,0,0,3730,5123
18550,8086493,8086570,8093677,0,0,77,7184
18552,8088191,8090434,8094291,0,0,2243,6100
18553,8093223,8093223,8097139,0,0,0,3916
18472,8057727,8097139,8097489,0,0,39412,39762
18473,8058430,8097489,8097972,0,0,39059,39542
18483,8060727,8097972,8099655,0,0,37245,38928
18554,8097527,8099655,8099843,0,0,2128,2316
18455,8054229,8090694,8110482,0,0,36465,56253
18556,8123903,8123903,8123989,0,0,0,86
18558,8126593,8126593,8126669,0,0,0,76
18559,8126705,8126705,8126915,0,0,0,210
18560,8126853,8126915,8127106,0,0,62,253
18561,8126992,8127106,8127228,0,0,114,236
18562,8127555,8127555,8127771,0,0,0,216
18563,8127628,8127771,8127918,0,0,143,290
18564,8129257,8129257,8130211,0,0,0,954
18566,8131540,8131540,8131556,0,0,0,16
18568,8131971,8131971,8132052,0,0,0,81
18567,8131744,8131744,8132118,0,0,0,374
18557,8125627,8125627,8132435,0,0,0,6808
18569,8132279,8132279,8133030,0,0,0,751
18570,8132971,8132971,8133055,0,0,0,84
18571,8133738,8133738,8133963,0,0,0,225
18572,8134230,8134230,8134319,0,0,0,89
18574,8134506,8134506,8134716,0,0,0,210
18575,8135482,8135482,8135496,0,0,0,14
18573,8134385,8134385,8135857,0,0,0,1472
18576,8135515,8135515,8135858,0,0,0,343
18565,8129946,8129946,8135910,0,0,0,5964
18578,8135728,8135728,8135927,0,0,0,199
18580,8135952,8135952,8136034,0,0,0,82
18581,8135995,8135995,8136130,0,0,0,135
18584,8136150,8136150,8136324,0,0,0,174
18555,8122065,8122065,8136445,0,0,0,14380
18582,8136089,8136089,8136667,0,0,0,578
18586,8136782,8136782,8136832,0,0,0,50
18583,8136101,8136101,8136846,0,0,0,745
18585,8136317,8136317,8137061,0,0,0,744
18587,8136990,8136990,8137074,0,0,0,84
18588,8137040,8137040,8137087,0,0,0,47
18577,8135700,8135700,8137098,0,0,0,1398
18590,8137088,8137098,8137139,0,0,10,51
18589,8137067,8137074,8137164,0,0,7,97
18591,8137154,8137154,8137200,0,0,0,46
18592,8137161,8137164,8137244,0,0,3,83
18593,8137334,8137334,8137591,0,0,0,257
18579,8135922,8135922,8137970,0,0,0,2048
18594,8137635,8137635,8138000,0,0,0,365
18596,8137983,8137983,8138140,0,0,0,157
18597,8138086,8138086,8138145,0,0,0,59
18598,8138456,8138456,8138506,0,0,0,50
18599,8138784,8138784,8138833,0,0,0,49
18600,8138871,8138871,8138997,0,0,0,126
18601,8139610,8139610,8139624,0,0,0,14
18602,8139718,8139718,8139770,0,0,0,52
18603,8140242,8140242,8140557,0,0,0,315
18604,8140329,8140329,8140909,0,0,0,580
18605,8140725,8140725,8141047,0,0,0,322
18607,8141036,8141036,8141145,0,0,0,109
18609,8141191,8141191,8141340,0,0,0,149
18610,8141395,8141395,8141612,0,0,0,217
18613,8141542,8141542,8141679,0,0,0,137
18611,8141429,8141612,8141800,0,0,183,371
18608,8141146,8141146,8142003,0,0,0,857
18614,8142036,8142036,8142788,0,0,0,752
18615,8142802,8142802,8142814,0,0,0,12
18617,8142866,8142866,8143766,0,0,0,900
18622,8143835,8143835,8144179,0,0,0,344
18612,8141505,8141800,8145048,0,0,295,3543
18618,8142874,8145048,8145062,0,0,2174,2188
18619,8142923,8145048,8145075,0,0,2125,2152
18623,8144580,8145048,8145181,0,0,468,601
18625,8145199,8145199,8145641,0,0,0,442
18620,8142957,8145048,8145812,0,0,2091,2855
18628,8145747,8145747,8145874,0,0,0,127
18621,8143344,8145874,8146357,0,0,2530,3013
18616,8142860,8142860,8147402,0,0,0,4542
18629,8145926,8147402,8147414,0,0,1476,1488
18630,8146388,8147414,8147488,0,0,1026,1100
18631,8146519,8147414,8147559,0,0,895,1040
18633,8147174,8147488,8147715,0,0,314,541
18632,8146980,8147715,8147871,0,0,735,891
18634,8147341,8147871,8148030,0,0,530,689
18635,8147596,8148030,8148327,0,0,434,731
18636,8147907,8148327,8149013,0,0,420,1106
18639,8148289,8149013,8149158,0,0,724,869
18637,8147926,8149013,8149183,0,0,1087,1257
18640,8148721,8149158,8149326,0,0,437,605
18638,8148282,8149326,8149363,0,0,1044,1081
18641,8148826,8149363,8149391,0,0,537,565
18642,8149011,8149391,8149397,0,0,380,386
18643,8149024,8149397,8149419,0,0,373,395
18644,8149225,8149419,8149441,0,0,194,216
18595,8137807,8137807,8149520,0,0,0,11713
18648,8149665,8149665,8149776,0,0,0,111
18645,8149328,8149441,8149825,0,0,113,497
18647,8149585,8149585,8150230,0,0,0,645
18646,8149524,8149524,8150281,0,0,0,757
18651,8150517,8150517,8151850,0,0,0,1333
18656,8151960,8151960,8151978,0,0,0,18
18624,8145087,8145087,8152041,0,0,0,6954
18654,8150987,8152041,8152633,0,0,1054,1646
18655,8151889,8152633,8153161,0,0,744,1272
18657,8152100,8153161,8153244,0,0,1061,1144
18652,8150526,8150526,8154090,0,0,0,3564
18663,8154083,8154083,8154098,0,0,0,15
18662,8153651,8153651,8154111,0,0,0,460
18664,8154107,8154107,8154118,0,0,0,11
18661,8153194,8153194,8154154,0,0,0,960
18658,8152431,8154118,8155399,0,0,1687,2968
18659,8153049,8155399,8155648,0,0,2350,2599
18660,8153089,8155648,8155691,0,0,2559,2602
18670,8155502,8155691,8156125,0,0,189,623
18671,8155774,8156125,8156227,0,0,351,453
18675,8156190,8156227,8156313,0,0,37,123
18676,8156368,8156368,8156467,0,0,0,99
18678,8156522,8156522,8156600,0,0,0,78
18680,8156644,8156644,8156738,0,0,0,94
18681,8156738,8156738,8156826,0,0,0,88
18667,8155063,8155063,8157087,0,0,0,2024
18668,8155195,8155691,8157094,0,0,496,1899
18684,8157074,8157074,8157150,0,0,0,76
18606,8140771,8140771,8157230,0,0,0,16459
18673,8155893,8157094,8157366,0,0,1201,1473
18688,8157226,8157366,8157414,0,0,140,188
18683,8157060,8157230,8157460,0,0,170,400
18690,8157579,8157579,8157630,0,0,0,51
18685,8157191,8157191,8157753,0,0,0,562
18626,8145379,8146357,8157860,0,0,978,12481
18689,8157422,8157460,8157913,0,0,38,491
18666,8154203,8157913,8158021,0,0,3710,3818
18669,8155400,8158021,8158135,0,0,2621,2735
18672,8155812,8158135,8158187,0,0,2323,2375
18674,8156138,8158187,8158251,0,0,2049,2113
18627,8145743,8157860,8158282,0,0,12117,12539
18677,8156456,8158251,8158282,0,0,1795,1826
18653,8150725,8150725,8158664,0,0,0,7939
18694,8158243,8158664,8158715,0,0,421,472
18696,8158427,8158715,8158761,0,0,288,334
18649,8149905,8158282,8158785,0,0,8377,8880
18699,8158681,8158761,8158807,0,0,80,126
18679,8156600,8158282,8159500,0,0,1682,2900
18691,8157800,8159500,8160271,0,0,1700,2471
18692,8158194,8160271,8160324,0,0,2077,2130
18693,8158203,8160324,8160606,0,0,2121,2403
18698,8158670,8160606,8160955,0,0,1936,2285
18704,8159969,8160955,8161006,0,0,986,1037
18702,8159055,8160955,8161045,0,0,1900,1990
18708,8160469,8161045,8161210,0,0,576,741
18686,8157199,8157366,8161419,0,0,167,4220
18710,8161402,8161402,8161419,0,0,0,17
18709,8161123,8161419,8161586,0,0,296,463
18650,8150012,8150012,8161720,0,0,0,11708
18695,8158336,8161720,8161804,0,0,3384,3468
18665,8154171,8155691,8161837,0,0,1520,7666
18703,8159847,8161804,8161957,0,0,1957,2110
18706,8160094,8161006,8162018,0,0,912,1924
18711,8161872,8162018,8162036,0,0,146,164
18712,8161949,8162036,8162050,0,0,87,101
18707,8160383,8161957,8162098,0,0,1574,1715
18713,8162304,8162304,8162326,0,0,0,22
18682,8156952,8158785,8162828,0,0,1833,5876
18700,8158703,8158807,8163137,0,0,104,4434
18716,8162649,8162649,8163230,0,0,0,581
18687,8157219,8162828,8163482,0,0,5609,6263
18714,8162312,8163482,8163599,0,0,1170,1287
18717,8163000,8163599,8163673,0,0,599,673
18720,8163422,8163673,8163754,0,0,251,332
18715,8162322,8162322,8163988,0,0,0,1666
18697,8158518,8160324,8165100,0,0,1806,6582
18701,8158907,8161720,8165352,0,0,2813,6445
18723,8163920,8163920,8165612,0,0,0,1692
18724,8165541,8165541,8166091,0,0,0,550
18725,8165935,8165935,8167379,0,0,0,1444
18727,8167270,8167270,8167450,0,0,0,180
18726,8166562,8166562,8167760,0,0,0,1198
18728,8168003,8168003,8168411,0,0,0,408
18721,8163720,8163754,8168684,0,0,34,4964
18719,8163353,8163673,8168967,0,0,320,5614
18729,8168463,8168463,8172554,0,0,0,4091
18730,8168634,8168634,8172717,0,0,0,4083
18731,8174766,8174766,8176836,0,0,0,2070
18722,8163736,8172554,8178329,0,0,8818,14593
18733,8182462,8182462,8182956,0,0,0,494
18705,8160077,8161837,8184278,0,0,1760,24201
18718,8163312,8163673,8186942,0,0,361,23630
18734,8182973,8182973,8197299,0,0,0,14326
18732,8175444,8178329,8200826,0,0,2885,25382
18735,8189371,8197299,8211008,0,0,7928,21637
18736,8215616,8215616,8218741,0,0,0,3125
18739,8220958,8220958,8221202,0,0,0,244
18738,8218677,8218677,8221721,0,0,0,3044
18740,8221388,8221388,8222210,0,0,0,822
18741,8221656,8221656,8224678,0,0,0,3022
18742,8224614,8224614,8227741,0,0,0,3127
18737,8217774,8217774,8229513,0,0,0,11739
18744,8227677,8227677,8230725,0,0,0,3048
18747,8232350,8232350,8232548,0,0,0,198
18748,8232562,8232562,8232843,0,0,0,281
18746,8230662,8230662,8233684,0,0,0,3022
18745,8230001,8230001,8234057,0,0,0,4056
18751,8233837,8233837,8234750,0,0,0,913
18743,8224722,8224722,8236639,0,0,0,11917
18749,8232974,8236639,8236669,0,0,3665,3695
18750,8233621,8233621,8236743,0,0,0,3122
18753,8236352,8236352,8237088,0,0,0,736
18756,8237832,8237832,8237940,0,0,0,108
18755,8237693,8237693,8238426,0,0,0,733
18757,8238374,8238374,8238484,0,0,0,110
18758,8239010,8239010,8239303,0,0,0,293
18754,8236680,8236680,8239695,0,0,0,3015
18752,8236145,8236145,8240238,0,0,0,4093
18760,8241388,8241388,8241469,0,0,0,81
18761,8241648,8241648,8241724,0,0,0,76
18762,8241833,8241833,8241908,0,0,0,75
18763,8242168,8242168,8242217,0,0,0,49
18764,8242373,8242373,8242421,0,0,0,48
18759,8239632,8239632,8242660,0,0,0,3028
18767,8242707,8242707,8242756,0,0,0,49
18765,8242563,8242563,8242778,0,0,0,215
18768,8243161,8243161,8243241,0,0,0,80
18771,8243877,8243877,8243956,0,0,0,79
18772,8244114,8244114,8244192,0,0,0,78
18766,8242596,8242596,8247793,0,0,0,5197
18775,8248351,8248351,8248432,0,0,0,81
18769,8243488,8243488,8250007,0,0,0,6519
18774,8248163,8248163,8250482,0,0,0,2319
18773,8247729,8247729,8251911,0,0,0,4182
18777,8250805,8250805,8254873,0,0,0,4068
18778,8251846,8251911,8254932,0,0,65,3086
18780,8255168,8255168,8255503,0,0,0,335
18776,8248797,8250007,8258600,0,0,1210,9803
18781,8255898,8255898,8259532,0,0,0,3634
18779,8254808,8254873,8260994,0,0,65,6186
18782,8260073,8260073,8261445,0,0,0,1372
18784,8264218,8264218,8264630,0,0,0,412
18770,8243542,8243542,8264691,0,0,0,21149
18785,8264660,8264660,8264697,0,0,0,37
18783,8261478,8261478,8264918,0,0,0,3440
18787,8265059,8265059,8265084,0,0,0,25
18788,8265094,8265094,8265397,0,0,0,303
18791,8265539,8265539,8265851,0,0,0,312
18792,8265997,8265997,8266476,0,0,0,479
18790,8265526,8265526,8266778,0,0,0,1252
18794,8269127,8269127,8269719,0,0,0,592
18796,8269840,8269840,8270266,0,0,0,426
18793,8268891,8268891,8270292,0,0,0,1401
18789,8265240,8265240,8271866,0,0,0,6626
18797,8272279,8272279,8272580,0,0,0,301
18798,8273370,8273370,8275385,0,0,0,2015
18786,8264846,8264846,8278614,0,0,0,13768
18799,8277441,8277441,8279776,0,0,0,2335
18800,8280962,8280962,8281663,0,0,0,701
18795,8269138,8269138,8283467,0,0,0,14329
18801,8282219,8282219,8284244,0,0,0,2025
18803,8284382,8284382,8287390,0,0,0,3008
18802,8283469,8283469,8297819,0,0,0,14350
18804,8304070,8304070,8307388,0,0,0,3318
18809,8309307,8309307,8309365,0,0,0,58
18808,8309113,8309113,8309427,0,0,0,314
18811,8310311,8310311,8310755,0,0,0,444
18806,8307324,8307324,8312717,0,0,0,5393
18813,8313457,8313457,8313923,0,0,0,466
18814,8315476,8315476,8316471,0,0,0,995
18805,8305385,8305385,8317158,0,0,0,11773
18807,8308893,8308893,8318097,0,0,0,9204
18815,8316727,8316727,8318161,0,0,0,1434
18810,8309510,8309510,8318994,0,0,0,9484
18812,8312653,8312653,8320270,0,0,0,7617
18819,8321816,8321816,8322083,0,0,0,267
18820,8325560,8325560,8325630,0,0,0,70
18817,8319001,8319001,8325722,0,0,0,6721
18822,8325740,8325740,8325800,0,0,0,60
18818,8320204,8320204,8326005,0,0,0,5801
18823,8325881,8325881,8326177,0,0,0,296
18825,8326901,8326901,8326974,0,0,0,73
18827,8327988,8327988,8328124,0,0,0,136
18828,8328988,8328988,8329178,0,0,0,190
18829,8329267,8329267,8329423,0,0,0,156
18830,8329451,8329451,8329623,0,0,0,172
18831,8329669,8329669,8329751,0,0,0,82
18832,8329783,8329783,8329919,0,0,0,136
18833,8329969,8329969,8330064,0,0,0,95
18826,8327607,8327607,8330112,0,0,0,2505
18816,8318903,8318903,8330593,0,0,0,11690
18834,8331084,8331084,8331314,0,0,0,230
18835,8331157,8331314,8331475,0,0,157,318
18837,8332110,8332110,8332582,0,0,0,472
18838,8332614,8332614,8332845,0,0,0,231
18839,8332939,8332939,8333282,0,0,0,343
18824,8325966,8326005,8333302,0,0,39,7336
18841,8333348,8333348,8333578,0,0,0,230
18842,8333676,8333676,8334084,0,0,0,408
18843,8334166,8334166,8334355,0,0,0,189
18821,8325728,8325728,8334386,0,0,0,8658
18845,8334476,8334476,8334551,0,0,0,75
18846,8334563,8334563,8335021,0,0,0,458
18847,8336730,8336730,8340153,0,0,0,3423
18840,8333199,8333199,8341985,0,0,0,8786
18848,8338589,8338589,8342641,0,0,0,4052
18850,8342376,8342376,8342684,0,0,0,308
18836,8331188,8331188,8343106,0,0,0,11918
18844,8334392,8334392,8343346,0,0,0,8954
18852,8342993,8342993,8343358,0,0,0,365
18855,8343701,8343701,8343985,0,0,0,284
18856,8345563,8345563,8345860,0,0,0,297
18851,8342770,8342770,8346859,0,0,0,4089
18857,8347134,8347134,8347413,0,0,0,279
18858,8348147,8348147,8348421,0,0,0,274
18860,8349326,8349326,8349596,0,0,0,270
18849,8341927,8341927,8350702,0,0,0,8775
18862,8351174,8351174,8351449,0,0,0,275
18861,8350289,8350289,8352972,0,0,0,2683
18854,8343356,8343356,8353457,0,0,0,10101
18853,8343108,8343108,8354434,0,0,0,11326
18859,8348634,8348634,8356322,0,0,0,7688
18863,8353437,8353437,8357121,0,0,0,3684
18865,8358164,8358164,8360262,0,0,0,2098
18866,8360798,8360798,8360926,0,0,0,128
18867,8365229,8365229,8367253,0,0,0,2024
18868,8367760,8367760,8367899,0,0,0,139
18864,8357641,8357641,8372003,0,0,0,14362
18869,8372005,8372005,8386387,0,0,0,14382
18870,8386873,8386873,8386901,0,0,0,28
18871,8387331,8387331,8387564,0,0,0,233
18872,8387678,8387678,8388537,0,0,0,859
18874,8388234,8388234,8388601,0,0,0,367
18873,8388075,8388075,8389635,0,0,0,1560
18879,8389684,8389684,8389727,0,0,0,43
18880,8389723,8389723,8389752,0,0,0,29
18881,8389800,8389800,8389849,0,0,0,49
18882,8391631,8391631,8391677,0,0,0,46
18875,8388693,8388693,8391873,0,0,0,3180
18877,8389520,8389520,8393297,0,0,0,3777
18878,8389677,8389677,8393666,0,0,0,3989
18885,8393177,8393666,8401758,0,0,489,8581
18890,8394848,8401758,8402082,0,0,6910,7234
18887,8393872,8401758,8402215,0,0,7886,8343
18883,8391918,8391918,8404393,0,0,0,12475
18898,8397359,8404393,8404439,0,0,7034,7080
18895,8396838,8404393,8404456,0,0,7555,7618
18901,8398828,8404456,8404616,0,0,5628,5788
18899,8398074,8404439,8404652,0,0,6365,6578
18884,8392419,8392419,8404806,0,0,0,12387
18888,8394261,8404393,8404922,0,0,10132,10661
18903,8400518,8404616,8404961,0,0,4098,4443
18896,8396940,8404922,8404999,0,0,7982,8059
18905,8401524,8404652,8405067,0,0,3128,3543
18908,8402407,8405067,8405220,0,0,2660,2813
18891,8395620,8404806,8405309,0,0,9186,9689
18910,8403514,8405220,8405346,0,0,1706,1832
18897,8397033,8405309,8405617,0,0,8276,8584
18906,8401798,8404961,8405786,0,0,3163,3988
18907,8402178,8405617,8405825,0,0,3439,3647
18894,8396813,8402215,8405886,0,0,5402,9073
18912,8403823,8405346,8405949,0,0,1523,2126
18886,8393690,8401758,8406041,0,0,8068,12351
18893,8396224,8402082,8406234,0,0,5858,10010
18917,8406187,8406187,8406565,0,0,0,378
18909,8402679,8405617,8407093,0,0,2938,4414
18919,8407019,8407093,8407181,0,0,74,162
18920,8407141,8407141,8407228,0,0,0,87
18921,8407356,8407356,8407416,0,0,0,60
18922,8407518,8407518,8407572,0,0,0,54
18923,8407727,8407727,8407804,0,0,0,77
18892,8396010,8405309,8408458,0,0,9299,12448
18918,8406510,8406565,8408602,0,0,55,2092
18925,8407817,8408602,8408680,0,0,785,863
18924,8407802,8407802,8408793,0,0,0,991
18926,8408026,8408026,8408838,0,0,0,812
18900,8398236,8404999,8409134,0,0,6763,10898
18930,8408366,8408680,8409183,0,0,314,817
18931,8408673,8408793,8409250,0,0,120,577
18933,8408864,8408864,8409344,0,0,0,480
18929,8408254,8408680,8409410,0,0,426,1156
18939,8409480,8409480,8409660,0,0,0,180
18916,8405951,8406041,8409919,0,0,90,3968
18937,8409371,8409371,8409941,0,0,0,570
18934,8409033,8409134,8410042,0,0,101,1009
18927,8408155,8409919,8410207,0,0,1764,2052
18938,8409426,8409426,8410305,0,0,0,879
18944,8410070,8410070,8410306,0,0,0,236
18941,8409960,8409960,8410487,0,0,0,527
18932,8408830,8410207,8410607,0,0,1377,1777
18947,8411033,8411033,8411110,0,0,0,77
18950,8411505,8411505,8411586,0,0,0,81
18936,8409216,8410607,8411649,0,0,1391,2433
18951,8411727,8411727,8411799,0,0,0,72
18946,8410924,8410924,8412190,0,0,0,1266
18940,8409557,8411649,8412255,0,0,2092,2698
18948,8411138,8412190,8412388,0,0,1052,1250
18952,8412016,8412016,8412718,0,0,0,702
18954,8412112,8412718,8412767,0,0,606,655
18935,8409051,8409134,8412984,0,0,83,3933
18889,8394556,8404393,8413972,0,0,9837,19416
18876,8389231,8389231,8414053,0,0,0,24822
18943,8410007,8413972,8414207,0,0,3965,4200
18902,8400143,8405309,8414781,0,0,5166,14638
18904,8401200,8405309,8414990,0,0,4109,13790
18958,8413094,8414990,8415252,0,0,1896,2158
18960,8414103,8415252,8415609,0,0,1149,1506
18961,8415348,8415348,8415633,0,0,0,285
18964,8415934,8415934,8415976,0,0,0,42
18955,8412186,8412984,8416211,0,0,798,4025
18942,8409992,8412255,8416223,0,0,2263,6231
18965,8416036,8416036,8416263,0,0,0,227
18949,8411484,8412388,8416384,0,0,904,4900
18966,8416458,8416458,8416501,0,0,0,43
18968,8416575,8416575,8416659,0,0,0,84
18959,8413834,8415252,8416715,0,0,1418,2881
18967,8416483,8416483,8416786,0,0,0,303
18957,8412817,8414781,8417134,0,0,1964,4317
18969,8416948,8416948,8417596,0,0,0,648
18970,8417880,8417880,8418021,0,0,0,141
18972,8418257,8418257,8418447,0,0,0,190
18971,8418247,8418247,8418478,0,0,0,231
18973,8418585,8418585,8418651,0,0,0,66
18911,8403581,8405886,8418673,0,0,2305,15092
18962,8415561,8415609,8418821,0,0,48,3260
18975,8418749,8418749,8418867,0,0,0,118
18976,8418920,8418920,8418957,0,0,0,37
18977,8419030,8419030,8419054,0,0,0,24
18980,8419329,8419329,8419402,0,0,0,73
18979,8419301,8419301,8419606,0,0,0,305
18913,8404142,8408458,8419957,0,0,4316,15815
18983,8419575,8419957,8420019,0,0,382,444
18984,8419826,8419957,8420093,0,0,131,267
18987,8420266,8420266,8420323,0,0,0,57
18986,8420248,8420248,8420363,0,0,0,115
18989,8420482,8420482,8420551,0,0,0,69
18982,8419531,8419606,8420561,0,0,75,1030
18991,8420676,8420676,8420781,0,0,0,105
18992,8420856,8420856,8420886,0,0,0,30
18993,8420896,8420896,8421025,0,0,0,129
18995,8421515,8421515,8421635,0,0,0,120
18985,8419994,8419994,8421730,0,0,0,1736
18996,8421771,8421771,8421804,0,0,0,33
18978,8419176,8419176,8422456,0,0,0,3280
18945,8410824,8414053,8422494,0,0,3229,11670
18974,8418736,8418736,8422673,0,0,0,3937
18953,8412035,8414207,8423323,0,0,2172,11288
18990,8420613,8422494,8424234,0,0,1881,3621
18988,8420312,8421730,8425339,0,0,1418,5027
18963,8415648,8416223,8425923,0,0,575,10275
18997,8422150,8422456,8426937,0,0,306,4787
18999,8424380,8424380,8427488,0,0,0,3108
19000,8427683,8427683,8427839,0,0,0,156
19001,8427831,8427831,8427926,0,0,0,95
18981,8419474,8419474,8428304,0,0,0,8830
18956,8412597,8417134,8428915,0,0,4537,16318
19002,8429105,8429105,8429190,0,0,0,85
18998,8422530,8424234,8430011,0,0,1704,7481
19003,8429954,8429954,8430039,0,0,0,85
19004,8430120,8430120,8430354,0,0,0,234
19005,8430184,8430184,8430356,0,0,0,172
18994,8421157,8423323,8430471,0,0,2166,9314
19006,8430467,8430467,8430558,0,0,0,91
18914,8404864,8428304,8435448,0,0,23440,30584
18928,8408169,8435448,8438148,0,0,27279,29979
19008,8430712,8438148,8438207,0,0,7436,7495
19009,8430907,8438148,8438238,0,0,7241,7331
19012,8431250,8438148,8438262,0,0,6898,7012
19016,8432432,8438207,8438410,0,0,5775,5978
19007,8430640,8438148,8438705,0,0,7508,8065
19018,8435558,8438705,8438776,0,0,3147,3218
19015,8432222,8438148,8438951,0,0,5926,6729
19019,8436043,8438776,8439101,0,0,2733,3058
19011,8431211,8438148,8439315,0,0,6937,8104
19020,8436698,8439101,8439599,0,0,2403,2901
19022,8437562,8439599,8440456,0,0,2037,2894
18915,8405043,8430558,8442569,0,0,25515,37526
19013,8431272,8442569,8442658,0,0,11297,11386
19017,8432470,8438951,8443123,0,0,6481,10653
19021,8437338,8438262,8444805,0,0,924,7467
19023,8438867,8439315,8448798,0,0,448,9931
19025,8450401,8450401,8453017,0,0,0,2616
19024,8449981,8449981,8454198,0,0,0,4217
19010,8431163,8438238,8461696,0,0,7075,30533
19014,8432002,8442658,8466479,0,0,10656,34477
19026,8465463,8465463,8470481,0,0,0,5018
19027,8472049,8472049,8489772,0,0,0,17723
19029,8490056,8490056,8490192,0,0,0,136
19028,8490055,8490055,8490206,0,0,0,151
19031,8490307,8490307,8490406,0,0,0,99
19033,8490760,8490760,8490887,0,0,0,127
19032,8490732,8490732,8491034,0,0,0,302
19034,8491090,8491090,8491173,0,0,0,83
19036,8491264,8491264,8491318,0,0,0,54
19038,8491380,8491380,8491430,0,0,0,50
19035,8491220,8491220,8491505,0,0,0,285
19040,8491518,8491518,8491541,0,0,0,23
19039,8491437,8491437,8491579,0,0,0,142
19042,8491581,8491581,8491643,0,0,0,62
19044,8491718,8491718,8491740,0,0,0,22
19043,8491694,8491694,8491753,0,0,0,59
19045,8491769,8491769,8491840,0,0,0,71
19030,8490295,8490295,8491905,0,0,0,1610
19047,8491927,8491927,8491942,0,0,0,15
19037,8491325,8491325,8492031,0,0,0,706
19048,8491947,8491947,8492039,0,0,0,92
19049,8492036,8492036,8492074,0,0,0,38
19041,8491525,8491525,8492118,0,0,0,593
19050,8492081,8492081,8492212,0,0,0,131
19054,8492451,8492451,8492464,0,0,0,13
19053,8492442,8492442,8492592,0,0,0,150
19051,8492115,8492115,8492673,0,0,0,558
19056,8492675,8492675,8492766,0,0,0,91
19055,8492666,8492666,8492816,0,0,0,150
19057,8492907,8492907,8493017,0,0,0,110
19058,8493155,8493155,8493210,0,0,0,55
19060,8493319,8493319,8493358,0,0,0,39
19059,8493290,8493290,8493474,0,0,0,184
19063,8493572,8493572,8493599,0,0,0,27
19061,8493448,8493448,8493634,0,0,0,186
19062,8493551,8493551,8493663,0,0,0,112
19064,8493865,8493865,8493915,0,0,0,50
19066,8494090,8494090,8494180,0,0,0,90
19068,8494138,8494138,8494184,0,0,0,46
19069,8494277,8494277,8494309,0,0,0,32
19071,8494294,8494294,8494365,0,0,0,71
19067,8494114,8494114,8494422,0,0,0,308
19065,8493911,8493911,8494655,0,0,0,744
19074,8494803,8494803,8494821,0,0,0,18
19073,8494789,8494789,8494824,0,0,0,35
19075,8494868,8494868,8494921,0,0,0,53
19072,8494474,8494474,8495140,0,0,0,666
19077,8495155,8495155,8495197,0,0,0,42
19078,8495204,8495204,8495219,0,0,0,15
19079,8495226,8495226,8495241,0,0,0,15
19080,8495246,8495246,8495260,0,0,0,14
19081,8495266,8495266,8495281,0,0,0,15
19052,8492149,8492149,8495533,0,0,0,3384
19083,8495422,8495422,8496095,0,0,0,673
19088,8496302,8496302,8496333,0,0,0,31
19089,8497231,8497231,8497586,0,0,0,355
19085,8495516,8495516,8499075,0,0,0,3559
19087,8495918,8495918,8499446,0,0,0,3528
19091,8501113,8501113,8501174,0,0,0,61
19092,8502128,8502128,8502213,0,0,0,85
19090,8499479,8499479,8502976,0,0,0,3497
19086,8495698,8495698,8505896,0,0,0,10198
19076,8494894,8494894,8505987,0,0,0,11093
19046,8491920,8491920,8505993,0,0,0,14073
19084,8495508,8495508,8506033,0,0,0,10525
19082,8495376,8495376,8506035,0,0,0,10659
19070,8494287,8494287,8507145,0,0,0,12858
19099,8512468,8512468,8515818,0,0,0,3350
19094,8508287,8508287,8516205,0,0,0,7918
19093,8508005,8508005,8516356,0,0,0,8351
19096,8508716,8508716,8516393,0,0,0,7677
19097,8508814,8508814,8516543,0,0,0,7729
19098,8508876,8508876,8516633,0,0,0,7757
19102,8516725,8516725,8516784,0,0,0,59
19095,8508563,8508563,8517764,0,0,0,9201
19100,8516724,8516724,8520453,0,0,0,3729
19103,8516725,8516784,8520512,0,0,59,3787
19106,8516784,8517764,8521494,0,0,980,4710
19107,8516784,8517764,8521494,0,0,980,4710
19104,8516783,8520512,8524182,0,0,3729,7399
19101,8516724,8520453,8524183,0,0,3729,7459
19113,8517325,8524182,8524241,0,0,6857,6916
19115,8517444,8524182,8524241,0,0,6738,6797
19114,8517384,8524182,8524242,0,0,6798,6858
19118,8517503,8524183,8524243,0,0,6680,6740
19126,8519003,8524183,8524244,0,0,5180,5241
19123,8518951,8524183,8524296,0,0,5232,5345
19127,8519004,8524241,8524300,0,0,5237,5296
19116,8517444,8524183,8524365,0,0,6739,6921
19124,8518951,8524296,8524409,0,0,5345,5458
19117,8517444,8524183,8524482,0,0,6739,7038
19109,8516843,8521494,8525163,0,0,4651,8320
19110,8516843,8521494,8525164,0,0,4651,8321
19111,8516843,8521494,8525164,0,0,4651,8321
19112,8516843,8521494,8525165,0,0,4651,8322
19120,8517683,8524482,8525563,0,0,6799,7880
19122,8518763,8525164,8525645,0,0,6401,6882
19125,8518951,8525563,8525796,0,0,6612,6845
19128,8519243,8525645,8526854,0,0,6402,7611
19105,8516783,8516783,8528453,0,0,0,11670
19133,8528857,8528857,8528907,0,0,0,50
19134,8528857,8528857,8528908,0,0,0,51
19135,8528857,8528907,8528958,0,0,50,101
19137,8528906,8528906,8532322,0,0,0,3416
19129,8519244,8525796,8533142,0,0,6552,13898
19131,8519604,8524241,8533148,0,0,4637,13544
19138,8532988,8532988,8533170,0,0,0,182
19132,8519604,8524242,8533180,0,0,4638,13576
19130,8519485,8524365,8533332,0,0,4880,13847
19139,8533275,8533275,8533634,0,0,0,359
19119,8517503,8533142,8533865,0,0,15639,16362
19108,8516784,8524182,8535851,0,0,7398,19067
19140,8534503,8534503,8538747,0,0,0,4244
19136,8528857,8538747,8538799,0,0,9890,9942
19121,8518344,8533865,8541939,0,0,15521,23595
19141,8544154,8544154,8552773,0,0,0,8619
19142,8553805,8553805,8556537,0,0,0,2732
19143,8556933,8556933,8556938,0,0,0,5
19145,8561069,8561069,8561246,0,0,0,177
19148,8562042,8562042,8562184,0,0,0,142
19147,8561659,8561659,8562790,0,0,0,1131
19151,8562459,8562790,8562851,0,0,331,392
19152,8562538,8562790,8562905,0,0,252,367
19154,8563000,8563000,8564149,0,0,0,1149
19156,8564132,8564149,8564246,0,0,17,114
19153,8562788,8562851,8566804,0,0,63,4016
19157,8564174,8564246,8567018,0,0,72,2844
19159,8564411,8566804,8567175,0,0,2393,2764
19164,8565269,8567175,8567588,0,0,1906,2319
19168,8566068,8567588,8567821,0,0,1520,1753
19146,8561488,8561488,8569593,0,0,0,8105
19144,8560887,8560887,8569727,0,0,0,8840
19150,8562177,8562177,8570201,0,0,0,8024
19160,8564464,8569727,8570336,0,0,5263,5872
19167,8565916,8570336,8570476,0,0,4420,4560
19176,8569457,8570476,8570581,0,0,1019,1124
19172,8567203,8570336,8570682,0,0,3133,3479
19158,8564338,8569593,8570809,0,0,5255,6471
19181,8570807,8570807,8571053,0,0,0,246
19186,8571705,8571705,8571825,0,0,0,120
19149,8562113,8562184,8572050,0,0,71,9937
19165,8565277,8572050,8572182,0,0,6773,6905
19161,8564505,8572050,8572189,0,0,7545,7684
19166,8565712,8572182,8572320,0,0,6470,6608
19174,8568044,8572320,8572473,0,0,4276,4429
19175,8568207,8572473,8572747,0,0,4266,4540
19170,8566550,8570809,8573090,0,0,4259,6540
19178,8569498,8572747,8573140,0,0,3249,3642
19182,8570822,8573140,8573199,0,0,2318,2377
19180,8570222,8573090,8573339,0,0,2868,3117
19171,8566817,8572189,8573401,0,0,5372,6584
19188,8571986,8573401,8573419,0,0,1415,1433
19185,8571482,8573401,8573480,0,0,1919,1998
19190,8572009,8573480,8573493,0,0,1471,1484
19191,8572021,8573493,8573516,0,0,1472,1495
19184,8571461,8573339,8573526,0,0,1878,2065
19192,8572027,8573516,8573530,0,0,1489,1503
19183,8571007,8573199,8573650,0,0,2192,2643
19193,8572175,8573526,8573837,0,0,1351,1662
19162,8564572,8567018,8574421,0,0,2446,9849
19195,8575969,8575969,8576027,0,0,0,58
19155,8563725,8563725,8576138,0,0,0,12413
19187,8571850,8571850,8576179,0,0,0,4329
19196,8576412,8576412,8576575,0,0,0,163
19163,8565097,8570201,8576618,0,0,5104,11521
19198,8576456,8576456,8576640,0,0,0,184
19194,8575869,8575869,8576712,0,0,0,843
19177,8569481,8576640,8576835,0,0,7159,7354
19199,8576859,8576859,8576961,0,0,0,102
19200,8576941,8576941,8577041,0,0,0,100
19179,8569841,8570581,8577044,0,0,740,7203
19197,8576418,8576418,8577123,0,0,0,705
19203,8577199,8577199,8577235,0,0,0,36
19202,8577176,8577176,8577329,0,0,0,153
19205,8577276,8577276,8577347,0,0,0,71
19207,8577365,8577365,8577401,0,0,0,36
19169,8566479,8567821,8577475,0,0,1342,10996
19189,8572001,8573419,8577662,0,0,1418,5661
19208,8577568,8577568,8577714,0,0,0,146
19201,8577017,8577017,8578186,0,0,0,1169
19211,8578327,8578327,8578375,0,0,0,48
19212,8578426,8578426,8578668,0,0,0,242
19210,8578113,8578113,8578867,0,0,0,754
19214,8578852,8578852,8578902,0,0,0,50
19213,8578801,8578801,8578911,0,0,0,110
19217,8579086,8579086,8579116,0,0,0,30
19216,8579042,8579042,8579365,0,0,0,323
19206,8577351,8577351,8579368,0,0,0,2017
19221,8579503,8579503,8579515,0,0,0,12
19219,8579481,8579481,8579526,0,0,0,45
19215,8578873,8578873,8579595,0,0,0,722
19220,8579487,8579487,8579673,0,0,0,186
19173,8567815,8572320,8579728,0,0,4505,11913
19218,8579427,8579427,8579786,0,0,0,359
19224,8579737,8579737,8579911,0,0,0,174
19227,8580156,8580156,8580206,0,0,0,50
19228,8580178,8580206,8580366,0,0,28,188
19231,8580481,8580481,8580636,0,0,0,155
19204,8577232,8577232,8581604,0,0,0,4372
19225,8579741,8579786,8581651,0,0,45,1910
19226,8580039,8581604,8581758,0,0,1565,1719
19235,8580897,8581758,8581776,0,0,861,879
19229,8580292,8581651,8581826,0,0,1359,1534
19230,8580315,8581651,8581845,0,0,1336,1530
19236,8580923,8581776,8582013,0,0,853,1090
19223,8579718,8579718,8585688,0,0,0,5970
19239,8581769,8585688,8585903,0,0,3919,4134
19240,8584736,8585903,8585922,0,0,1167,1186
19222,8579669,8579669,8586170,0,0,0,6501
19232,8580534,8581826,8587573,0,0,1292,7039
19209,8578106,8578106,8587620,0,0,0,9514
19233,8580550,8580636,8587708,0,0,86,7158
19234,8580812,8581845,8587784,0,0,1033,6972
19237,8581632,8581776,8587818,0,0,144,6186
19238,8581753,8582013,8587930,0,0,260,6177
19244,8587727,8587727,8595980,0,0,0,8253
19247,8587741,8587741,8596765,0,0,0,9024
19248,8587769,8587930,8596990,0,0,161,9221
19243,8587713,8587713,8597002,0,0,0,9289
19242,8587646,8587646,8597056,0,0,0,9410
19246,8587736,8587784,8597110,0,0,48,9374
19254,8596112,8596990,8597521,0,0,878,1409
19255,8596112,8597056,8597587,0,0,944,1475
19253,8594965,8596990,8597608,0,0,2025,2643
19260,8598441,8598441,8598501,0,0,0,60
19256,8598440,8598440,8598566,0,0,0,126
19262,8598441,8598501,8598625,0,0,60,184
19252,8594009,8596765,8598687,0,0,2756,4678
19264,8598500,8598625,8598688,0,0,125,188
19265,8598500,8598625,8598688,0,0,125,188
19257,8598440,8598566,8598692,0,0,126,252
19266,8598500,8598687,8598750,0,0,187,250
19267,8598500,8598688,8598752,0,0,188,252
19261,8598441,8598692,8598752,0,0,251,311
19281,8598562,8598750,8598809,0,0,188,247
19282,8598562,8598752,8598812,0,0,190,250
19274,8598561,8598752,8598813,0,0,191,252
19263,8598441,8598692,8598816,0,0,251,375
19268,8598500,8598752,8598816,0,0,252,316
19276,8598561,8598688,8598870,0,0,127,309
19269,8598500,8598816,8598880,0,0,316,380
19283,8598562,8598809,8598927,0,0,247,365
19275,8598561,8598880,8598941,0,0,319,380
19287,8598620,8598870,8598993,0,0,250,373
19292,8598621,8598927,8599048,0,0,306,427
19295,8598742,8599048,8599107,0,0,306,365
19277,8598561,8598813,8599114,0,0,252,553
19296,8598742,8599107,8599166,0,0,365,424
19284,8598562,8598812,8599173,0,0,250,611
19278,8598561,8598816,8599178,0,0,255,617
19297,8598742,8599166,8599225,0,0,424,483
19298,8598742,8599173,8599233,0,0,431,491
19299,8598800,8599178,8599238,0,0,378,438
19300,8598800,8599178,8599239,0,0,378,439
19293,8598621,8598993,8599294,0,0,372,673
19288,8598620,8599114,8599296,0,0,494,676
19279,8598561,8598941,8599304,0,0,380,743
19302,8598800,8599225,8599347,0,0,425,547
19308,8598920,8599294,8599353,0,0,374,433
19303,8598800,8599233,8599355,0,0,433,555
19301,8598800,8599296,8599357,0,0,496,557
19306,8598860,8599238,8599360,0,0,378,500
19307,8598860,8599239,8599361,0,0,379,501
19309,8598920,8599347,8599407,0,0,427,487
19304,8598860,8599355,8599416,0,0,495,556
19310,8598920,8599357,8599417,0,0,437,497
19311,8598920,8599361,8599421,0,0,441,501
19312,8598920,8599416,8599477,0,0,496,557
19289,8598620,8599421,8599662,0,0,801,1042
19318,8599597,8599597,8599718,0,0,0,121
19305,8598860,8599662,8599723,0,0,802,863
19280,8598561,8599304,8599727,0,0,743,1166
19319,8599662,8599662,8599779,0,0,0,117
19313,8598920,8599723,8599784,0,0,803,864
19314,8598920,8599727,8599788,0,0,807,868
19320,8599959,8599959,8600018,0,0,0,59
19317,8599460,8599784,8600042,0,0,324,582
19270,8598560,8600042,8600105,0,0,1482,1545
19322,8600079,8600079,8600125,0,0,0,46
19321,8600018,8600018,8600126,0,0,0,108
19272,8598560,8600105,8600529,0,0,1545,1969
19251,8592206,8597002,8600799,0,0,4796,8593
19290,8598620,8600529,8600832,0,0,1909,2212
19291,8598620,8600832,8601195,0,0,2212,2575
19316,8599358,8601195,8601556,0,0,1837,2198
19250,8589340,8597002,8602990,0,0,7662,13650
19249,8588271,8595980,8603700,0,0,7709,15429
19241,8586940,8586940,8605329,0,0,0,18389
19326,8600383,8600383,8605441,0,0,0,5058
19327,8600384,8600384,8605563,0,0,0,5179
19340,8605715,8605715,8605774,0,0,0,59
19325,8600375,8600799,8605813,0,0,424,5438
19341,8605715,8605774,8605834,0,0,59,119
19334,8605714,8605813,8605874,0,0,99,160
19342,8605715,8605874,8605934,0,0,159,219
19343,8605715,8605834,8605953,0,0,119,238
19336,8605714,8605714,8605958,0,0,0,244
19344,8605715,8605934,8606054,0,0,219,339
19330,8605713,8605713,8606077,0,0,0,364
19348,8605774,8605958,8606079,0,0,184,305
19349,8605774,8605958,8606079,0,0,184,305
19352,8605834,8606054,8606114,0,0,220,280
19354,8605893,8606079,8606143,0,0,186,250
19355,8605893,8606079,8606143,0,0,186,250
19245,8587736,8597002,8606148,0,0,9266,18412
19357,8605894,8606114,8606177,0,0,220,283
19358,8605956,8606143,8606202,0,0,187,246
19359,8605956,8606143,8606202,0,0,187,246
19335,8605714,8606148,8606210,0,0,434,496
19337,8605714,8605874,8606237,0,0,160,523
19363,8606014,8606177,8606238,0,0,163,224
19364,8606014,8606202,8606263,0,0,188,249
19345,8605715,8605934,8606295,0,0,219,580
19346,8605715,8605953,8606314,0,0,238,599
19350,8605774,8606237,8606358,0,0,463,584
19356,8605893,8606295,8606359,0,0,402,466
19360,8605956,8606358,8606417,0,0,402,461
19361,8605956,8606359,8606419,0,0,403,463
19365,8606014,8606417,8606478,0,0,403,464
19324,8600375,8601556,8606539,0,0,1181,6164
19366,8606014,8606419,8606539,0,0,405,525
19338,8605714,8606210,8606573,0,0,496,859
19371,8606074,8606478,8606599,0,0,404,525
19339,8605714,8606210,8606754,0,0,496,1040
19351,8605774,8606573,8606815,0,0,799,1041
19362,8606013,8606754,8606817,0,0,741,804
19369,8606074,8606815,8606875,0,0,741,801
19372,8606074,8606817,8606939,0,0,743,865
19347,8605773,8606539,8606962,0,0,766,1189
19375,8606134,8606875,8606999,0,0,741,865
19370,8606074,8606962,8607022,0,0,888,948
19332,8605713,8606077,8607039,0,0,364,1326
19379,8606195,8606939,8607058,0,0,744,863
19376,8606194,8607022,8607085,0,0,828,891
19377,8606194,8607039,8607102,0,0,845,908
19380,8606256,8607085,8607143,0,0,829,887
19381,8606256,8607102,8607160,0,0,846,904
19383,8606313,8607143,8607263,0,0,830,950
19390,8607071,8607071,8607289,0,0,0,218
19367,8606014,8606202,8607499,0,0,188,1485
19368,8606014,8606238,8607536,0,0,224,1522
19258,8598440,8607499,8607625,0,0,9059,9185
19400,8607691,8607691,8607749,0,0,0,58
19259,8598440,8607625,8607752,0,0,9185,9312
19373,8606074,8606539,8607776,0,0,465,1702
19271,8598560,8607752,8607815,0,0,9192,9255
19401,8607691,8607776,8607834,0,0,85,143
19402,8607691,8607749,8607869,0,0,58,178
19407,8607692,8607869,8607925,0,0,177,233
19403,8607691,8607834,8607954,0,0,143,263
19413,8607748,8607954,8608016,0,0,206,268
19414,8607748,8608016,8608138,0,0,268,390
19328,8600386,8602990,8608167,0,0,2604,7781
19405,8607691,8607834,8608193,0,0,143,502
19415,8607810,8608138,8608197,0,0,328,387
19416,8607810,8608167,8608226,0,0,357,416
19273,8598560,8607815,8608239,0,0,9255,9679
19417,8607810,8608193,8608252,0,0,383,442
19418,8607868,8608197,8608257,0,0,329,389
19408,8607692,8607925,8608283,0,0,233,591
19419,8607868,8608226,8608287,0,0,358,419
19285,8598619,8608239,8608300,0,0,9620,9681
19382,8606257,8606999,8608309,0,0,742,2052
19420,8607868,8608252,8608313,0,0,384,445
19423,8607928,8608283,8608344,0,0,355,416
19397,8607690,8608309,8608368,0,0,619,678
19427,8607988,8608313,8608374,0,0,325,386
19422,8607868,8608257,8608379,0,0,389,511
19426,8607928,8608287,8608409,0,0,359,481
19384,8606313,8607160,8608475,0,0,847,2162
19404,8607691,8608409,8608648,0,0,718,957
19286,8598619,8608300,8608664,0,0,9681,10045
19398,8607690,8608368,8608729,0,0,678,1039
19294,8598679,8608664,8608968,0,0,9985,10289
19406,8607691,8608648,8609008,0,0,957,1317
19409,8607747,8609008,8609131,0,0,1261,1384
19421,8607868,8609131,8609192,0,0,1263,1324
19431,8607988,8608344,8609245,0,0,356,1257
19424,8607928,8609192,8609253,0,0,1264,1325
19399,8607690,8608729,8609271,0,0,1039,1581
19432,8607989,8608374,8609273,0,0,385,1284
19428,8607988,8609253,8609314,0,0,1265,1326
19434,8608048,8609314,8609376,0,0,1266,1328
19430,8607988,8609273,8609396,0,0,1285,1408
19394,8607688,8608475,8609435,0,0,787,1747
19410,8607747,8609271,8609454,0,0,1524,1707
19395,8607689,8609435,8609496,0,0,1746,1807
19425,8607928,8609454,8609516,0,0,1526,1588
19429,8607988,8609516,8609577,0,0,1528,1589
19315,8599100,8608968,8609587,0,0,9868,10487
19435,8608048,8609577,8609639,0,0,1529,1591
19437,8608048,8609639,8609762,0,0,1591,1714
19396,8607689,8609496,8609858,0,0,1807,2169
19441,8608110,8609762,8609883,0,0,1652,1773
19438,8608048,8609376,8610216,0,0,1328,2168
19411,8607747,8609858,8610283,0,0,2111,2536
19436,8608048,8610283,8610346,0,0,2235,2298
19440,8608109,8610346,8610469,0,0,2237,2360
19455,8610476,8610476,8610508,0,0,0,32
19444,8608231,8610469,8610528,0,0,2238,2297
19443,8608171,8609883,8610600,0,0,1712,2429
19446,8608289,8610528,8610648,0,0,2239,2359
19451,8609194,8610648,8610881,0,0,1454,1687
19454,8610356,8610881,8610941,0,0,525,585
19456,8610793,8610941,8611041,0,0,148,248
19447,8608289,8610600,8611198,0,0,2311,2909
19457,8610979,8610979,8611934,0,0,0,955
19329,8605713,8611934,8611997,0,0,6221,6284
19331,8605713,8611997,8612362,0,0,6284,6649
19333,8605713,8612362,8614157,0,0,6649,8444
19323,8600185,8609587,8614670,0,0,9402,14485
19374,8606133,8614670,8614732,0,0,8537,8599
19378,8606194,8614732,8614853,0,0,8538,8659
19385,8606373,8614853,8614913,0,0,8480,8540
19386,8606433,8614913,8614974,0,0,8480,8541
19387,8606494,8614974,8615035,0,0,8480,8541
19353,8605834,8614157,8615056,0,0,8323,9222
19388,8606555,8615035,8615154,0,0,8480,8599
19389,8606674,8615056,8616009,0,0,8382,9335
19392,8607688,8616009,8616071,0,0,8321,8383
19391,8607687,8615154,8616356,0,0,7467,8669
19393,8607688,8616071,8616435,0,0,8383,8747
19433,8608047,8616435,8616499,0,0,8388,8452
19439,8608109,8616499,8616561,0,0,8390,8452
19442,8608170,8616561,8616681,0,0,8391,8511
19445,8608287,8616681,8616742,0,0,8394,8455
19448,8608348,8616742,8616861,0,0,8394,8513
19449,8608467,8616861,8617041,0,0,8394,8574
19450,8608647,8617041,8617281,0,0,8394,8634
19412,8607747,8616356,8617318,0,0,8609,9571
19453,8610297,8617318,8617377,0,0,7021,7080
19452,8609194,8617281,8617514,0,0,8087,8320
19458,8611945,8617377,8618599,0,0,5432,6654
19460,8618718,8618718,8619864,0,0,0,1146
19459,8614397,8617377,8621677,0,0,2980,7280
19462,8619613,8619613,8624641,0,0,0,5028
19463,8623219,8623219,8624790,0,0,0,1571
19461,8618903,8618903,8625172,0,0,0,6269
19464,8630624,8630624,8639245,0,0,0,8621
19466,8664587,8664587,8664767,0,0,0,180
19471,8667179,8667179,8667487,0,0,0,308
19467,8667178,8667178,8667488,0,0,0,310
19473,8667179,8667487,8667872,0,0,308,693
19468,8667178,8667488,8667875,0,0,310,697
19469,8667178,8667178,8668171,0,0,0,993
19475,8667179,8667872,8668437,0,0,693,1258
19472,8667179,8668171,8668480,0,0,992,1301
19477,8667482,8668437,8668519,0,0,955,1037
19479,8667563,8668519,8668558,0,0,956,995
19481,8667563,8668558,8668619,0,0,995,1056
19483,8667601,8668619,8668704,0,0,1018,1103
19486,8667624,8668704,8668824,0,0,1080,1200
19474,8667179,8668480,8668865,0,0,1301,1686
19478,8667482,8668865,8669070,0,0,1383,1588
19482,8667563,8669070,8669131,0,0,1507,1568
19485,8667623,8669131,8669252,0,0,1508,1629
19487,8667686,8669252,8669309,0,0,1566,1623
19490,8667743,8669309,8669398,0,0,1566,1655
19491,8667792,8669398,8669559,0,0,1606,1767
19465,8649952,8649952,8669672,0,0,0,19720
19501,8669236,8669672,8669733,0,0,436,497
19470,8667178,8667875,8669760,0,0,697,2582
19489,8667686,8668824,8670086,0,0,1138,2400
19502,8669236,8669733,8670092,0,0,497,856
19504,8669297,8670092,8670272,0,0,795,975
19506,8669476,8670272,8670334,0,0,796,858
19508,8669537,8670334,8670392,0,0,797,855
19511,8669594,8670392,8670470,0,0,798,876
19513,8669609,8670470,8670591,0,0,861,982
19476,8667481,8669760,8670597,0,0,2279,3116
19503,8669236,8670086,8670623,0,0,850,1387
19480,8667563,8670597,8670636,0,0,3034,3073
19484,8667601,8670636,8670722,0,0,3035,3121
19518,8669672,8670591,8670727,0,0,919,1055
19493,8667832,8669559,8670735,0,0,1727,2903
19497,8669063,8670735,8670795,0,0,1672,1732
19488,8667686,8670722,8670828,0,0,3036,3142
19492,8667832,8670828,8670888,0,0,2996,3056
19494,8667892,8670888,8671029,0,0,2996,3137
19538,8671026,8671026,8671085,0,0,0,59
19539,8671026,8671026,8671085,0,0,0,59
19498,8669063,8670795,8671146,0,0,1732,2083
19495,8668033,8671029,8671166,0,0,2996,3133
19541,8671026,8671085,8671233,0,0,59,207
19542,8671026,8671085,8671233,0,0,59,207
19533,8671025,8671025,8671310,0,0,0,285
19540,8671026,8671310,8671369,0,0,284,343
19543,8671026,8671233,8671577,0,0,207,551
19544,8671026,8671233,8671577,0,0,207,551
19546,8671084,8671577,8671666,0,0,493,582
19547,8671084,8671577,8671667,0,0,493,583
19520,8669729,8670623,8671668,0,0,894,1939
19545,8671026,8671369,8671713,0,0,343,687
19552,8671173,8671666,8671742,0,0,493,569
19553,8671173,8671667,8671743,0,0,494,570
19548,8671084,8671713,8671817,0,0,629,733
19554,8671173,8671742,8671818,0,0,569,645
19555,8671173,8671743,8671820,0,0,570,647
19556,8671188,8671817,8671877,0,0,629,689
19557,8671248,8671818,8671878,0,0,570,630
19558,8671248,8671820,8671881,0,0,572,633
19559,8671248,8671877,8671938,0,0,629,690
19562,8671308,8671877,8672000,0,0,569,692
19563,8671308,8671878,8672002,0,0,570,694
19534,8671025,8671668,8672014,0,0,643,989
19561,8671308,8672002,8672063,0,0,694,755
19499,8669063,8671146,8672097,0,0,2083,3034
19564,8671308,8672063,8672187,0,0,755,879
19569,8671368,8672187,8672309,0,0,819,941
19496,8668170,8671166,8672473,0,0,2996,4303
19500,8669123,8672097,8672512,0,0,2974,3389
19536,8671025,8672014,8672531,0,0,989,1506
19505,8669414,8672473,8672535,0,0,3059,3121
19507,8669476,8672473,8672535,0,0,2997,3059
19509,8669537,8672512,8672570,0,0,2975,3033
19510,8669537,8672535,8672608,0,0,2998,3071
19512,8669594,8672535,8672614,0,0,2941,3020
19517,8669672,8672570,8672670,0,0,2898,2998
19532,8671025,8672614,8672675,0,0,1589,1650
19549,8671084,8672531,8672756,0,0,1447,1672
19560,8671307,8672756,8672818,0,0,1449,1511
19567,8671368,8672818,8672881,0,0,1450,1513
19568,8671368,8672881,8672944,0,0,1513,1576
19572,8671430,8672944,8673003,0,0,1514,1573
19535,8671025,8672670,8673016,0,0,1645,1991
19573,8671430,8673003,8673062,0,0,1573,1632
19571,8671369,8671938,8673108,0,0,569,1739
19577,8671488,8673062,8673157,0,0,1574,1669
19565,8671308,8671881,8673230,0,0,573,1922
19550,8671084,8673016,8673364,0,0,1932,2280
19566,8671367,8673364,8673487,0,0,1997,2120
19570,8671368,8672309,8673539,0,0,941,2171
19574,8671430,8673487,8673547,0,0,2057,2117
19576,8671488,8673547,8673600,0,0,2059,2112
19537,8671025,8672675,8673615,0,0,1650,2590
19590,8673631,8673631,8673645,0,0,0,14
19580,8671540,8673615,8673658,0,0,2075,2118
19519,8669672,8672608,8673711,0,0,2936,4039
19578,8671488,8673600,8673711,0,0,2112,2223
19582,8671582,8673658,8673763,0,0,2076,2181
19579,8671489,8673157,8674387,0,0,1668,2898
19583,8671598,8673711,8675044,0,0,2113,3446
19596,8674057,8674057,8680272,0,0,0,6215
19599,8675512,8675512,8681557,0,0,0,6045
19598,8675511,8675511,8684032,0,0,0,8521
19591,8673649,8673649,8684092,0,0,0,10443
19589,8673629,8673711,8684114,0,0,82,10485
19594,8673966,8673966,8684152,0,0,0,10186
19514,8669669,8684114,8684175,0,0,14445,14506
19595,8674055,8674055,8684212,0,0,0,10157
19605,8684393,8684393,8684455,0,0,0,62
19606,8684393,8684455,8684579,0,0,62,186
19515,8669669,8684175,8684580,0,0,14506,14911
19607,8684452,8684579,8684641,0,0,127,189
19608,8684452,8684579,8684642,0,0,127,190
19617,8684454,8684642,8684699,0,0,188,245
19613,8684453,8684642,8684702,0,0,189,249
19614,8684453,8684642,8684702,0,0,189,249
19609,8684452,8684641,8684704,0,0,189,252
19618,8684454,8684699,8684757,0,0,245,303
19619,8684454,8684702,8684760,0,0,248,306
19620,8684454,8684704,8684762,0,0,250,308
19615,8684453,8684702,8684763,0,0,249,310
19616,8684453,8684704,8684765,0,0,251,312
19621,8684572,8684704,8684785,0,0,132,213
19623,8684772,8684772,8684795,0,0,0,23
19622,8684714,8684757,8684815,0,0,43,101
19610,8684452,8684815,8684878,0,0,363,426
19611,8684452,8684878,8684942,0,0,426,490
19624,8684795,8684942,8685002,0,0,147,207
19516,8669669,8684580,8685686,0,0,14911,16017
19627,8685625,8685625,8685914,0,0,0,289
19628,8685768,8685768,8685937,0,0,0,169
19521,8669729,8685686,8686732,0,0,15957,17003
19522,8670074,8686732,8686831,0,0,16658,16757
19523,8670173,8686831,8686950,0,0,16658,16777
19524,8670327,8686950,8687011,0,0,16623,16684
19525,8670387,8687011,8687131,0,0,16624,16744
19526,8670507,8687131,8687277,0,0,16624,16770
19527,8670712,8687277,8687339,0,0,16565,16627
19528,8670963,8687339,8687403,0,0,16376,16440
19629,8688550,8688550,8688587,0,0,0,37
19601,8675579,8680272,8688905,0,0,4693,13326
19630,8688880,8688880,8688920,0,0,0,40
19529,8670963,8687403,8689371,0,0,16440,18408
19530,8671023,8689371,8689434,0,0,18348,18411
19531,8671023,8689434,8689844,0,0,18411,18821
19600,8675578,8681557,8690130,0,0,5979,14552
19602,8675579,8681557,8690249,0,0,5978,14670
19632,8690133,8690133,8690847,0,0,0,714
19551,8671084,8689844,8690863,0,0,18760,19779
19631,8690098,8690847,8690938,0,0,749,840
19575,8671430,8690863,8690974,0,0,19433,19544
19581,8671540,8690974,8691090,0,0,19434,19550
19584,8671656,8691090,8691182,0,0,19434,19526
19585,8671748,8691182,8691259,0,0,19434,19511
19633,8690904,8690938,8691377,0,0,34,473
19586,8671885,8691259,8691421,0,0,19374,19536
19635,8691551,8691551,8691615,0,0,0,64
19634,8691471,8691471,8692158,0,0,0,687
19636,8691730,8691730,8692169,0,0,0,439
19587,8672047,8691421,8692695,0,0,19374,20648
19637,8692247,8692247,8692746,0,0,0,499
19639,8692589,8692589,8692825,0,0,0,236
19588,8673444,8692695,8692923,0,0,19251,19479
19640,8692802,8692802,8693235,0,0,0,433
19638,8692450,8692450,8693481,0,0,0,1031
19641,8693697,8693697,8693862,0,0,0,165
19643,8694255,8694255,8694659,0,0,0,404
19642,8694238,8694238,8694702,0,0,0,464
19645,8696078,8696078,8696103,0,0,0,25
19593,8673757,8673763,8696136,0,0,6,22379
19646,8696176,8696176,8696198,0,0,0,22
19648,8696522,8696522,8696544,0,0,0,22
19649,8696616,8696616,8696684,0,0,0,68
19650,8696627,8696627,8696687,0,0,0,60
19651,8697346,8697346,8697665,0,0,0,319
19652,8697983,8697983,8698032,0,0,0,49
19654,8698222,8698222,8698263,0,0,0,41
19653,8698210,8698210,8698307,0,0,0,97
19644,8694944,8694944,8698932,0,0,0,3988
19655,8698583,8698583,8700146,0,0,0,1563
19647,8696229,8696229,8700566,0,0,0,4337
19658,8700257,8700257,8702151,0,0,0,1894
19592,8673724,8692923,8703148,0,0,19199,29424
19656,8699571,8699571,8705516,0,0,0,5945
19626,8685094,8685094,8705926,0,0,0,20832
19661,8704423,8705926,8706295,0,0,1503,1872
19597,8675389,8703148,8708957,0,0,27759,33568
19657,8699634,8699634,8710539,0,0,0,10905
19663,8711416,8711416,8714377,0,0,0,2961
19662,8710603,8710603,8717951,0,0,0,7348
19664,8717224,8717224,8720179,0,0,0,2955
19659,8702236,8702236,8723052,0,0,0,20816
19604,8684392,8723052,8723177,0,0,38660,38785
19612,8684452,8723177,8723241,0,0,38725,38789
19625,8684855,8723241,8723302,0,0,38386,38447
19603,8680746,8708957,8727634,0,0,28211,46888
19666,8727754,8727754,8730945,0,0,0,3191
19665,8723898,8727634,8731344,0,0,3736,7446
19671,8732517,8732517,8733773,0,0,0,1256
19667,8731167,8731167,8734352,0,0,0,3185
19670,8732460,8734352,8734444,0,0,1892,1984
19672,8732624,8734444,8734547,0,0,1820,1923
19673,8733361,8734547,8734633,0,0,1186,1272
19674,8733559,8734633,8734726,0,0,1074,1167
19675,8733824,8734726,8740801,0,0,902,6977
19680,8735144,8740801,8740828,0,0,5657,5684
19678,8734652,8740801,8740977,0,0,6149,6325
19684,8736856,8740977,8741112,0,0,4121,4256
19679,8735102,8740801,8741173,0,0,5699,6071
19660,8704098,8723302,8741215,0,0,19204,37117
19686,8737764,8741173,8741270,0,0,3409,3506
19676,8733970,8741215,8741292,0,0,7245,7322
19682,8735541,8740828,8741322,0,0,5287,5781
19685,8737360,8740977,8741352,0,0,3617,3992
19690,8738055,8741112,8741354,0,0,3057,3299
19692,8739314,8741322,8741467,0,0,2008,2153
19697,8740145,8741354,8741491,0,0,1209,1346
19693,8739747,8741352,8741498,0,0,1605,1751
19703,8741109,8741498,8741591,0,0,389,482
19701,8740551,8741491,8741636,0,0,940,1085
19699,8740403,8741467,8741689,0,0,1064,1286
19704,8741237,8741591,8741977,0,0,354,740
19677,8734329,8741292,8742110,0,0,6963,7781
19708,8741707,8741977,8742124,0,0,270,417
19689,8738006,8741689,8742126,0,0,3683,4120
19709,8742170,8742170,8742389,0,0,0,219
19711,8742399,8742399,8742538,0,0,0,139
19713,8742559,8742559,8743172,0,0,0,613
19714,8742672,8743172,8743954,0,0,500,1282
19717,8742909,8743954,8744032,0,0,1045,1123
19683,8736400,8740828,8744130,0,0,4428,7730
19719,8743178,8744130,8744209,0,0,952,1031
19718,8743175,8744032,8744321,0,0,857,1146
19721,8743317,8744209,8744324,0,0,892,1007
19722,8743625,8744321,8744507,0,0,696,882
19725,8743997,8744507,8744645,0,0,510,648
19726,8744222,8744645,8744690,0,0,423,468
19728,8744452,8744690,8744786,0,0,238,334
19669,8732306,8732306,8744795,0,0,0,12489
19681,8735226,8740801,8744846,0,0,5575,9620
19729,8744491,8744786,8744928,0,0,295,437
19691,8738866,8742126,8745284,0,0,3260,6418
19694,8740041,8744795,8745858,0,0,4754,5817
19710,8742192,8745858,8746119,0,0,3666,3927
19712,8742450,8746119,8746526,0,0,3669,4076
19696,8740079,8744846,8747218,0,0,4767,7139
19720,8743266,8746526,8747485,0,0,3260,4219
19733,8746098,8747485,8747606,0,0,1387,1508
19732,8745858,8747485,8747624,0,0,1627,1766
19736,8746536,8747624,8747758,0,0,1088,1222
19737,8746881,8747758,8747894,0,0,877,1013
19738,8746909,8747894,8748029,0,0,985,1120
19735,8746207,8747606,8748156,0,0,1399,1949
19739,8747328,8748029,8748158,0,0,701,830
19741,8747646,8748156,8748280,0,0,510,634
19727,8744246,8747218,8749068,0,0,2972,4822
19743,8748359,8749068,8749197,0,0,709,838
19746,8749325,8749325,8749342,0,0,0,17
19747,8749339,8749339,8749354,0,0,0,15
19668,8732258,8732258,8749419,0,0,0,17161
19748,8749581,8749581,8749682,0,0,0,101
19734,8746112,8748280,8752099,0,0,2168,5987
19730,8744947,8744947,8752168,0,0,0,7221
19753,8751383,8752099,8752336,0,0,716,953
19750,8750834,8752099,8752348,0,0,1265,1514
19688,8737958,8741270,8753655,0,0,3312,15697
19751,8750851,8752336,8754406,0,0,1485,3555
19749,8749967,8749967,8755724,0,0,0,5757
19759,8755222,8755724,8755828,0,0,502,606
19762,8755749,8755828,8755858,0,0,79,109
19723,8743734,8744324,8756656,0,0,590,12922
19695,8740077,8744795,8756738,0,0,4718,16661
19766,8756549,8756656,8756760,0,0,107,211
19698,8740245,8745284,8756827,0,0,5039,16582
19764,8756013,8756827,8756941,0,0,814,928
19757,8754536,8754536,8757208,0,0,0,2672
19702,8740752,8749419,8758819,0,0,8667,18067
19768,8758986,8758986,8759414,0,0,0,428
19761,8755544,8755724,8759635,0,0,180,4091
19765,8756254,8756941,8759746,0,0,687,3492
19763,8755807,8755858,8759807,0,0,51,4000
19742,8747955,8758819,8760028,0,0,10864,12073
19745,8748772,8760028,8760069,0,0,11256,11297
19771,8759453,8759807,8760183,0,0,354,730
19770,8759114,8759746,8760194,0,0,632,1080
19772,8759597,8760183,8760847,0,0,586,1250
19776,8760524,8760847,8761158,0,0,323,634
19778,8761085,8761085,8762109,0,0,0,1024
19769,8759079,8759414,8763119,0,0,335,4040
19760,8755279,8756738,8763237,0,0,1459,7958
19779,8761581,8761581,8763341,0,0,0,1760
19754,8752881,8763237,8763359,0,0,10356,10478
19755,8753777,8763359,8763589,0,0,9582,9812
19756,8753997,8763589,8763667,0,0,9592,9670
19758,8755218,8763667,8763775,0,0,8449,8557
19752,8751178,8760069,8764081,0,0,8891,12903
19774,8759999,8764081,8764599,0,0,4082,4600
19767,8758075,8763775,8764804,0,0,5700,6729
19783,8762809,8762809,8765372,0,0,0,2563
19687,8737839,8742110,8765581,0,0,4271,27742
19773,8759825,8760194,8765587,0,0,369,5762
19700,8740411,8765581,8765627,0,0,25170,25216
19706,8741578,8765627,8765676,0,0,24049,24098
19705,8741289,8765581,8765678,0,0,24292,24389
19715,8742807,8765676,8765776,0,0,22869,22969
19716,8742885,8765678,8765807,0,0,22793,22922
19731,8744999,8765807,8766160,0,0,20808,21161
19784,8763472,8763472,8766317,0,0,0,2845
19787,8765434,8766317,8766456,0,0,883,1022
19788,8766188,8766456,8767354,0,0,268,1166
19790,8768113,8768113,8768711,0,0,0,598
19791,8768356,8768356,8768804,0,0,0,448
19724,8743823,8765776,8769107,0,0,21953,25284
19792,8769203,8769203,8769502,0,0,0,299
19793,8769385,8769385,8769715,0,0,0,330
19795,8769843,8769843,8770112,0,0,0,269
19789,8767730,8767730,8770270,0,0,0,2540
19781,8762095,8764599,8771083,0,0,2504,8988
19796,8770290,8770290,8771281,0,0,0,991
19794,8769425,8769502,8771522,0,0,77,2097
19785,8764521,8764804,8772183,0,0,283,7662
19740,8747485,8766160,8772868,0,0,18675,25383
19707,8741615,8754406,8775202,0,0,12791,33587
19798,8772173,8772183,8775732,0,0,10,3559
19744,8748629,8769107,8775846,0,0,20478,27217
19777,8760933,8772868,8782565,0,0,11935,21632
19802,8777479,8782565,8783237,0,0,5086,5758
19804,8779654,8783237,8783895,0,0,3583,4241
19806,8784316,8784316,8784989,0,0,0,673
19799,8773145,8775202,8785384,0,0,2057,12239
19800,8773389,8775732,8787118,0,0,2343,13729
19807,8785076,8785076,8787768,0,0,0,2692
19786,8764960,8775846,8789410,0,0,10886,24450
19810,8789098,8789098,8790681,0,0,0,1583
19801,8775663,8782565,8791365,0,0,6902,15702
19808,8785524,8785524,8792669,0,0,0,7145
19809,8785700,8785700,8792851,0,0,0,7151
19775,8760083,8771522,8793803,0,0,11439,33720
19813,8796715,8796715,8797184,0,0,0,469
19812,8796053,8796053,8798007,0,0,0,1954
19815,8798473,8798473,8798744,0,0,0,271
19814,8797100,8797100,8798901,0,0,0,1801
19816,8799021,8799021,8799105,0,0,0,84
19818,8799252,8799252,8799260,0,0,0,8
19819,8799263,8799263,8799271,0,0,0,8
19820,8799330,8799330,8799478,0,0,0,148
19817,8799222,8799222,8799604,0,0,0,382
19811,8791342,8792851,8800056,0,0,1509,8714
19780,8761587,8790681,8802174,0,0,29094,40587
19797,8770652,8802174,8806716,0,0,31522,36064
19803,8777618,8806716,8811173,0,0,29098,33555
19805,8782079,8811173,8816508,0,0,29094,34429
19782,8762449,8800056,8822706,0,0,37607,60257
19821,8813710,8816508,8823694,0,0,2798,9984
19822,8817886,8822706,8824923,0,0,4820,7037
19827,8826521,8826521,8826586,0,0,0,65
19824,8821417,8824923,8826945,0,0,3506,5528
19823,8820898,8820898,8828060,0,0,0,7162
19829,8826640,8828060,8828119,0,0,1420,1479
19825,8824528,8826945,8828170,0,0,2417,3642
19833,8828123,8828123,8828285,0,0,0,162
19830,8826782,8828060,8829304,0,0,1278,2522
19834,8828395,8828395,8829418,0,0,0,1023
19831,8827839,8828170,8829419,0,0,331,1580
19836,8829906,8829906,8829966,0,0,0,60
19826,8825198,8825198,8831903,0,0,0,6705
19839,8833011,8833011,8833375,0,0,0,364
19828,8826628,8826628,8833889,0,0,0,7261
19841,8833838,8833838,8834814,0,0,0,976
19837,8830553,8833889,8835237,0,0,3336,4684
19846,8836125,8836125,8836397,0,0,0,272
19840,8833673,8835237,8836594,0,0,1564,2921
19843,8833906,8836594,8836655,0,0,2688,2749
19848,8837216,8837216,8837310,0,0,0,94
19849,8837567,8837567,8837596,0,0,0,29
19847,8836864,8836864,8837665,0,0,0,801
19850,8837803,8837803,8838016,0,0,0,213
19835,8829838,8829838,8838187,0,0,0,8349
19838,8831881,8831881,8838517,0,0,0,6636
19854,8838609,8838609,8839569,0,0,0,960
19851,8838225,8838225,8842194,0,0,0,3969
19832,8828064,8829418,8843323,0,0,1354,15259
19857,8843330,8843330,8845453,0,0,0,2123
19859,8845932,8845932,8845945,0,0,0,13
19860,8845987,8845987,8846067,0,0,0,80
19858,8845504,8845504,8846068,0,0,0,564
19861,8846136,8846136,8846198,0,0,0,62
19862,8846214,8846214,8846281,0,0,0,67
19842,8833894,8836594,8846767,0,0,2700,12873
19853,8838457,8838457,8847423,0,0,0,8966
19863,8847029,8847423,8847875,0,0,394,846
19845,8836118,8836594,8848096,0,0,476,11978
19865,8847550,8848096,8848835,0,0,546,1285
19844,8835281,8846767,8849750,0,0,11486,14469
19867,8849707,8849707,8851149,0,0,0,1442
19864,8847481,8847875,8851297,0,0,394,3816
19856,8841972,8841972,8852771,0,0,0,10799
19869,8851620,8851620,8853294,0,0,0,1674
19868,8850842,8851149,8854826,0,0,307,3984
19871,8853321,8853321,8856898,0,0,0,3577
19874,8854768,8856898,8856986,0,0,2130,2218
19875,8855364,8856898,8857068,0,0,1534,1704
19873,8854456,8854826,8858119,0,0,370,3663
19877,8857733,8857733,8864077,0,0,0,6344
19879,8857752,8864077,8864142,0,0,6325,6390
19852,8838246,8849750,8864222,0,0,11504,25976
19878,8857751,8858119,8865108,0,0,368,7357
19882,8859873,8865108,8865162,0,0,5235,5289
19881,8859162,8865108,8865208,0,0,5946,6046
19880,8857950,8864142,8865813,0,0,6192,7863
19884,8867753,8867753,8867798,0,0,0,45
19866,8849201,8852771,8872406,0,0,3570,23205
19883,8864015,8865208,8873827,0,0,1193,9812
19889,8876254,8876254,8876341,0,0,0,87
19890,8876580,8876580,8876834,0,0,0,254
19891,8877258,8877258,8877272,0,0,0,14
19892,8877363,8877363,8877382,0,0,0,19
19893,8877636,8877636,8877656,0,0,0,20
19894,8877654,8877654,8877834,0,0,0,180
19870,8852773,8872406,8877973,0,0,19633,25200
19886,8869063,8869063,8880189,0,0,0,11126
19898,8879188,8880189,8880198,0,0,1001,1010
19897,8878651,8880189,8880256,0,0,1538,1605
19896,8877977,8880189,8880300,0,0,2212,2323
19899,8879454,8880189,8881577,0,0,735,2123
19855,8839031,8864222,8882122,0,0,25191,43091
19900,8883450,8883450,8884458,0,0,0,1008
19902,8884594,8884594,8884645,0,0,0,51
19903,8884642,8884642,8884722,0,0,0,80
19904,8884721,8884721,8884813,0,0,0,92
19905,8884810,8884810,8885078,0,0,0,268
19906,8885076,8885076,8886856,0,0,0,1780
19907,8888866,8888866,8889037,0,0,0,171
19895,8877953,8877953,8889731,0,0,0,11778
19885,8867797,8889731,8889791,0,0,21934,21994
19876,8856539,8882122,8891572,0,0,25583,35033
19908,8892828,8892828,8892926,0,0,0,98
19909,8893004,8893004,8893013,0,0,0,9
19910,8893045,8893045,8893122,0,0,0,77
19872,8853333,8877973,8893375,0,0,24640,40042
19888,8874069,8893375,8893629,0,0,19306,19560
19887,8870639,8889791,8902574,0,0,19152,31935
19914,8894501,8902574,8902580,0,0,8073,8079
19917,8895664,8902574,8902580,0,0,6910,6916
19913,8894493,8902574,8902585,0,0,8081,8092
19916,8895651,8902574,8902588,0,0,6923,6937
19912,8894480,8902574,8902590,0,0,8094,8110
19911,8893548,8902574,8902618,0,0,9026,9070
19915,8894637,8902574,8902791,0,0,7937,8154
19918,8895733,8902574,8902922,0,0,6841,7189
19901,8883486,8893629,8906571,0,0,10143,23085
19923,8912415,8912415,8912550,0,0,0,135
19919,8896687,8902922,8916880,0,0,6235,20193
19921,8911373,8911373,8917318,0,0,0,5945
19922,8911444,8916880,8918292,0,0,5436,6848
19920,8910646,8910646,8921545,0,0,0,10899
19924,8912852,8918292,8922638,0,0,5440,9786
19925,8915436,8915436,8924777,0,0,0,9341
19928,8917253,8917318,8925843,0,0,65,8590
19931,8924075,8925843,8926266,0,0,1768,2191
19927,8917199,8921545,8928510,0,0,4346,11311
19926,8916555,8922638,8930345,0,0,6083,13790
19930,8917667,8930345,8931635,0,0,12678,13968
19935,8927802,8931635,8932066,0,0,3833,4264
19937,8930665,8931635,8932377,0,0,970,1712
19938,8931941,8932066,8932575,0,0,125,634
19939,8932161,8932377,8934799,0,0,216,2638
19929,8917468,8924777,8934965,0,0,7309,17497
19940,8934599,8934599,8935608,0,0,0,1009
19932,8924784,8926266,8937196,0,0,1482,12412
19933,8925713,8928510,8937675,0,0,2797,11962
19944,8935990,8937675,8937795,0,0,1685,1805
19945,8936882,8937675,8937909,0,0,793,1027
19946,8938019,8938019,8938498,0,0,0,479
19936,8928515,8931635,8938574,0,0,3120,10059
19934,8927653,8928510,8939096,0,0,857,11443
19948,8938541,8938574,8939460,0,0,33,919
19942,8935458,8935608,8942569,0,0,150,7111
19951,8940491,8942569,8942822,0,0,2078,2331
19956,8942584,8942822,8942837,0,0,238,253
19957,8942771,8942837,8942983,0,0,66,212
19958,8943158,8943158,8943253,0,0,0,95
19941,8934873,8934873,8943880,0,0,0,9007
19949,8938769,8938769,8944230,0,0,0,5461
19961,8943535,8943880,8944322,0,0,345,787
19963,8944212,8944212,8944702,0,0,0,490
19964,8944270,8944702,8946571,0,0,432,2301
19943,8935720,8937196,8947921,0,0,1476,12201
19966,8946449,8947921,8949169,0,0,1472,2720
19959,8943328,8943328,8950231,0,0,0,6903
19947,8938267,8938498,8950907,0,0,231,12640
19962,8943835,8944230,8951067,0,0,395,7232
19952,8941819,8951067,8951195,0,0,9248,9376
19953,8942200,8951195,8951247,0,0,8995,9047
19965,8944804,8946571,8951283,0,0,1767,6479
19954,8942322,8951247,8951340,0,0,8925,9018
19969,8950613,8950613,8951985,0,0,0,1372
19955,8942423,8951340,8952088,0,0,8917,9665
19960,8943435,8952088,8952193,0,0,8653,8758
19967,8949560,8949560,8952464,0,0,0,2904
19970,8951569,8951985,8953140,0,0,416,1571
19968,8950230,8952193,8956455,0,0,1963,6225
19972,8956918,8956918,8956934,0,0,0,16
19950,8939284,8939460,8959327,0,0,176,20043
19971,8954504,8956455,8960704,0,0,1951,6200
19975,8961148,8961148,8961278,0,0,0,130
19976,8962153,8962153,8963371,0,0,0,1218
19973,8957986,8957986,8963460,0,0,0,5474
19974,8958755,8960704,8964960,0,0,1949,6205
19978,8965511,8965511,8968708,0,0,0,3197
19979,8968844,8968844,8972037,0,0,0,3193
19977,8963014,8963460,8973064,0,0,446,10050
19980,8972079,8972079,8975258,0,0,0,3179
19981,8972618,8972618,8977522,0,0,0,4904
19982,8979422,8979422,8982615,0,0,0,3193
19983,8983109,8983109,8986291,0,0,0,3182
19984,8986315,8986315,8989515,0,0,0,3200
19985,8989595,8989595,8990203,0,0,0,608
19987,8994568,8994568,8994630,0,0,0,62
19986,8991409,8991409,8994634,0,0,0,3225
19988,8994629,8994629,9002985,0,0,0,8356
19990,8994696,8994696,9003048,0,0,0,8352
19991,8994697,8994697,9003139,0,0,0,8442
19992,8994725,8994725,9003171,0,0,0,8446
19993,8994726,8994726,9003261,0,0,0,8535
19989,8994629,8994630,9003947,0,0,1,9318
19994,9001562,9002985,9006940,0,0,1423,5378
20000,9004089,9004089,9009342,0,0,0,5253
19997,9004077,9004077,9009343,0,0,0,5266
19998,9004077,9004077,9009343,0,0,0,5266
19999,9004077,9004077,9009343,0,0,0,5266
19996,9003946,9003947,9009401,0,0,1,5455
20003,9008097,9009401,9010646,0,0,1304,2549
20002,9008038,9009343,9010647,0,0,1305,2609
20004,9010150,9010646,9010705,0,0,496,555
20005,9010450,9010646,9011024,0,0,196,574
20006,9011308,9011308,9013910,0,0,0,2602
19995,9003412,9003412,9014061,0,0,0,10649
20007,9014596,9014596,9015095,0,0,0,499
20008,9014596,9014596,9015271,0,0,0,675
20009,9016170,9016170,9016331,0,0,0,161
20010,9016175,9016175,9016331,0,0,0,156
20011,9016888,9016888,9017009,0,0,0,121
20012,9016888,9016888,9017009,0,0,0,121
20013,9017070,9017070,9017135,0,0,0,65
20014,9017071,9017071,9017135,0,0,0,64
20015,9017133,9017133,9017189,0,0,0,56
20016,9017134,9017134,9017189,0,0,0,55
20017,9017309,9017309,9017428,0,0,0,119
20018,9017309,9017309,9017428,0,0,0,119
20019,9017488,9017488,9017548,0,0,0,60
20020,9017488,9017488,9017549,0,0,0,61
20021,9017548,9017548,9017609,0,0,0,61
20022,9017548,9017548,9017668,0,0,0,120
20023,9017668,9017668,9017728,0,0,0,60
20024,9017668,9017668,9017729,0,0,0,61
20025,9017728,9017728,9017909,0,0,0,181
20026,9017728,9017728,9017909,0,0,0,181
20027,9018141,9018141,9018201,0,0,0,60
20028,9018142,9018142,9018201,0,0,0,59
20029,9018262,9018262,9018356,0,0,0,94
20030,9018263,9018263,9018356,0,0,0,93
20032,9018418,9018418,9018890,0,0,0,472
20031,9018416,9018416,9018891,0,0,0,475
20033,9019013,9019013,9019070,0,0,0,57
20034,9019013,9019013,9019070,0,0,0,57
20001,9004119,9006940,9019247,0,0,2821,15128
20035,9019157,9019157,9019411,0,0,0,254
20036,9028089,9028089,9028348,0,0,0,259
20037,9028628,9028628,9028648,0,0,0,20
20038,9028767,9028767,9028827,0,0,0,60
20041,9028925,9028925,9029054,0,0,0,129
20042,9028927,9028927,9030473,0,0,0,1546
20039,9028882,9028882,9030474,0,0,0,1592
20040,9028882,9028882,9030474,0,0,0,1592
20044,9028985,9028985,9030534,0,0,0,1549
20045,9029053,9029054,9030535,0,0,1,1482
20043,9028927,9028927,9030713,0,0,0,1786
20046,9034731,9034731,9034957,0,0,0,226
20047,9036634,9036634,9036717,0,0,0,83
20048,9036739,9036739,9036966,0,0,0,227
20049,9037825,9037825,9037992,0,0,0,167
20050,9038796,9038796,9039855,0,0,0,1059
20052,9040860,9040860,9041331,0,0,0,471
20054,9042583,9042583,9043334,0,0,0,751
20053,9041470,9041470,9043793,0,0,0,2323
20056,9043632,9043632,9044109,0,0,0,477
20051,9040249,9040249,9044411,0,0,0,4162
20057,9044643,9044643,9045007,0,0,0,364
20058,9045004,9045004,9045016,0,0,0,12
20060,9050157,9050157,9050182,0,0,0,25
20062,9050671,9050671,9050701,0,0,0,30
20055,9042942,9042942,9050806,0,0,0,7864
20061,9050657,9050657,9050889,0,0,0,232
20063,9051112,9051112,9051142,0,0,0,30
20064,9051152,9051152,9053467,0,0,0,2315
20066,9053692,9053692,9054980,0,0,0,1288
20068,9055399,9055399,9055548,0,0,0,149
20059,9050095,9050095,9055812,0,0,0,5717
20065,9053433,9053433,9061318,0,0,0,7885
20067,9054870,9054870,9061978,0,0,0,7108
20069,9055605,9055605,9067746,0,0,0,12141
20070,9065994,9065994,9069194,0,0,0,3200
20071,9071191,9071191,9074379,0,0,0,3188
20073,9080952,9080952,9081856,0,0,0,904
20078,9083641,9083641,9083659,0,0,0,18
20079,9083863,9083863,9084201,0,0,0,338
20074,9081138,9081138,9084326,0,0,0,3188
20077,9082914,9082914,9084360,0,0,0,1446
20081,9084340,9084340,9084434,0,0,0,94
20082,9084661,9084661,9084755,0,0,0,94
20084,9084955,9084955,9085330,0,0,0,375
20083,9084831,9084831,9085669,0,0,0,838
20088,9085670,9085670,9086019,0,0,0,349
20089,9086154,9086154,9086583,0,0,0,429
20076,9082371,9082371,9087653,0,0,0,5282
20092,9086608,9086608,9087957,0,0,0,1349
20091,9086508,9086508,9088506,0,0,0,1998
20096,9087612,9088506,9088653,0,0,894,1041
20075,9081620,9081620,9088833,0,0,0,7213
20097,9087630,9088653,9088835,0,0,1023,1205
20100,9088302,9088835,9088940,0,0,533,638
20101,9088973,9088973,9089033,0,0,0,60
20093,9086641,9087653,9089038,0,0,1012,2397
20102,9089024,9089033,9089077,0,0,9,53
20104,9089541,9089541,9089566,0,0,0,25
20103,9089506,9089506,9089614,0,0,0,108
20105,9089573,9089614,9089636,0,0,41,63
20107,9089942,9089942,9090044,0,0,0,102
20109,9090010,9090044,9090124,0,0,34,114
20098,9088011,9088833,9090262,0,0,822,2251
20099,9088101,9088833,9090275,0,0,732,2174
20108,9089954,9090044,9090348,0,0,90,394
20111,9090344,9090344,9090448,0,0,0,104
20112,9090419,9090419,9090538,0,0,0,119
20072,9080849,9080849,9092187,0,0,0,11338
20106,9089673,9092187,9092691,0,0,2514,3018
20117,9091262,9092691,9092832,0,0,1429,1570
20120,9092003,9092832,9092897,0,0,829,894
20115,9091061,9092691,9092925,0,0,1630,1864
20085,9085104,9085104,9093160,0,0,0,8056
20113,9090689,9092691,9093339,0,0,2002,2650
20125,9093458,9093458,9093518,0,0,0,60
20094,9086917,9090538,9093574,0,0,3621,6657
20110,9090192,9092187,9093916,0,0,1995,3724
20114,9090757,9093574,9094008,0,0,2817,3251
20095,9087037,9087957,9094059,0,0,920,7022
20124,9093073,9093073,9094356,0,0,0,1283
20123,9092967,9092967,9094636,0,0,0,1669
20128,9094507,9094636,9095083,0,0,129,576
20080,9084278,9084278,9095147,0,0,0,10869
20127,9094417,9094417,9095208,0,0,0,791
20119,9091770,9092691,9095940,0,0,921,4170
20131,9096080,9096080,9096097,0,0,0,17
20130,9095695,9095695,9096145,0,0,0,450
20134,9096660,9096660,9096772,0,0,0,112
20132,9096612,9096612,9097002,0,0,0,390
20135,9097052,9097052,9098064,0,0,0,1012
20139,9099328,9099328,9099356,0,0,0,28
20138,9099283,9099283,9099470,0,0,0,187
20140,9099389,9099389,9100011,0,0,0,622
20090,9086294,9086294,9100287,0,0,0,13993
20144,9100293,9100293,9100389,0,0,0,96
20133,9096639,9096639,9100718,0,0,0,4079
20147,9100547,9100547,9100848,0,0,0,301
20146,9100315,9100315,9101078,0,0,0,763
20148,9100812,9100848,9101093,0,0,36,281
20143,9099815,9100287,9104439,0,0,472,4624
20149,9100920,9101078,9104543,0,0,158,3623
20151,9101203,9104439,9104585,0,0,3236,3382
20153,9101589,9104543,9104696,0,0,2954,3107
20154,9103533,9104585,9104746,0,0,1052,1213
20156,9103836,9104696,9105243,0,0,860,1407
20141,9099395,9099470,9105271,0,0,75,5876
20087,9085432,9085432,9105342,0,0,0,19910
20155,9103808,9105271,9105691,0,0,1463,1883
20159,9105293,9105293,9106213,0,0,0,920
20152,9101472,9104543,9106293,0,0,3071,4821
20161,9105348,9106213,9106299,0,0,865,951
20162,9105721,9106293,9106306,0,0,572,585
20163,9105761,9106299,9106419,0,0,538,658
20167,9106184,9106419,9106437,0,0,235,253
20168,9106236,9106437,9106517,0,0,201,281
20157,9103898,9104746,9106656,0,0,848,2758
20164,9105930,9106656,9106818,0,0,726,888
20126,9093836,9094059,9106995,0,0,223,13159
20169,9106701,9106995,9107092,0,0,294,391
20170,9106766,9106995,9107153,0,0,229,387
20165,9106123,9106818,9107191,0,0,695,1068
20160,9105312,9105691,9107314,0,0,379,2002
20129,9095082,9095147,9107494,0,0,65,12412
20166,9106155,9106306,9107684,0,0,151,1529
20172,9107146,9107146,9108022,0,0,0,876
20173,9107785,9107785,9108422,0,0,0,637
20145,9100314,9107494,9108969,0,0,7180,8655
20176,9108155,9108155,9109213,0,0,0,1058
20121,9092385,9094008,9109283,0,0,1623,16898
20179,9108777,9109213,9109303,0,0,436,526
20118,9091444,9093916,9109623,0,0,2472,18179
20183,9109841,9109841,9109942,0,0,0,101
20150,9100927,9101093,9109971,0,0,166,9044
20174,9108057,9108057,9110259,0,0,0,2202
20175,9108149,9108149,9110451,0,0,0,2302
20184,9109898,9109898,9110570,0,0,0,672
20189,9110639,9110639,9110737,0,0,0,98
20188,9110591,9110591,9111026,0,0,0,435
20192,9111657,9111657,9111812,0,0,0,155
20180,9109019,9109283,9111940,0,0,264,2921
20193,9111740,9111940,9111982,0,0,200,242
20142,9099781,9100011,9112045,0,0,230,12264
20191,9111057,9111057,9113052,0,0,0,1995
20181,9109161,9109303,9113075,0,0,142,3914
20196,9112938,9113075,9113092,0,0,137,154
20197,9112958,9113092,9113108,0,0,134,150
20198,9112979,9113108,9113122,0,0,129,143
20199,9112997,9113122,9113138,0,0,125,141
20200,9113019,9113138,9113153,0,0,119,134
20178,9108768,9108768,9113205,0,0,0,4437
20202,9113520,9113520,9113911,0,0,0,391
20195,9112818,9112818,9114045,0,0,0,1227
20186,9110355,9110355,9114523,0,0,0,4168
20190,9110717,9110717,9114732,0,0,0,4015
20205,9114519,9114519,9114769,0,0,0,250
20207,9115010,9115010,9115132,0,0,0,122
20209,9115471,9115471,9115815,0,0,0,344
20185,9109939,9109939,9115971,0,0,0,6032
20171,9106966,9108969,9116036,0,0,2003,9070
20208,9115136,9115136,9116113,0,0,0,977
20211,9116220,9116220,9116340,0,0,0,120
20122,9092539,9105342,9116630,0,0,12803,24091
20194,9112134,9112134,9116675,0,0,0,4541
20212,9116546,9116546,9116695,0,0,0,149
20210,9115791,9115815,9116749,0,0,24,958
20206,9114753,9114753,9116979,0,0,0,2226
20213,9116807,9116979,9117085,0,0,172,278
20214,9116990,9116990,9117347,0,0,0,357
20204,9114266,9114266,9118022,0,0,0,3756
20215,9117378,9118022,9118186,0,0,644,808
20216,9118269,9118269,9118847,0,0,0,578
20086,9085327,9116695,9120633,0,0,31368,35306
20217,9119934,9119934,9120689,0,0,0,755
20218,9122617,9122617,9123377,0,0,0,760
20219,9124013,9124013,9124637,0,0,0,624
20182,9109637,9116036,9124961,0,0,6399,15324
20201,9113056,9113153,9126528,0,0,97,13472
20116,9091151,9120633,9128104,0,0,29482,36953
20221,9126168,9126168,9128176,0,0,0,2008
20224,9128456,9128456,9128573,0,0,0,117
20225,9128645,9128645,9128973,0,0,0,328
20227,9128912,9128912,9129074,0,0,0,162
20222,9127863,9127863,9129886,0,0,0,2023
20136,9098382,9128104,9130162,0,0,29722,31780
20229,9130025,9130025,9130242,0,0,0,217
20230,9130490,9130490,9130649,0,0,0,159
20223,9128212,9128212,9130911,0,0,0,2699
20137,9098593,9130162,9131568,0,0,31569,32975
20233,9132002,9132002,9132038,0,0,0,36
20226,9128851,9128851,9132980,0,0,0,4129
20228,9129113,9129113,9133014,0,0,0,3901
20158,9104578,9131568,9135890,0,0,26990,31312
20231,9130625,9130625,9136568,0,0,0,5943
20234,9132329,9132329,9137096,0,0,0,4767
20237,9136073,9136073,9142837,0,0,0,6764
20177,9108164,9135890,9145124,0,0,27726,36960
20187,9110394,9145124,9145959,0,0,34730,35565
20235,9133513,9133513,9146321,0,0,0,12808
20236,9134161,9134161,9147127,0,0,0,12966
20203,9113793,9145959,9148646,0,0,32166,34853
20220,9124160,9148646,9148886,0,0,24486,24726
20238,9140081,9140081,9149062,0,0,0,8981
20232,9130947,9130947,9153376,0,0,0,22429
20239,9147620,9147620,9156525,0,0,0,8905
20240,9154133,9154133,9157339,0,0,0,3206
20242,9158503,9158503,9161706,0,0,0,3203
20243,9160738,9160738,9162928,0,0,0,2190
20246,9163210,9163210,9163984,0,0,0,774
20241,9156527,9156527,9165426,0,0,0,8899
20248,9165179,9165179,9165587,0,0,0,408
20245,9162369,9162369,9165658,0,0,0,3289
20247,9164022,9164022,9165795,0,0,0,1773
20249,9165538,9165538,9165827,0,0,0,289
20251,9166391,9166391,9169610,0,0,0,3219
20252,9168959,9168959,9169722,0,0,0,763
20250,9166194,9166194,9170516,0,0,0,4322
20253,9169451,9169451,9171732,0,0,0,2281
20244,9162272,9162272,9171965,0,0,0,9693
20259,9170974,9171965,9172020,0,0,991,1046
20263,9171793,9171965,9172284,0,0,172,491
20261,9171601,9171601,9172415,0,0,0,814
20257,9170902,9170902,9172526,0,0,0,1624
20255,9170470,9170470,9173252,0,0,0,2782
20268,9173184,9173184,9173282,0,0,0,98
20270,9173692,9173692,9173769,0,0,0,77
20269,9173652,9173652,9173884,0,0,0,232
20254,9170273,9170273,9173889,0,0,0,3616
20266,9172498,9172498,9174461,0,0,0,1963
20272,9173816,9173889,9175038,0,0,73,1222
20258,9170946,9170946,9175225,0,0,0,4279
20278,9174694,9174694,9175419,0,0,0,725
20274,9174027,9174027,9175771,0,0,0,1744
20262,9171670,9171732,9175982,0,0,62,4312
20276,9174093,9175225,9176108,0,0,1132,2015
20256,9170840,9170840,9176112,0,0,0,5272
20279,9174702,9175225,9176178,0,0,523,1476
20283,9176175,9176175,9176244,0,0,0,69
20285,9177093,9177093,9177196,0,0,0,103
20287,9177820,9177820,9178047,0,0,0,227
20289,9177942,9178047,9178075,0,0,105,133
20280,9175152,9175225,9179041,0,0,73,3889
20290,9177965,9179041,9179081,0,0,1076,1116
20288,9177859,9177859,9179264,0,0,0,1405
20281,9175501,9175501,9179286,0,0,0,3785
20291,9178005,9179264,9179305,0,0,1259,1300
20295,9179107,9179286,9179443,0,0,179,336
20297,9179491,9179491,9179563,0,0,0,72
20273,9173927,9175038,9180396,0,0,1111,6469
20302,9180744,9180744,9180775,0,0,0,31
20303,9180811,9180811,9180868,0,0,0,57
20301,9180235,9180235,9180903,0,0,0,668
20305,9180911,9180911,9180952,0,0,0,41
20304,9180877,9180877,9181075,0,0,0,198
20307,9181010,9181010,9181122,0,0,0,112
20260,9171486,9171965,9181209,0,0,479,9723
20309,9181422,9181422,9181594,0,0,0,172
20310,9181423,9181423,9181594,0,0,0,171
20308,9181109,9181109,9181839,0,0,0,730
20312,9181659,9181659,9182605,0,0,0,946
20316,9182066,9182605,9182665,0,0,539,599
20318,9182245,9182605,9182726,0,0,360,481
20319,9182366,9182665,9183083,0,0,299,717
20320,9182425,9182726,9183085,0,0,301,660
20313,9181660,9182605,9183549,0,0,945,1889
20315,9181999,9181999,9183899,0,0,0,1900
20286,9177632,9177632,9184099,0,0,0,6467
20325,9182852,9183899,9184109,0,0,1047,1257
20326,9183286,9184109,9184324,0,0,823,1038
20329,9183851,9184324,9184375,0,0,473,524
20330,9183852,9184375,9184425,0,0,523,573
20321,9182724,9184099,9184812,0,0,1375,2088
20331,9183901,9184425,9184836,0,0,524,935
20327,9183791,9184812,9184873,0,0,1021,1082
20332,9183901,9184836,9185247,0,0,935,1346
20334,9184024,9184873,9185409,0,0,849,1385
20299,9179948,9179948,9185735,0,0,0,5787
20323,9182844,9183083,9185934,0,0,239,3090
20324,9182844,9183085,9185937,0,0,241,3093
20314,9181768,9185735,9187688,0,0,3967,5920
20342,9185793,9185793,9188246,0,0,0,2453
20348,9186786,9186786,9188290,0,0,0,1504
20343,9185793,9185934,9188388,0,0,141,2595
20322,9182724,9187688,9188401,0,0,4964,5677
20328,9183791,9188401,9188462,0,0,4610,4671
20298,9179557,9179557,9189133,0,0,0,9576
20311,9181599,9181599,9189215,0,0,0,7616
20333,9184023,9188462,9189520,0,0,4439,5497
20353,9188407,9189133,9190020,0,0,726,1613
20338,9185475,9189520,9190131,0,0,4045,4656
20344,9185852,9190131,9190194,0,0,4279,4342
20350,9187803,9188246,9190415,0,0,443,2612
20293,9178575,9179286,9190753,0,0,711,12178
20358,9189484,9190753,9191307,0,0,1269,1823
20360,9189724,9191307,9192257,0,0,1583,2533
20346,9186146,9190194,9192294,0,0,4048,6148
20267,9172667,9172667,9192594,0,0,0,19927
20339,9185595,9192594,9192655,0,0,6999,7060
20341,9185732,9192594,9192655,0,0,6862,6923
20359,9189655,9191307,9193147,0,0,1652,3492
20361,9190404,9192294,9193192,0,0,1890,2788
20366,9193141,9193192,9193218,0,0,51,77
20351,9188294,9188294,9193233,0,0,0,4939
20352,9188294,9188388,9193327,0,0,94,5033
20340,9185693,9189520,9193491,0,0,3827,7798
20364,9191715,9193147,9194800,0,0,1432,3085
20371,9195637,9195637,9195683,0,0,0,46
20373,9195708,9195708,9195765,0,0,0,57
20362,9190834,9192257,9195804,0,0,1423,4970
20357,9189080,9190415,9195856,0,0,1335,6776
20372,9195657,9195657,9196067,0,0,0,410
20375,9196125,9196125,9196203,0,0,0,78
20356,9188901,9190020,9196256,0,0,1119,7355
20374,9195826,9195826,9196383,0,0,0,557
20370,9195130,9195130,9196419,0,0,0,1289
20292,9178297,9179081,9197187,0,0,784,18890
20336,9184115,9185409,9197783,0,0,1294,13668
20376,9196433,9197187,9198208,0,0,754,1775
20383,9197020,9198208,9198238,0,0,1188,1218
20384,9197095,9198238,9198263,0,0,1143,1168
20337,9184426,9189215,9198264,0,0,4789,13838
20379,9196653,9198264,9198704,0,0,1611,2051
20389,9197535,9198704,9198869,0,0,1169,1334
20390,9197591,9198869,9199749,0,0,1278,2158
20377,9196502,9197783,9199778,0,0,1281,3276
20394,9197961,9199778,9199880,0,0,1817,1919
20396,9198306,9199880,9199914,0,0,1574,1608
20403,9198785,9199914,9199968,0,0,1129,1183
20398,9198360,9199880,9200014,0,0,1520,1654
20392,9197843,9199749,9200232,0,0,1906,2389
20387,9197417,9198704,9200455,0,0,1287,3038
20317,9182126,9183549,9200469,0,0,1423,18343
20405,9198879,9200014,9200990,0,0,1135,2111
20381,9196738,9198264,9201254,0,0,1526,4516
20399,9198515,9201254,9201315,0,0,2739,2800
20349,9187105,9192655,9201319,0,0,5550,14214
20397,9198344,9200469,9201716,0,0,2125,3372
20367,9193374,9193374,9201945,0,0,0,8571
20408,9199878,9200232,9201962,0,0,354,2084
20347,9186265,9192655,9202163,0,0,6390,15898
20401,9198769,9201716,9202169,0,0,2947,3400
20412,9201603,9202169,9202302,0,0,566,699
20388,9197484,9202163,9202366,0,0,4679,4882
20406,9199826,9201945,9202555,0,0,2119,2729
20415,9202012,9202555,9202575,0,0,543,563
20411,9200366,9200990,9202621,0,0,624,2255
20385,9197125,9201319,9202643,0,0,4194,5518
20391,9197824,9202366,9202818,0,0,4542,4994
20386,9197363,9198263,9203144,0,0,900,5781
20378,9196603,9198264,9203685,0,0,1661,7082
20417,9202104,9202575,9203744,0,0,471,1640
20407,9199852,9203685,9203844,0,0,3833,3992
20418,9203292,9203292,9204251,0,0,0,959
20400,9198598,9201315,9204264,0,0,2717,5666
20382,9196753,9197187,9204391,0,0,434,7638
20410,9200276,9203844,9205079,0,0,3568,4803
20368,9193478,9196419,9205348,0,0,2941,11870
20395,9198274,9202643,9205859,0,0,4369,7585
20409,9200117,9200455,9205988,0,0,338,5871
20421,9204261,9204264,9206092,0,0,3,1831
20264,9171938,9206092,9206295,0,0,34154,34357
20402,9198772,9202818,9206501,0,0,4046,7729
20265,9172436,9206295,9207596,0,0,33859,35160
20404,9198835,9199968,9208112,0,0,1133,9277
20271,9173724,9207596,9208302,0,0,33872,34578
20416,9202029,9204251,9209294,0,0,2222,7265
20275,9174048,9208302,9209342,0,0,34254,35294
20277,9174397,9209342,9209628,0,0,34945,35231
20282,9175762,9209628,9210333,0,0,33866,34571
20426,9210118,9210118,9210815,0,0,0,697
20284,9176891,9210333,9211017,0,0,33442,34126
20294,9178709,9211017,9211656,0,0,32308,32947
20296,9179404,9211656,9212362,0,0,32252,32958
20300,9180125,9212362,9217185,0,0,32237,37060
20306,9180949,9217185,9218245,0,0,36236,37296
20423,9207078,9208112,9218350,0,0,1034,11272
20335,9184073,9218245,9218420,0,0,34172,34347
20345,9186000,9218420,9220758,0,0,32420,34758
20420,9203695,9205079,9223223,0,0,1384,19528
20354,9188591,9220758,9223539,0,0,32167,34948
20429,9213451,9213451,9223556,0,0,0,10105
20355,9188769,9223539,9223795,0,0,34770,35026
20433,9221837,9223223,9224188,0,0,1386,2351
20363,9191612,9223795,9225319,0,0,32183,33707
20365,9192935,9225319,9226684,0,0,32384,33749
20428,9212255,9212255,9227441,0,0,0,15186
20434,9222782,9223556,9227767,0,0,774,4985
20430,9215169,9218350,9228199,0,0,3181,13030
20369,9194870,9226684,9228491,0,0,31814,33621
20414,9201942,9202302,9230195,0,0,360,28253
20380,9196658,9228491,9231478,0,0,31833,34820
20435,9224264,9224264,9232669,0,0,0,8405
20393,9197910,9231478,9235811,0,0,33568,37901
20425,9210029,9228199,9237152,0,0,18170,27123
20436,9226366,9226366,9237257,0,0,0,10891
20413,9201716,9235811,9237359,0,0,34095,35643
20419,9203553,9237359,9238182,0,0,33806,34629
20424,9209560,9238182,9240352,0,0,28622,30792
20437,9228995,9230195,9241233,0,0,1200,12238
20438,9233161,9233161,9242724,0,0,0,9563
20427,9211955,9240352,9243025,0,0,28397,31070
20431,9215598,9243025,9243062,0,0,27427,27464
20432,9216027,9243062,9243092,0,0,27035,27065
20439,9237316,9237316,9243642,0,0,0,6326
20440,9238915,9238915,9247789,0,0,0,8874
20442,9245294,9245294,9249821,0,0,0,4527
20444,9249083,9249083,9252368,0,0,0,3285
20441,9242730,9242730,9252561,0,0,0,9831
20422,9206107,9206501,9252893,0,0,394,46786
20448,9251220,9252368,9252915,0,0,1148,1695
20450,9252346,9252915,9253359,0,0,569,1013
20445,9249121,9249121,9254277,0,0,0,5156
20446,9249935,9249935,9255397,0,0,0,5462
20453,9254624,9254624,9255762,0,0,0,1138
20449,9251775,9252368,9256073,0,0,593,4298
20447,9251105,9251105,9256357,0,0,0,5252
20443,9247791,9247791,9256660,0,0,0,8869
20455,9256606,9256606,9256720,0,0,0,114
20458,9258893,9258893,9258917,0,0,0,24
20451,9252565,9252565,9259999,0,0,0,7434
20460,9259308,9259308,9260172,0,0,0,864
20459,9259014,9260172,9260196,0,0,1158,1182
20457,9256685,9256685,9260378,0,0,0,3693
20452,9254217,9254217,9260593,0,0,0,6376
20463,9260634,9260634,9261618,0,0,0,984
20465,9262083,9262083,9262112,0,0,0,29
20454,9255485,9255485,9264437,0,0,0,8952
20466,9264875,9264875,9264914,0,0,0,39
20467,9264913,9264913,9264974,0,0,0,61
20471,9264974,9264974,9264995,0,0,0,21
20472,9264974,9264974,9264995,0,0,0,21
20468,9264973,9264973,9265009,0,0,0,36
20469,9264973,9264973,9265010,0,0,0,37
20470,9264973,9265009,9265111,0,0,36,138
20456,9256641,9256641,9269012,0,0,0,12371
20475,9265255,9269012,9269213,0,0,3757,3958
20461,9260416,9260416,9269314,0,0,0,8898
20473,9265197,9265197,9270458,0,0,0,5261
20474,9265197,9265197,9270621,0,0,0,5424
20477,9269213,9269213,9279825,0,0,0,10612
20483,9278359,9279825,9279862,0,0,1466,1503
20462,9260536,9260593,9280492,0,0,57,19956
20479,9270978,9270978,9283932,0,0,0,12954
20481,9271997,9271997,9284328,0,0,0,12331
20482,9276706,9283932,9286398,0,0,7226,9692
20486,9287292,9287292,9287309,0,0,0,17
20488,9287362,9287362,9288226,0,0,0,864
20487,9287329,9287329,9288851,0,0,0,1522
20493,9289030,9289030,9289040,0,0,0,10
20491,9288697,9288697,9289126,0,0,0,429
20485,9285096,9285096,9289539,0,0,0,4443
20490,9288596,9288596,9290148,0,0,0,1552
20497,9289721,9290148,9290186,0,0,427,465
20495,9289427,9289427,9291692,0,0,0,2265
20500,9291731,9291731,9291817,0,0,0,86
20498,9290350,9290350,9292105,0,0,0,1755
20499,9290541,9292105,9292166,0,0,1564,1625
20502,9291937,9292166,9292242,0,0,229,305
20501,9291739,9291817,9292489,0,0,78,750
20494,9289268,9289268,9292987,0,0,0,3719
20464,9260981,9270458,9293146,0,0,9477,32165
20506,9292424,9292489,9293211,0,0,65,787
20489,9288275,9288275,9293240,0,0,0,4965
20496,9289460,9289539,9293249,0,0,79,3789
20478,9270978,9280492,9293318,0,0,9514,22340
20507,9293428,9293428,9293463,0,0,0,35
20476,9265255,9293146,9293737,0,0,27891,28482
20504,9292076,9293211,9294122,0,0,1135,2046
20480,9271058,9293737,9294289,0,0,22679,23231
20492,9288860,9294289,9295017,0,0,5429,6157
20505,9292197,9293240,9295539,0,0,1043,3342
20484,9284276,9293318,9295909,0,0,9042,11633
20510,9294184,9294289,9296091,0,0,105,1907
20512,9295898,9295898,9296514,0,0,0,616
20515,9297463,9297463,9297484,0,0,0,21
20514,9297229,9297229,9297675,0,0,0,446
20517,9297964,9297964,9298772,0,0,0,808
20511,9295820,9295820,9298893,0,0,0,3073
20508,9293465,9293465,9299603,0,0,0,6138
20520,9299680,9299680,9299786,0,0,0,106
20522,9300382,9300382,9300923,0,0,0,541
20519,9299281,9299281,9301596,0,0,0,2315
20518,9298129,9298129,9302135,0,0,0,4006
20521,9299806,9299806,9302577,0,0,0,2771
20525,9302586,9302586,9302851,0,0,0,265
20527,9303148,9303148,9303179,0,0,0,31
20529,9304089,9304089,9304264,0,0,0,175
20530,9305402,9305402,9305418,0,0,0,16
20531,9305509,9305509,9305520,0,0,0,11
20523,9300439,9300439,9306016,0,0,0,5577
20516,9297478,9297478,9307062,0,0,0,9584
20534,9307332,9307332,9307509,0,0,0,177
20535,9308475,9308475,9309239,0,0,0,764
20532,9306248,9306248,9309725,0,0,0,3477
20536,9309904,9309904,9310951,0,0,0,1047
20503,9291954,9292242,9311376,0,0,288,19422
20537,9311110,9311110,9312472,0,0,0,1362
20539,9313788,9313788,9313828,0,0,0,40
20541,9319983,9319983,9320002,0,0,0,19
20533,9307003,9307003,9320229,0,0,0,13226
20513,9296148,9296148,9331515,0,0,0,35367
20543,9334825,9334825,9334841,0,0,0,16
20544,9334848,9334848,9334864,0,0,0,16
20547,9336120,9336120,9336173,0,0,0,53
20542,9329810,9329810,9339398,0,0,0,9588
20545,9335895,9335895,9340083,0,0,0,4188
20548,9340595,9340595,9341865,0,0,0,1270
20550,9341763,9341763,9341929,0,0,0,166
20546,9335920,9335920,9356043,0,0,0,20123
20554,9345170,9356043,9356130,0,0,10873,10960
20524,9301822,9301822,9356151,0,0,0,54329
20538,9312912,9312912,9356151,0,0,0,43239
20540,9314444,9314444,9356151,0,0,0,41707
20528,9303259,9303259,9356152,0,0,0,52893
20526,9302863,9302863,9356154,0,0,0,53291
20552,9344699,9356043,9356181,0,0,11344,11482
20556,9346366,9356151,9356239,0,0,9785,9873
20559,9349081,9356151,9356251,0,0,7070,7170
20553,9344973,9356043,9356275,0,0,11070,11302
20555,9345524,9356130,9356310,0,0,10606,10786
20549,9341322,9341929,9356493,0,0,607,15171
20509,9293475,9294122,9356799,0,0,647,63324
20563,9356462,9356462,9358364,0,0,0,1902
20560,9356401,9356401,9358365,0,0,0,1964
20561,9356401,9356493,9358457,0,0,92,2056
20551,9341946,9356043,9358772,0,0,14097,16826
20566,9358544,9358544,9359947,0,0,0,1403
20562,9356461,9358457,9360361,0,0,1996,3900
20570,9358545,9358545,9360718,0,0,0,2173
20567,9358544,9358544,9360888,0,0,0,2344
20571,9358545,9358545,9360888,0,0,0,2343
20564,9356963,9356963,9360964,0,0,0,4001
20583,9358621,9360888,9361665,0,0,2267,3044
20572,9358545,9358545,9362408,0,0,0,3863
20573,9358545,9358772,9362635,0,0,227,4090
20585,9358621,9360964,9363061,0,0,2343,4440
20584,9358621,9363061,9363839,0,0,4440,5218
20568,9358544,9360361,9364133,0,0,1817,5589
20574,9358545,9359947,9364307,0,0,1402,5762
20557,9346894,9356151,9364675,0,0,9257,17781
20589,9363878,9364133,9364829,0,0,255,951
20587,9358621,9360964,9365309,0,0,2343,6688
20575,9358545,9360718,9365381,0,0,2173,6836
20569,9358544,9360361,9365444,0,0,1817,6900
20576,9358545,9360888,9365969,0,0,2343,7424
20565,9358484,9360361,9366168,0,0,1877,7684
20579,9358620,9365381,9366219,0,0,6761,7599
20591,9367262,9367262,9367283,0,0,0,21
20586,9358621,9363839,9368122,0,0,5218,9501
20590,9364211,9364211,9368206,0,0,0,3995
20581,9358620,9366168,9371265,0,0,7548,12645
20558,9348228,9356152,9371384,0,0,7924,23156
20588,9358621,9366219,9371889,0,0,7598,13268
20577,9358620,9371265,9372044,0,0,12645,13424
20578,9358620,9372044,9372823,0,0,13424,14203
20596,9372843,9372843,9372853,0,0,0,10
20595,9372502,9372502,9373077,0,0,0,575
20592,9371156,9371156,9375099,0,0,0,3943
20580,9358620,9372823,9376610,0,0,14203,17990
20594,9372202,9372202,9376683,0,0,0,4481
20593,9372025,9372025,9376743,0,0,0,4718
20597,9375759,9376743,9380221,0,0,984,4462
20598,9376971,9380221,9380281,0,0,3250,3310
20609,9377804,9380281,9380342,0,0,2477,2538
20602,9377562,9380221,9380631,0,0,2659,3069
20608,9377623,9380221,9380687,0,0,2598,3064
20604,9377563,9380221,9380688,0,0,2658,3125
20610,9377923,9380342,9380839,0,0,2419,2916
20601,9377558,9380221,9380874,0,0,2663,3316
20617,9378420,9380839,9380940,0,0,2419,2520
20600,9377557,9380221,9380965,0,0,2664,3408
20599,9377505,9380221,9381018,0,0,2716,3513
20618,9378580,9380940,9381036,0,0,2360,2456
20606,9377622,9380631,9381038,0,0,3009,3416
20603,9377563,9380631,9381039,0,0,3068,3476
20612,9378240,9380688,9381308,0,0,2448,3068
20620,9379275,9381036,9381386,0,0,1761,2111
20619,9378676,9381018,9381487,0,0,2342,2811
20611,9378240,9381038,9381535,0,0,2798,3295
20615,9378300,9381039,9381598,0,0,2739,3298
20582,9358620,9376610,9382223,0,0,17990,23603
20605,9377622,9382223,9382573,0,0,4601,4951
20621,9379324,9381535,9382628,0,0,2211,3304
20625,9379385,9381598,9382630,0,0,2213,3245
20607,9377622,9382573,9382981,0,0,4951,5359
20614,9378300,9382630,9383066,0,0,4330,4766
20613,9378240,9382573,9383539,0,0,4333,5299
20631,9390428,9390428,9390450,0,0,0,22
20636,9390531,9390531,9390581,0,0,0,50
20633,9390523,9390523,9390582,0,0,0,59
20634,9390530,9390582,9390634,0,0,52,104
20635,9390530,9390582,9390634,0,0,52,104
20638,9390816,9390816,9390889,0,0,0,73
20630,9390426,9390426,9390959,0,0,0,533
20627,9379385,9380687,9391559,0,0,1302,12174
20628,9379445,9380874,9391778,0,0,1429,12333
20629,9379625,9381386,9391988,0,0,1761,12363
20623,9379325,9381308,9392211,0,0,1983,12886
20639,9391003,9391003,9393317,0,0,0,2314
20622,9379324,9382981,9393737,0,0,3657,14413
20626,9379385,9383066,9393761,0,0,3681,14376
20616,9378300,9393737,9394643,0,0,15437,16343
20644,9394661,9394661,9394672,0,0,0,11
20645,9394707,9394707,9395408,0,0,0,701
20624,9379384,9394643,9395616,0,0,15259,16232
20632,9390485,9395616,9395714,0,0,5131,5229
20641,9394126,9395714,9395747,0,0,1588,1621
20642,9394179,9395747,9395770,0,0,1568,1591
20646,9394733,9395770,9395859,0,0,1037,1126
20647,9394823,9395859,9395913,0,0,1036,1090
20640,9393395,9393395,9395928,0,0,0,2533
20637,9390773,9390773,9396227,0,0,0,5454
20649,9397438,9397438,9397945,0,0,0,507
20650,9399019,9399019,9399456,0,0,0,437
20643,9394655,9394655,9403315,0,0,0,8660
20648,9395183,9395183,9403614,0,0,0,8431
20651,9400145,9400145,9409956,0,0,0,9811
20653,9415610,9415610,9415691,0,0,0,81
20652,9410716,9410716,9420289,0,0,0,9573
20655,9421412,9421412,9421491,0,0,0,79
20656,9422429,9422429,9422489,0,0,0,60
20658,9428987,9428987,9429637,0,0,0,650
20654,9420232,9420232,9430058,0,0,0,9826
20661,9432813,9432813,9433247,0,0,0,434
20663,9435383,9435383,9435929,0,0,0,546
20665,9436656,9436656,9436668,0,0,0,12
20659,9429712,9429712,9439131,0,0,0,9419
20667,9438256,9438256,9439243,0,0,0,987
20660,9430059,9430059,9439642,0,0,0,9583
20666,9437069,9439131,9440267,0,0,2062,3198
20664,9436366,9436366,9440286,0,0,0,3920
20670,9440302,9440302,9440363,0,0,0,61
20671,9442982,9442982,9443604,0,0,0,622
20669,9440291,9440291,9443776,0,0,0,3485
20662,9434595,9439131,9448009,0,0,4536,13414
20675,9443791,9448009,9448035,0,0,4218,4244
20657,9428888,9428888,9448779,0,0,0,19891
20668,9439643,9439643,9449218,0,0,0,9575
20676,9447434,9449218,9450617,0,0,1784,3183
20673,9443731,9443776,9451393,0,0,45,7662
20680,9450444,9451393,9451412,0,0,949,968
20677,9449113,9450617,9451625,0,0,1504,2512
20681,9450711,9451412,9451813,0,0,701,1102
20683,9451220,9451813,9451904,0,0,593,684
20679,9450431,9451625,9452065,0,0,1194,1634
20672,9443412,9443604,9452479,0,0,192,9067
20689,9452579,9452579,9452763,0,0,0,184
20682,9451024,9452065,9452772,0,0,1041,1748
20674,9443780,9448009,9452848,0,0,4229,9068
20686,9452035,9452772,9452915,0,0,737,880
20688,9452541,9452915,9453055,0,0,374,514
20685,9451637,9452479,9453097,0,0,842,1460
20691,9453100,9453100,9453241,0,0,0,141
20693,9453516,9453516,9453644,0,0,0,128
20692,9453233,9453233,9454275,0,0,0,1042
20694,9453960,9453960,9454532,0,0,0,572
20695,9454510,9454532,9454666,0,0,22,156
20684,9451268,9451904,9456145,0,0,636,4877
20697,9456403,9456403,9456449,0,0,0,46
20698,9456689,9456689,9456745,0,0,0,56
20699,9456722,9456722,9456874,0,0,0,152
20690,9452823,9452823,9457161,0,0,0,4338
20701,9457802,9457802,9458089,0,0,0,287
20696,9455912,9455912,9458280,0,0,0,2368
20702,9458654,9458654,9460976,0,0,0,2322
20705,9460043,9460976,9461026,0,0,933,983
20706,9460180,9461026,9461075,0,0,846,895
20678,9449220,9451393,9461216,0,0,2173,11996
20687,9452289,9452848,9461791,0,0,559,9502
20708,9462226,9462226,9463480,0,0,0,1254
20709,9462395,9463480,9463569,0,0,1085,1174
20710,9462598,9463569,9463656,0,0,971,1058
20711,9463123,9463656,9463747,0,0,533,624
20700,9457510,9457510,9463841,0,0,0,6331
20713,9464213,9464213,9465120,0,0,0,907
20715,9465420,9465420,9465509,0,0,0,89
20703,9458893,9458893,9466037,0,0,0,7144
20704,9459042,9459042,9468627,0,0,0,9585
20712,9463946,9463946,9468760,0,0,0,4814
20714,9465219,9465219,9469131,0,0,0,3912
20707,9461233,9461233,9470094,0,0,0,8861
20717,9468802,9468802,9472145,0,0,0,3343
20716,9468630,9468630,9478470,0,0,0,9840
20718,9470095,9470095,9478979,0,0,0,8884
20723,9481365,9481365,9481388,0,0,0,23
20724,9481572,9481572,9482482,0,0,0,910
20719,9477492,9477492,9485482,0,0,0,7990
20726,9486411,9486411,9486451,0,0,0,40
20720,9477910,9477910,9486608,0,0,0,8698
20727,9486664,9486664,9487326,0,0,0,662
20721,9478471,9478471,9488073,0,0,0,9602
20722,9481136,9481136,9491789,0,0,0,10653
20725,9486403,9486403,9495570,0,0,0,9167
20728,9487330,9487330,9495869,0,0,0,8539
20729,9488074,9488074,9497672,0,0,0,9598
20730,9497674,9497674,9507503,0,0,0,9829
20731,9498874,9498874,9507747,0,0,0,8873
20734,9510924,9510924,9514291,0,0,0,3367
20733,9507748,9507748,9516612,0,0,0,8864
20732,9507504,9507504,9517100,0,0,0,9596
20735,9514296,9514296,9517669,0,0,0,3373
20739,9517687,9517687,9517747,0,0,0,60
20740,9518473,9518473,9518994,0,0,0,521
20738,9517675,9517675,9521043,0,0,0,3368
20743,9522028,9522028,9522052,0,0,0,24
20744,9522070,9522070,9522093,0,0,0,23
20745,9522084,9522084,9522432,0,0,0,348
20746,9522752,9522752,9522806,0,0,0,54
20747,9523398,9523398,9523449,0,0,0,51
20748,9523678,9523678,9523688,0,0,0,10
20741,9519198,9519198,9524006,0,0,0,4808
20750,9523919,9524006,9524134,0,0,87,215
20742,9521047,9521047,9524416,0,0,0,3369
20752,9524433,9524433,9524493,0,0,0,60
20749,9523887,9523887,9524684,0,0,0,797
20736,9516613,9516613,9525451,0,0,0,8838
20737,9517102,9517102,9526943,0,0,0,9841
20755,9525668,9525668,9527081,0,0,0,1413
20757,9528022,9528022,9528247,0,0,0,225
20751,9524422,9524422,9528514,0,0,0,4092
20758,9528638,9528638,9529075,0,0,0,437
20759,9529576,9529576,9529602,0,0,0,26
20760,9529664,9529664,9529689,0,0,0,25
20761,9529733,9529733,9529763,0,0,0,30
20764,9531121,9531121,9531835,0,0,0,714
20766,9531889,9531889,9532146,0,0,0,257
20754,9525452,9525452,9534362,0,0,0,8910
20762,9529858,9534362,9534404,0,0,4504,4546
20765,9531165,9531165,9534551,0,0,0,3386
20763,9529941,9534404,9535363,0,0,4463,5422
20756,9526945,9526945,9536510,0,0,0,9565
20768,9534555,9534555,9537923,0,0,0,3368
20774,9538398,9538398,9538966,0,0,0,568
20772,9537927,9537927,9541300,0,0,0,3373
20776,9539132,9539132,9543010,0,0,0,3878
20767,9534365,9535363,9544222,0,0,998,9857
20779,9541304,9541304,9544670,0,0,0,3366
20753,9525202,9525202,9545071,0,0,0,19869
20769,9534949,9545071,9545929,0,0,10122,10980
20771,9536541,9536541,9546133,0,0,0,9592
20770,9536031,9545929,9546782,0,0,9898,10751
20773,9537932,9546782,9547373,0,0,8850,9441
20775,9538965,9547373,9547482,0,0,8408,8517
20777,9539144,9547482,9547590,0,0,8338,8446
20778,9541249,9547590,9547693,0,0,6341,6444
20780,9541416,9547693,9547795,0,0,6277,6379
20782,9543913,9543913,9547821,0,0,0,3908
20785,9547503,9547795,9547933,0,0,292,430
20783,9544675,9544675,9548046,0,0,0,3371
20787,9548797,9548797,9548897,0,0,0,100
20789,9550040,9550040,9550149,0,0,0,109
20786,9548051,9548051,9551444,0,0,0,3393
20781,9543226,9543226,9552120,0,0,0,8894
20788,9549075,9549075,9552939,0,0,0,3864
20784,9546107,9546107,9555949,0,0,0,9842
20791,9552866,9552866,9556566,0,0,0,3700
20792,9553149,9553149,9557042,0,0,0,3893
20790,9552121,9552121,9561009,0,0,0,8888
20797,9560811,9560811,9561633,0,0,0,822
20798,9561442,9561442,9561993,0,0,0,551
20799,9562972,9562972,9563495,0,0,0,523
20800,9563215,9563215,9563537,0,0,0,322
20801,9564302,9564302,9564461,0,0,0,159
20802,9564370,9564370,9564625,0,0,0,255
20803,9565235,9565235,9565420,0,0,0,185
20793,9555951,9555951,9565538,0,0,0,9587
20805,9565599,9565599,9565881,0,0,0,282
20806,9565720,9565720,9566166,0,0,0,446
20807,9566123,9566123,9566650,0,0,0,527
20809,9566879,9566879,9567158,0,0,0,279
20808,9566765,9566765,9567859,0,0,0,1094
20810,9567253,9567253,9568256,0,0,0,1003
20794,9557999,9557999,9569195,0,0,0,11196
20795,9558332,9558332,9569602,0,0,0,11270
20811,9569106,9569106,9569661,0,0,0,555
20796,9559194,9559194,9570080,0,0,0,10886
20812,9570283,9570283,9570339,0,0,0,56
20813,9571303,9571303,9571367,0,0,0,64
20815,9572207,9572207,9572283,0,0,0,76
20816,9572458,9572458,9573308,0,0,0,850
20814,9571736,9571736,9575200,0,0,0,3464
20804,9565545,9565545,9575409,0,0,0,9864
20818,9576505,9576505,9579468,0,0,0,2963
20819,9579595,9579595,9582799,0,0,0,3204
20817,9575412,9575412,9585012,0,0,0,9600
20821,9583012,9583012,9586204,0,0,0,3192
20820,9580880,9580880,9589740,0,0,0,8860
20823,9587674,9587674,9590869,0,0,0,3195
20825,9590885,9590885,9594075,0,0,0,3190
20822,9585015,9585015,9594709,0,0,0,9694
20828,9595474,9595474,9595491,0,0,0,17
20830,9595524,9595524,9595707,0,0,0,183
20829,9595503,9595503,9596164,0,0,0,661
20831,9596180,9596180,9597151,0,0,0,971
20827,9595396,9595396,9597614,0,0,0,2218
20832,9597167,9597167,9597640,0,0,0,473
20834,9597604,9597614,9597648,0,0,10,44
20836,9597791,9597791,9597821,0,0,0,30
20826,9594175,9594175,9598045,0,0,0,3870
20837,9597810,9597821,9598179,0,0,11,369
20824,9589742,9589742,9598622,0,0,0,8880
20842,9600130,9600130,9600138,0,0,0,8
20833,9597517,9597517,9600247,0,0,0,2730
20840,9599585,9599585,9600480,0,0,0,895
20844,9600704,9600704,9600837,0,0,0,133
20845,9601063,9601063,9601176,0,0,0,113
20846,9601279,9601279,9601500,0,0,0,221
20848,9601608,9601608,9601695,0,0,0,87
20850,9601777,9601777,9601909,0,0,0,132
20851,9601988,9601988,9602248,0,0,0,260
20854,9602345,9602345,9602374,0,0,0,29
20853,9602285,9602285,9602385,0,0,0,100
20855,9602386,9602386,9602409,0,0,0,23
20852,9602124,9602124,9602433,0,0,0,309
20856,9602475,9602475,9602653,0,0,0,178
20849,9601657,9601657,9602723,0,0,0,1066
20858,9602916,9602916,9602952,0,0,0,36
20841,9599923,9599923,9603175,0,0,0,3252
20835,9597721,9597721,9603240,0,0,0,5519
20839,9598629,9598629,9603367,0,0,0,4738
20838,9598074,9598179,9603408,0,0,105,5334
20843,9600585,9600585,9603539,0,0,0,2954
20860,9603518,9603518,9603920,0,0,0,402
20847,9601563,9603240,9604916,0,0,1677,3353
20864,9605008,9605008,9605687,0,0,0,679
20861,9604450,9604450,9606111,0,0,0,1661
20865,9605017,9605687,9606303,0,0,670,1286
20868,9605859,9606111,9606702,0,0,252,843
20867,9605795,9606303,9606876,0,0,508,1081
20875,9606923,9606923,9606930,0,0,0,7
20863,9604959,9604959,9606978,0,0,0,2019
20870,9606597,9606876,9607012,0,0,279,415
20877,9607084,9607084,9607146,0,0,0,62
20871,9606740,9606978,9607301,0,0,238,561
20878,9607482,9607482,9607601,0,0,0,119
20862,9604777,9604777,9607622,0,0,0,2845
20872,9606755,9606978,9607666,0,0,223,911
20874,9606779,9607622,9607681,0,0,843,902
20873,9606767,9607301,9607695,0,0,534,928
20857,9602892,9602892,9607930,0,0,0,5038
20879,9607626,9607666,9608062,0,0,40,436
20882,9608295,9608295,9608310,0,0,0,15
20880,9608092,9608092,9608494,0,0,0,402
20883,9608306,9608306,9609019,0,0,0,713
20885,9608588,9608588,9609061,0,0,0,473
20887,9608778,9609061,9609109,0,0,283,331
20859,9603246,9603367,9609259,0,0,121,6013
20890,9609011,9609259,9609295,0,0,248,284
20892,9609324,9609324,9609351,0,0,0,27
20896,9609552,9609552,9609581,0,0,0,29
20895,9609490,9609490,9609583,0,0,0,93
20876,9606960,9606960,9609914,0,0,0,2954
20884,9608488,9608488,9610343,0,0,0,1855
20900,9609872,9610343,9610395,0,0,471,523
20888,9608786,9609019,9611098,0,0,233,2312
20891,9609255,9609255,9611410,0,0,0,2155
20908,9611394,9611410,9611565,0,0,16,171
20906,9611188,9611188,9611913,0,0,0,725
20910,9611764,9611764,9612014,0,0,0,250
20914,9612986,9612986,9613191,0,0,0,205
20902,9610200,9611098,9613250,0,0,898,3050
20916,9613331,9613331,9613413,0,0,0,82
20918,9613635,9613635,9613677,0,0,0,42
20919,9613722,9613722,9613920,0,0,0,198
20922,9613912,9613912,9613999,0,0,0,87
20923,9614203,9614203,9614223,0,0,0,20
20925,9614810,9614810,9614858,0,0,0,48
20901,9610165,9610395,9615145,0,0,230,4980
20927,9615507,9615507,9616007,0,0,0,500
20929,9615978,9615978,9616372,0,0,0,394
20898,9609687,9609687,9616455,0,0,0,6768
20930,9616291,9616291,9616461,0,0,0,170
20931,9616528,9616528,9616573,0,0,0,45
20933,9616666,9616666,9616679,0,0,0,13
20935,9617237,9617237,9617283,0,0,0,46
20899,9609774,9609914,9617578,0,0,140,7804
20886,9608684,9608684,9617666,0,0,0,8982
20905,9610575,9617666,9618091,0,0,7091,7516
20941,9618153,9618153,9618166,0,0,0,13
20924,9614338,9614338,9618192,0,0,0,3854
20940,9617942,9617942,9618287,0,0,0,345
20866,9605108,9606978,9618342,0,0,1870,13234
20943,9618365,9618365,9618397,0,0,0,32
20907,9611249,9618091,9618495,0,0,6842,7246
20945,9618596,9618596,9618625,0,0,0,29
20946,9618659,9618659,9618679,0,0,0,20
20934,9616802,9616802,9618894,0,0,0,2092
20909,9611604,9618495,9618936,0,0,6891,7332
20948,9618935,9618935,9618983,0,0,0,48
20928,9615684,9615684,9619321,0,0,0,3637
20912,9612662,9618936,9619347,0,0,6274,6685
20869,9606120,9606702,9619424,0,0,582,13304
20944,9618476,9618476,9619869,0,0,0,1393
20915,9613106,9619347,9619944,0,0,6241,6838
20921,9613802,9619944,9620004,0,0,6142,6202
20942,9618284,9618284,9620186,0,0,0,1902
20949,9620091,9620091,9620270,0,0,0,179
20951,9620214,9620270,9620286,0,0,56,72
20947,9618865,9618865,9621214,0,0,0,2349
20950,9620206,9620206,9621255,0,0,0,1049
20954,9620532,9621255,9621283,0,0,723,751
20955,9620803,9621283,9621469,0,0,480,666
20953,9620306,9621214,9621639,0,0,908,1333
20894,9609470,9617666,9621981,0,0,8196,12511
20956,9621126,9621469,9622450,0,0,343,1324
20936,9617359,9621981,9622461,0,0,4622,5102
20963,9622108,9622108,9622667,0,0,0,559
20920,9613790,9619424,9623037,0,0,5634,9247
20958,9621776,9622667,9623901,0,0,891,2125
20932,9616649,9620004,9623933,0,0,3355,7284
20959,9621947,9623901,9623945,0,0,1954,1998
20961,9622063,9623933,9623949,0,0,1870,1886
20960,9622007,9623933,9623950,0,0,1926,1943
20965,9622713,9623950,9624110,0,0,1237,1397
20897,9609586,9609586,9624152,0,0,0,14566
20881,9608183,9608183,9624229,0,0,0,16046
20970,9623773,9624229,9624274,0,0,456,501
20962,9622094,9623945,9624296,0,0,1851,2202
20972,9624231,9624274,9624377,0,0,43,146
20967,9623047,9623950,9624634,0,0,903,1587
20939,9617765,9617765,9624752,0,0,0,6987
20973,9624634,9624634,9625192,0,0,0,558
20952,9620265,9620286,9625997,0,0,21,5732
20978,9625646,9625997,9626039,0,0,351,393
20977,9625546,9625546,9626246,0,0,0,700
20937,9617409,9622461,9626282,0,0,5052,8873
20974,9624758,9626282,9626313,0,0,1524,1555
20975,9625401,9626313,9626469,0,0,912,1068
20985,9626680,9626680,9626735,0,0,0,55
20968,9623559,9624110,9626873,0,0,551,3314
20966,9622869,9624752,9626884,0,0,1883,4015
20889,9608893,9609109,9626928,0,0,216,18035
20981,9626296,9626884,9626930,0,0,588,634
20982,9626337,9626337,9626966,0,0,0,629
20984,9626429,9626930,9626972,0,0,501,543
20957,9621360,9623037,9626984,0,0,1677,5624
20988,9626914,9626984,9627017,0,0,70,103
20980,9625858,9626039,9627392,0,0,181,1534
20986,9626732,9626732,9627428,0,0,0,696
20979,9625689,9626469,9627435,0,0,780,1746
20893,9609405,9609405,9627492,0,0,0,18087
20971,9623864,9624229,9628019,0,0,365,4155
20993,9627865,9628019,9628067,0,0,154,202
20994,9627876,9628067,9628092,0,0,191,216
20992,9627711,9627711,9628813,0,0,0,1102
20983,9626373,9626928,9629056,0,0,555,2683
20997,9628121,9629056,9629543,0,0,935,1422
21000,9629401,9629543,9629646,0,0,142,245
21001,9629586,9629646,9629692,0,0,60,106
20990,9627105,9627105,9629700,0,0,0,2595
20996,9627937,9628813,9629709,0,0,876,1772
20998,9628131,9628813,9629930,0,0,682,1799
20989,9626979,9626979,9630926,0,0,0,3947
21002,9629661,9629661,9631068,0,0,0,1407
21004,9630061,9630926,9631136,0,0,865,1075
21008,9630436,9631136,9631394,0,0,700,958
21009,9630517,9631394,9631425,0,0,877,908
21010,9630563,9631425,9631447,0,0,862,884
21011,9630792,9631447,9631508,0,0,655,716
21012,9630916,9631508,9631771,0,0,592,855
21014,9631401,9631771,9632396,0,0,370,995
20969,9623637,9624152,9632709,0,0,515,9072
21005,9630084,9631068,9633165,0,0,984,3081
21007,9630409,9631068,9633209,0,0,659,2800
20987,9626890,9626972,9633453,0,0,82,6563
21017,9631555,9632709,9633505,0,0,1154,1950
21020,9632264,9633209,9633580,0,0,945,1316
21025,9633511,9633580,9633642,0,0,69,131
21024,9633120,9633505,9633841,0,0,385,721
21028,9633781,9633841,9633883,0,0,60,102
20964,9622587,9623949,9633992,0,0,1362,11405
21016,9631448,9632396,9634026,0,0,948,2578
21031,9633943,9633943,9634036,0,0,0,93
21019,9631998,9633165,9634067,0,0,1167,2069
21006,9630133,9634036,9634436,0,0,3903,4303
21015,9631412,9634436,9634522,0,0,3024,3110
21027,9633613,9633642,9634832,0,0,29,1219
20995,9627903,9628092,9634992,0,0,189,7089
21036,9635684,9635684,9635988,0,0,0,304
21021,9632491,9633505,9636554,0,0,1014,4063
21003,9630000,9633453,9636775,0,0,3453,6775
21023,9632859,9636775,9636877,0,0,3916,4018
20903,9610344,9618342,9638246,0,0,7998,27902
21030,9633856,9638246,9638305,0,0,4390,4449
21037,9635794,9638305,9638444,0,0,2511,2650
21034,9635602,9638305,9638450,0,0,2703,2848
20991,9627278,9627435,9638548,0,0,157,11270
20976,9625412,9629930,9638959,0,0,4518,13547
21018,9631803,9634522,9639720,0,0,2719,7917
21039,9636329,9636329,9640263,0,0,0,3934
21043,9639922,9640263,9641339,0,0,341,1417
21038,9635967,9638444,9641631,0,0,2477,5664
21044,9642107,9642107,9642306,0,0,0,199
21045,9642539,9642539,9642731,0,0,0,192
21033,9634908,9634908,9643031,0,0,0,8123
21041,9638398,9639720,9643086,0,0,1322,4688
21042,9639029,9639029,9644461,0,0,0,5432
21040,9637906,9638548,9647219,0,0,642,9313
21032,9634415,9638959,9647919,0,0,4544,13504
21026,9633572,9636877,9648025,0,0,3305,14453
21047,9644484,9644484,9648362,0,0,0,3878
21029,9633842,9638246,9649125,0,0,4404,15283
20904,9610497,9648025,9649583,0,0,37528,39086
20911,9612074,9649583,9649720,0,0,37509,37646
20913,9612960,9649720,9649914,0,0,36760,36954
21052,9651901,9651901,9652146,0,0,0,245
21046,9643390,9643390,9652218,0,0,0,8828
21053,9652058,9652058,9653753,0,0,0,1695
21050,9648390,9648390,9656038,0,0,0,7648
21049,9646878,9646878,9656703,0,0,0,9825
20917,9613367,9649914,9657309,0,0,36547,43942
21051,9648807,9649125,9657521,0,0,318,8714
21057,9658023,9658023,9663155,0,0,0,5132
21060,9663301,9663301,9663358,0,0,0,57
20926,9615181,9657309,9665693,0,0,42128,50512
21056,9657014,9657014,9666591,0,0,0,9577
20938,9617685,9665693,9667273,0,0,48008,49588
21059,9663288,9663288,9668644,0,0,0,5356
20999,9629180,9667273,9669127,0,0,38093,39947
21063,9670818,9670818,9671284,0,0,0,466
21054,9652172,9652172,9672481,0,0,0,20309
21062,9670051,9670051,9674189,0,0,0,4138
21061,9666589,9666589,9676412,0,0,0,9823
21066,9677181,9677181,9680384,0,0,0,3203
21064,9672184,9672184,9681080,0,0,0,8896
21068,9681001,9681001,9681378,0,0,0,377
21070,9683342,9683342,9684485,0,0,0,1143
21067,9680986,9680986,9684624,0,0,0,3638
21013,9630928,9669127,9685213,0,0,38199,54285
21022,9632505,9685213,9685663,0,0,52708,53158
21065,9676415,9676415,9686082,0,0,0,9667
21076,9685787,9686082,9686782,0,0,295,995
21077,9686234,9686782,9687701,0,0,548,1467
21071,9683759,9684485,9687968,0,0,726,4209
21078,9686680,9687701,9688905,0,0,1021,2225
21073,9685355,9687968,9689174,0,0,2613,3819
21072,9685125,9685125,9689496,0,0,0,4371
21069,9681024,9681080,9689905,0,0,56,8881
21084,9688734,9688905,9689921,0,0,171,1187
21085,9688952,9689496,9690455,0,0,544,1503
21089,9689701,9690455,9690585,0,0,754,884
21096,9690797,9690797,9690844,0,0,0,47
21086,9688978,9689921,9691164,0,0,943,2186
21094,9690326,9690455,9691246,0,0,129,920
21101,9691462,9691462,9691741,0,0,0,279
21080,9687248,9689174,9693007,0,0,1926,5759
21081,9687259,9693007,9693067,0,0,5748,5808
21082,9687721,9693067,9693171,0,0,5346,5450
21088,9689619,9689921,9693741,0,0,302,4122
21106,9693175,9693741,9694159,0,0,566,984
21109,9693590,9694159,9694633,0,0,569,1043
21083,9688447,9693171,9695059,0,0,4724,6612
21087,9689475,9695059,9695215,0,0,5584,5740
21092,9690147,9695215,9695358,0,0,5068,5211
21090,9689891,9691164,9697406,0,0,1273,7515
21108,9693453,9697406,9697441,0,0,3953,3988
21113,9694423,9697441,9697460,0,0,3018,3037
21114,9694452,9697460,9697517,0,0,3008,3065
21095,9690534,9695358,9697964,0,0,4824,7430
21117,9695545,9697964,9698102,0,0,2419,2557
21112,9693922,9697441,9698329,0,0,3519,4407
21116,9695021,9697964,9698535,0,0,2943,3514
21120,9696050,9698535,9698666,0,0,2485,2616
21118,9695888,9698102,9698872,0,0,2214,2984
21111,9693794,9694633,9699083,0,0,839,5289
21103,9692183,9692183,9699296,0,0,0,7113
21035,9635611,9685663,9699299,0,0,50052,63688
21119,9696031,9698329,9699375,0,0,2298,3344
21123,9697223,9699083,9699437,0,0,1860,2214
21124,9697267,9699296,9699747,0,0,2029,2480
21132,9699467,9699747,9699769,0,0,280,302
21133,9699558,9699769,9700172,0,0,211,614
21099,9691189,9695358,9701194,0,0,4169,10005
21134,9699580,9700172,9701469,0,0,592,1889
21136,9699894,9701469,9701503,0,0,1575,1609
21138,9700877,9701503,9701647,0,0,626,770
21125,9697617,9699437,9703400,0,0,1820,5783
21048,9645604,9699299,9703549,0,0,53695,57945
21139,9701035,9701647,9704663,0,0,612,3628
21121,9696548,9698666,9704693,0,0,2118,8145
21144,9703642,9704663,9706013,0,0,1021,2371
21115,9694845,9697517,9706380,0,0,2672,11535
21149,9704487,9706380,9706400,0,0,1893,1913
21152,9704818,9706400,9706524,0,0,1582,1706
21122,9697104,9698872,9706579,0,0,1768,9475
21153,9705064,9706524,9706933,0,0,1460,1869
21160,9706631,9706933,9707023,0,0,302,392
21148,9704360,9706013,9707194,0,0,1653,2834
21155,9705512,9706579,9707197,0,0,1067,1685
21163,9706967,9707197,9707275,0,0,230,308
21162,9706810,9707194,9707276,0,0,384,466
21161,9706798,9707023,9707685,0,0,225,887
21126,9697940,9701194,9709497,0,0,3254,11557
21075,9685758,9689905,9709761,0,0,4147,24003
21091,9690059,9709761,9709885,0,0,19702,19826
21127,9698026,9703400,9710185,0,0,5374,12159
21147,9703978,9704693,9710254,0,0,715,6276
21140,9701160,9710185,9710277,0,0,9025,9117
21130,9698747,9709497,9711076,0,0,10750,12329
21142,9702789,9711076,9711351,0,0,8287,8562
21165,9707410,9707685,9714251,0,0,275,6841
21055,9653390,9703549,9714357,0,0,50159,60967
21168,9707533,9714251,9714398,0,0,6718,6865
21170,9707884,9714398,9714768,0,0,6514,6884
21166,9707438,9710254,9716681,0,0,2816,9243
21058,9662340,9714357,9719718,0,0,52017,57378
21150,9704614,9711351,9720537,0,0,6737,15923
21173,9708018,9714768,9720723,0,0,6750,12705
21176,9708521,9720723,9720807,0,0,12202,12286
21177,9708697,9720807,9721014,0,0,12110,12317
21156,9705833,9720537,9721033,0,0,14704,15200
21093,9690186,9709885,9721255,0,0,19699,31069
21178,9708858,9721014,9722132,0,0,12156,13274
21141,9701898,9710277,9722179,0,0,8379,20281
21175,9708339,9716681,9722210,0,0,8342,13871
21097,9690965,9721255,9722341,0,0,30290,31376
21129,9698284,9707276,9722785,0,0,8992,24501
21159,9706574,9722785,9723248,0,0,16211,16674
21179,9708892,9722132,9723919,0,0,13240,15027
21183,9709821,9723919,9724017,0,0,14098,14196
21184,9710192,9724017,9724109,0,0,13825,13917
21180,9709000,9722210,9727184,0,0,13210,18184
21185,9710313,9724109,9727771,0,0,13796,17458
21157,9706126,9721033,9728706,0,0,14907,22580
21188,9712812,9728706,9728726,0,0,15894,15914
21191,9714343,9728706,9728741,0,0,14363,14398
21194,9714540,9728741,9729082,0,0,14201,14542
21196,9715141,9729082,9729261,0,0,13941,14120
21198,9715279,9729261,9729275,0,0,13982,13996
21158,9706428,9722179,9729551,0,0,15751,23123
21199,9715325,9729275,9729599,0,0,13950,14274
21204,9715605,9729599,9729715,0,0,13994,14110
21203,9715538,9729551,9729742,0,0,14013,14204
21206,9716107,9729715,9729797,0,0,13608,13690
21208,9716526,9729742,9729844,0,0,13216,13318
21164,9707182,9723248,9729858,0,0,16066,22676
21218,9719575,9729844,9729867,0,0,10269,10292
21211,9716755,9729797,9729913,0,0,13042,13158
21219,9719990,9729867,9730263,0,0,9877,10273
21225,9724535,9730263,9730345,0,0,5728,5810
21226,9725696,9730345,9730389,0,0,4649,4693
21186,9710690,9727184,9730463,0,0,16494,19773
21231,9729483,9730463,9730598,0,0,980,1115
21207,9716486,9729858,9730719,0,0,13372,14233
21232,9729705,9730598,9730757,0,0,893,1052
21227,9727163,9730389,9730858,0,0,3226,3695
21074,9685746,9719718,9731044,0,0,33972,45298
21234,9730645,9730757,9732018,0,0,112,1373
21187,9711133,9727771,9732060,0,0,16638,20927
21200,9715388,9729551,9732500,0,0,14163,17112
21209,9716674,9730719,9732987,0,0,14045,16313
21192,9714417,9728726,9733443,0,0,14309,19026
21222,9721573,9729913,9733715,0,0,8340,12142
21098,9691086,9721255,9734072,0,0,30169,42986
21214,9717500,9732987,9734558,0,0,15487,17058
21213,9717306,9732500,9734756,0,0,15194,17450
21220,9720273,9734756,9734783,0,0,14483,14510
21079,9686796,9731044,9735194,0,0,44248,48398
21104,9693104,9735194,9736781,0,0,42090,43677
21131,9699123,9736781,9737128,0,0,37658,38005
21137,9700353,9737128,9737326,0,0,36775,36973
21100,9691305,9722341,9738072,0,0,31036,46767
21145,9703797,9738072,9738129,0,0,34275,34332
21235,9732941,9733443,9738260,0,0,502,5319
21105,9693142,9736781,9738451,0,0,43639,45309
21151,9704686,9738451,9738720,0,0,33765,34034
21167,9707513,9738720,9738896,0,0,31207,31383
21237,9733630,9738260,9739457,0,0,4630,5827
21221,9720417,9734783,9739802,0,0,14366,19385
21228,9728820,9739802,9739839,0,0,10982,11019
21238,9734273,9739457,9740313,0,0,5184,6040
21242,9735652,9740313,9740838,0,0,4661,5186
21215,9719206,9734558,9741694,0,0,15352,22488
21230,9729237,9741694,9741755,0,0,12457,12518
21243,9735787,9741755,9741944,0,0,5968,6157
21107,9693182,9736781,9742208,0,0,43599,49026
21172,9707937,9742208,9743201,0,0,34271,35264
21236,9733246,9733715,9743288,0,0,469,10042
21249,9742575,9743288,9743461,0,0,713,886
21250,9742745,9743461,9743601,0,0,716,856
21229,9729225,9739839,9743766,0,0,10614,14541
21252,9742883,9743766,9743983,0,0,883,1100
21253,9743098,9743766,9744077,0,0,668,979
21212,9717066,9732018,9744736,0,0,14952,27670
21169,9707557,9738896,9744946,0,0,31339,37389
21255,9744511,9744511,9744977,0,0,0,466
21254,9743406,9743983,9745091,0,0,577,1685
21102,9692052,9734072,9745543,0,0,42020,53491
21246,9738283,9740838,9745827,0,0,2555,7544
21182,9709479,9744946,9746768,0,0,35467,37289
21257,9746462,9746462,9746866,0,0,0,404
21143,9703488,9737326,9747542,0,0,33838,44054
21181,9709231,9743201,9747710,0,0,33970,38479
21201,9715422,9747710,9747840,0,0,32288,32418
21146,9703914,9738129,9747904,0,0,34215,43990
21190,9714120,9746768,9748177,0,0,32648,34057
21259,9747831,9747831,9748336,0,0,0,505
21193,9714513,9747542,9748514,0,0,33029,34001
21217,9719256,9748514,9748534,0,0,29258,29278
21202,9715529,9747840,9749407,0,0,32311,33878
21110,9693600,9736781,9750631,0,0,43181,57031
21189,9713749,9745543,9750654,0,0,31794,36905
21261,9750368,9750368,9750738,0,0,0,370
21256,9745087,9745087,9752397,0,0,0,7310
21216,9719243,9748177,9752920,0,0,28934,33677
21251,9742832,9743601,9753422,0,0,769,10590
21258,9747758,9747758,9753729,0,0,0,5971
21247,9739018,9741944,9753735,0,0,2926,14717
21154,9705101,9750654,9753864,0,0,45553,48763
21197,9715187,9753864,9754339,0,0,38677,39152
21205,9715655,9747904,9755403,0,0,32249,39748
21174,9708199,9753729,9755617,0,0,45530,47418
21263,9753813,9753813,9756989,0,0,0,3176
21210,9716692,9754339,9761323,0,0,37647,44631
21262,9752649,9752649,9762220,0,0,0,9571
21264,9760346,9760346,9763846,0,0,0,3500
21265,9762222,9762222,9764106,0,0,0,1884
21128,9698156,9761323,9766923,0,0,63167,68767
21267,9764818,9764818,9770048,0,0,0,5230
21135,9699815,9766923,9770409,0,0,67108,70594
21266,9762935,9762935,9770504,0,0,0,7569
21171,9707892,9770409,9770534,0,0,62517,62642
21272,9770618,9770618,9771524,0,0,0,906
21278,9771960,9771960,9772533,0,0,0,573
21282,9772614,9772614,9773813,0,0,0,1199
21268,9769183,9769183,9773990,0,0,0,4807
21195,9714595,9770534,9774633,0,0,55939,60038
21285,9773869,9773869,9774862,0,0,0,993
21287,9774722,9774862,9774876,0,0,140,154
21288,9774753,9774876,9774913,0,0,123,160
21273,9770632,9770632,9775394,0,0,0,4762
21269,9769587,9770048,9777717,0,0,461,8130
21233,9730057,9774633,9778610,0,0,44576,48553
21239,9734734,9778610,9778656,0,0,43876,43922
21240,9735058,9778656,9778700,0,0,43598,43642
21241,9735440,9778700,9778845,0,0,43260,43405
21270,9769594,9777717,9779111,0,0,8123,9517
21244,9736191,9778845,9779260,0,0,42654,43069
21281,9772579,9779111,9779284,0,0,6532,6705
21245,9737628,9779260,9779523,0,0,41632,41895
21289,9774797,9779284,9780493,0,0,4487,5696
21291,9775111,9775111,9780628,0,0,0,5517
21293,9776324,9780628,9780814,0,0,4304,4490
21294,9776550,9780814,9780867,0,0,4264,4317
21274,9770726,9775394,9780998,0,0,4668,10272
21286,9774192,9774192,9781830,0,0,0,7638
21297,9777051,9781830,9781894,0,0,4779,4843
21298,9777141,9781894,9781938,0,0,4753,4797
21299,9777383,9781938,9781983,0,0,4555,4600
21300,9777471,9781983,9782142,0,0,4512,4671
21276,9771638,9779111,9783555,0,0,7473,11917
21302,9778764,9782142,9786820,0,0,3378,8056
21307,9780952,9786820,9786911,0,0,5868,5959
21309,9781320,9786911,9787018,0,0,5591,5698
21311,9782053,9787018,9787484,0,0,4965,5431
21312,9782331,9787484,9787586,0,0,5153,5255
21295,9776566,9780867,9787748,0,0,4301,11182
21318,9783906,9787748,9787808,0,0,3842,3902
21319,9784057,9787808,9788146,0,0,3751,4089
21292,9776025,9780493,9788158,0,0,4468,12133
21315,9782616,9787586,9788863,0,0,4970,6247
21320,9784756,9788146,9788984,0,0,3390,4228
21323,9785133,9788984,9789106,0,0,3851,3973
21329,9785754,9789106,9789148,0,0,3352,3394
21321,9784938,9788863,9789199,0,0,3925,4261
21330,9786277,9789148,9789251,0,0,2871,2974
21331,9786285,9789199,9789413,0,0,2914,3128
21334,9786855,9789413,9789586,0,0,2558,2731
21335,9786980,9789586,9789875,0,0,2606,2895
21305,9779580,9788158,9790078,0,0,8578,10498
21308,9781273,9790078,9790125,0,0,8805,8852
21296,9776833,9780998,9791118,0,0,4165,14285
21310,9781582,9790125,9792222,0,0,8543,10640
21316,9783689,9792222,9792247,0,0,8533,8558
21333,9786584,9789251,9792406,0,0,2667,5822
21223,9721620,9748534,9792704,0,0,26914,71084
21279,9772159,9792704,9792840,0,0,20545,20681
21224,9723086,9749407,9792932,0,0,26321,69846
21301,9778708,9792932,9793191,0,0,14224,14483
21304,9779085,9793191,9793964,0,0,14106,14879
21322,9785125,9793964,9793976,0,0,8839,8851
21324,9785145,9793976,9793982,0,0,8831,8837
21325,9785187,9793982,9794103,0,0,8795,8916
21314,9782558,9791118,9794613,0,0,8560,12055
21336,9787550,9789875,9795116,0,0,2325,7566
21340,9789613,9792406,9795447,0,0,2793,5834
21342,9789864,9795116,9795503,0,0,5252,5639
21290,9774905,9792840,9795789,0,0,17935,20884
21303,9779049,9783555,9795852,0,0,4506,16803
21344,9790142,9795503,9795956,0,0,5361,5814
21347,9790343,9795956,9796061,0,0,5613,5718
21349,9790904,9796061,9796194,0,0,5157,5290
21317,9783717,9792247,9796873,0,0,8530,13156
21327,9785506,9794103,9797769,0,0,8597,12263
21332,9786513,9795789,9797771,0,0,9276,11258
21337,9787889,9797769,9798106,0,0,9880,10217
21351,9791180,9796194,9798371,0,0,5014,7191
21341,9789712,9798106,9798500,0,0,8394,8788
21343,9790097,9795447,9798505,0,0,5350,8408
21369,9797156,9798505,9798543,0,0,1349,1387
21375,9798708,9798708,9798784,0,0,0,76
21348,9790355,9798500,9798787,0,0,8145,8432
21352,9791734,9798787,9799012,0,0,7053,7278
21354,9792492,9799012,9799074,0,0,6520,6582
21365,9795899,9799074,9800715,0,0,3175,4816
21370,9797205,9800715,9800751,0,0,3510,3546
21345,9790208,9795852,9800829,0,0,5644,10621
21350,9791150,9796873,9800859,0,0,5723,9709
21338,9789041,9794613,9800983,0,0,5572,11942
21371,9797686,9800751,9801180,0,0,3065,3494
21380,9799497,9801180,9801194,0,0,1683,1697
21381,9799810,9801194,9801259,0,0,1384,1449
21339,9789179,9797771,9801323,0,0,8592,12144
21384,9800129,9801259,9801334,0,0,1130,1205
21355,9792736,9801323,9801371,0,0,8587,8635
21356,9792789,9801371,9801466,0,0,8582,8677
21374,9798603,9800859,9801690,0,0,2256,3087
21357,9792889,9801466,9801719,0,0,8577,8830
21372,9798512,9800829,9801728,0,0,2317,3216
21359,9793181,9801719,9801974,0,0,8538,8793
21248,9739098,9779523,9802094,0,0,40425,62996
21383,9799979,9801728,9802274,0,0,1749,2295
21386,9800494,9802274,9802332,0,0,1780,1838
21367,9796373,9798371,9802376,0,0,1998,6003
21377,9799161,9800983,9802377,0,0,1822,3216
21390,9800951,9802274,9802377,0,0,1323,1426
21394,9801742,9802377,9802392,0,0,635,650
21395,9801908,9802392,9802405,0,0,484,497
21391,9801182,9802332,9802411,0,0,1150,1229
21392,9801507,9802376,9802599,0,0,869,1092
21387,9800556,9802377,9802670,0,0,1821,2114
21397,9802424,9802599,9802687,0,0,175,263
21353,9792420,9798787,9802819,0,0,6367,10399
21378,9799199,9801180,9803156,0,0,1981,3957
21362,9794082,9802819,9803229,0,0,8737,9147
21399,9803240,9803240,9803334,0,0,0,94
21400,9803536,9803536,9803695,0,0,0,159
21361,9794007,9801974,9803772,0,0,7967,9765
21403,9803782,9803782,9804312,0,0,0,530
21385,9800276,9801334,9804571,0,0,1058,4295
21405,9804512,9804512,9804575,0,0,0,63
21388,9800691,9802411,9806563,0,0,1720,5872
21364,9795176,9803229,9806596,0,0,8053,11420
21409,9806455,9806455,9806781,0,0,0,326
21376,9799119,9799119,9806836,0,0,0,7717
21389,9800908,9806596,9807288,0,0,5688,6380
21379,9799463,9801690,9807575,0,0,2227,8112
21373,9798552,9803772,9807691,0,0,5220,9139
21393,9801617,9807288,9808052,0,0,5671,6435
21396,9802409,9807575,9808343,0,0,5166,5934
21412,9806774,9806774,9808459,0,0,0,1685
21398,9802476,9807691,9808608,0,0,5215,6132
21416,9807841,9808459,9808774,0,0,618,933
21401,9803616,9808052,9808790,0,0,4436,5174
21406,9805559,9808790,9809058,0,0,3231,3499
21404,9804501,9808608,9809421,0,0,4107,4920
21408,9806287,9809058,9809475,0,0,2771,3188
21260,9748741,9802094,9810864,0,0,53353,62123
21407,9805653,9805653,9811925,0,0,0,6272
21410,9806478,9806563,9811954,0,0,85,5476
21402,9803624,9808343,9812328,0,0,4719,8704
21414,9807540,9809475,9813738,0,0,1935,6198
21413,9807168,9809421,9814058,0,0,2253,6890
21422,9814706,9814706,9814791,0,0,0,85
21418,9808204,9811925,9815588,0,0,3721,7384
21415,9807615,9812328,9816518,0,0,4713,8903
21419,9808510,9813738,9817034,0,0,5228,8524
21280,9772449,9817034,9817084,0,0,44585,44635
21283,9772690,9817084,9817131,0,0,44394,44441
21284,9773650,9817131,9817182,0,0,43481,43532
21271,9770432,9810864,9819143,0,0,40432,48711
21275,9771356,9819143,9819191,0,0,47787,47835
21306,9780563,9819191,9819672,0,0,38628,39109
21326,9785264,9817182,9824898,0,0,31918,39634
21358,9792964,9824898,9825068,0,0,31934,32104
21360,9793734,9825068,9825652,0,0,31334,31918
21363,9794523,9825652,9827662,0,0,31129,33139
21423,9815214,9827662,9830306,0,0,12448,15092
21434,9821732,9830306,9830362,0,0,8574,8630
21433,9820819,9830306,9830376,0,0,9487,9557
21432,9819627,9830306,9830382,0,0,10679,10755
21435,9822034,9830362,9830424,0,0,8328,8390
21427,9818400,9830306,9830426,0,0,11906,12026
21429,9818995,9830306,9830430,0,0,11311,11435
21426,9818181,9830306,9830432,0,0,12125,12251
21431,9819386,9830306,9830432,0,0,10920,11046
21424,9817371,9830306,9830433,0,0,12935,13062
21438,9822740,9830382,9830434,0,0,7642,7694
21440,9823035,9830426,9830508,0,0,7391,7473
21439,9822942,9830424,9830521,0,0,7482,7579
21445,9823522,9830433,9830525,0,0,6911,7003
21436,9822208,9830376,9830549,0,0,8168,8341
21441,9823116,9830430,9830553,0,0,7314,7437
21449,9824737,9830521,9830577,0,0,5784,5840
21450,9824918,9830525,9830577,0,0,5607,5659
21442,9823236,9830432,9830586,0,0,7196,7350
21447,9824137,9830508,9830601,0,0,6371,6464
21451,9825587,9830549,9830696,0,0,4962,5109
21446,9823968,9830434,9830712,0,0,6466,6744
21313,9782452,9819672,9830966,0,0,37220,48514
21444,9823386,9830432,9831017,0,0,7046,7631
21328,9785684,9830966,9832505,0,0,45282,46821
21453,9826270,9830553,9834445,0,0,4283,8175
21346,9790274,9832505,9834463,0,0,42231,44189
21459,9831223,9831223,9835075,0,0,0,3852
21461,9833995,9835075,9835132,0,0,1080,1137
21277,9771925,9815588,9835458,0,0,43663,63533
21463,9835049,9835458,9835525,0,0,409,476
21464,9836092,9836092,9836443,0,0,0,351
21465,9836593,9836593,9837070,0,0,0,477
21454,9826678,9830577,9837407,0,0,3899,10729
21366,9796092,9834463,9837601,0,0,38371,41509
21455,9826728,9830601,9837733,0,0,3873,11005
21460,9831454,9831454,9838031,0,0,0,6577
21466,9838288,9838288,9838359,0,0,0,71
21368,9796670,9837601,9839906,0,0,40931,43236
21382,9799813,9839906,9839973,0,0,40093,40160
21411,9806671,9839973,9840709,0,0,33302,34038
21417,9808069,9840709,9841364,0,0,32640,33295
21468,9841271,9841271,9841941,0,0,0,670
21469,9842080,9842080,9842246,0,0,0,166
21462,9834365,9835132,9842248,0,0,767,7883
21420,9810198,9841364,9842820,0,0,31166,32622
21467,9838359,9838359,9843058,0,0,0,4699
21421,9811716,9842820,9843457,0,0,31104,31741
21428,9818913,9843457,9843517,0,0,24544,24604
21425,9817945,9843058,9843726,0,0,25113,25781
21437,9822531,9843726,9844377,0,0,21195,21846
21443,9823301,9844377,9845170,0,0,21076,21869
21448,9824309,9845170,9846449,0,0,20861,22140
21430,9819097,9843517,9846688,0,0,24420,27591
21452,9826079,9846449,9847283,0,0,20370,21204
21456,9827034,9846688,9847502,0,0,19654,20468
21457,9827968,9847283,9848724,0,0,19315,20756
21470,9849298,9849298,9850093,0,0,0,795
21471,9853014,9853014,9853636,0,0,0,622
21473,9853015,9853015,9853636,0,0,0,621
21474,9853015,9853015,9853694,0,0,0,679
21472,9853014,9853694,9854317,0,0,680,1303
21475,9853754,9854317,9855530,0,0,563,1776
21476,9853754,9855530,9856743,0,0,1776,2989
21477,9853754,9856743,9857957,0,0,2989,4203
21458,9829742,9847502,9862706,0,0,17760,32964
21478,9853754,9857957,9864896,0,0,4203,11142
21479,9853754,9862706,9869645,0,0,8952,15891
21480,9853755,9864896,9871930,0,0,11141,18175
21481,9853755,9864896,9871931,0,0,11141,18176
21484,9853756,9871930,9873141,0,0,18174,19385
21482,9853755,9869645,9876680,0,0,15890,22925
21483,9853755,9869645,9876680,0,0,15890,22925
21485,9853756,9871931,9878964,0,0,18175,25208
21486,9853756,9871930,9878992,0,0,18174,25236
21500,9853758,9878964,9880172,0,0,25206,26414
21487,9853756,9873141,9880204,0,0,19385,26448
21501,9853758,9878992,9880561,0,0,25234,26803
21508,9861395,9880172,9882088,0,0,18777,20693
21509,9861395,9880561,9882545,0,0,19166,21150
21488,9853756,9876680,9883743,0,0,22924,29987
21489,9853756,9876680,9883743,0,0,22924,29987
21492,9853757,9876680,9883805,0,0,22923,30048
21493,9853757,9876680,9883806,0,0,22923,30049
21490,9853756,9876680,9883808,0,0,22924,30052
21491,9853756,9876680,9883808,0,0,22924,30052
21506,9861394,9880204,9884092,0,0,18810,22698
21510,9861395,9882088,9884426,0,0,20693,23031
21523,9861516,9884092,9884869,0,0,22576,23353
21530,9861517,9884426,9885248,0,0,22909,23731
21513,9861453,9883743,9885668,0,0,22290,24215
21514,9861453,9883805,9885731,0,0,22352,24278
21531,9861517,9885248,9886071,0,0,23731,24554
21494,9853757,9878964,9886090,0,0,25207,32333
21495,9853757,9878964,9886179,0,0,25207,32422
21496,9853757,9878964,9886180,0,0,25207,32423
21497,9853757,9878964,9886180,0,0,25207,32423
21498,9853757,9878964,9886181,0,0,25207,32424
21499,9853757,9878964,9886210,0,0,25207,32453
21502,9853758,9878992,9886237,0,0,25234,32479
21548,9879128,9886181,9886262,0,0,7053,7134
21511,9861395,9882545,9886401,0,0,21150,25006
21553,9880147,9886210,9886651,0,0,6063,6504
21554,9880147,9886237,9886738,0,0,6090,6591
21546,9874445,9886180,9886815,0,0,11735,12370
21512,9861395,9883743,9887630,0,0,22348,26235
21567,9881080,9887630,9887654,0,0,6550,6574
21525,9861516,9884869,9888694,0,0,23353,27178
21515,9861453,9883806,9890084,0,0,22353,28631
21516,9861453,9883808,9890087,0,0,22355,28634
21552,9880146,9890087,9890589,0,0,9941,10443
21507,9861394,9883743,9891286,0,0,22349,29892
21517,9861453,9883808,9891291,0,0,22355,29838
21529,9861516,9883743,9894661,0,0,22227,33145
21528,9861516,9888694,9896209,0,0,27178,34693
21538,9867852,9885668,9897494,0,0,17816,29642
21562,9880990,9897494,9897587,0,0,16504,16597
21563,9881067,9897587,9897607,0,0,16520,16540
21539,9867852,9885731,9897648,0,0,17879,29796
21540,9867852,9885731,9897678,0,0,17879,29826
21541,9867912,9886090,9897856,0,0,18178,29944
21542,9867922,9886071,9897918,0,0,18149,29996
21565,9881072,9897856,9898048,0,0,16784,16976
21543,9867922,9886179,9898056,0,0,18257,30134
21544,9869730,9890084,9899716,0,0,20354,29986
21503,9854029,9878992,9901793,0,0,24963,47764
21568,9881080,9887654,9903032,0,0,6574,21952
21581,9882247,9901793,9905442,0,0,19546,23195
21561,9880923,9886738,9907556,0,0,5815,26633
21557,9880862,9886262,9907711,0,0,5400,26849
21536,9862952,9891286,9907913,0,0,28334,44961
21585,9882517,9907711,9908142,0,0,25194,25625
21551,9880083,9907913,9908418,0,0,27830,28335
21555,9880829,9908418,9908426,0,0,27589,27597
21576,9882009,9908426,9908660,0,0,26417,26651
21579,9882246,9908660,9912389,0,0,26414,30143
21566,9881079,9886815,9912420,0,0,5736,31341
21537,9863012,9896209,9912776,0,0,33197,49764
21587,9883458,9912420,9912862,0,0,28962,29404
21571,9881104,9897648,9913001,0,0,16544,31897
21575,9881499,9898056,9913014,0,0,16557,31515
21589,9883980,9912776,9913059,0,0,28796,29079
21593,9885894,9913014,9913094,0,0,27120,27200
21590,9884513,9912862,9913360,0,0,28349,28847
21591,9884668,9913001,9913421,0,0,28333,28753
21599,9888174,9913421,9913480,0,0,25247,25306
21595,9886312,9913094,9913526,0,0,26782,27214
21600,9888360,9913480,9913534,0,0,25120,25174
21601,9888574,9913526,9913582,0,0,24952,25008
21596,9887324,9913360,9913799,0,0,26036,26475
21606,9892622,9913799,9914118,0,0,21177,21496
21558,9880862,9886401,9914213,0,0,5539,33351
21608,9896456,9914213,9914374,0,0,17757,17918
21609,9896456,9914374,9914536,0,0,17918,18080
21605,9892131,9913582,9914592,0,0,21451,22461
21559,9880922,9886651,9914673,0,0,5729,33751
21610,9896468,9914536,9914717,0,0,18068,18249
21611,9896617,9914592,9914768,0,0,17975,18151
21612,9896617,9914673,9914849,0,0,18056,18232
21613,9900739,9914717,9914892,0,0,13978,14153
21583,9882248,9903032,9915095,0,0,20784,32847
21607,9893538,9914118,9915105,0,0,20580,21567
21624,9909909,9915105,9915128,0,0,5196,5219
21623,9909890,9915095,9915212,0,0,5205,5322
21626,9909989,9915212,9915239,0,0,5223,5250
21625,9909918,9915128,9915470,0,0,5210,5552
21580,9882246,9912389,9916119,0,0,30143,33873
21594,9886035,9913059,9916282,0,0,27024,30247
21602,9889162,9916282,9916393,0,0,27120,27231
21627,9910052,9915239,9916957,0,0,5187,6905
21629,9912077,9916957,9917021,0,0,4880,4944
21630,9912185,9917021,9917404,0,0,4836,5219
21631,9912197,9917404,9917464,0,0,5207,5267
21570,9881087,9894661,9919754,0,0,13574,38667
21603,9889307,9913534,9919887,0,0,24227,30580
21633,9912566,9919754,9920089,0,0,7188,7523
21634,9912898,9919887,9920421,0,0,6989,7523
21635,9913428,9920089,9921019,0,0,6661,7591
21616,9906180,9914768,9921025,0,0,8588,14845
21556,9880861,9890589,9921137,0,0,9728,40276
21582,9882247,9905442,9921159,0,0,23195,38912
21639,9915383,9921025,9921275,0,0,5642,5892
21604,9891333,9916393,9921592,0,0,25060,30259
21584,9882248,9907556,9921777,0,0,25308,39529
21560,9880922,9891291,9921878,0,0,10369,40956
21615,9902130,9921159,9921914,0,0,19029,19784
21586,9882639,9908142,9921972,0,0,25503,39333
21619,9906724,9914892,9922145,0,0,8168,15421
21640,9917117,9921275,9922196,0,0,4158,5079
21573,9881439,9897918,9922933,0,0,16479,41494
21642,9918035,9921777,9922934,0,0,3742,4899
21572,9881341,9897678,9922992,0,0,16337,41651
21614,9901887,9921137,9923210,0,0,19250,21323
21637,9914355,9921019,9923783,0,0,6664,9428
21617,9906453,9914849,9924153,0,0,8396,17700
21569,9881086,9898048,9924679,0,0,16962,43593
21564,9881067,9897607,9924864,0,0,16540,43797
21644,9919189,9921972,9925571,0,0,2783,6382
21547,9875489,9886180,9925699,0,0,10691,50210
21574,9881498,9899716,9925966,0,0,18218,44468
21645,9922776,9922933,9927164,0,0,157,4388
21646,9927262,9927262,9927286,0,0,0,24
21620,9907717,9921592,9928931,0,0,13875,21214
21597,9887427,9916119,9929632,0,0,28692,42205
21647,9927384,9927384,9930802,0,0,0,3418
21628,9910507,9915470,9931084,0,0,4963,20577
21622,9908324,9921914,9931374,0,0,13590,23050
21643,9918592,9923210,9931796,0,0,4618,13204
21632,9912437,9917464,9932239,0,0,5027,19802
21641,9917784,9922992,9933088,0,0,5208,15304
21621,9907748,9921878,9933226,0,0,14130,25478
21505,9861394,9931374,9933360,0,0,69980,71966
21638,9915055,9922196,9933657,0,0,7141,18602
21636,9913977,9920421,9933992,0,0,6444,20015
21524,9861516,9933360,9934184,0,0,71844,72668
21504,9861393,9929632,9934416,0,0,68239,73023
21588,9883864,9912776,9936984,0,0,28912,53120
21648,9933967,9933992,9937189,0,0,25,3222
21526,9861516,9933657,9937483,0,0,72141,75967
21598,9887439,9924679,9937694,0,0,37240,50255
21527,9861516,9934184,9938010,0,0,72668,76494
21545,9871877,9938010,9939314,0,0,66133,67437
21550,9880076,9939314,9939765,0,0,59238,59689
21577,9882245,9939765,9939902,0,0,57520,57657
21578,9882246,9939902,9940038,0,0,57656,57792
21649,9937333,9937333,9940530,0,0,0,3197
21618,9906588,9940530,9943445,0,0,33942,36857
21655,9945906,9945906,9946304,0,0,0,398
21656,9946161,9946161,9946593,0,0,0,432
21651,9940740,9943445,9946647,0,0,2705,5907
21653,9944795,9944795,9947037,0,0,0,2242
21657,9946825,9946825,9947894,0,0,0,1069
21592,9885392,9940038,9948296,0,0,54646,62904
21660,9948023,9948023,9948403,0,0,0,380
21659,9947622,9947622,9948664,0,0,0,1042
21663,9948872,9948872,9948905,0,0,0,33
21664,9948958,9948958,9949108,0,0,0,150
21665,9949102,9949102,9949215,0,0,0,113
21667,9949160,9949160,9949969,0,0,0,809
21669,9949262,9949969,9950671,0,0,707,1409
21534,9862594,9934416,9951338,0,0,71822,88744
21676,9950475,9951338,9951577,0,0,863,1102
21680,9950918,9951338,9951655,0,0,420,737
21681,9951076,9951577,9951884,0,0,501,808
21666,9949147,9951338,9951967,0,0,2191,2820
21685,9951417,9951884,9952023,0,0,467,606
21684,9951317,9951655,9952093,0,0,338,776
21687,9951859,9952093,9952344,0,0,234,485
21675,9950268,9951338,9952454,0,0,1070,2186
21691,9952398,9952454,9952564,0,0,56,166
21674,9950050,9951338,9953004,0,0,1288,2954
21672,9949695,9950671,9953274,0,0,976,3579
21677,9950552,9951967,9953482,0,0,1415,2930
21679,9950749,9953482,9953673,0,0,2733,2924
21535,9862653,9937483,9954346,0,0,74830,91693
21668,9949253,9949253,9963009,0,0,0,13756
21658,9947167,9947167,9963010,0,0,0,15843
21662,9948731,9948731,9963011,0,0,0,14280
21693,9952992,9952992,9963075,0,0,0,10083
21696,9953559,9963009,9963129,0,0,9450,9570
21705,9963165,9963165,9963265,0,0,0,100
21710,9963218,9963265,9963321,0,0,47,103
21711,9963218,9963321,9963377,0,0,103,159
21688,9951888,9952344,9963461,0,0,456,11573
21670,9949407,9954346,9963471,0,0,4939,14064
21686,9951541,9952023,9963488,0,0,482,11947
21715,9963336,9963461,9963529,0,0,125,193
21704,9963157,9963471,9963531,0,0,314,374
21716,9963422,9963488,9963551,0,0,66,129
21712,9963272,9963551,9963578,0,0,279,306
21708,9963218,9963531,9963579,0,0,313,361
21661,9948702,9948702,9963599,0,0,0,14897
21714,9963324,9963578,9963649,0,0,254,325
21713,9963306,9963377,9963797,0,0,71,491
21689,9952087,9953673,9964510,0,0,1586,12423
21721,9964516,9964516,9964652,0,0,0,136
21671,9949591,9951338,9964670,0,0,1747,15079
21720,9964436,9964670,9964736,0,0,234,300
21719,9964146,9964510,9964950,0,0,364,804
21723,9964721,9964950,9964982,0,0,229,261
21724,9965277,9965277,9965313,0,0,0,36
21717,9963489,9963579,9965368,0,0,90,1879
21698,9955485,9963010,9965395,0,0,7525,9910
21678,9950652,9953274,9965543,0,0,2622,14891
21726,9965321,9965321,9965577,0,0,0,256
21728,9965593,9965593,9966067,0,0,0,474
21722,9964595,9964736,9966134,0,0,141,1539
21732,9966241,9966241,9966342,0,0,0,101
21697,9955041,9963471,9966775,0,0,8430,11734
21702,9962296,9966775,9966886,0,0,4479,4590
21654,9945383,9948296,9968180,0,0,2913,22797
21707,9963217,9968180,9968230,0,0,4963,5013
21709,9963218,9968230,9968279,0,0,5012,5061
21733,9966551,9968279,9968588,0,0,1728,2037
21735,9967060,9968588,9968668,0,0,1528,1608
21730,9966028,9968230,9969315,0,0,2202,3287
21729,9965648,9966067,9969428,0,0,419,3780
21739,9967513,9969428,9969457,0,0,1915,1944
21741,9968325,9969457,9969498,0,0,1132,1173
21742,9968478,9969498,9969877,0,0,1020,1399
21736,9967096,9968588,9970088,0,0,1492,2992
21744,9968656,9970088,9970381,0,0,1432,1725
21746,9969022,9970381,9970398,0,0,1359,1376
21703,9962325,9966886,9970531,0,0,4561,8206
21743,9968607,9969877,9970581,0,0,1270,1974
21748,9969586,9970531,9970628,0,0,945,1042
21727,9965341,9965368,9970741,0,0,27,5400
21750,9970127,9970628,9970952,0,0,501,825
21751,9970274,9970581,9971097,0,0,307,823
21747,9969119,9970398,9971315,0,0,1279,2196
21718,9963843,9963843,9971357,0,0,0,7514
21752,9970893,9970893,9971406,0,0,0,513
21757,9971825,9971825,9971865,0,0,0,40
21755,9971552,9971552,9971919,0,0,0,367
21756,9971737,9971737,9972123,0,0,0,386
21760,9972188,9972188,9972222,0,0,0,34
21759,9972145,9972145,9972410,0,0,0,265
21753,9970975,9970975,9973032,0,0,0,2057
21738,9967485,9968668,9973051,0,0,1183,5566
21768,9973053,9973053,9973314,0,0,0,261
21690,9952317,9963075,9973682,0,0,10758,21365
21769,9973176,9973176,9973886,0,0,0,710
21762,9972427,9972427,9973918,0,0,0,1491
21740,9967595,9969428,9974182,0,0,1833,6587
21725,9965304,9974182,9975055,0,0,8878,9751
21758,9972079,9975055,9975121,0,0,2976,3042
21761,9972377,9975121,9975165,0,0,2744,2788
21764,9972534,9975165,9975265,0,0,2631,2731
21765,9972738,9975265,9975363,0,0,2527,2625
21766,9972945,9975363,9975405,0,0,2418,2460
21770,9973275,9975405,9975504,0,0,2130,2229
21749,9969818,9970531,9975506,0,0,713,5688
21771,9973446,9975504,9975522,0,0,2058,2076
21772,9973638,9975522,9975561,0,0,1884,1923
21775,9974381,9975506,9975577,0,0,1125,1196
21773,9974030,9975561,9975602,0,0,1531,1572
21777,9974579,9975506,9975614,0,0,927,1035
21774,9974232,9975602,9975700,0,0,1370,1468
21776,9974497,9975700,9975742,0,0,1203,1245
21780,9974763,9975742,9975761,0,0,979,998
21788,9975382,9975761,9975812,0,0,379,430
21785,9975086,9975761,9975856,0,0,675,770
21792,9975792,9975856,9975932,0,0,64,140
21783,9974889,9975761,9975950,0,0,872,1061
21694,9953014,9963471,9976097,0,0,10457,23083
21737,9967113,9969315,9976128,0,0,2202,9015
21795,9975967,9976128,9976240,0,0,161,273
21782,9974803,9975761,9976272,0,0,958,1469
21791,9975657,9975812,9976294,0,0,155,637
21796,9976212,9976212,9976302,0,0,0,90
21793,9975854,9975950,9976355,0,0,96,501
21779,9974741,9975614,9976424,0,0,873,1683
21786,9975144,9975761,9976528,0,0,617,1384
21798,9976317,9976317,9976556,0,0,0,239
21699,9956589,9963599,9976605,0,0,7010,20016
21784,9975038,9976605,9976624,0,0,1567,1586
21787,9975292,9976624,9976713,0,0,1332,1421
21789,9975404,9976713,9976868,0,0,1309,1464
21790,9975624,9976868,9977103,0,0,1244,1479
21799,9976386,9976386,9977107,0,0,0,721
21778,9974586,9975577,9977246,0,0,991,2660
21802,9977374,9977374,9977392,0,0,0,18
21803,9977420,9977420,9977515,0,0,0,95
21797,9976226,9976272,9977528,0,0,46,1302
21805,9977503,9977503,9977534,0,0,0,31
21745,9968809,9970381,9977561,0,0,1572,8752
21801,9977038,9977038,9977658,0,0,0,620
21809,9977826,9977826,9977884,0,0,0,58
21800,9977024,9977024,9977918,0,0,0,894
21804,9977471,9977471,9978084,0,0,0,613
21806,9977507,9977507,9978751,0,0,0,1244
21812,9980604,9980604,9980762,0,0,0,158
21811,9978794,9978794,9982397,0,0,0,3603
21808,9977813,9977813,9982398,0,0,0,4585
21767,9973031,9973031,9982458,0,0,0,9427
21754,9971469,9971469,9982460,0,0,0,10991
21794,9975893,9976097,9982602,0,0,204,6709
21807,9977513,9977513,9982624,0,0,0,5111
21810,9978015,9978015,9982624,0,0,0,4609
21518,9861515,9982458,9983237,0,0,120943,121722
21781,9974786,9975761,9983434,0,0,975,8648
21519,9861515,9983237,9984062,0,0,121722,122547
21734,9966827,9968588,9984314,0,0,1761,17487
21520,9861515,9984062,9984888,0,0,122547,123373
21700,9957208,9965543,9984906,0,0,8335,27698
21815,9984011,9984011,9985023,0,0,0,1012
21814,9982891,9982891,9986829,0,0,0,3938
21521,9861515,9984888,9992309,0,0,123373,130794
21817,9988008,9988008,9995319,0,0,0,7311
21823,9996717,9996717,9997128,0,0,0,411
21818,9991771,9991771,9998517,0,0,0,6746
21824,9999567,9999567,9999709,0,0,0,142
21522,9861515,9992309,9999730,0,0,130794,138215
21825,10001707,10001707,10001861,0,0,0,154
21826,10002737,10002737,10003379,0,0,0,642
21827,10004770,10004770,10008214,0,0,0,3444
21828,10005138,10005138,10009074,0,0,0,3936
21829,10005477,10005477,10012163,0,0,0,6686
21830,10009335,10009335,10012716,0,0,0,3381
21816,9985025,9985025,10013003,0,0,0,27978
21532,9862339,9999730,10016844,0,0,137391,154505
21549,9880046,10016844,10017265,0,0,136798,137219
21650,9940099,10017265,10017431,0,0,77166,77332
21652,9941638,10017431,10017775,0,0,75793,76137
21673,9949865,10017775,10018313,0,0,67910,68448
21682,9951132,10018313,10018338,0,0,67181,67206
21683,9951218,10018338,10019126,0,0,67120,67908
21692,9952803,10019126,10019697,0,0,66323,66894
21695,9953385,10019697,10020201,0,0,66312,66816
21701,9960597,10020201,10022900,0,0,59604,62303
21706,9963177,10022900,10022990,0,0,59723,59813
21731,9966150,10022990,10025847,0,0,56840,59697
21533,9862534,10013003,10029922,0,0,150469,167388
21763,9972477,10025847,10035579,0,0,53370,63102
21813,9980704,10029922,10041249,0,0,49218,60545
21820,9996078,10041249,10047262,0,0,45171,51184
21819,9993534,10035579,10050783,0,0,42045,57249
21822,9996560,10050783,10051148,0,0,54223,54588
21840,10035472,10051148,10051212,0,0,15676,15740
21839,10035072,10051148,10051216,0,0,16076,16144
21821,9996279,10047262,10053093,0,0,50983,56814
21833,10028206,10053093,10053447,0,0,24887,25241
21849,10039074,10051148,10053587,0,0,12074,14513
21834,10029234,10053447,10053792,0,0,24213,24558
21835,10030423,10053792,10054010,0,0,23369,23587
21842,10036414,10051148,10054538,0,0,14734,18124
21854,10040301,10051212,10054674,0,0,10911,14373
21852,10039619,10054538,10054774,0,0,14919,15155
21838,10032764,10051148,10054793,0,0,18384,22029
21859,10042696,10054774,10054826,0,0,12078,12130
21866,10049887,10051216,10054961,0,0,1329,5074
21831,10013236,10051148,10055030,0,0,37912,41794
21862,10045749,10055030,10055068,0,0,9281,9319
21863,10045814,10055068,10055123,0,0,9254,9309
21848,10039011,10054538,10055135,0,0,15527,16124
21855,10041401,10054674,10055234,0,0,13273,13833
21858,10042184,10055234,10055723,0,0,13050,13539
21836,10030657,10054010,10057360,0,0,23353,26703
21853,10039808,10054793,10058379,0,0,14985,18571
21860,10043405,10055723,10059122,0,0,12318,15717
21837,10031202,10057360,10060716,0,0,26158,29514
21844,10037895,10060716,10060759,0,0,22821,22864
21845,10038535,10060759,10060820,0,0,22224,22285
21841,10036311,10051148,10060823,0,0,14837,24512
21846,10038611,10060820,10060935,0,0,22209,22324
21832,10026534,10051148,10060987,0,0,24614,34453
21847,10038832,10060935,10061255,0,0,22103,22423
21850,10039181,10061255,10061522,0,0,22074,22341
21865,10046809,10058379,10061818,0,0,11570,15009
21851,10039571,10061255,10062310,0,0,21684,22739
21843,10036507,10051148,10063037,0,0,14641,26530
21864,10045900,10055123,10064535,0,0,9223,18635
21869,10066847,10066847,10066924,0,0,0,77
21856,10041668,10061522,10081418,0,0,19854,39750
21870,10124957,10124957,10125230,0,0,0,273
21871,10129439,10129439,10129448,0,0,0,9
21872,10129935,10129935,10129945,0,0,0,10
21873,10130561,10130561,10134226,0,0,0,3665
21874,10137405,10137405,10137416,0,0,0,11
21876,10168746,10168746,10168757,0,0,0,11
21875,10158683,10158683,10179823,0,0,0,21140
21877,10201141,10201141,10201152,0,0,0,11
21878,10201147,10201147,10201156,0,0,0,9
21879,10205872,10205872,10205884,0,0,0,12
21880,10205881,10205881,10205890,0,0,0,9
21881,10205922,10205922,10211492,0,0,0,5570
21867,10050254,10059122,10213193,0,0,8868,162939
21861,10045081,10054826,10214082,0,0,9745,169001
21885,10207310,10214082,10214504,0,0,6772,7194
21886,10207428,10214504,10214930,0,0,7076,7502
21887,10207965,10214930,10215451,0,0,6965,7486
21891,10209503,10215451,10215470,0,0,5948,5967
21893,10209662,10215470,10215475,0,0,5808,5813
21894,10209761,10215475,10215545,0,0,5714,5784
21892,10209638,10215451,10215554,0,0,5813,5916
21895,10209903,10215545,10215602,0,0,5642,5699
21899,10210624,10215602,10215612,0,0,4978,4988
21900,10210633,10215612,10215620,0,0,4979,4987
21868,10050846,10062310,10215781,0,0,11464,164935
21897,10210155,10215554,10215859,0,0,5399,5704
21901,10210753,10215620,10215883,0,0,4867,5130
21911,10211854,10215883,10216062,0,0,4029,4208
21888,10208104,10215781,10216164,0,0,7677,8060
21905,10211124,10215859,10216174,0,0,4735,5050
21902,10210873,10216164,10216178,0,0,5291,5305
21898,10210557,10216164,10216231,0,0,5607,5674
21904,10210956,10216231,10216328,0,0,5275,5372
21917,10212201,10216174,10216336,0,0,3973,4135
21919,10212516,10216336,10216345,0,0,3820,3829
21913,10212031,10216062,10216361,0,0,4031,4330
21906,10211222,10216328,10216380,0,0,5106,5158
21920,10212596,10216345,10216456,0,0,3749,3860
21922,10212718,10216361,10216456,0,0,3643,3738
21907,10211424,10216380,10216466,0,0,4956,5042
21927,10213327,10216456,10216648,0,0,3129,3321
21924,10212887,10216456,10216951,0,0,3569,4064
21928,10213386,10216648,10217018,0,0,3262,3632
21930,10213495,10217018,10217170,0,0,3523,3675
21932,10213545,10217170,10217430,0,0,3625,3885
21903,10210894,10216178,10217614,0,0,5284,6720
21933,10213664,10217430,10217657,0,0,3766,3993
21929,10213487,10216951,10218096,0,0,3464,4609
21934,10214167,10217657,10218096,0,0,3490,3929
21909,10211605,10217614,10218649,0,0,6009,7044
21936,10215296,10218096,10218652,0,0,2800,3356
21937,10216407,10218652,10218709,0,0,2245,2302
21910,10211785,10218649,10218940,0,0,6864,7155
21912,10212014,10218940,10219305,0,0,6926,7291
21908,10211565,10216466,10220405,0,0,4901,8840
21915,10212086,10219305,10220420,0,0,7219,8334
21918,10212395,10220420,10220481,0,0,8025,8086
21921,10212706,10220481,10220520,0,0,7775,7814
21916,10212143,10220405,10220528,0,0,8262,8385
21938,10216551,10218709,10220651,0,0,2158,4100
21923,10212763,10220520,10220816,0,0,7757,8053
21940,10216856,10220651,10221414,0,0,3795,4558
21941,10216955,10221414,10221427,0,0,4459,4472
21942,10217046,10221427,10221436,0,0,4381,4390
21944,10217634,10221436,10221512,0,0,3802,3878
21945,10217773,10221512,10221560,0,0,3739,3787
21946,10218246,10221560,10221615,0,0,3314,3369
21949,10218637,10221615,10221677,0,0,2978,3040
21950,10218722,10221677,10221729,0,0,2955,3007
21952,10219152,10221729,10221788,0,0,2577,2636
21953,10219699,10221788,10221843,0,0,2089,2144
21954,10219777,10221843,10222222,0,0,2066,2445
21884,10206392,10215781,10222716,0,0,9389,16324
21883,10206111,10213193,10222807,0,0,7082,16696
21943,10217081,10222807,10222819,0,0,5726,5738
21956,10221293,10222819,10222888,0,0,1526,1595
21958,10221838,10222819,10222888,0,0,981,1050
21961,10222340,10222888,10222909,0,0,548,569
21962,10222370,10222888,10222949,0,0,518,579
21963,10222921,10222921,10222999,0,0,0,78
21935,10214282,10218096,10224027,0,0,3814,9745
21964,10223200,10224027,10224078,0,0,827,878
21955,10220413,10222222,10224099,0,0,1809,3686
21968,10223775,10224099,10224260,0,0,324,485
21931,10213528,10222807,10224296,0,0,9279,10768
21969,10223817,10224260,10224335,0,0,443,518
21971,10224565,10224565,10224646,0,0,0,81
21972,10224587,10224646,10224695,0,0,59,108
21973,10224622,10224695,10224709,0,0,73,87
21976,10224889,10224889,10224971,0,0,0,82
21977,10224903,10224971,10225046,0,0,68,143
21966,10223565,10224078,10225076,0,0,513,1511
21980,10225183,10225183,10225234,0,0,0,51
21982,10225433,10225433,10225491,0,0,0,58
21882,10205937,10211492,10225795,0,0,5555,19858
21984,10225765,10225765,10226061,0,0,0,296
21985,10225857,10226061,10226143,0,0,204,286
21988,10226265,10226265,10226370,0,0,0,105
21989,10226426,10226426,10226693,0,0,0,267
21990,10226748,10226748,10226854,0,0,0,106
21991,10227102,10227102,10227231,0,0,0,129
21992,10227414,10227414,10227624,0,0,0,210
21925,10213021,10220528,10227643,0,0,7507,14622
21970,10223911,10227643,10227660,0,0,3732,3749
21974,10224672,10227660,10227756,0,0,2988,3084
21993,10227537,10227624,10227905,0,0,87,368
21926,10213069,10220816,10227966,0,0,7747,14897
21994,10227622,10227905,10227978,0,0,283,356
21960,10222035,10224296,10228262,0,0,2261,6227
21959,10221969,10222999,10228970,0,0,1030,7001
21996,10228142,10228970,10229053,0,0,828,911
21997,10228152,10229053,10229112,0,0,901,960
21998,10228267,10229112,10229165,0,0,845,898
22002,10228450,10229165,10229237,0,0,715,787
22001,10228354,10229112,10229319,0,0,758,965
22006,10228675,10229319,10229438,0,0,644,763
22007,10228893,10229438,10229531,0,0,545,638
22008,10228998,10229531,10229589,0,0,533,591
22009,10229239,10229589,10229675,0,0,350,436
22011,10229376,10229675,10229703,0,0,299,327
22012,10229439,10229703,10229940,0,0,264,501
22016,10229900,10229940,10229982,0,0,40,82
21967,10223627,10225795,10230047,0,0,2168,6420
22019,10230284,10230284,10230325,0,0,0,41
22022,10230619,10230619,10230700,0,0,0,81
21914,10212054,10222716,10230709,0,0,10662,18655
21975,10224859,10227756,10230845,0,0,2897,5986
22023,10230987,10230987,10231006,0,0,0,19
22000,10228307,10230845,10231060,0,0,2538,2753
21978,10224924,10225046,10231086,0,0,122,6162
22025,10231081,10231086,10231164,0,0,5,83
21995,10228056,10228056,10231190,0,0,0,3134
22003,10228464,10231060,10231404,0,0,2596,2940
22024,10231072,10231072,10231696,0,0,0,624
22027,10231279,10231696,10232170,0,0,417,891
22031,10232266,10232266,10232520,0,0,0,254
22026,10231171,10231404,10232559,0,0,233,1388
22005,10228625,10229237,10233873,0,0,612,5248
22033,10232329,10232559,10233877,0,0,230,1548
22034,10232832,10233873,10234291,0,0,1041,1459
22032,10232279,10232520,10235383,0,0,241,3104
22042,10233910,10235383,10235435,0,0,1473,1525
22040,10233441,10234291,10235730,0,0,850,2289
22045,10234552,10235435,10235930,0,0,883,1378
22038,10233301,10233877,10236020,0,0,576,2719
22048,10234664,10235930,10236195,0,0,1266,1531
22047,10234625,10235730,10236476,0,0,1105,1851
22044,10234169,10236020,10237031,0,0,1851,2862
21939,10216682,10230709,10237063,0,0,14027,20381
22052,10235217,10237031,10237191,0,0,1814,1974
22055,10235527,10237031,10237356,0,0,1504,1829
21999,10228291,10230047,10237529,0,0,1756,9238
22056,10235556,10237191,10238113,0,0,1635,2557
22058,10235882,10237356,10238383,0,0,1474,2501
22050,10235036,10236195,10238538,0,0,1159,3502
22065,10237846,10238383,10238573,0,0,537,727
22060,10236115,10238113,10238721,0,0,1998,2606
22051,10235067,10236476,10238790,0,0,1409,3723
22053,10235387,10237529,10238884,0,0,2142,3497
22066,10238348,10238538,10239142,0,0,190,794
22068,10239033,10239142,10239660,0,0,109,627
22057,10235784,10238884,10240035,0,0,3100,4251
22054,10235467,10238790,10240570,0,0,3323,5103
22067,10238484,10238573,10240631,0,0,89,2147
22069,10240448,10240448,10241312,0,0,0,864
21983,10225587,10227966,10242731,0,0,2379,17144
21986,10225966,10228262,10243019,0,0,2296,17053
21948,10218419,10237063,10243616,0,0,18644,25197
21857,10042058,10081418,10243684,0,0,39360,201626
22063,10237042,10240035,10244063,0,0,2993,7021
22072,10242747,10243019,10245090,0,0,272,2343
22075,10245258,10245258,10245314,0,0,0,56
22074,10244978,10244978,10245317,0,0,0,339
22079,10245962,10245962,10246782,0,0,0,820
21979,10224979,10243616,10248419,0,0,18637,23440
21987,10225997,10248419,10248737,0,0,22422,22740
22010,10229281,10248737,10249347,0,0,19456,20066
22013,10229459,10249347,10249416,0,0,19888,19957
22014,10229753,10249416,10249535,0,0,19663,19782
21889,10208216,10243684,10251062,0,0,35468,42846
22004,10228526,10231190,10251707,0,0,2664,23181
22081,10250455,10250455,10253363,0,0,0,2908
22073,10244515,10244515,10254855,0,0,0,10340
22084,10253586,10253586,10255443,0,0,0,1857
21890,10209497,10251062,10255998,0,0,41565,46501
22070,10241082,10241082,10256556,0,0,0,15474
21951,10219146,10242731,10256650,0,0,23585,37504
22020,10230310,10256650,10256714,0,0,26340,26404
22087,10254994,10256556,10256754,0,0,1562,1760
22021,10230438,10256714,10256824,0,0,26276,26386
22028,10231411,10256824,10256907,0,0,25413,25496
22029,10231971,10256907,10256995,0,0,24936,25024
22030,10232120,10256995,10257057,0,0,24875,24937
22015,10229789,10249535,10257223,0,0,19746,27434
22039,10233341,10257223,10257303,0,0,23882,23962
22035,10232907,10257057,10258156,0,0,24150,25249
22043,10233995,10258156,10258207,0,0,24161,24212
22049,10234908,10258207,10258310,0,0,23299,23402
22059,10236011,10258310,10258375,0,0,22299,22364
22061,10236255,10258375,10258425,0,0,22120,22170
22062,10236437,10258425,10258483,0,0,21988,22046
22089,10256554,10256754,10259239,0,0,200,2685
22092,10259147,10259147,10259318,0,0,0,171
22064,10237568,10258483,10262475,0,0,20915,24907
22083,10253113,10253113,10262702,0,0,0,9589
22095,10260193,10262702,10262861,0,0,2509,2668
22096,10260433,10262861,10262919,0,0,2428,2486
22018,10230025,10254855,10263069,0,0,24830,33044
22094,10260058,10260058,10263208,0,0,0,3150
22091,10259131,10263208,10263816,0,0,4077,4685
22090,10257997,10259239,10264394,0,0,1242,6397
22093,10259941,10263816,10264484,0,0,3875,4543
22071,10241565,10262475,10266335,0,0,20910,24770
21957,10221502,10255998,10267298,0,0,34496,45796
21896,10210083,10255998,10267305,0,0,45915,57222
22036,10232932,10267298,10267552,0,0,34366,34620
22099,10263896,10264484,10267677,0,0,588,3781
22085,10253772,10267552,10267714,0,0,13780,13942
22086,10254534,10267552,10267715,0,0,13018,13181
22088,10255759,10267715,10267751,0,0,11956,11992
22101,10268759,10268759,10269065,0,0,0,306
22076,10245431,10263069,10269830,0,0,17638,24399
22037,10233179,10267305,10271527,0,0,34126,38348
22078,10245612,10266335,10273685,0,0,20723,28073
22100,10268171,10268171,10273817,0,0,0,5646
21947,10218338,10271527,10274885,0,0,53189,56547
22097,10260677,10264394,10276692,0,0,3717,16015
22041,10233739,10257303,10277222,0,0,23564,43483
21965,10223213,10274885,10278397,0,0,51672,55184
21981,10225404,10278397,10280162,0,0,52993,54758
22017,10229918,10280162,10284571,0,0,50244,54653
22102,10272972,10272972,10285421,0,0,0,12449
22105,10288859,10288859,10289889,0,0,0,1030
22107,10290313,10290313,10290326,0,0,0,13
22108,10290344,10290344,10291736,0,0,0,1392
22103,10285419,10285419,10291791,0,0,0,6372
22118,10294069,10294069,10294239,0,0,0,170
22113,10293230,10293230,10294807,0,0,0,1577
22110,10291756,10291756,10295535,0,0,0,3779
22121,10294831,10294831,10295638,0,0,0,807
22125,10295603,10295603,10296146,0,0,0,543
22127,10296138,10296138,10296216,0,0,0,78
22129,10296342,10296342,10296465,0,0,0,123
22132,10296800,10296800,10296895,0,0,0,95
22133,10296830,10296895,10296939,0,0,65,109
22134,10296920,10296939,10297048,0,0,19,128
22136,10297153,10297153,10297249,0,0,0,96
22131,10296608,10296608,10297548,0,0,0,940
22046,10234585,10284571,10300297,0,0,49986,65712
22077,10245543,10300297,10312325,0,0,54754,66782
22080,10250227,10312325,10313411,0,0,62098,63184
22082,10251394,10313411,10313525,0,0,62017,62131
22115,10293513,10293513,10315776,0,0,0,22263
22112,10291981,10291981,10315821,0,0,0,23840
22109,10291662,10291662,10315892,0,0,0,24230
22116,10293804,10315821,10315895,0,0,22017,22091
22111,10291837,10291837,10315896,0,0,0,24059
22114,10293489,10293489,10315897,0,0,0,22408
22137,10297596,10297596,10315951,0,0,0,18355
22128,10296165,10296165,10315957,0,0,0,19792
22106,10290107,10290107,10315967,0,0,0,25860
22120,10294615,10315896,10315973,0,0,21281,21358
22140,10315377,10315377,10316023,0,0,0,646
22122,10294838,10315957,10316028,0,0,21119,21190
22123,10295280,10315973,10316035,0,0,20693,20755
22126,10295626,10316028,10316086,0,0,20402,20460
22138,10302316,10315776,10316235,0,0,13460,13919
22130,10296578,10316035,10316292,0,0,19457,19714
22119,10294609,10315895,10318900,0,0,21286,24291
22141,10316053,10316292,10324078,0,0,239,8025
22139,10304738,10316235,10324091,0,0,11497,19353
22146,10317098,10324091,10324181,0,0,6993,7083
22148,10317595,10324181,10324264,0,0,6586,6669
22150,10318413,10324264,10324332,0,0,5851,5919
22147,10317237,10324091,10324547,0,0,6854,7310
22154,10319069,10324547,10324637,0,0,5478,5568
22153,10318711,10324332,10324655,0,0,5621,5944
22155,10319097,10324637,10324655,0,0,5540,5558
22143,10316203,10324078,10324953,0,0,7875,8750
22144,10316274,10324091,10325042,0,0,7817,8768
22151,10318632,10324953,10325480,0,0,6321,6848
22152,10318657,10324953,10325550,0,0,6296,6893
22158,10319473,10325480,10326269,0,0,6007,6796
22163,10319932,10325550,10326358,0,0,5618,6426
22165,10320041,10326358,10326411,0,0,6317,6370
22161,10319873,10325550,10326520,0,0,5677,6647
22166,10320131,10326411,10326558,0,0,6280,6427
22170,10320861,10326558,10326570,0,0,5697,5709
22160,10319653,10325042,10326630,0,0,5389,6977
22171,10320925,10326570,10326815,0,0,5645,5890
22174,10321626,10326815,10326884,0,0,5189,5258
22098,10263536,10313525,10326954,0,0,49989,63418
22175,10321708,10326884,10326999,0,0,5176,5291
22159,10319552,10324655,10327085,0,0,5103,7533
22181,10322777,10327085,10327194,0,0,4308,4417
22176,10321848,10326999,10327289,0,0,5151,5441
22173,10321117,10326630,10327594,0,0,5513,6477
22183,10322999,10327289,10327941,0,0,4290,4942
22185,10323409,10327941,10328019,0,0,4532,4610
22142,10316173,10318900,10328747,0,0,2727,12574
22172,10321078,10328747,10329261,0,0,7669,8183
22164,10320036,10328747,10329270,0,0,8711,9234
22168,10320738,10326520,10329678,0,0,5782,8940
22182,10322940,10327194,10330380,0,0,4254,7440
22191,10326348,10330380,10330438,0,0,4032,4090
22179,10321995,10329270,10330492,0,0,7275,8497
22184,10323006,10327594,10330714,0,0,4588,7708
22196,10328227,10330438,10330715,0,0,2211,2488
22198,10328609,10330714,10330948,0,0,2105,2339
22178,10321959,10329261,10330954,0,0,7302,8995
22200,10329327,10330715,10331170,0,0,1388,1843
22156,10319125,10324655,10331656,0,0,5530,12531
22180,10322093,10330492,10332052,0,0,8399,9959
22162,10319904,10326269,10332431,0,0,6365,12527
22145,10316408,10324091,10333799,0,0,7683,17391
22187,10324533,10330954,10334078,0,0,6421,9545
22201,10329443,10334078,10334232,0,0,4635,4789
22135,10297084,10316086,10334342,0,0,19002,37258
22203,10329849,10334232,10334364,0,0,4383,4515
22188,10324588,10331656,10334768,0,0,7068,10180
22206,10332659,10334364,10334869,0,0,1705,2210
22167,10320479,10334342,10334957,0,0,13863,14478
22202,10329822,10330948,10335060,0,0,1126,5238
22210,10333861,10335060,10335342,0,0,1199,1481
22169,10320774,10334957,10335436,0,0,14183,14662
22211,10334145,10335342,10339441,0,0,1197,5296
22212,10334236,10339441,10339618,0,0,5205,5382
22213,10334248,10339618,10339663,0,0,5370,5415
22216,10335333,10339663,10339926,0,0,4330,4593
22194,10327447,10332052,10340768,0,0,4605,13321
22220,10338395,10340768,10340831,0,0,2373,2436
22190,10325824,10329678,10340928,0,0,3854,15104
22195,10327455,10332431,10341157,0,0,4976,13702
22222,10339073,10340768,10341166,0,0,1695,2093
22218,10336576,10339663,10341955,0,0,3087,5379
22189,10325204,10335436,10343250,0,0,10232,18046
22224,10339540,10340831,10343855,0,0,1291,4315
22225,10342288,10342288,10344208,0,0,0,1920
22226,10344277,10344277,10345169,0,0,0,892
22227,10345411,10345411,10345487,0,0,0,76
22228,10345674,10345674,10345721,0,0,0,47
22230,10345987,10345987,10346125,0,0,0,138
22229,10345757,10345757,10346316,0,0,0,559
22231,10346401,10346401,10346463,0,0,0,62
22232,10346412,10346412,10346526,0,0,0,114
22233,10346454,10346526,10347598,0,0,72,1144
22234,10347978,10347978,10348478,0,0,0,500
22219,10337902,10339926,10349816,0,0,2024,11914
22192,10326357,10343250,10350058,0,0,16893,23701
22223,10339284,10341166,10352518,0,0,1882,13234
22221,10338581,10341157,10352659,0,0,2576,14078
22208,10333398,10334768,10353200,0,0,1370,19802
22193,10327277,10350058,10354012,0,0,22781,26735
22104,10288085,10326954,10354021,0,0,38869,65936
22117,10293902,10354021,10354300,0,0,60119,60398
22177,10321883,10354300,10356074,0,0,32417,34191
22197,10328366,10356074,10356193,0,0,27708,27827
22199,10329290,10356193,10356314,0,0,26903,27024
22204,10330853,10356314,10356441,0,0,25461,25588
22205,10331206,10353200,10357528,0,0,21994,26322
22186,10323711,10328019,10357951,0,0,4308,34240
22235,10348479,10357528,10358139,0,0,9049,9660
22207,10333169,10354012,10358332,0,0,20843,25163
22238,10350930,10358332,10358405,0,0,7402,7475
22239,10351029,10358405,10358721,0,0,7376,7692
22241,10351919,10358721,10358890,0,0,6802,6971
22236,10349399,10358139,10359410,0,0,8740,10011
22237,10350525,10350525,10359658,0,0,0,9133
22214,10334805,10356441,10360749,0,0,21636,25944
22240,10351206,10352518,10361448,0,0,1312,10242
22217,10335752,10356441,10364989,0,0,20689,29237
22209,10333408,10334869,10368258,0,0,1461,34850
22242,10359045,10359045,10368675,0,0,0,9630
22215,10335195,10359410,10371856,0,0,24215,36661
22244,10373068,10373068,10373325,0,0,0,257
22245,10373341,10373341,10373362,0,0,0,21
22124,10295591,10354021,10373713,0,0,58430,78122
22247,10373414,10373414,10374415,0,0,0,1001
22249,10373725,10373725,10375992,0,0,0,2267
22246,10373370,10373370,10375993,0,0,0,2623
22248,10373567,10373713,10376137,0,0,146,2570
22149,10318317,10368675,10376180,0,0,50358,57863
22252,10376078,10376078,10376466,0,0,0,388
22253,10376185,10376185,10376850,0,0,0,665
22261,10378590,10378590,10378692,0,0,0,102
22259,10378578,10378578,10378996,0,0,0,418
22250,10375189,10375189,10379182,0,0,0,3993
22258,10378534,10378534,10379422,0,0,0,888
22260,10378584,10378996,10379820,0,0,412,1236
22255,10376780,10376780,10380231,0,0,0,3451
22266,10380440,10380440,10380502,0,0,0,62
22268,10380628,10380628,10380670,0,0,0,42
22269,10381050,10381050,10381115,0,0,0,65
22265,10380056,10380231,10381299,0,0,175,1243
22271,10381403,10381403,10381486,0,0,0,83
22243,10368677,10371856,10381662,0,0,3179,12985
22273,10381884,10381884,10381923,0,0,0,39
22272,10381669,10381669,10382049,0,0,0,380
22251,10375629,10375629,10382790,0,0,0,7161
22280,10383335,10383335,10383376,0,0,0,41
22254,10376456,10376456,10383466,0,0,0,7010
22275,10382010,10383466,10383500,0,0,1456,1490
22257,10377798,10377798,10384000,0,0,0,6202
22274,10381920,10381923,10384104,0,0,3,2184
22283,10384173,10384173,10384193,0,0,0,20
22263,10379486,10379820,10384463,0,0,334,4977
22262,10378733,10379422,10384683,0,0,689,5950
22267,10380461,10381299,10384822,0,0,838,4361
22282,10383796,10384000,10384831,0,0,204,1035
22288,10384807,10384831,10384877,0,0,24,70
22287,10384788,10384788,10384886,0,0,0,98
22284,10384255,10384255,10386282,0,0,0,2027
22289,10384910,10386282,10386414,0,0,1372,1504
22277,10382588,10382588,10386526,0,0,0,3938
22292,10385283,10386526,10386614,0,0,1243,1331
22293,10385396,10386614,10386694,0,0,1218,1298
22290,10385250,10386414,10386722,0,0,1164,1472
22297,10386330,10386722,10387022,0,0,392,692
22298,10386580,10387022,10387058,0,0,442,478
22299,10386591,10387058,10387334,0,0,467,743
22300,10386635,10387334,10387389,0,0,699,754
22304,10386890,10387389,10387925,0,0,499,1035
22305,10386910,10387925,10388073,0,0,1015,1163
22296,10385865,10386694,10388223,0,0,829,2358
22307,10387338,10388073,10388314,0,0,735,976
22281,10383573,10384822,10388765,0,0,1249,5192
22291,10385267,10388765,10388809,0,0,3498,3542
22310,10387512,10388314,10388815,0,0,802,1303
22294,10385634,10388765,10388878,0,0,3131,3244
22311,10387554,10388815,10389024,0,0,1261,1470
22301,10386688,10388878,10389318,0,0,2190,2630
22295,10385759,10388809,10389319,0,0,3050,3560
22303,10386816,10389319,10389340,0,0,2503,2524
22302,10386750,10389318,10389341,0,0,2568,2591
22312,10387597,10389024,10389348,0,0,1427,1751
22306,10386944,10389340,10389362,0,0,2396,2418
22314,10388104,10389348,10389392,0,0,1244,1288
22308,10387368,10389341,10389546,0,0,1973,2178
22320,10388796,10389546,10389861,0,0,750,1065
22276,10382404,10383500,10390279,0,0,1096,7875
22322,10390250,10390250,10390853,0,0,0,603
22326,10391112,10391112,10391304,0,0,0,192
22309,10387405,10388223,10391457,0,0,818,4052
22285,10384263,10384886,10391497,0,0,623,7234
22279,10383120,10384683,10391559,0,0,1563,8439
22318,10388450,10389392,10391581,0,0,942,3131
22317,10388287,10389362,10391778,0,0,1075,3491
22315,10388173,10389362,10391892,0,0,1189,3719
22327,10391245,10391304,10392195,0,0,59,950
22330,10391966,10392195,10392432,0,0,229,466
22328,10391422,10391892,10392584,0,0,470,1162
22331,10391996,10392584,10392613,0,0,588,617
22336,10392325,10392613,10392802,0,0,288,477
22325,10390737,10391581,10392889,0,0,844,2152
22337,10392488,10392802,10393179,0,0,314,691
22338,10392639,10393179,10393219,0,0,540,580
22339,10392697,10393219,10393314,0,0,522,617
22321,10388959,10389861,10393903,0,0,902,4944
22316,10388273,10391497,10394097,0,0,3224,5824
22344,10393139,10393903,10394249,0,0,764,1110
22347,10393523,10394249,10394477,0,0,726,954
22332,10392132,10392432,10394608,0,0,300,2476
22348,10393711,10394477,10395007,0,0,766,1296
22352,10394455,10395007,10395275,0,0,552,820
22334,10392254,10392889,10395402,0,0,635,3148
22353,10394522,10395275,10395448,0,0,753,926
22351,10394443,10394608,10395491,0,0,165,1048
22358,10394750,10395448,10396193,0,0,698,1443
22364,10395503,10396193,10397226,0,0,690,1723
22343,10393125,10393314,10397254,0,0,189,4129
22365,10395666,10397226,10397312,0,0,1560,1646
22333,10392207,10392613,10397422,0,0,406,5215
22366,10396160,10397254,10397880,0,0,1094,1720
22369,10396487,10397312,10398315,0,0,825,1828
22362,10395199,10395491,10398667,0,0,292,3468
22371,10396829,10397880,10399170,0,0,1051,2341
22375,10397885,10398667,10399360,0,0,782,1475
22323,10390350,10390350,10399474,0,0,0,9124
22157,10319336,10376180,10399506,0,0,56844,80170
22376,10397960,10399170,10399621,0,0,1210,1661
22380,10398773,10399621,10399801,0,0,848,1028
22372,10396870,10398315,10399873,0,0,1445,3003
22381,10399008,10399801,10399937,0,0,793,929
22379,10398656,10399360,10400022,0,0,704,1366
22385,10399355,10400022,10400966,0,0,667,1611
22383,10399104,10399937,10400976,0,0,833,1872
22341,10392809,10399474,10401152,0,0,6665,8343
22386,10399590,10400966,10401291,0,0,1376,1701
22387,10399649,10400976,10401344,0,0,1327,1695
22388,10399933,10401291,10401400,0,0,1358,1467
22392,10400647,10401400,10401731,0,0,753,1084
22393,10400677,10401731,10401773,0,0,1054,1096
22394,10400697,10401773,10402228,0,0,1076,1531
22395,10400713,10402228,10402268,0,0,1515,1555
22335,10392292,10395402,10402434,0,0,3110,10142
22354,10394633,10402434,10403866,0,0,7801,9233
22382,10399085,10399873,10404099,0,0,788,5014
22397,10400768,10404099,10404500,0,0,3331,3732
22398,10400863,10404500,10404730,0,0,3637,3867
22401,10401113,10404730,10404773,0,0,3617,3660
22389,10399951,10401344,10404807,0,0,1393,4856
22329,10391866,10394097,10404812,0,0,2231,12946
22402,10401145,10404773,10404824,0,0,3628,3679
22404,10401427,10404824,10404995,0,0,3397,3568
22319,10388642,10391559,10404997,0,0,2917,16355
22403,10401420,10404807,10405003,0,0,3387,3583
22405,10401505,10404995,10405052,0,0,3490,3547
22342,10392918,10404997,10405179,0,0,12079,12261
22345,10393320,10405179,10405336,0,0,11859,12016
22256,10377397,10399506,10405945,0,0,22109,28548
22270,10381163,10405945,10406040,0,0,24782,24877
22396,10400756,10402268,10406220,0,0,1512,5464
22410,10401895,10406220,10406377,0,0,4325,4482
22340,10392709,10404812,10406444,0,0,12103,13735
22286,10384296,10406040,10406583,0,0,21744,22287
22350,10394337,10406444,10406589,0,0,12107,12252
22356,10394692,10406589,10406605,0,0,11897,11913
22357,10394734,10406605,10407273,0,0,11871,12539
22349,10394185,10401152,10407469,0,0,6967,13284
22412,10401950,10406377,10407818,0,0,4427,5868
22409,10401725,10405052,10407986,0,0,3327,6261
22414,10402206,10407986,10408070,0,0,5780,5864
22415,10402287,10408070,10408112,0,0,5783,5825
22360,10395021,10407273,10408119,0,0,12252,13098
22413,10402010,10407818,10408196,0,0,5808,6186
22417,10402854,10408196,10408264,0,0,5342,5410
22416,10402332,10408112,10408808,0,0,5780,6476
22418,10403016,10408264,10409159,0,0,5248,6143
22421,10403497,10409159,10409396,0,0,5662,5899
22408,10401659,10405003,10409722,0,0,3344,8063
22425,10403826,10409722,10409752,0,0,5896,5926
22426,10403939,10409752,10410325,0,0,5813,6386
22427,10404037,10410325,10410353,0,0,6288,6316
22429,10404183,10410353,10410385,0,0,6170,6202
22430,10404450,10410385,10410408,0,0,5935,5958
22368,10396251,10407469,10410625,0,0,11218,14374
22432,10404949,10410408,10410743,0,0,5459,5794
22424,10403719,10410625,10411042,0,0,6906,7323
22420,10403325,10408808,10411314,0,0,5483,7989
22433,10405092,10410743,10411338,0,0,5651,6246
22423,10403707,10409396,10411578,0,0,5689,7871
22359,10394795,10403866,10411786,0,0,9071,16991
22436,10405392,10411578,10411935,0,0,6186,6543
22434,10405163,10411314,10412113,0,0,6151,6950
22370,10396802,10397422,10412250,0,0,620,15448
22428,10404092,10411042,10412268,0,0,6950,8176
22442,10406025,10412250,10412274,0,0,6225,6249
22390,10400431,10408119,10412440,0,0,7688,12009
22435,10405341,10411338,10412646,0,0,5997,7305
22449,10407246,10412274,10412940,0,0,5028,5694
22451,10407433,10412646,10412976,0,0,5213,5543
22456,10407589,10412976,10413300,0,0,5387,5711
22457,10407662,10413300,10413334,0,0,5638,5672
22459,10408045,10413334,10413388,0,0,5289,5343
22441,10405831,10412113,10413745,0,0,6282,7914
22439,10405656,10411786,10416098,0,0,6130,10442
22454,10407504,10416098,10416406,0,0,8594,8902
22450,10407276,10412440,10416414,0,0,5164,9138
22460,10408053,10413388,10416914,0,0,5335,8861
22452,10407454,10412940,10417186,0,0,5486,9732
22471,10412948,10417186,10417200,0,0,4238,4252
22461,10408056,10413745,10417334,0,0,5689,9278
22447,10406600,10412268,10417368,0,0,5668,10768
22462,10408169,10416414,10417413,0,0,8245,9244
22443,10406303,10412268,10417492,0,0,5965,11189
22472,10413002,10417200,10417653,0,0,4198,4651
22440,10405810,10411935,10417824,0,0,6125,12014
22313,10387846,10406583,10417856,0,0,18737,30010
22473,10413451,10417334,10418099,0,0,3883,4648
22477,10414411,10417653,10418288,0,0,3242,3877
22346,10393509,10405336,10418304,0,0,11827,24795
22264,10379534,10405945,10418396,0,0,26411,38862
22361,10395131,10418304,10418479,0,0,23173,23348
22374,10397772,10418396,10418612,0,0,20624,20840
22377,10398331,10418479,10418620,0,0,20148,20289
22384,10399350,10418620,10418772,0,0,19270,19422
22391,10400531,10418772,10418923,0,0,18241,18392
22399,10400999,10418923,10418984,0,0,17924,17985
22476,10414214,10417492,10419088,0,0,3278,4874
22466,10411785,10417413,10419175,0,0,5628,7390
22455,10407560,10416406,10419231,0,0,8846,11671
22400,10401056,10418984,10419479,0,0,17928,18423
22367,10396245,10407273,10419512,0,0,11028,23267
22406,10401547,10419479,10419784,0,0,17932,18237
22407,10401582,10419512,10420358,0,0,17930,18776
22411,10401915,10419784,10420520,0,0,17869,18605
22378,10398601,10418612,10420597,0,0,20011,21996
22422,10403544,10420520,10421034,0,0,16976,17490
22463,10409097,10416914,10421186,0,0,7817,12089
22431,10404792,10420597,10421251,0,0,15805,16459
22324,10390611,10417856,10421577,0,0,27245,30966
22419,10403022,10420358,10421606,0,0,17336,18584
22438,10405570,10421251,10422118,0,0,15681,16548
22363,10395438,10418396,10422312,0,0,22958,26874
22480,10422307,10422307,10422332,0,0,0,25
22481,10422336,10422336,10422355,0,0,0,19
22448,10407225,10422312,10422646,0,0,15087,15421
22482,10422428,10422428,10422651,0,0,0,223
22483,10422662,10422662,10423070,0,0,0,408
22484,10422708,10423070,10423099,0,0,362,391
22453,10407475,10422646,10423140,0,0,15171,15665
22475,10413766,10417368,10423842,0,0,3602,10076
22467,10411799,10418099,10425192,0,0,6300,13393
22468,10412009,10419088,10426392,0,0,7079,14383
22487,10425079,10426392,10426500,0,0,1313,1421
22489,10426044,10426392,10426526,0,0,348,482
22445,10406439,10421606,10426654,0,0,15167,20215
22490,10426334,10426500,10426740,0,0,166,406
22488,10425243,10426740,10426894,0,0,1497,1651
22469,10412350,10426654,10426956,0,0,14304,14606
22485,10422733,10425192,10426966,0,0,2459,4233
22437,10405504,10421034,10427014,0,0,15530,21510
22373,10397581,10421577,10427058,0,0,23996,29477
22492,10426742,10426966,10427066,0,0,224,324
22491,10426671,10426894,10427084,0,0,223,413
22446,10406471,10422118,10427129,0,0,15647,20658
22494,10427640,10427640,10428197,0,0,0,557
22486,10423090,10427058,10428256,0,0,3968,5166
22495,10428272,10428272,10429306,0,0,0,1034
22478,10420775,10423842,10429658,0,0,3067,8883
22278,10382861,10429658,10431654,0,0,46797,48793
22493,10427248,10427248,10432783,0,0,0,5535
22498,10430690,10432783,10432950,0,0,2093,2260
22465,10411643,10423140,10433068,0,0,11497,21425
22499,10431959,10432783,10433090,0,0,824,1131
22500,10432854,10432950,10434127,0,0,96,1273
22474,10413559,10419175,10435517,0,0,5616,21958
22479,10421567,10427014,10435956,0,0,5447,14389
22470,10412434,10426956,10436088,0,0,14522,23654
22501,10434557,10434557,10436887,0,0,0,2330
22502,10435221,10435221,10438839,0,0,0,3618
22503,10438076,10438076,10440420,0,0,0,2344
22355,10394653,10431654,10443067,0,0,37001,48414
22444,10406424,10440420,10445363,0,0,33996,38939
22464,10411630,10445363,10447422,0,0,33733,35792
22496,10428368,10447422,10461655,0,0,19054,33287
22458,10407902,10443067,10466781,0,0,35165,58879
22506,10457322,10466781,10467302,0,0,9459,9980
22508,10458146,10466781,10467967,0,0,8635,9821
22497,10429151,10461655,10468018,0,0,32504,38867
22507,10458025,10466781,10468086,0,0,8756,10061
22510,10459122,10468018,10468459,0,0,8896,9337
22522,10464748,10468459,10468496,0,0,3711,3748
22521,10464016,10468459,10468529,0,0,4443,4513
22504,10449093,10466781,10468862,0,0,17688,19769
22515,10461674,10467302,10469113,0,0,5628,7439
22509,10458903,10466781,10469411,0,0,7878,10508
22528,10465809,10468862,10469415,0,0,3053,3606
22534,10466830,10469415,10469487,0,0,2585,2657
22530,10466665,10469411,10469513,0,0,2746,2848
22520,10463642,10468086,10469578,0,0,4444,5936
22527,10465411,10468529,10469689,0,0,3118,4278
22512,10459547,10466781,10469813,0,0,7234,10266
22514,10461531,10466781,10469923,0,0,5250,8392
22532,10466745,10469411,10470018,0,0,2666,3273
22531,10466673,10469813,10470198,0,0,3140,3525
22513,10459556,10466781,10470219,0,0,7225,10663
22523,10464867,10468459,10470244,0,0,3592,5377
22540,10467564,10469689,10470278,0,0,2125,2714
22518,10462960,10468086,10470299,0,0,5126,7339
22547,10468720,10470278,10470346,0,0,1558,1626
22519,10462978,10468459,10470416,0,0,5481,7438
22533,10466818,10469923,10470572,0,0,3105,3754
22536,10467290,10470219,10470603,0,0,2929,3313
22542,10467877,10470416,10470676,0,0,2539,2799
22541,10467750,10470244,10470743,0,0,2494,2993
22551,10469511,10470346,10470744,0,0,835,1233
22555,10470693,10470744,10470787,0,0,51,94
22525,10464992,10469113,10470902,0,0,4121,5910
22556,10470894,10470894,10470916,0,0,0,22
22552,10469556,10470743,10470951,0,0,1187,1395
22549,10468827,10470299,10471127,0,0,1472,2300
22550,10468977,10470676,10471240,0,0,1699,2263
22526,10465172,10468459,10471704,0,0,3287,6532
22557,10471391,10471704,10471728,0,0,313,337
22554,10470599,10471240,10471762,0,0,641,1163
22558,10471454,10471762,10471874,0,0,308,420
22553,10469573,10470951,10471891,0,0,1378,2318
22559,10471585,10471874,10472037,0,0,289,452
22562,10472008,10472037,10472061,0,0,29,53
22561,10471796,10471796,10472102,0,0,0,306
22524,10464979,10468496,10472113,0,0,3517,7134
22567,10472489,10472489,10472528,0,0,0,39
22566,10472461,10472461,10472554,0,0,0,93
22565,10472401,10472401,10472605,0,0,0,204
22568,10472837,10472837,10472864,0,0,0,27
22569,10473019,10473019,10473258,0,0,0,239
22571,10473270,10473270,10473313,0,0,0,43
22572,10473322,10473322,10473384,0,0,0,62
22573,10473373,10473384,10473416,0,0,11,43
22538,10467384,10469513,10473479,0,0,2129,6095
22574,10473423,10473423,10473483,0,0,0,60
22575,10473477,10473479,10473536,0,0,2,59
22543,10468145,10470572,10473889,0,0,2427,5744
22535,10467237,10470198,10474064,0,0,2961,6827
22576,10473710,10474064,10474146,0,0,354,436
22579,10474244,10474244,10474277,0,0,0,33
22578,10474069,10474146,10474284,0,0,77,215
22577,10473908,10473908,10474526,0,0,0,618
22581,10474294,10474526,10474575,0,0,232,281
22582,10474383,10474575,10474622,0,0,192,239
22584,10474509,10474622,10474638,0,0,113,129
22588,10474721,10474721,10474735,0,0,0,14
22560,10471762,10471891,10474845,0,0,129,3083
22589,10475263,10475263,10475318,0,0,0,55
22590,10475337,10475337,10475379,0,0,0,42
22592,10475576,10475576,10475651,0,0,0,75
22591,10475486,10475486,10475666,0,0,0,180
22537,10467347,10469487,10475838,0,0,2140,8491
22563,10472061,10472061,10475865,0,0,0,3804
22597,10475845,10475865,10475897,0,0,20,52
22596,10475746,10475838,10475912,0,0,92,166
22595,10475717,10475912,10475930,0,0,195,213
22580,10474262,10474284,10476138,0,0,22,1876
22539,10467418,10469578,10476176,0,0,2160,8758
22564,10472202,10472202,10476186,0,0,0,3984
22599,10476197,10476197,10476254,0,0,0,57
22505,10455553,10466781,10476370,0,0,11228,20817
22517,10462576,10467967,10476562,0,0,5391,13986
22586,10474558,10474845,10476566,0,0,287,2008
22511,10459400,10468459,10476647,0,0,9059,17247
22600,10476616,10476647,10476661,0,0,31,45
22601,10476639,10476647,10476699,0,0,8,60
22570,10473137,10473137,10476789,0,0,0,3652
22604,10476783,10476783,10476856,0,0,0,73
22605,10476953,10476953,10476981,0,0,0,28
22593,10475614,10475651,10477459,0,0,37,1845
22608,10477289,10477459,10477500,0,0,170,211
22607,10477096,10477459,10477511,0,0,363,415
22603,10476720,10476720,10477661,0,0,0,941
22548,10468753,10470603,10477700,0,0,1850,8947
22612,10477743,10477743,10477778,0,0,0,35
22613,10477908,10477908,10477954,0,0,0,46
22615,10478184,10478184,10478204,0,0,0,20
22618,10478318,10478318,10478413,0,0,0,95
22620,10478578,10478578,10478651,0,0,0,73
22619,10478469,10478469,10478746,0,0,0,277
22598,10476189,10476189,10478969,0,0,0,2780
22609,10477470,10477500,10478982,0,0,30,1512
22594,10475655,10475666,10479000,0,0,11,3345
22621,10478737,10478737,10479005,0,0,0,268
22622,10478798,10478798,10479426,0,0,0,628
22614,10478019,10478019,10479441,0,0,0,1422
22624,10479017,10479426,10479534,0,0,409,517
22627,10479201,10479534,10479689,0,0,333,488
22628,10479428,10479689,10479704,0,0,261,276
22629,10479522,10479704,10479720,0,0,182,198
22606,10476971,10476981,10479943,0,0,10,2972
22616,10478211,10479005,10480452,0,0,794,2241
22625,10479027,10479441,10480482,0,0,414,1455
22631,10479626,10480482,10480501,0,0,856,875
22632,10479732,10480501,10480520,0,0,769,788
22633,10479826,10480520,10480546,0,0,694,720
22634,10479937,10480546,10480715,0,0,609,778
22516,10462116,10476566,10480803,0,0,14450,18687
22635,10479992,10480715,10480818,0,0,723,826
22636,10480200,10480818,10480922,0,0,618,722
22630,10479529,10479720,10480924,0,0,191,1395
22638,10480403,10480924,10480947,0,0,521,544
22637,10480360,10480922,10480948,0,0,562,588
22640,10480592,10480947,10481661,0,0,355,1069
22643,10480781,10481661,10481701,0,0,880,920
22645,10480948,10481701,10481760,0,0,753,812
22647,10481107,10481760,10481779,0,0,653,672
22610,10477503,10477511,10481836,0,0,8,4333
22649,10481306,10481836,10481858,0,0,530,552
22602,10476682,10476682,10481934,0,0,0,5252
22648,10481242,10481779,10482118,0,0,537,876
22639,10480515,10481934,10482426,0,0,1419,1911
22651,10481453,10482118,10482613,0,0,665,1160
22652,10481538,10482613,10483475,0,0,1075,1937
22654,10481951,10483475,10483486,0,0,1524,1535
22656,10482152,10483486,10483506,0,0,1334,1354
22657,10482187,10483506,10483594,0,0,1319,1407
22660,10482485,10483594,10483613,0,0,1109,1128
22661,10482670,10483613,10483873,0,0,943,1203
22529,10466152,10480803,10486488,0,0,14651,20336
22545,10468553,10486488,10488673,0,0,17935,20120
22642,10480685,10480948,10495774,0,0,263,15089
22650,10481448,10481858,10495811,0,0,410,14363
22623,10478834,10480452,10496048,0,0,1618,17214
22663,10482756,10495774,10496089,0,0,13018,13333
22653,10481812,10496048,10496220,0,0,14236,14408
22641,10480667,10481934,10496594,0,0,1267,15927
22662,10482711,10483873,10496676,0,0,1162,13965
22658,10482314,10496594,10496735,0,0,14280,14421
22617,10478275,10479943,10496809,0,0,1668,18534
22644,10480894,10482426,10496859,0,0,1532,15965
22677,10495755,10496859,10496924,0,0,1104,1169
22679,10496225,10496924,10496989,0,0,699,764
22680,10496580,10496989,10497075,0,0,409,495
22681,10496896,10497075,10497150,0,0,179,254
22683,10497084,10497150,10497179,0,0,66,95
22684,10497194,10497194,10497267,0,0,0,73
22655,10481957,10496220,10497326,0,0,14263,15369
22685,10497524,10497524,10497552,0,0,0,28
22686,10497772,10497772,10497791,0,0,0,19
22687,10497853,10497853,10498240,0,0,0,387
22689,10497976,10498240,10498265,0,0,264,289
22690,10498131,10498265,10498283,0,0,134,152
22544,10468399,10470018,10498316,0,0,1619,29917
22659,10482385,10496735,10498388,0,0,14350,16003
22688,10497907,10498388,10498628,0,0,481,721
22691,10498312,10498312,10498727,0,0,0,415
22693,10498793,10498793,10498813,0,0,0,20
22692,10498349,10498628,10498841,0,0,279,492
22678,10496155,10497326,10498923,0,0,1171,2768
22696,10498970,10498970,10498986,0,0,0,16
22697,10499515,10499515,10499533,0,0,0,18
22670,10492059,10496676,10499720,0,0,4617,7661
22668,10485952,10496089,10500070,0,0,10137,14118
22698,10499725,10500070,10500087,0,0,345,362
22699,10499965,10500087,10500185,0,0,122,220
22700,10500133,10500185,10500201,0,0,52,68
22701,10500271,10500271,10500675,0,0,0,404
22702,10500763,10500763,10500782,0,0,0,19
22694,10498818,10498818,10501149,0,0,0,2331
22704,10501495,10501495,10501514,0,0,0,19
22705,10501662,10501662,10501682,0,0,0,20
22706,10501823,10501823,10501849,0,0,0,26
22546,10468577,10488673,10502923,0,0,20096,34346
22583,10474477,10502923,10502945,0,0,28446,28468
22674,10495605,10496809,10504276,0,0,1204,8671
22585,10474522,10502945,10504297,0,0,28423,29775
22587,10474559,10504297,10504369,0,0,29738,29810
22703,10501312,10501312,10504833,0,0,0,3521
22708,10504870,10504870,10505002,0,0,0,132
22709,10505284,10505284,10505321,0,0,0,37
22710,10505400,10505400,10505468,0,0,0,68
22611,10477550,10504369,10505922,0,0,26819,28372
22669,10486270,10505922,10506024,0,0,19652,19754
22667,10485866,10504369,10506648,0,0,18503,20782
22665,10484803,10496809,10507330,0,0,12006,22527
22664,10482962,10495811,10508148,0,0,12849,25186
22666,10485336,10498923,10508836,0,0,13587,23500
22646,10481056,10496048,10510322,0,0,14992,29266
22714,10510152,10510152,10511384,0,0,0,1232
22715,10510844,10511384,10512344,0,0,540,1500
22711,10505483,10505483,10512819,0,0,0,7336
22716,10511901,10512344,10513101,0,0,443,1200
22721,10512938,10513101,10513527,0,0,163,589
22707,10503154,10504276,10513744,0,0,1122,10590
22675,10495612,10496859,10513829,0,0,1247,18217
22718,10512797,10513744,10514212,0,0,947,1415
22719,10512829,10513829,10514276,0,0,1000,1447
22626,10479162,10510322,10514420,0,0,31160,35258
22671,10493431,10514420,10514732,0,0,20989,21301
22713,10506835,10506835,10516584,0,0,0,9749
22725,10514499,10516584,10516691,0,0,2085,2192
22720,10512852,10512852,10516847,0,0,0,3995
22712,10506316,10506316,10517800,0,0,0,11484
22672,10495198,10514732,10518378,0,0,19534,23180
22676,10495743,10518378,10518403,0,0,22635,22660
22695,10498950,10499720,10518999,0,0,770,20049
22727,10515658,10518999,10519193,0,0,3341,3535
22728,10515976,10519193,10519493,0,0,3217,3517
22731,10519490,10519493,10519504,0,0,3,14
22682,10496957,10518403,10519584,0,0,21446,22627
22673,10495426,10504369,10519810,0,0,8943,24384
22726,10514767,10516691,10520701,0,0,1924,5934
22730,10519074,10519074,10520731,0,0,0,1657
22717,10512738,10517800,10528421,0,0,5062,15683
22736,10524621,10528421,10529923,0,0,3800,5302
22734,10521998,10528421,10529924,0,0,6423,7926
22722,10513195,10519584,10529960,0,0,6389,16765
22732,10519950,10519950,10529992,0,0,0,10042
22737,10526954,10528421,10531415,0,0,1467,4461
22729,10516261,10519810,10534014,0,0,3549,17753
22735,10522276,10528421,10538300,0,0,6145,16024
22738,10532155,10532155,10541763,0,0,0,9608
22733,10521037,10521037,10544403,0,0,0,23366
22723,10513360,10514212,10545253,0,0,852,31893
22741,10546384,10546384,10547253,0,0,0,869
22743,10547873,10547873,10547903,0,0,0,30
22742,10546839,10546839,10548015,0,0,0,1176
22746,10548105,10548105,10548544,0,0,0,439
22739,10540461,10540461,10548753,0,0,0,8292
22747,10548554,10548554,10548794,0,0,0,240
22744,10547904,10547904,10549073,0,0,0,1169
22748,10548926,10548926,10549097,0,0,0,171
22751,10549273,10549273,10549311,0,0,0,38
22752,10549323,10549323,10549555,0,0,0,232
22754,10549874,10549874,10550247,0,0,0,373
22757,10550766,10550766,10550785,0,0,0,19
22756,10550204,10550204,10551004,0,0,0,800
22759,10551009,10551009,10551027,0,0,0,18
22755,10549900,10549900,10551077,0,0,0,1177
22760,10551155,10551155,10551185,0,0,0,30
22762,10551205,10551205,10551222,0,0,0,17
22763,10551353,10551353,10551440,0,0,0,87
22764,10551436,10551436,10551484,0,0,0,48
22740,10541764,10541764,10551605,0,0,0,9841
22768,10551970,10551970,10551995,0,0,0,25
22767,10551926,10551926,10552012,0,0,0,86
22769,10552205,10552205,10552227,0,0,0,22
22753,10549551,10549551,10552651,0,0,0,3100
22774,10552650,10552650,10552819,0,0,0,169
22775,10552955,10552955,10553019,0,0,0,64
22776,10552965,10552965,10553028,0,0,0,63
22750,10549120,10549120,10553031,0,0,0,3911
22771,10552519,10552519,10553155,0,0,0,636
22778,10553211,10553211,10553236,0,0,0,25
22777,10553040,10553040,10553493,0,0,0,453
22773,10552624,10552624,10553547,0,0,0,923
22779,10553530,10553530,10553548,0,0,0,18
22781,10553752,10553752,10553772,0,0,0,20
22782,10553905,10553905,10554196,0,0,0,291
22783,10554334,10554334,10554359,0,0,0,25
22784,10554394,10554394,10554450,0,0,0,56
22780,10553637,10553637,10554591,0,0,0,954
22766,10551682,10551682,10554764,0,0,0,3082
22786,10554838,10554838,10554858,0,0,0,20
22758,10550837,10551004,10554876,0,0,167,4039
22787,10554877,10554877,10554910,0,0,0,33
22785,10554814,10554814,10555165,0,0,0,351
22789,10555223,10555223,10555248,0,0,0,25
22791,10555433,10555433,10555486,0,0,0,53
22792,10555772,10555772,10555800,0,0,0,28
22794,10555880,10555880,10555937,0,0,0,57
22765,10551558,10551558,10556103,0,0,0,4545
22793,10555868,10555868,10556129,0,0,0,261
22797,10557287,10557287,10557310,0,0,0,23
22761,10551164,10551164,10559898,0,0,0,8734
22745,10548063,10548063,10560186,0,0,0,12123
22790,10555323,10555323,10560205,0,0,0,4882
22800,10560027,10560186,10560216,0,0,159,189
22802,10560227,10560227,10560281,0,0,0,54
22803,10560295,10560295,10560358,0,0,0,63
22749,10548979,10548979,10560427,0,0,0,11448
22804,10560444,10560444,10561153,0,0,0,709
22724,10513448,10514276,10561419,0,0,828,47971
22801,10560142,10560205,10562925,0,0,63,2783
22810,10563267,10563267,10563598,0,0,0,331
22811,10563555,10563598,10564978,0,0,43,1423
22807,10561753,10561753,10565748,0,0,0,3995
22808,10562420,10562420,10566038,0,0,0,3618
22809,10562933,10562933,10566120,0,0,0,3187
22805,10560829,10560829,10566121,0,0,0,5292
22795,10556143,10556143,10566186,0,0,0,10043
22770,10552285,10552285,10566191,0,0,0,13906
22796,10556342,10556342,10566273,0,0,0,9931
22815,10566509,10566509,10567282,0,0,0,773
22817,10567546,10567546,10567593,0,0,0,47
22816,10567339,10567339,10568655,0,0,0,1316
22823,10568980,10568980,10569493,0,0,0,513
22814,10565737,10566038,10569930,0,0,301,4193
22825,10569485,10569930,10569944,0,0,445,459
22812,10564058,10564978,10569953,0,0,920,5895
22818,10567554,10567554,10570367,0,0,0,2813
22820,10568592,10568592,10570623,0,0,0,2031
22826,10569508,10569930,10570675,0,0,422,1167
22819,10567882,10567882,10571947,0,0,0,4065
22829,10570125,10570125,10572114,0,0,0,1989
22832,10571143,10571143,10572142,0,0,0,999
22834,10571853,10571947,10572234,0,0,94,381
22839,10572458,10572458,10572475,0,0,0,17
22824,10569449,10569493,10572586,0,0,44,3137
22841,10572539,10572586,10572613,0,0,47,74
22827,10569531,10570623,10572961,0,0,1092,3430
22833,10571454,10572961,10573007,0,0,1507,1553
22837,10572369,10572369,10573125,0,0,0,756
22822,10568666,10568666,10573187,0,0,0,4521
22840,10572512,10572512,10573657,0,0,0,1145
22846,10573806,10573806,10574070,0,0,0,264
22772,10552571,10559898,10574079,0,0,7327,21508
22788,10555033,10574079,10574149,0,0,19046,19116
22798,10557607,10574149,10574172,0,0,16542,16565
22844,10572978,10573125,10574183,0,0,147,1205
22847,10574169,10574169,10574887,0,0,0,718
22850,10575061,10575061,10575169,0,0,0,108
22821,10568641,10568641,10575223,0,0,0,6582
22838,10572393,10575223,10576139,0,0,2830,3746
22799,10558230,10574172,10576406,0,0,15942,18176
22806,10560976,10576406,10576584,0,0,15430,15608
22851,10575417,10576139,10576680,0,0,722,1263
22852,10575708,10576139,10577060,0,0,431,1352
22855,10577470,10577470,10577940,0,0,0,470
22836,10571901,10573007,10577941,0,0,1106,6040
22849,10574929,10577941,10577993,0,0,3012,3064
22842,10572572,10572613,10578065,0,0,41,5493
22858,10577920,10578065,10578198,0,0,145,278
22859,10578046,10578198,10578563,0,0,152,517
22828,10569986,10569986,10578664,0,0,0,8678
22848,10574759,10574759,10578669,0,0,0,3910
22845,10573102,10573187,10578749,0,0,85,5647
22860,10578089,10578563,10578916,0,0,474,827
22830,10570725,10572114,10578933,0,0,1389,8208
22857,10577843,10577940,10579036,0,0,97,1193
22861,10578101,10578933,10579086,0,0,832,985
22862,10578447,10579036,10579132,0,0,589,685
22856,10577719,10577940,10579149,0,0,221,1430
22863,10578550,10579086,10579168,0,0,536,618
22867,10578666,10579132,10579229,0,0,466,563
22870,10579449,10579449,10580052,0,0,0,603
22813,10565449,10576584,10580246,0,0,11135,14797
22835,10571871,10572961,10580572,0,0,1090,8701
22872,10579601,10580052,10581767,0,0,451,2166
22874,10580347,10581767,10582038,0,0,1420,1691
22854,10576801,10580572,10582439,0,0,3771,5638
22868,10578784,10579168,10582450,0,0,384,3666
22873,10579715,10581767,10582649,0,0,2052,2934
22884,10581965,10582439,10582863,0,0,474,898
22877,10580689,10582038,10583041,0,0,1349,2352
22871,10579576,10579576,10583892,0,0,0,4316
22883,10581850,10582439,10584260,0,0,589,2410
22853,10575822,10577993,10584543,0,0,2171,8721
22881,10581142,10583892,10584548,0,0,2750,3406
22879,10580907,10582439,10585321,0,0,1532,4414
22882,10581661,10582439,10586458,0,0,778,4797
22887,10587410,10587410,10587649,0,0,0,239
22843,10572729,10584548,10589694,0,0,11819,16965
22831,10571045,10580246,10589911,0,0,9201,18866
22864,10578582,10578664,10590792,0,0,82,12210
22869,10579012,10589694,10591352,0,0,10682,12340
22876,10580666,10591352,10591363,0,0,10686,10697
22878,10580883,10591363,10591464,0,0,10480,10581
22889,10592978,10592978,10593126,0,0,0,148
22890,10594721,10594721,10594783,0,0,0,62
22891,10594953,10594953,10595047,0,0,0,94
22892,10595062,10595062,10595369,0,0,0,307
22880,10581012,10591464,10597448,0,0,10452,16436
22893,10596861,10596861,10597606,0,0,0,745
22875,10580567,10589911,10597645,0,0,9344,17078
22885,10582062,10582450,10598052,0,0,388,15990
22896,10598165,10598165,10598613,0,0,0,448
22898,10600942,10600942,10601216,0,0,0,274
22894,10597727,10597727,10602675,0,0,0,4948
22899,10601916,10601916,10603435,0,0,0,1519
22901,10604022,10604022,10604189,0,0,0,167
22902,10604777,10604777,10604851,0,0,0,74
22903,10605231,10605231,10605305,0,0,0,74
22866,10578599,10578749,10606726,0,0,150,28127
22904,10606106,10606106,10607290,0,0,0,1184
22865,10578594,10578669,10607377,0,0,75,28783
22905,10606160,10606160,10608225,0,0,0,2065
22906,10609551,10609551,10611932,0,0,0,2381
22907,10609580,10609580,10612272,0,0,0,2692
22910,10615707,10615707,10615732,0,0,0,25
22911,10617433,10617433,10617472,0,0,0,39
22909,10615539,10615539,10618590,0,0,0,3051
22888,10592026,10597645,10620228,0,0,5619,28202
22886,10587041,10597448,10623339,0,0,10407,36298
22900,10602765,10602765,10625061,0,0,0,22296
22913,10625955,10625955,10625985,0,0,0,30
22895,10598031,10598031,10627171,0,0,0,29140
22897,10598464,10598464,10628873,0,0,0,30409
22912,10625056,10625056,10633723,0,0,0,8667
22908,10614542,10620228,10636487,0,0,5686,21945
22914,10633722,10633722,10640835,0,0,0,7113
22916,10642622,10642622,10642668,0,0,0,46
22917,10642753,10642753,10642863,0,0,0,110
22919,10645248,10645248,10645284,0,0,0,36
22918,10644794,10644794,10645348,0,0,0,554
22920,10645347,10645347,10645886,0,0,0,539
22922,10648532,10648532,10648566,0,0,0,34
22924,10648680,10648680,10648721,0,0,0,41
22923,10648583,10648583,10649272,0,0,0,689
22921,10647482,10647482,10649351,0,0,0,1869
22915,10640837,10640837,10650482,0,0,0,9645
22926,10650039,10650039,10650576,0,0,0,537
22928,10651810,10651810,10651895,0,0,0,85
22929,10651897,10651897,10652062,0,0,0,165
22930,10652300,10652300,10652468,0,0,0,168
22931,10652633,10652633,10652917,0,0,0,284
22932,10653127,10653127,10653765,0,0,0,638
22933,10654090,10654090,10654457,0,0,0,367
22934,10654403,10654403,10654460,0,0,0,57
22925,10649262,10649262,10655990,0,0,0,6728
22935,10655986,10655986,10657535,0,0,0,1549
22927,10650519,10650519,10660407,0,0,0,9888
22938,10661330,10661330,10661393,0,0,0,63
22939,10661394,10661394,10661681,0,0,0,287
22940,10661742,10661742,10662027,0,0,0,285
22936,10657533,10657533,10664029,0,0,0,6496
22941,10662586,10662586,10666316,0,0,0,3730
22942,10667237,10667237,10667282,0,0,0,45
22944,10671949,10671949,10672004,0,0,0,55
22945,10672120,10672120,10672183,0,0,0,63
22943,10667318,10667318,10676414,0,0,0,9096
22947,10680681,10680681,10680943,0,0,0,262
22948,10681369,10681369,10682254,0,0,0,885
22946,10672188,10672188,10682693,0,0,0,10505
22949,10682359,10682359,10683438,0,0,0,1079
22951,10683821,10683821,10683844,0,0,0,23
22937,10658393,10658393,10684395,0,0,0,26002
22952,10684525,10684525,10684830,0,0,0,305
22953,10684919,10684919,10685084,0,0,0,165
22950,10682750,10682750,10705243,0,0,0,22493
22954,10709366,10709366,10709377,0,0,0,11
22955,10709909,10709909,10714877,0,0,0,4968
22956,10717700,10717700,10717907,0,0,0,207
22957,10718388,10718388,10729591,0,0,0,11203
22958,10732002,10732002,10732072,0,0,0,70
22959,10733243,10733243,10733427,0,0,0,184
22960,10734226,10734226,10734493,0,0,0,267
22962,10734991,10734991,10735657,0,0,0,666
22963,10738305,10738305,10739357,0,0,0,1052
22964,10739609,10739609,10739822,0,0,0,213
22961,10734888,10734888,10740834,0,0,0,5946
22966,10742376,10742376,10742815,0,0,0,439
22967,10742888,10742888,10743121,0,0,0,233
22968,10743415,10743415,10743587,0,0,0,172
22965,10740620,10740620,10745038,0,0,0,4418
22970,10745378,10745378,10746130,0,0,0,752
22971,10748218,10748218,10748295,0,0,0,77
22972,10748347,10748347,10748395,0,0,0,48
22973,10748459,10748459,10748572,0,0,0,113
22974,10748685,10748685,10748745,0,0,0,60
22975,10749108,10749108,10749132,0,0,0,24
22976,10749301,10749301,10749385,0,0,0,84
22977,10749529,10749529,10749662,0,0,0,133
22978,10749746,10749746,10749806,0,0,0,60
22969,10745149,10745149,10749872,0,0,0,4723
22979,10749894,10749894,10749953,0,0,0,59
22981,10750134,10750134,10750193,0,0,0,59
22982,10750471,10750471,10750535,0,0,0,64
22983,10750847,10750847,10750911,0,0,0,64
22984,10751051,10751051,10751111,0,0,0,60
22985,10752158,10752158,10752381,0,0,0,223
22986,10752402,10752402,10752416,0,0,0,14
22987,10752427,10752427,10752526,0,0,0,99
22988,10752536,10752536,10752630,0,0,0,94
22990,10752672,10752672,10752714,0,0,0,42
22991,10752725,10752725,10752810,0,0,0,85
22989,10752614,10752614,10752949,0,0,0,335
22992,10752831,10752831,10752997,0,0,0,166
22993,10753061,10753061,10753171,0,0,0,110
22994,10753198,10753198,10753226,0,0,0,28
22995,10753499,10753499,10753545,0,0,0,46
22996,10753582,10753582,10753678,0,0,0,96
22997,10753686,10753686,10753960,0,0,0,274
22999,10754343,10754343,10754506,0,0,0,163
23000,10754582,10754582,10754598,0,0,0,16
22980,10750062,10750062,10754706,0,0,0,4644
22998,10754140,10754140,10754723,0,0,0,583
23004,10755232,10755232,10755246,0,0,0,14
23005,10755424,10755424,10755435,0,0,0,11
23006,10755650,10755650,10755789,0,0,0,139
23002,10754804,10754804,10757886,0,0,0,3082
23001,10754621,10754621,10758576,0,0,0,3955
23007,10757934,10758576,10759848,0,0,642,1914
23008,10764388,10764388,10765809,0,0,0,1421
23010,10766035,10766035,10766064,0,0,0,29
23011,10766590,10766590,10766809,0,0,0,219
23012,10767179,10767179,10767304,0,0,0,125
23009,10764411,10764411,10770418,0,0,0,6007
23013,10768724,10768724,10770505,0,0,0,1781
23014,10768979,10768979,10770726,0,0,0,1747
23016,10771162,10771162,10771523,0,0,0,361
23015,10770823,10770823,10772015,0,0,0,1192
23003,10755039,10757886,10772119,0,0,2847,17080
23019,10774157,10774157,10774271,0,0,0,114
23020,10774330,10774330,10774407,0,0,0,77
23021,10774490,10774490,10774698,0,0,0,208
23017,10771818,10771818,10774759,0,0,0,2941
23022,10775830,10775830,10775947,0,0,0,117
23018,10771977,10771977,10776298,0,0,0,4321
23023,10776591,10776591,10776699,0,0,0,108
23024,10778062,10778062,10778176,0,0,0,114
23025,10778652,10778652,10778759,0,0,0,107
23026,10781579,10781579,10781601,0,0,0,22
23027,10781653,10781653,10781665,0,0,0,12
23028,10782596,10782596,10785787,0,0,0,3191
23029,10798641,10798641,10801823,0,0,0,3182
23030,10802110,10802110,10805296,0,0,0,3186
23031,10805657,10805657,10805731,0,0,0,74
23032,10806129,10806129,10806182,0,0,0,53
23034,10806554,10806554,10806697,0,0,0,143
23035,10806753,10806753,10806803,0,0,0,50
23036,10806864,10806864,10806956,0,0,0,92
23039,10807092,10807092,10807113,0,0,0,21
23038,10806983,10806983,10807269,0,0,0,286
23040,10807311,10807311,10807418,0,0,0,107
23041,10807488,10807488,10807532,0,0,0,44
23043,10808075,10808075,10808714,0,0,0,639
23045,10809217,10809217,10809725,0,0,0,508
23044,10808100,10808100,10810263,0,0,0,2163
23048,10809883,10810263,10810506,0,0,380,623
23047,10809808,10809808,10810517,0,0,0,709
23053,10810499,10810506,10810581,0,0,7,82
23033,10806503,10806503,10810741,0,0,0,4238
23054,10810728,10810741,10810841,0,0,13,113
23037,10806975,10806975,10810845,0,0,0,3870
23055,10810736,10810741,10810846,0,0,5,110
23051,10809957,10810581,10811167,0,0,624,1210
23057,10811143,10811143,10811176,0,0,0,33
23058,10811186,10811186,10811280,0,0,0,94
23049,10809898,10810506,10811516,0,0,608,1618
23050,10809898,10810506,10811517,0,0,608,1619
23052,10809957,10810741,10811631,0,0,784,1674
23046,10809530,10810263,10812885,0,0,733,3355
23059,10811243,10811280,10814703,0,0,37,3460
23062,10812632,10812632,10814859,0,0,0,2227
23042,10808035,10808035,10814864,0,0,0,6829
23056,10810750,10810750,10814920,0,0,0,4170
23063,10814692,10814703,10814966,0,0,11,274
23061,10811892,10811892,10815003,0,0,0,3111
23060,10811708,10811708,10815013,0,0,0,3305
23066,10815425,10815425,10815496,0,0,0,71
23067,10815440,10815440,10815502,0,0,0,62
23069,10815669,10815669,10815735,0,0,0,66
23070,10815681,10815681,10815848,0,0,0,167
23065,10815281,10815281,10815907,0,0,0,626
23073,10815919,10815919,10815941,0,0,0,22
23064,10815045,10815045,10816313,0,0,0,1268
23072,10815752,10815752,10816518,0,0,0,766
23075,10816442,10816442,10816518,0,0,0,76
23074,10816399,10816399,10816522,0,0,0,123
23076,10816665,10816665,10816792,0,0,0,127
23078,10816783,10816783,10816864,0,0,0,81
23077,10816687,10816687,10817177,0,0,0,490
23079,10817147,10817147,10817206,0,0,0,59
23080,10817239,10817239,10817346,0,0,0,107
23081,10817638,10817638,10817668,0,0,0,30
23082,10818126,10818126,10818194,0,0,0,68
23083,10818361,10818361,10818426,0,0,0,65
23085,10818590,10818590,10818653,0,0,0,63
23088,10819352,10819352,10819384,0,0,0,32
23071,10815738,10815738,10819564,0,0,0,3826
23087,10819087,10819087,10819644,0,0,0,557
23089,10819475,10819475,10819969,0,0,0,494
23090,10819699,10819699,10822536,0,0,0,2837
23084,10818490,10818490,10822647,0,0,0,4157
23086,10818674,10818674,10822807,0,0,0,4133
23068,10815612,10815612,10822868,0,0,0,7256
23091,10823204,10823204,10823224,0,0,0,20
23093,10823459,10823459,10823528,0,0,0,69
23092,10823410,10823410,10823898,0,0,0,488
23096,10823780,10823780,10824151,0,0,0,371
23100,10824269,10824269,10824308,0,0,0,39
23099,10824257,10824257,10824332,0,0,0,75
23097,10824154,10824154,10824425,0,0,0,271
23101,10824439,10824439,10824639,0,0,0,200
23102,10824669,10824669,10824716,0,0,0,47
23103,10824892,10824892,10826236,0,0,0,1344
23098,10824189,10824189,10826571,0,0,0,2382
23094,10823488,10823488,10826645,0,0,0,3157
23104,10826687,10826687,10826727,0,0,0,40
23105,10826807,10826807,10826839,0,0,0,32
23095,10823777,10823777,10827159,0,0,0,3382
23106,10826973,10826973,10827283,0,0,0,310
23107,10827107,10827107,10827284,0,0,0,177
23108,10827392,10827392,10827412,0,0,0,20
23111,10827410,10827410,10827431,0,0,0,21
23112,10827563,10827563,10827577,0,0,0,14
23114,10827775,10827775,10827873,0,0,0,98
23110,10827406,10827406,10827931,0,0,0,525
23117,10827969,10827969,10828005,0,0,0,36
23116,10827914,10827914,10828093,0,0,0,179
23115,10827804,10827804,10828187,0,0,0,383
23120,10828687,10828687,10828705,0,0,0,18
23119,10828666,10828666,10828734,0,0,0,68
23121,10828787,10828787,10828854,0,0,0,67
23118,10828270,10828270,10829056,0,0,0,786
23123,10829184,10829184,10829286,0,0,0,102
23126,10829566,10829566,10829656,0,0,0,90
23127,10829679,10829679,10829812,0,0,0,133
23125,10829442,10829442,10829975,0,0,0,533
23113,10827738,10827738,10830303,0,0,0,2565
23122,10828969,10828969,10831145,0,0,0,2176
23129,10829879,10829879,10831351,0,0,0,1472
23134,10831400,10831400,10831441,0,0,0,41
23133,10831138,10831138,10831641,0,0,0,503
23130,10830824,10830824,10831813,0,0,0,989
23136,10831760,10831760,10832563,0,0,0,803
23124,10829424,10829424,10832918,0,0,0,3494
23139,10832999,10832999,10833077,0,0,0,78
23140,10833117,10833117,10833152,0,0,0,35
23143,10833527,10833527,10833604,0,0,0,77
23138,10832380,10832380,10833803,0,0,0,1423
23142,10833209,10833209,10834085,0,0,0,876
23147,10833955,10833955,10834433,0,0,0,478
23131,10830944,10830944,10834873,0,0,0,3929
23148,10834095,10834095,10835081,0,0,0,986
23149,10834334,10834334,10835081,0,0,0,747
23141,10833201,10833201,10835203,0,0,0,2002
23135,10831607,10831607,10838198,0,0,0,6591
23150,10834568,10834568,10838361,0,0,0,3793
23160,10836797,10838361,10838436,0,0,1564,1639
23161,10837258,10838436,10838481,0,0,1178,1223
23162,10837538,10838481,10838548,0,0,943,1010
23137,10832352,10832352,10838557,0,0,0,6205
23158,10836560,10838557,10839345,0,0,1997,2785
23164,10837684,10839345,10839508,0,0,1661,1824
23170,10838583,10839508,10839660,0,0,925,1077
23157,10836469,10838198,10839898,0,0,1729,3429
23175,10839125,10839898,10840107,0,0,773,982
23153,10835027,10835027,10840212,0,0,0,5185
23167,10838428,10839345,10841206,0,0,917,2778
23132,10830980,10830980,10841229,0,0,0,10249
23181,10840244,10840244,10841291,0,0,0,1047
23185,10841276,10841276,10841318,0,0,0,42
23169,10838473,10841318,10841368,0,0,2845,2895
23163,10837630,10838548,10841511,0,0,918,3881
23189,10842403,10842403,10842441,0,0,0,38
23166,10838140,10839898,10842841,0,0,1758,4701
23187,10841793,10842841,10842875,0,0,1048,1082
23188,10841940,10842875,10842924,0,0,935,984
23154,10835719,10835719,10843015,0,0,0,7296
23172,10838780,10839660,10843167,0,0,880,4387
23191,10842594,10842924,10843300,0,0,330,706
23109,10827404,10827404,10845180,0,0,0,17776
23182,10840597,10840597,10847039,0,0,0,6442
23173,10838935,10841368,10848803,0,0,2433,9868
23190,10842567,10848803,10848835,0,0,6236,6268
23193,10844155,10847039,10850531,0,0,2884,6376
23177,10839541,10839898,10850618,0,0,357,11077
23186,10841537,10843300,10850839,0,0,1763,9302
23198,10849472,10850618,10850910,0,0,1146,1438
23199,10849488,10850839,10851041,0,0,1351,1553
23195,10844726,10850839,10851137,0,0,6113,6411
23179,10840147,10843015,10851663,0,0,2868,11516
23201,10852324,10852324,10852360,0,0,0,36
23196,10847496,10850531,10852545,0,0,3035,5049
23202,10853004,10853004,10853207,0,0,0,203
23128,10829821,10845180,10853921,0,0,15359,24100
23144,10833550,10853921,10853976,0,0,20371,20426
23151,10834805,10853976,10854000,0,0,19171,19195
23192,10843562,10848835,10854032,0,0,5273,10470
23152,10835000,10854000,10854039,0,0,19000,19039
23155,10835789,10854039,10854140,0,0,18250,18351
23197,10848765,10851137,10854524,0,0,2372,5759
23156,10836125,10854140,10854531,0,0,18015,18406
23165,10838122,10854531,10854557,0,0,16409,16435
23168,10838454,10854557,10854586,0,0,16103,16132
23174,10838948,10854586,10854606,0,0,15638,15658
23176,10839360,10854606,10854626,0,0,15246,15266
23178,10839696,10854626,10854649,0,0,14930,14953
23180,10840185,10854649,10854676,0,0,14464,14491
23183,10840767,10854676,10854704,0,0,13909,13937
23184,10841127,10854704,10854735,0,0,13577,13608
23145,10833625,10853921,10854909,0,0,20296,21284
23159,10836581,10854524,10854937,0,0,17943,18356
23204,10855020,10855020,10855578,0,0,0,558
23200,10850869,10851663,10855592,0,0,794,4723
23206,10855954,10855954,10856048,0,0,0,94
23205,10855535,10855592,10856176,0,0,57,641
23207,10856116,10856116,10856972,0,0,0,856
23208,10856263,10856263,10857217,0,0,0,954
23203,10853897,10853897,10857965,0,0,0,4068
23212,10858648,10858648,10858693,0,0,0,45
23211,10858453,10858453,10859164,0,0,0,711
23214,10859674,10859674,10859970,0,0,0,296
23209,10856667,10856667,10861401,0,0,0,4734
23215,10862431,10862431,10862482,0,0,0,51
23216,10862554,10862554,10862611,0,0,0,57
23146,10833811,10833811,10863736,0,0,0,29925
23218,10865024,10865024,10865207,0,0,0,183
23219,10865434,10865434,10865475,0,0,0,41
23220,10865531,10865531,10867510,0,0,0,1979
23223,10866829,10867510,10867537,0,0,681,708
23194,10844705,10854735,10867921,0,0,10030,23216
23221,10865699,10865699,10869192,0,0,0,3493
23171,10838591,10854937,10870994,0,0,16346,32403
23213,10859297,10859297,10871052,0,0,0,11755
23222,10866537,10867510,10874046,0,0,973,7509
23224,10871321,10871321,10877485,0,0,0,6164
23210,10857825,10867921,10883910,0,0,10096,26085
23217,10863733,10863733,10888476,0,0,0,24743
23225,10875548,10875548,10889972,0,0,0,14424
23226,10885249,10885249,10891704,0,0,0,6455
23229,10892193,10892193,10892918,0,0,0,725
23228,10891804,10891804,10893784,0,0,0,1980
23231,10892960,10892960,10894865,0,0,0,1905
23234,10895062,10895062,10895135,0,0,0,73
23233,10895009,10895009,10895579,0,0,0,570
23227,10888473,10888473,10896026,0,0,0,7553
23240,10895994,10895994,10896039,0,0,0,45
23236,10895169,10895169,10896073,0,0,0,904
23241,10896040,10896073,10896104,0,0,33,64
23242,10896078,10896104,10896206,0,0,26,128
23237,10895329,10895329,10896460,0,0,0,1131
23244,10896259,10896460,10896487,0,0,201,228
23245,10896384,10896384,10896590,0,0,0,206
23238,10895717,10895717,10896599,0,0,0,882
23232,10893347,10893347,10896762,0,0,0,3415
23246,10896556,10896762,10896806,0,0,206,250
23243,10896219,10896219,10896811,0,0,0,592
23239,10895786,10896039,10896845,0,0,253,1059
23251,10897051,10897051,10897502,0,0,0,451
23252,10897194,10897194,10897671,0,0,0,477
23248,10896771,10896806,10898018,0,0,35,1247
23255,10897869,10897869,10898153,0,0,0,284
23250,10897036,10898018,10898630,0,0,982,1594
23253,10897635,10898630,10898674,0,0,995,1039
23230,10892597,10892597,10898917,0,0,0,6320
23257,10898179,10898674,10898925,0,0,495,746
23258,10898270,10898270,10899250,0,0,0,980
23263,10899110,10899110,10899276,0,0,0,166
23259,10898430,10898674,10899858,0,0,244,1428
23256,10898151,10898151,10900584,0,0,0,2433
23266,10900229,10900584,10900618,0,0,355,389
23249,10896975,10896975,10900740,0,0,0,3765
23267,10900356,10900584,10901068,0,0,228,712
23268,10900731,10900740,10901166,0,0,9,435
23271,10901100,10901100,10901183,0,0,0,83
23265,10899334,10899334,10902308,0,0,0,2974
23274,10902010,10902308,10902428,0,0,298,418
23275,10902100,10902428,10902728,0,0,328,628
23261,10898477,10899858,10902745,0,0,1381,4268
23278,10902696,10902728,10902811,0,0,32,115
23279,10902888,10902888,10902965,0,0,0,77
23262,10898528,10898917,10903035,0,0,389,4507
23280,10903009,10903009,10903339,0,0,0,330
23260,10898471,10898674,10906509,0,0,203,8038
23272,10901740,10906509,10906567,0,0,4769,4827
23269,10900840,10902745,10906648,0,0,1905,5808
23284,10903529,10906648,10906696,0,0,3119,3167
23273,10901916,10906567,10906734,0,0,4651,4818
23285,10903605,10906696,10906838,0,0,3091,3233
23286,10903614,10906734,10906843,0,0,3120,3229
23283,10903445,10906648,10906867,0,0,3203,3422
23287,10903723,10906838,10906876,0,0,3115,3153
23292,10904415,10906843,10906896,0,0,2428,2481
23294,10904551,10906867,10906906,0,0,2316,2355
23291,10904368,10906843,10906923,0,0,2475,2555
23296,10904660,10906896,10906998,0,0,2236,2338
23300,10904869,10906998,10907084,0,0,2129,2215
23295,10904551,10906876,10907092,0,0,2325,2541
23302,10905002,10907084,10907210,0,0,2082,2208
23290,10904310,10906843,10907299,0,0,2533,2989
23304,10905395,10907092,10907329,0,0,1697,1934
23288,10903723,10906843,10907432,0,0,3120,3709
23313,10906779,10907432,10907494,0,0,653,715
23281,10903102,10903339,10907495,0,0,237,4393
23306,10905784,10907210,10907504,0,0,1426,1720
23310,10906350,10907299,10907562,0,0,949,1212
23235,10895130,10895130,10907912,0,0,0,12782
23311,10906360,10907329,10908131,0,0,969,1771
23318,10907586,10908131,10908161,0,0,545,575
23297,10904746,10907562,10908203,0,0,2816,3457
23254,10897699,10907912,10908247,0,0,10213,10548
23264,10899118,10901183,10908625,0,0,2065,9507
23319,10907674,10908161,10908959,0,0,487,1285
23276,10902271,10903035,10909187,0,0,764,6916
23289,10903846,10908625,10909245,0,0,4779,5399
23247,10896596,10896596,10909331,0,0,0,12735
23307,10905807,10908203,10909381,0,0,2396,3574
23321,10907846,10909331,10909382,0,0,1485,1536
23325,10908564,10909381,10909442,0,0,817,878
23293,10904478,10909245,10909504,0,0,4767,5026
23326,10908624,10909382,10909847,0,0,758,1223
23327,10908683,10909442,10909848,0,0,759,1165
23328,10908786,10909847,10909902,0,0,1061,1116
23299,10904831,10906923,10910126,0,0,2092,5295
23315,10907339,10909187,10910130,0,0,1848,2791
23324,10908398,10910130,10910161,0,0,1732,1763
23320,10907695,10908959,10910332,0,0,1264,2637
23282,10903325,10906648,10910639,0,0,3323,7314
23330,10909075,10909848,10910664,0,0,773,1589
23338,10910623,10910664,10910903,0,0,41,280
23301,10904942,10909504,10911000,0,0,4562,6058
23331,10909168,10910639,10911023,0,0,1471,1855
23303,10905358,10911000,10911099,0,0,5642,5741
23305,10905741,10911099,10911194,0,0,5358,5453
23335,10909569,10910126,10911242,0,0,557,1673
23334,10909488,10911023,10911392,0,0,1535,1904
23270,10901003,10908247,10911940,0,0,7244,10937
23312,10906604,10911940,10912048,0,0,5336,5444
23314,10907159,10912048,10912086,0,0,4889,4927
23323,10908249,10912086,10912138,0,0,3837,3889
23345,10912520,10912520,10912705,0,0,0,185
23339,10910952,10912138,10912906,0,0,1186,1954
23340,10910966,10912906,10912965,0,0,1940,1999
23343,10912275,10912965,10912979,0,0,690,704
23298,10904822,10906906,10913285,0,0,2084,8463
23337,10910109,10911242,10913788,0,0,1133,3679
23352,10913742,10913788,10914317,0,0,46,575
23359,10915119,10915119,10915179,0,0,0,60
23341,10911243,10911392,10915320,0,0,149,4077
23347,10913132,10913285,10915581,0,0,153,2449
23322,10908106,10909381,10916164,0,0,1275,8058
23368,10915943,10916164,10916194,0,0,221,251
23371,10916237,10916237,10916285,0,0,0,48
23365,10915692,10915692,10916297,0,0,0,605
23309,10906319,10911940,10916561,0,0,5621,10242
23374,10916513,10916513,10916562,0,0,0,49
23375,10916584,10916584,10916800,0,0,0,216
23316,10907473,10907494,10916989,0,0,21,9516
23346,10912549,10916561,10917283,0,0,4012,4734
23348,10913435,10917283,10917377,0,0,3848,3942
23349,10913473,10917377,10917397,0,0,3904,3924
23308,10906069,10911194,10917416,0,0,5125,11347
23353,10914006,10917397,10917442,0,0,3391,3436
23354,10914050,10917416,10917475,0,0,3366,3425
23367,10915734,10915734,10917658,0,0,0,1924
23357,10914863,10917475,10918101,0,0,2612,3238
23360,10915164,10918101,10918233,0,0,2937,3069
23361,10915168,10918233,10918304,0,0,3065,3136
23364,10915527,10918304,10918328,0,0,2777,2801
23336,10909898,10910332,10918439,0,0,434,8541
23381,10917556,10918439,10918677,0,0,883,1121
23366,10915699,10918328,10918722,0,0,2629,3023
23363,10915394,10915394,10918922,0,0,0,3528
23369,10916061,10918722,10919398,0,0,2661,3337
23355,10914234,10917442,10919890,0,0,3208,5656
23376,10916610,10919890,10919966,0,0,3280,3356
23344,10912335,10912979,10920036,0,0,644,7701
23384,10918265,10918922,10920205,0,0,657,1940
23386,10918664,10920205,10920240,0,0,1541,1576
23377,10916651,10919890,10920329,0,0,3239,3678
23370,10916212,10916297,10920798,0,0,85,4586
23390,10919156,10920798,10920835,0,0,1642,1679
23391,10919229,10920835,10920870,0,0,1606,1641
23378,10916756,10920036,10920913,0,0,3280,4157
23387,10918863,10920329,10921538,0,0,1466,2675
23397,10920146,10921538,10921566,0,0,1392,1420
23398,10920833,10921566,10921610,0,0,733,777
23373,10916344,10919398,10921794,0,0,3054,5450
23317,10907473,10907495,10922181,0,0,22,14708
23395,10919962,10921538,10922239,0,0,1576,2277
23362,10915214,10915214,10922263,0,0,0,7049
23400,10922167,10922167,10922274,0,0,0,107
23379,10916814,10920913,10922324,0,0,4099,5510
23333,10909380,10909902,10922677,0,0,522,13297
23380,10917203,10917658,10922722,0,0,455,5519
23372,10916314,10916989,10922755,0,0,675,6441
23382,10918014,10918677,10922927,0,0,663,4913
23399,10921641,10922239,10923090,0,0,598,1449
23404,10922943,10923090,10923148,0,0,147,205
23277,10902366,10911940,10923248,0,0,9574,20882
23329,10908971,10910161,10923271,0,0,1190,14300
23350,10913655,10923248,10923275,0,0,9593,9620
23388,10919035,10920240,10923353,0,0,1205,4318
23408,10923393,10923393,10923413,0,0,0,20
23392,10919411,10920870,10923606,0,0,1459,4195
23385,10918317,10919966,10923727,0,0,1649,5410
23389,10919132,10920798,10923815,0,0,1666,4683
23403,10922882,10922927,10924057,0,0,45,1175
23407,10923318,10923318,10924191,0,0,0,873
23383,10918242,10921794,10924265,0,0,3552,6023
23411,10924154,10924191,10924372,0,0,37,218
23410,10923699,10923699,10924403,0,0,0,704
23396,10920099,10922722,10924630,0,0,2623,4531
23412,10924173,10924630,10924702,0,0,457,529
23393,10919441,10922324,10924892,0,0,2883,5451
23415,10925430,10925430,10925513,0,0,0,83
23418,10925549,10925549,10925618,0,0,0,69
23419,10925788,10925788,10925925,0,0,0,137
23420,10925933,10925933,10925970,0,0,0,37
23401,10922698,10924057,10926049,0,0,1359,3351
23421,10925977,10925977,10926119,0,0,0,142
23416,10925458,10925458,10926159,0,0,0,701
23424,10926232,10926232,10926333,0,0,0,101
23426,10926355,10926355,10926441,0,0,0,86
23427,10926466,10926466,10926530,0,0,0,64
23428,10926556,10926556,10926615,0,0,0,59
23429,10926637,10926637,10926699,0,0,0,62
23417,10925505,10925505,10927174,0,0,0,1669
23431,10927188,10927188,10927282,0,0,0,94
23432,10927256,10927282,10927337,0,0,26,81
23433,10927327,10927337,10927625,0,0,10,298
23423,10926076,10926076,10927840,0,0,0,1764
23430,10927076,10927076,10927864,0,0,0,788
23437,10927844,10927864,10928092,0,0,20,248
23358,10914938,10923275,10928154,0,0,8337,13216
23394,10919782,10928154,10928405,0,0,8372,8623
23434,10927374,10927625,10928522,0,0,251,1148
23438,10928089,10928089,10928864,0,0,0,775
23436,10927640,10927840,10929230,0,0,200,1590
23439,10928262,10928405,10929310,0,0,143,1048
23441,10928940,10928940,10929573,0,0,0,633
23443,10929582,10929582,10929726,0,0,0,144
23440,10928692,10928692,10930186,0,0,0,1494
23445,10930579,10930579,10930867,0,0,0,288
23446,10931120,10931120,10931468,0,0,0,348
23447,10931526,10931526,10931755,0,0,0,229
23448,10931759,10931759,10932000,0,0,0,241
23450,10932307,10932307,10932555,0,0,0,248
23452,10932737,10932737,10932974,0,0,0,237
23413,10924352,10924372,10933041,0,0,20,8689
23449,10931869,10931869,10933080,0,0,0,1211
23454,10933330,10933330,10933533,0,0,0,203
23453,10933320,10933320,10933815,0,0,0,495
23455,10933698,10933698,10933868,0,0,0,170
23402,10922881,10922881,10934030,0,0,0,11149
23405,10922943,10923090,10934176,0,0,147,11233
23456,10934083,10934083,10934206,0,0,0,123
23459,10934348,10934348,10934370,0,0,0,22
23460,10934384,10934384,10934454,0,0,0,70
23461,10934573,10934573,10934667,0,0,0,94
23463,10934775,10934775,10934789,0,0,0,14
23464,10934800,10934800,10935081,0,0,0,281
23458,10934317,10934317,10936918,0,0,0,2601
23466,10934999,10936918,10936965,0,0,1919,1966
23467,10935264,10936965,10937001,0,0,1701,1737
23468,10935643,10937001,10937044,0,0,1358,1401
23462,10934638,10934638,10940993,0,0,0,6355
23472,10950482,10950482,10954615,0,0,0,4133
23473,10979002,10979002,10979030,0,0,0,28
23475,10983943,10983943,10985719,0,0,0,1776
23476,10988255,10988255,10988659,0,0,0,404
23409,10923426,10923426,10988688,0,0,0,65262
23406,10923267,10924265,10989473,0,0,998,66206
23444,10930331,10930331,10990463,0,0,0,60132
23425,10926283,10926283,10990533,0,0,0,64250
23422,10926057,10926057,10990682,0,0,0,64625
23451,10932726,10932726,10990745,0,0,0,58019
23457,10934299,10934299,10990750,0,0,0,56451
23414,10924371,10924702,10990866,0,0,331,66495
23465,10934923,10935081,10990903,0,0,158,55980
23477,10990964,10990964,10991374,0,0,0,410
23469,10936315,10937044,10991416,0,0,729,55101
23332,10909222,10990463,10991713,0,0,81241,82491
23483,10991681,10991681,10992103,0,0,0,422
23478,10990994,10990994,10992450,0,0,0,1456
23479,10991385,10991385,10992516,0,0,0,1131
23490,10992761,10992761,10992842,0,0,0,81
23489,10992694,10992694,10992924,0,0,0,230
23491,10993049,10993049,10993279,0,0,0,230
23492,10993358,10993358,10993585,0,0,0,227
23480,10991535,10991535,10993878,0,0,0,2343
23485,10991955,10993878,10993908,0,0,1923,1953
23494,10993721,10993721,10993965,0,0,0,244
23495,10993839,10993839,10993980,0,0,0,141
23498,10994336,10994336,10994365,0,0,0,29
23482,10991655,10991655,10994559,0,0,0,2904
23497,10994011,10994011,10994625,0,0,0,614
23488,10992582,10992582,10994659,0,0,0,2077
23470,10936886,10940993,10994696,0,0,4107,57810
23504,10994757,10994757,10994839,0,0,0,82
23481,10991638,10991638,10994971,0,0,0,3333
23506,10994931,10994931,10995338,0,0,0,407
23511,10995427,10995427,10995964,0,0,0,537
23513,10996288,10996288,10996330,0,0,0,42
23515,10996426,10996426,10996488,0,0,0,62
23516,10996487,10996488,10996548,0,0,1,61
23517,10996547,10996548,10996571,0,0,1,24
23519,10996551,10996571,10996601,0,0,20,50
23520,10996562,10996601,10996686,0,0,39,124
23484,10991945,10993878,10997147,0,0,1933,5202
23493,10993572,10997147,10997176,0,0,3575,3604
23496,10993852,10997176,10997212,0,0,3324,3360
23499,10994419,10997212,10997252,0,0,2793,2833
23342,10912078,10991713,10999146,0,0,79635,87068
23351,10913723,10999146,10999172,0,0,85423,85449
23486,10992461,10993908,11000157,0,0,1447,7696
23508,10995080,11000157,11000502,0,0,5077,5422
23523,10996580,11000502,11000568,0,0,3922,3988
23522,10996570,11000502,11000578,0,0,3932,4008
23525,10996646,11000568,11000623,0,0,3922,3977
23528,10998210,11000623,11000632,0,0,2413,2422
23535,11001385,11001385,11001394,0,0,0,9
23356,10914432,10999172,11001495,0,0,84740,87063
23536,11002606,11002606,11002621,0,0,0,15
23435,10927431,11001495,11003441,0,0,74064,76010
23501,10994607,10994607,11003452,0,0,0,8845
23502,10994638,10994638,11003460,0,0,0,8822
23524,10996645,11003452,11003508,0,0,6807,6863
23503,10994738,10994738,11003539,0,0,0,8801
23509,10995099,10995099,11003541,0,0,0,8442
23505,10994913,10994913,11003542,0,0,0,8629
23521,10996569,10996686,11003657,0,0,117,7088
23514,10996328,11003657,11003691,0,0,7329,7363
23512,10995653,11003508,11004013,0,0,7855,8360
23527,10997724,11004013,11004133,0,0,6289,6409
23507,10994975,10997252,11005660,0,0,2277,10685
23538,11003693,11005660,11005672,0,0,1967,1979
23540,11005085,11005660,11005695,0,0,575,610
23542,11005849,11005849,11005884,0,0,0,35
23537,11002773,11002773,11006641,0,0,0,3868
23545,11006283,11006641,11006648,0,0,358,365
23526,10996700,11000578,11007423,0,0,3878,10723
23543,11005849,11005849,11008344,0,0,0,2495
23544,11005915,11005915,11008344,0,0,0,2429
23546,11007052,11008344,11008409,0,0,1292,1357
23510,10995162,11000502,11008801,0,0,5340,13639
23530,10998463,11004133,11009053,0,0,5670,10590
23547,11009114,11009114,11009980,0,0,0,866
23548,11009114,11009114,11010015,0,0,0,901
23549,11009881,11010015,11010427,0,0,134,546
23518,10996548,11003691,11010525,0,0,7143,13977
23550,11009914,11010525,11010887,0,0,611,973
23487,10992524,11009053,11011000,0,0,16529,18476
23529,10998423,11011000,11011755,0,0,12577,13332
23531,10999309,11011755,11011770,0,0,12446,12461
23532,10999516,11011770,11011783,0,0,12254,12267
23533,10999876,11011783,11011801,0,0,11907,11925
23442,10929258,11003441,11014231,0,0,74183,84973
23534,11000229,11011801,11014873,0,0,11572,14644
23551,11010257,11014873,11015051,0,0,4616,4794
23471,10937922,11014231,11017077,0,0,76309,79155
23552,11018175,11018175,11018257,0,0,0,82
23554,11018325,11018325,11018645,0,0,0,320
23553,11018242,11018242,11018729,0,0,0,487
23556,11019184,11019184,11019714,0,0,0,530
23558,11023040,11023040,11023112,0,0,0,72
23559,11023138,11023138,11023571,0,0,0,433
23561,11024102,11024102,11024127,0,0,0,25
23560,11023661,11023661,11024290,0,0,0,629
23562,11024408,11024408,11024424,0,0,0,16
23563,11024664,11024664,11024700,0,0,0,36
23564,11024939,11024939,11024971,0,0,0,32
23567,11025574,11025574,11027951,0,0,0,2377
23570,11026841,11027951,11028020,0,0,1110,1179
23557,11020169,11020169,11028043,0,0,0,7874
23572,11028049,11028049,11028444,0,0,0,395
23569,11026704,11026704,11028694,0,0,0,1990
23566,11025240,11025240,11029140,0,0,0,3900
23573,11028124,11028124,11029300,0,0,0,1176
23541,11005092,11005660,11030498,0,0,568,25406
23574,11031117,11031117,11031233,0,0,0,116
23575,11031503,11031503,11031589,0,0,0,86
23576,11031700,11031700,11032877,0,0,0,1177
23577,11032725,11032725,11033035,0,0,0,310
23568,11026429,11028043,11034654,0,0,1614,8225
23578,11033279,11033279,11034752,0,0,0,1473
23580,11037942,11037942,11037967,0,0,0,25
23474,10981113,11017077,11038802,0,0,35964,57689
23579,11035999,11035999,11040057,0,0,0,4058
23555,11018770,11018770,11041181,0,0,0,22411
23500,10994452,11038802,11047569,0,0,44350,53117
23539,11004669,11047569,11049159,0,0,42900,44490
23571,11027517,11049159,11053139,0,0,21642,25622
23565,11025157,11025157,11060186,0,0,0,35029
23587,11070132,11070132,11070190,0,0,0,58
23586,11069969,11069969,11070307,0,0,0,338
23581,11068937,11068937,11070653,0,0,0,1716
23590,11070619,11070619,11070721,0,0,0,102
23583,11069645,11069645,11070960,0,0,0,1315
23591,11071092,11071092,11071146,0,0,0,54
23584,11069736,11069736,11071338,0,0,0,1602
23592,11071126,11071126,11071338,0,0,0,212
23582,11069119,11069119,11071339,0,0,0,2220
23585,11069745,11069745,11071371,0,0,0,1626
23588,11070199,11070199,11071630,0,0,0,1431
23589,11070382,11070382,11071631,0,0,0,1249
23595,11072110,11072110,11072439,0,0,0,329
23594,11071851,11071851,11072442,0,0,0,591
23598,11072873,11072873,11072900,0,0,0,27
23603,11075308,11075308,11075566,0,0,0,258
23604,11075689,11075689,11075718,0,0,0,29
23602,11074838,11074838,11076307,0,0,0,1469
23593,11071416,11071416,11077408,0,0,0,5992
23605,11077425,11077425,11077448,0,0,0,23
23606,11078304,11078304,11078320,0,0,0,16
23607,11080047,11080047,11080092,0,0,0,45
23600,11073100,11073100,11081171,0,0,0,8071
23601,11073116,11073116,11081171,0,0,0,8055
23597,11072442,11072442,11081172,0,0,0,8730
23599,11072902,11072902,11081172,0,0,0,8270
23610,11081755,11081755,11081783,0,0,0,28
23609,11081690,11081690,11081959,0,0,0,269
23611,11081822,11081822,11082006,0,0,0,184
23596,11072117,11072117,11082030,0,0,0,9913
23613,11082300,11082300,11082339,0,0,0,39
23615,11082402,11082402,11082521,0,0,0,119
23614,11082362,11082362,11082524,0,0,0,162
23612,11082205,11082205,11085837,0,0,0,3632
23621,11082987,11085837,11086168,0,0,2850,3181
23623,11083292,11086168,11086225,0,0,2876,2933
23619,11082937,11082937,11086266,0,0,0,3329
23627,11083469,11086225,11086277,0,0,2756,2808
23632,11083983,11086277,11086300,0,0,2294,2317
23630,11083696,11086266,11086336,0,0,2570,2640
23633,11084065,11086300,11086338,0,0,2235,2273
23635,11084280,11086338,11086362,0,0,2058,2082
23636,11084300,11086362,11086389,0,0,2062,2089
23637,11084567,11086389,11086405,0,0,1822,1838
23638,11084690,11086405,11086418,0,0,1715,1728
23634,11084110,11086336,11086468,0,0,2226,2358
23640,11084869,11086468,11086500,0,0,1599,1631
23641,11084945,11086500,11086512,0,0,1555,1567
23643,11085108,11086512,11086682,0,0,1404,1574
23648,11085627,11086682,11086765,0,0,1055,1138
23631,11083708,11086266,11087079,0,0,2558,3371
23620,11082952,11085837,11087119,0,0,2885,4167
23650,11085717,11087079,11087211,0,0,1362,1494
23639,11084722,11086418,11087213,0,0,1696,2491
23652,11085918,11087211,11087216,0,0,1293,1298
23654,11086070,11087216,11087235,0,0,1146,1165
23608,11081610,11081610,11087468,0,0,0,5858
23649,11085702,11086765,11087679,0,0,1063,1977
23659,11086614,11087679,11087706,0,0,1065,1092
23657,11086248,11087468,11087846,0,0,1220,1598
23660,11086614,11087706,11087856,0,0,1092,1242
23663,11087082,11087856,11088031,0,0,774,949
23655,11086100,11087235,11088115,0,0,1135,2015
23653,11086024,11087213,11088120,0,0,1189,2096
23662,11086814,11087846,11088503,0,0,1032,1689
23617,11082515,11082521,11088659,0,0,6,6144
23624,11083333,11088659,11088777,0,0,5326,5444
23622,11083152,11088659,11088791,0,0,5507,5639
23626,11083463,11088777,11088817,0,0,5314,5354
23629,11083608,11088791,11088829,0,0,5183,5221
23616,11082466,11082466,11088864,0,0,0,6398
23645,11085454,11088829,11088868,0,0,3375,3414
23644,11085142,11088817,11089080,0,0,3675,3938
23646,11085499,11088868,11089537,0,0,3369,4038
23647,11085553,11089080,11089839,0,0,3527,4286
23661,11086638,11089839,11089892,0,0,3201,3254
23671,11088517,11089892,11089930,0,0,1375,1413
23625,11083418,11085837,11090159,0,0,2419,6741
23651,11085730,11087119,11090253,0,0,1389,4523
23658,11086271,11089537,11090376,0,0,3266,4105
23628,11083585,11086225,11090481,0,0,2640,6896
23642,11085042,11088864,11090530,0,0,3822,5488
23667,11087330,11090530,11090891,0,0,3200,3561
23664,11087195,11090376,11090961,0,0,3181,3766
23656,11086247,11088503,11091123,0,0,2256,4876
23665,11087209,11089839,11091496,0,0,2630,4287
23618,11082918,11082918,11091522,0,0,0,8604
23668,11087493,11090481,11091851,0,0,2988,4358
23672,11088650,11091496,11091902,0,0,2846,3252
23669,11087757,11088115,11091963,0,0,358,4206
23666,11087268,11088031,11092282,0,0,763,5014
23674,11089670,11089892,11092780,0,0,222,3110
23676,11091771,11091851,11093528,0,0,80,1757
23678,11093522,11093522,11093688,0,0,0,166
23670,11088043,11090891,11094253,0,0,2848,6210
23684,11094254,11094254,11094264,0,0,0,10
23683,11094154,11094154,11094573,0,0,0,419
23679,11093525,11093525,11094871,0,0,0,1346
23681,11093744,11093744,11094941,0,0,0,1197
23673,11089179,11090891,11095259,0,0,1712,6080
23682,11094105,11094105,11095321,0,0,0,1216
23680,11093678,11093678,11095354,0,0,0,1676
23677,11093514,11093514,11095765,0,0,0,2251
23675,11091766,11091766,11096260,0,0,0,4494
23689,11096039,11096039,11096471,0,0,0,432
23692,11096624,11096624,11096900,0,0,0,276
23694,11096701,11096701,11097331,0,0,0,630
23696,11097167,11097167,11097655,0,0,0,488
23697,11097660,11097660,11097687,0,0,0,27
23690,11096394,11096394,11098041,0,0,0,1647
23700,11099059,11099059,11099351,0,0,0,292
23701,11099410,11099410,11099536,0,0,0,126
23702,11099770,11099770,11099819,0,0,0,49
23704,11100074,11100074,11100101,0,0,0,27
23695,11096794,11096794,11100115,0,0,0,3321
23703,11099798,11099798,11100741,0,0,0,943
23706,11100448,11100741,11100810,0,0,293,362
23707,11100528,11100741,11100934,0,0,213,406
23710,11101048,11101048,11101094,0,0,0,46
23685,11094817,11094817,11101276,0,0,0,6459
23709,11100848,11100848,11101398,0,0,0,550
23693,11096681,11096681,11101576,0,0,0,4895
23711,11101493,11101576,11101605,0,0,83,112
23712,11101493,11101605,11101816,0,0,112,323
23713,11101833,11101833,11102045,0,0,0,212
23716,11102011,11102011,11102294,0,0,0,283
23718,11102223,11102223,11102462,0,0,0,239
23714,11101856,11102462,11102528,0,0,606,672
23691,11096515,11096515,11102662,0,0,0,6147
23719,11102869,11102869,11102907,0,0,0,38
23715,11101991,11102528,11103150,0,0,537,1159
23698,11097939,11097939,11103238,0,0,0,5299
23720,11103061,11103061,11103607,0,0,0,546
23717,11102201,11103150,11106331,0,0,949,4130
23705,11100358,11100741,11106352,0,0,383,5994
23724,11105977,11106352,11109840,0,0,375,3863
23708,11100727,11101398,11110064,0,0,671,9337
23722,11103617,11110064,11110202,0,0,6447,6585
23723,11105170,11110064,11110276,0,0,4894,5106
23721,11103176,11106331,11112176,0,0,3155,9000
23699,11098046,11098046,11112277,0,0,0,14231
23726,11107047,11107047,11112328,0,0,0,5281
23729,11113203,11113203,11114036,0,0,0,833
23730,11114048,11114048,11115754,0,0,0,1706
23733,11116474,11116474,11116649,0,0,0,175
23732,11115858,11115858,11116914,0,0,0,1056
23737,11117191,11117191,11117272,0,0,0,81
23736,11117016,11117016,11117460,0,0,0,444
23739,11117429,11117429,11117517,0,0,0,88
23740,11117684,11117684,11117993,0,0,0,309
23738,11117311,11117311,11118515,0,0,0,1204
23741,11118426,11118426,11118861,0,0,0,435
23734,11116678,11116678,11119063,0,0,0,2385
23735,11116959,11116959,11120915,0,0,0,3956
23731,11114794,11114794,11126821,0,0,0,12027
23687,11094840,11094840,11129760,0,0,0,34920
23725,11106310,11110276,11132405,0,0,3966,26095
23743,11133643,11133643,11134258,0,0,0,615
23688,11094853,11094853,11135624,0,0,0,40771
23686,11094830,11094830,11149174,0,0,0,54344
23728,11112780,11149174,11163796,0,0,36394,51016
23742,11127562,11163796,11175148,0,0,36234,47586
23748,11152791,11175148,11175902,0,0,22357,23111
23750,11154991,11175148,11176164,0,0,20157,21173
23744,11150749,11175148,11176358,0,0,24399,25609
23754,11156818,11175902,11176710,0,0,19084,19892
23756,11157601,11176710,11176781,0,0,19109,19180
23757,11157762,11176781,11176837,0,0,19019,19075
23755,11156874,11176164,11177049,0,0,19290,20175
23759,11157883,11177049,11177115,0,0,19166,19232
23761,11158349,11177115,11177180,0,0,18766,18831
23752,11156074,11175902,11177534,0,0,19828,21460
23764,11158871,11177534,11177601,0,0,18663,18730
23765,11159371,11177601,11177774,0,0,18230,18403
23745,11152644,11175148,11178517,0,0,22504,25873
23749,11154267,11175148,11179085,0,0,20881,24818
23746,11152681,11175148,11179088,0,0,22467,26407
23770,11161087,11179088,11179157,0,0,18001,18070
23772,11161379,11179157,11179506,0,0,17778,18127
23771,11161134,11179088,11179541,0,0,17954,18407
23774,11161723,11179506,11179581,0,0,17783,17858
23781,11163078,11179581,11179608,0,0,16503,16530
23782,11163152,11179608,11179668,0,0,16456,16516
23751,11156023,11176358,11179756,0,0,20335,23733
23766,11159656,11177774,11180036,0,0,18118,20380
23786,11163325,11180036,11180095,0,0,16711,16770
23760,11158269,11178517,11180166,0,0,20248,21897
23762,11158477,11178517,11180210,0,0,20040,21733
23763,11158562,11177180,11180347,0,0,18618,21785
23791,11163796,11180347,11180442,0,0,16551,16646
23795,11164252,11180442,11180499,0,0,16190,16247
23796,11164337,11180499,11180536,0,0,16162,16199
23773,11161388,11180166,11180607,0,0,18778,19219
23798,11164742,11180536,11180741,0,0,15794,15999
23799,11164785,11180741,11180855,0,0,15956,16070
23758,11157843,11176837,11180878,0,0,18994,23035
23804,11165095,11180855,11180890,0,0,15760,15795
23806,11165370,11180878,11180914,0,0,15508,15544
23785,11163241,11179668,11181666,0,0,16427,18425
23811,11165709,11181666,11181731,0,0,15957,16022
23780,11163062,11179541,11181735,0,0,16479,18673
23812,11166602,11181731,11181751,0,0,15129,15149
23813,11166746,11181735,11181775,0,0,14989,15029
23815,11167243,11181751,11181797,0,0,14508,14554
23817,11168328,11181797,11181837,0,0,13469,13509
23816,11168058,11181775,11181841,0,0,13717,13783
23819,11168603,11181841,11181881,0,0,13238,13278
23820,11168812,11181881,11181924,0,0,13069,13112
23821,11169026,11181924,11181964,0,0,12898,12938
23822,11169260,11181964,11182005,0,0,12704,12745
23776,11162474,11180607,11182117,0,0,18133,19643
23777,11162493,11182117,11182187,0,0,19624,19694
23823,11169326,11182005,11182406,0,0,12679,13080
23767,11160134,11179085,11182437,0,0,18951,22303
23825,11169438,11182406,11182476,0,0,12968,13038
23826,11169649,11182476,11182553,0,0,12827,12904
23827,11169922,11182553,11182595,0,0,12631,12673
23828,11170167,11182595,11182641,0,0,12428,12474
23830,11170318,11182641,11182727,0,0,12323,12409
23831,11170613,11182727,11182760,0,0,12114,12147
23778,11162581,11182187,11182767,0,0,19606,20186
23832,11170704,11182760,11182800,0,0,12056,12096
23833,11170907,11182800,11182866,0,0,11893,11959
23779,11162597,11182437,11183000,0,0,19840,20403
23768,11160238,11179756,11183259,0,0,19518,23021
23835,11171028,11182866,11183731,0,0,11838,12703
23836,11171103,11183731,11183831,0,0,12628,12728
23837,11171424,11183831,11183900,0,0,12407,12476
23783,11163187,11182767,11184268,0,0,19580,21081
23784,11163205,11183000,11184463,0,0,19795,21258
23788,11163424,11183259,11184577,0,0,19835,21153
23792,11163836,11184577,11184800,0,0,20741,20964
23818,11168447,11181837,11185283,0,0,13390,16836
23810,11165634,11180914,11186732,0,0,15280,21098
23809,11165617,11180890,11186795,0,0,15273,21178
23787,11163360,11180095,11188076,0,0,16735,24716
23844,11172374,11185283,11188980,0,0,12909,16606
23853,11175965,11188980,11188996,0,0,13015,13031
23775,11162152,11180210,11189658,0,0,18058,27506
23857,11176974,11188996,11189742,0,0,12022,12768
23793,11163896,11184800,11190250,0,0,20904,26354
23797,11164655,11190250,11190454,0,0,25595,25799
23800,11164861,11184463,11191495,0,0,19602,26634
23789,11163515,11184268,11192372,0,0,20753,28857
23847,11174785,11186732,11192768,0,0,11947,17983
23807,11165405,11190454,11193305,0,0,25049,27900
23845,11174088,11193305,11193800,0,0,19217,19712
23846,11174121,11193800,11194228,0,0,19679,20107
23850,11174961,11194228,11194260,0,0,19267,19299
23808,11165438,11191495,11194297,0,0,26057,28859
23851,11175769,11194260,11194423,0,0,18491,18654
23852,11175800,11194297,11194428,0,0,18497,18628
23858,11177552,11189742,11194474,0,0,12190,16922
23855,11176661,11194428,11195171,0,0,17767,18510
23856,11176687,11195171,11195272,0,0,18484,18585
23854,11176645,11194423,11195344,0,0,17778,18699
23727,11112509,11132405,11195377,0,0,19896,82868
23790,11163782,11195377,11195568,0,0,31595,31786
23803,11164967,11195568,11195573,0,0,30601,30606
23805,11165347,11195568,11196101,0,0,30221,30754
23801,11164911,11189658,11196243,0,0,24747,31332
23802,11164945,11190454,11197005,0,0,25509,32060
23871,11186117,11197005,11197373,0,0,10888,11256
23859,11177634,11192768,11197418,0,0,15134,19784
23877,11187239,11197418,11197798,0,0,10179,10559
23878,11188013,11197798,11197913,0,0,9785,9900
23873,11186218,11197373,11198270,0,0,11155,12052
23879,11190777,11197913,11198282,0,0,7136,7505
23824,11169356,11196101,11198345,0,0,26745,28989
23814,11166771,11195573,11198585,0,0,28802,31814
23880,11191577,11198270,11198743,0,0,6693,7166
23829,11170183,11198345,11199055,0,0,28162,28872
23834,11171015,11198585,11199062,0,0,27570,28047
23860,11177667,11194474,11199091,0,0,16807,21424
23838,11171469,11199055,11199193,0,0,27586,27724
23862,11178958,11195272,11199201,0,0,16314,20243
23839,11171475,11199062,11199252,0,0,27587,27777
23869,11183707,11196243,11199311,0,0,12536,15604
23866,11182842,11199311,11199667,0,0,16469,16825
23861,11177684,11195272,11199871,0,0,17588,22187
23868,11183441,11199667,11200718,0,0,16226,17277
23872,11186204,11197005,11200943,0,0,10801,14739
23865,11182681,11196243,11201549,0,0,13562,18868
23753,11156698,11195377,11201989,0,0,38679,45291
23843,11172118,11201989,11202123,0,0,29871,30005
23842,11171798,11183900,11202321,0,0,12102,30523
23840,11171778,11199193,11203132,0,0,27415,31354
23867,11183418,11202123,11203251,0,0,18705,19833
23876,11186923,11203251,11203290,0,0,16328,16367
23863,11181795,11195344,11203365,0,0,13549,21570
23882,11201214,11203290,11203416,0,0,2076,2202
23874,11186426,11200718,11204252,0,0,14292,17826
23875,11186747,11203132,11205142,0,0,16385,18395
23881,11195406,11198282,11206578,0,0,2876,11172
23848,11174789,11186795,11209852,0,0,12006,35063
23841,11171790,11192372,11211291,0,0,20582,39501
23864,11182223,11199252,11214064,0,0,17029,31841
23769,11160727,11205142,11216016,0,0,44415,55289
23747,11152789,11175148,11217334,0,0,22359,64545
23849,11174794,11188076,11228905,0,0,13282,54111
23794,11164180,11216016,11233778,0,0,51836,69598
23870,11184973,11233778,11241166,0,0,48805,56193
23883,11201444,11201444,11255360,0,0,0,53916
23884,11201463,11201549,11255400,0,0,86,53937
23887,11259931,11259931,11261175,0,0,0,1244
23889,11264133,11264133,11264215,0,0,0,82
23888,11262236,11262236,11265203,0,0,0,2967
23891,11266280,11266280,11266337,0,0,0,57
23892,11266435,11266435,11266518,0,0,0,83
23893,11267260,11267260,11267700,0,0,0,440
23894,11268129,11268129,11268207,0,0,0,78
23895,11269115,11269115,11273091,0,0,0,3976
23890,11265552,11265552,11274478,0,0,0,8926
23885,11256111,11256111,11279068,0,0,0,22957
23886,11256121,11256121,11286370,0,0,0,30249
23896,11271613,11271613,11288008,0,0,0,16395
23899,11291283,11291283,11291347,0,0,0,64
23900,11292064,11292064,11292147,0,0,0,83
23901,11292129,11292129,11292231,0,0,0,102
23902,11292672,11292672,11292747,0,0,0,75
23903,11293132,11293132,11293191,0,0,0,59
23904,11293636,11293636,11293699,0,0,0,63
23905,11293933,11293933,11293974,0,0,0,41
23906,11294101,11294101,11294153,0,0,0,52
23907,11294221,11294221,11294280,0,0,0,59
23909,11294502,11294502,11294561,0,0,0,59
23908,11294363,11294363,11295009,0,0,0,646
23910,11295247,11295247,11295325,0,0,0,78
23911,11297726,11297726,11299359,0,0,0,1633
23898,11289004,11289004,11305700,0,0,0,16696
23897,11286364,11286364,11338357,0,0,0,51993
23914,11342495,11342495,11342530,0,0,0,35
23915,11343415,11343415,11343451,0,0,0,36
23918,11345708,11345708,11345808,0,0,0,100
23919,11345815,11345815,11345932,0,0,0,117
23920,11346094,11346094,11347939,0,0,0,1845
23921,11346834,11347939,11348260,0,0,1105,1426
23924,11348094,11348094,11348796,0,0,0,702
23913,11341110,11341110,11348924,0,0,0,7814
23926,11349038,11349038,11349065,0,0,0,27
23927,11349056,11349065,11349122,0,0,9,66
23929,11349246,11349246,11349282,0,0,0,36
23923,11347932,11347939,11349587,0,0,7,1655
23930,11349431,11349431,11350114,0,0,0,683
23931,11349650,11349650,11350131,0,0,0,481
23934,11351932,11351932,11352481,0,0,0,549
23941,11353541,11353541,11354220,0,0,0,679
23935,11352123,11352123,11355577,0,0,0,3454
23938,11353264,11353264,11355941,0,0,0,2677
23942,11355728,11355728,11356639,0,0,0,911
23943,11356007,11356007,11356652,0,0,0,645
23944,11356664,11356664,11357016,0,0,0,352
23945,11356700,11356700,11357206,0,0,0,506
23947,11357115,11357115,11357602,0,0,0,487
23949,11357875,11357875,11358944,0,0,0,1069
23948,11357635,11357635,11359755,0,0,0,2120
23916,11343416,11343416,11360990,0,0,0,17574
23912,11339090,11339090,11361225,0,0,0,22135
23917,11345560,11361225,11361477,0,0,15665,15917
23922,11347063,11361477,11362151,0,0,14414,15088
23925,11348390,11362151,11362823,0,0,13761,14433
23928,11349166,11362823,11362886,0,0,13657,13720
23933,11351616,11362886,11363088,0,0,11270,11472
23951,11362518,11362518,11363118,0,0,0,600
23936,11352247,11363088,11363249,0,0,10841,11002
23937,11352453,11363249,11363340,0,0,10796,10887
23932,11351011,11351011,11364078,0,0,0,13067
23952,11363977,11363977,11365055,0,0,0,1078
23950,11361685,11361685,11367761,0,0,0,6076
23955,11370833,11370833,11370941,0,0,0,108
23956,11370960,11370960,11371362,0,0,0,402
23957,11372120,11372120,11372176,0,0,0,56
23959,11372262,11372262,11372407,0,0,0,145
23958,11372182,11372182,11373116,0,0,0,934
23960,11373297,11373297,11373520,0,0,0,223
23961,11373420,11373520,11373557,0,0,100,137
23962,11373764,11373764,11373816,0,0,0,52
23954,11370600,11370600,11373909,0,0,0,3309
23964,11374001,11374001,11374143,0,0,0,142
23965,11374236,11374236,11374278,0,0,0,42
23963,11373845,11373845,11374681,0,0,0,836
23967,11374991,11374991,11375031,0,0,0,40
23966,11374775,11374775,11375549,0,0,0,774
23968,11375591,11375591,11375673,0,0,0,82
23969,11375958,11375958,11376157,0,0,0,199
23971,11376385,11376385,11376653,0,0,0,268
23970,11376194,11376194,11376661,0,0,0,467
23972,11376846,11376846,11377024,0,0,0,178
23973,11377342,11377342,11377434,0,0,0,92
23974,11377497,11377497,11377605,0,0,0,108
23975,11377760,11377760,11377854,0,0,0,94
23976,11378343,11378343,11378493,0,0,0,150
23977,11378995,11378995,11379236,0,0,0,241
23939,11353471,11353471,11379286,0,0,0,25815
23978,11379967,11379967,11380117,0,0,0,150
23946,11357089,11363340,11381127,0,0,6251,24038
23979,11381035,11381035,11381134,0,0,0,99
23940,11353481,11353481,11381161,0,0,0,27680
23981,11381194,11381194,11381283,0,0,0,89
23982,11381403,11381403,11381484,0,0,0,81
23983,11381611,11381611,11381710,0,0,0,99
23984,11382509,11382509,11392878,0,0,0,10369
23953,11365176,11381127,11402260,0,0,15951,37084
23980,11381158,11381158,11404570,0,0,0,23412
23989,11412048,11412048,11412089,0,0,0,41
23985,11410275,11410275,11412963,0,0,0,2688
23993,11415344,11415344,11415722,0,0,0,378
23991,11412283,11412283,11416920,0,0,0,4637
23996,11415559,11416920,11416961,0,0,1361,1402
23998,11416650,11416961,11417662,0,0,311,1012
24001,11417187,11417662,11418068,0,0,475,881
24002,11417195,11418068,11418278,0,0,873,1083
23988,11411679,11411679,11418713,0,0,0,7034
23992,11414722,11416920,11419614,0,0,2198,4892
24004,11417710,11419614,11419640,0,0,1904,1930
24005,11418062,11419614,11419645,0,0,1552,1583
24006,11418276,11419640,11419676,0,0,1364,1400
24007,11418637,11419645,11419691,0,0,1008,1054
24012,11419050,11419691,11419728,0,0,641,678
24010,11418945,11419676,11419738,0,0,731,793
24016,11419449,11419738,11419771,0,0,289,322
24017,11419768,11419771,11419814,0,0,3,46
23994,11415421,11415722,11420132,0,0,301,4711
24018,11420098,11420098,11420208,0,0,0,110
24021,11420483,11420483,11420585,0,0,0,102
24022,11420774,11420774,11420823,0,0,0,49
24023,11421168,11421168,11421487,0,0,0,319
23999,11416993,11417662,11421886,0,0,669,4893
24025,11421763,11421763,11422049,0,0,0,286
24003,11417617,11418278,11422251,0,0,661,4634
24028,11422156,11422156,11422319,0,0,0,163
24030,11422514,11422514,11422542,0,0,0,28
24032,11422578,11422578,11422598,0,0,0,20
24033,11422626,11422626,11422645,0,0,0,19
24034,11422804,11422804,11422866,0,0,0,62
23997,11415594,11418713,11422891,0,0,3119,7297
24015,11419175,11419728,11423805,0,0,553,4630
24035,11423508,11423508,11423896,0,0,0,388
24038,11423825,11423896,11423919,0,0,71,94
24037,11423665,11423805,11424231,0,0,140,566
24039,11423868,11423919,11424255,0,0,51,387
24027,11421992,11421992,11424652,0,0,0,2660
24029,11422222,11422251,11424852,0,0,29,2630
24011,11419041,11424255,11424952,0,0,5214,5911
24000,11417177,11422891,11425011,0,0,5714,7834
23995,11415530,11418713,11425713,0,0,3183,10183
23990,11412271,11412963,11425730,0,0,692,13459
24008,11418696,11425730,11425794,0,0,7034,7098
24013,11419084,11425730,11427192,0,0,6646,8108
24042,11424544,11427192,11427429,0,0,2648,2885
24045,11424793,11427429,11427566,0,0,2636,2773
24047,11424902,11427566,11427586,0,0,2664,2684
24049,11424965,11427586,11427608,0,0,2621,2643
24046,11424811,11427429,11427628,0,0,2618,2817
24053,11425730,11427608,11427656,0,0,1878,1926
24054,11425797,11427628,11427658,0,0,1831,1861
24056,11426035,11427656,11427678,0,0,1621,1643
24062,11426450,11427678,11427708,0,0,1228,1258
24061,11426423,11427658,11427755,0,0,1235,1332
24064,11426741,11427755,11427823,0,0,1014,1082
24026,11421871,11425713,11428021,0,0,3842,6150
24048,11424950,11428021,11428055,0,0,3071,3105
24050,11425069,11428055,11428094,0,0,2986,3025
24055,11425815,11428094,11428147,0,0,2279,2332
24057,11426106,11428147,11428204,0,0,2041,2098
24043,11424581,11427192,11428388,0,0,2611,3807
24068,11427161,11428388,11428482,0,0,1227,1321
24070,11427592,11428482,11428501,0,0,890,909
24044,11424688,11427192,11428704,0,0,2504,4016
24067,11426858,11428204,11428886,0,0,1346,2028
24075,11428705,11428886,11428924,0,0,181,219
24065,11426771,11427823,11429056,0,0,1052,2285
24076,11429026,11429026,11429215,0,0,0,189
24071,11427623,11428501,11429335,0,0,878,1712
24041,11424446,11424852,11430167,0,0,406,5721
24082,11429921,11429921,11430183,0,0,0,262
24019,11420124,11420132,11430643,0,0,8,10519
24080,11429724,11429724,11430672,0,0,0,948
24051,11425195,11430672,11430756,0,0,5477,5561
24052,11425294,11430756,11430787,0,0,5462,5493
24058,11426121,11430787,11430827,0,0,4666,4706
24040,11424364,11424652,11430920,0,0,288,6556
24084,11430866,11430920,11430941,0,0,54,75
24066,11426849,11428204,11430999,0,0,1355,4150
24063,11426503,11427708,11431505,0,0,1205,5002
24086,11431105,11431105,11431541,0,0,0,436
24089,11431567,11431567,11431713,0,0,0,146
24091,11432278,11432278,11432301,0,0,0,23
24092,11432337,11432337,11432527,0,0,0,190
24094,11432654,11432654,11432680,0,0,0,26
24020,11420285,11425011,11432702,0,0,4726,12417
24083,11430365,11430365,11432715,0,0,0,2350
24077,11429299,11432715,11432786,0,0,3416,3487
24072,11427796,11428704,11433149,0,0,908,5353
24078,11429524,11432786,11433291,0,0,3262,3767
24031,11422561,11427192,11434405,0,0,4631,11844
24036,11423607,11425713,11434686,0,0,2106,11079
24098,11432827,11434686,11434702,0,0,1859,1875
24100,11434934,11434934,11434994,0,0,0,60
24085,11430994,11434405,11435434,0,0,3411,4440
24024,11421693,11424952,11435706,0,0,3259,14013
24101,11435719,11435719,11435833,0,0,0,114
24069,11427196,11432702,11435953,0,0,5506,8757
24088,11431470,11435953,11435987,0,0,4483,4517
24059,11426267,11430827,11436045,0,0,4560,9778
24093,11432560,11435987,11436169,0,0,3427,3609
24087,11431404,11435434,11436389,0,0,4030,4985
23986,11410714,11410714,11436562,0,0,0,25848
24095,11432735,11433149,11436823,0,0,414,4088
24107,11437044,11437044,11437069,0,0,0,25
24108,11437063,11437069,11437084,0,0,6,21
24014,11419104,11425794,11437143,0,0,6690,18039
24102,11436265,11436265,11437366,0,0,0,1101
24106,11436827,11437366,11437470,0,0,539,643
24110,11437091,11437091,11437706,0,0,0,615
24099,11433316,11435706,11437751,0,0,2390,4435
24109,11437072,11437470,11437850,0,0,398,778
24104,11436610,11436610,11437983,0,0,0,1373
24112,11437864,11437864,11438157,0,0,0,293
24081,11429783,11433291,11438552,0,0,3508,8769
24114,11438331,11438552,11438706,0,0,221,375
24116,11438721,11438721,11438850,0,0,0,129
24097,11432788,11434686,11439126,0,0,1898,6338
24115,11438390,11438390,11439153,0,0,0,763
24113,11438165,11438165,11439389,0,0,0,1224
24111,11437333,11437850,11439679,0,0,517,2346
24120,11439679,11439679,11439701,0,0,0,22
24121,11439745,11439745,11439808,0,0,0,63
24122,11439877,11439877,11439904,0,0,0,27
24125,11439995,11439995,11440024,0,0,0,29
24126,11440168,11440168,11440191,0,0,0,23
24117,11439175,11439175,11440389,0,0,0,1214
24128,11440444,11440444,11440469,0,0,0,25
24129,11440464,11440464,11440556,0,0,0,92
24096,11432759,11436045,11440583,0,0,3286,7824
24132,11440606,11440606,11440627,0,0,0,21
24118,11439329,11440583,11440770,0,0,1254,1441
24133,11440794,11440794,11440817,0,0,0,23
24124,11439936,11439936,11440833,0,0,0,897
24139,11441076,11441076,11441109,0,0,0,33
24131,11440591,11440591,11441222,0,0,0,631
24135,11440876,11441222,11441348,0,0,346,472
24123,11439926,11439926,11441350,0,0,0,1424
24141,11441457,11441457,11441480,0,0,0,23
24105,11436755,11436755,11442753,0,0,0,5998
24143,11441512,11442753,11443004,0,0,1241,1492
24144,11441690,11443004,11443015,0,0,1314,1325
24145,11441781,11443015,11443026,0,0,1234,1245
24146,11441912,11443026,11443040,0,0,1114,1128
24147,11442003,11443040,11443072,0,0,1037,1069
24148,11442073,11443072,11443106,0,0,999,1033
24149,11442200,11443106,11443118,0,0,906,918
24151,11442426,11443118,11443130,0,0,692,704
24103,11436581,11436581,11443159,0,0,0,6578
24152,11442455,11443130,11443309,0,0,675,854
24137,11441035,11443159,11443417,0,0,2124,2382
24154,11443106,11443309,11443446,0,0,203,340
24142,11441491,11441491,11443664,0,0,0,2173
23987,11410736,11410736,11443969,0,0,0,33233
24134,11440832,11440832,11444227,0,0,0,3395
24090,11432111,11437143,11444393,0,0,5032,12282
24150,11442289,11444393,11444463,0,0,2104,2174
24136,11440923,11441348,11444584,0,0,425,3661
24127,11440213,11440770,11444769,0,0,557,4556
24165,11444673,11444769,11444822,0,0,96,149
24159,11443965,11444584,11444854,0,0,619,889
24160,11444047,11444047,11445117,0,0,0,1070
24140,11441361,11444393,11445820,0,0,3032,4459
24153,11443063,11444463,11445857,0,0,1400,2794
24156,11443602,11443602,11445880,0,0,0,2278
24167,11446008,11446008,11446122,0,0,0,114
24164,11444304,11444769,11447022,0,0,465,2718
24163,11444287,11444769,11447046,0,0,482,2759
24170,11446460,11447046,11447150,0,0,586,690
24168,11446181,11446181,11447202,0,0,0,1021
24173,11446853,11447202,11447302,0,0,349,449
24119,11439502,11439502,11447310,0,0,0,7808
24172,11446829,11447202,11447775,0,0,373,946
24174,11447208,11447208,11447821,0,0,0,613
24171,11446736,11447150,11447825,0,0,414,1089
24162,11444225,11445820,11447843,0,0,1595,3618
24175,11447648,11447648,11448048,0,0,0,400
24138,11441053,11443417,11448131,0,0,2364,7078
24161,11444208,11444227,11448266,0,0,19,4058
24157,11443816,11443816,11448442,0,0,0,4626
24166,11445981,11445981,11448646,0,0,0,2665
24009,11418756,11447843,11449627,0,0,29087,30871
24155,11443167,11444769,11450275,0,0,1602,7108
24180,11448701,11450275,11450335,0,0,1574,1634
24130,11440589,11440589,11450494,0,0,0,9905
24169,11446305,11447022,11450954,0,0,717,4649
24178,11448506,11450954,11451249,0,0,2448,2743
24060,11426388,11449627,11451290,0,0,23239,24902
24181,11449284,11451249,11451498,0,0,1965,2214
24182,11449804,11451498,11451748,0,0,1694,1944
24179,11448689,11448689,11452051,0,0,0,3362
24158,11443859,11443969,11454279,0,0,110,10420
24183,11452058,11452058,11455426,0,0,0,3368
24185,11455421,11455421,11455444,0,0,0,23
24186,11455564,11455564,11455579,0,0,0,15
24187,11455679,11455679,11455693,0,0,0,14
24188,11457043,11457043,11457122,0,0,0,79
24177,11448127,11448131,11457276,0,0,4,9149
24189,11457261,11457261,11457342,0,0,0,81
24176,11448113,11448113,11457437,0,0,0,9324
24191,11457543,11457543,11457563,0,0,0,20
24192,11457696,11457696,11457710,0,0,0,14
24193,11457708,11457708,11457774,0,0,0,66
24194,11457900,11457900,11458128,0,0,0,228
24195,11458291,11458291,11458327,0,0,0,36
24198,11460040,11460040,11460771,0,0,0,731
24200,11460248,11460771,11460834,0,0,523,586
24199,11460089,11460771,11460850,0,0,682,761
24197,11459238,11459238,11461962,0,0,0,2724
24073,11428027,11451290,11464039,0,0,23263,36012
24074,11428323,11464039,11464282,0,0,35716,35959
24202,11471763,11471763,11473746,0,0,0,1983
24079,11429568,11464282,11473837,0,0,34714,44269
24196,11458946,11458946,11474717,0,0,0,15771
24184,11452568,11452568,11475500,0,0,0,22932
24190,11457441,11457441,11479969,0,0,0,22528
24201,11460618,11473837,11490253,0,0,13219,29635
24209,11497788,11497788,11498583,0,0,0,795
24210,11498128,11498128,11501534,0,0,0,3406
24214,11499575,11501534,11501573,0,0,1959,1998
24217,11501720,11501720,11501974,0,0,0,254
24218,11502195,11502195,11502435,0,0,0,240
24220,11503342,11503342,11503426,0,0,0,84
24205,11494933,11494933,11503593,0,0,0,8660
24204,11494917,11494917,11503594,0,0,0,8677
24212,11498731,11501534,11505502,0,0,2803,6771
24219,11502784,11502784,11507163,0,0,0,4379
24203,11479965,11479965,11507233,0,0,0,27268
24224,11504031,11507163,11507284,0,0,3132,3253
24230,11504590,11507284,11508978,0,0,2694,4388
24211,11498571,11498583,11510833,0,0,12,12262
24229,11504381,11507233,11511608,0,0,2852,7227
24233,11506788,11511608,11511655,0,0,4820,4867
24235,11507557,11511655,11511689,0,0,4098,4132
24236,11507622,11511689,11511837,0,0,4067,4215
24238,11508056,11511837,11512478,0,0,3781,4422
24239,11508666,11512478,11512507,0,0,3812,3841
24213,11498781,11503594,11513327,0,0,4813,14546
24232,11505674,11508978,11513389,0,0,3304,7715
24242,11508894,11513389,11513415,0,0,4495,4521
24240,11508780,11512507,11514521,0,0,3727,5741
24244,11509156,11514521,11514547,0,0,5365,5391
24245,11509272,11514547,11514599,0,0,5275,5327
24246,11509338,11514599,11514629,0,0,5261,5291
24222,11503991,11505502,11515579,0,0,1511,11588
24207,11497145,11497145,11515996,0,0,0,18851
24243,11508990,11513415,11516317,0,0,4425,7327
24250,11510270,11516317,11516390,0,0,6047,6120
24254,11511011,11516390,11516761,0,0,5379,5750
24264,11515459,11516761,11517473,0,0,1302,2014
24216,11501280,11513327,11518350,0,0,12047,17070
24221,11503938,11518350,11518478,0,0,14412,14540
24227,11504286,11518478,11518793,0,0,14192,14507
24215,11499785,11510833,11522121,0,0,11048,22336
24225,11504109,11522121,11522159,0,0,18012,18050
24228,11504308,11522159,11522857,0,0,17851,18549
24226,11504172,11522121,11522897,0,0,17949,18725
24237,11507682,11522857,11522936,0,0,15175,15254
24234,11506888,11522857,11522942,0,0,15969,16054
24247,11509375,11514629,11523000,0,0,5254,13625
24255,11511440,11522942,11523031,0,0,11502,11591
24252,11510460,11522936,11523041,0,0,12476,12581
24257,11512721,11523041,11523116,0,0,10320,10395
24256,11512380,11523031,11523124,0,0,10651,10744
24258,11513212,11523116,11523202,0,0,9904,9990
24259,11513574,11523124,11523238,0,0,9550,9664
24260,11513796,11523202,11523287,0,0,9406,9491
24261,11514180,11523238,11523303,0,0,9058,9123
24262,11514482,11523287,11523341,0,0,8805,8859
24263,11514942,11523303,11523590,0,0,8361,8648
24273,11517254,11523590,11523933,0,0,6336,6679
24269,11516349,11523590,11523936,0,0,7241,7587
24241,11508851,11522897,11523980,0,0,14046,15129
24267,11516173,11517473,11524196,0,0,1300,8023
24281,11518203,11524196,11524297,0,0,5993,6094
24282,11518286,11524297,11524313,0,0,6011,6027
24280,11518146,11523936,11524384,0,0,5790,6238
24284,11518386,11524384,11524427,0,0,5998,6041
24283,11518297,11524313,11524929,0,0,6016,6632
24249,11510252,11515579,11525235,0,0,5327,14983
24289,11519398,11524929,11525411,0,0,5531,6013
24291,11520058,11525411,11525442,0,0,5353,5384
24290,11519973,11525235,11525706,0,0,5262,5733
24206,11496705,11496705,11525792,0,0,0,29087
24295,11520502,11525706,11526092,0,0,5204,5590
24297,11521487,11526092,11526139,0,0,4605,4652
24296,11521465,11525792,11526384,0,0,4327,4919
24298,11521506,11526139,11526830,0,0,4633,5324
24300,11521599,11526830,11526862,0,0,5231,5263
24301,11521602,11526862,11526891,0,0,5260,5289
24302,11521903,11526891,11526936,0,0,4988,5033
24299,11521530,11526384,11527685,0,0,4854,6155
24304,11522208,11527685,11527728,0,0,5477,5520
24306,11522850,11527728,11527765,0,0,4878,4915
24309,11523298,11527765,11527797,0,0,4467,4499
24310,11523592,11527797,11527820,0,0,4205,4228
24311,11524763,11527820,11528057,0,0,3057,3294
24279,11517861,11523933,11528269,0,0,6072,10408
24323,11526622,11528269,11528294,0,0,1647,1672
24285,11518394,11524427,11528401,0,0,6033,10007
24223,11504007,11518350,11528411,0,0,14343,24404
24322,11526452,11528057,11528469,0,0,1605,2017
24248,11509647,11523980,11528798,0,0,14333,19151
24327,11527791,11528401,11528883,0,0,610,1092
24325,11527254,11528294,11529008,0,0,1040,1754
24292,11520104,11528411,11529062,0,0,8307,8958
24338,11528616,11528616,11529296,0,0,0,680
24251,11510405,11528798,11529890,0,0,18393,19485
24303,11522133,11526936,11530603,0,0,4803,8470
24293,11520189,11525442,11530980,0,0,5253,10791
24350,11529461,11530980,11531222,0,0,1519,1761
24348,11529247,11530603,11531436,0,0,1356,2189
24307,11522872,11529008,11531789,0,0,6136,8917
24314,11526078,11531789,11531830,0,0,5711,5752
24308,11523128,11529062,11532273,0,0,5934,9145
24268,11516176,11523000,11532623,0,0,6824,16447
24355,11529676,11532623,11532807,0,0,2947,3131
24266,11516055,11523341,11532949,0,0,7286,16894
24362,11530517,11532807,11533566,0,0,2290,3049
24320,11526364,11532273,11533756,0,0,5909,7392
24329,11527924,11533756,11533774,0,0,5832,5850
24346,11529127,11529296,11534019,0,0,169,4892
24324,11526640,11532949,11534252,0,0,6309,7612
24330,11528051,11533774,11534349,0,0,5723,6298
24334,11528532,11534349,11534369,0,0,5817,5837
24335,11528538,11534369,11534389,0,0,5831,5851
24336,11528581,11534389,11534408,0,0,5808,5827
24339,11528750,11534408,11534428,0,0,5658,5678
24340,11528801,11534428,11534468,0,0,5627,5667
24342,11528871,11534468,11534505,0,0,5597,5634
24343,11528926,11534505,11534595,0,0,5579,5669
24344,11529015,11534595,11534655,0,0,5580,5640
24345,11529074,11534655,11534693,0,0,5581,5619
24347,11529177,11534693,11534762,0,0,5516,5585
24208,11497163,11515996,11534828,0,0,18833,37665
24349,11529367,11534762,11534833,0,0,5395,5466
24272,11516625,11534828,11534847,0,0,18203,18222
24271,11516599,11534828,11534849,0,0,18229,18250
24270,11516564,11534828,11534854,0,0,18264,18290
24275,11517336,11534849,11534859,0,0,17513,17523
24274,11517316,11534847,11534862,0,0,17531,17546
24351,11529527,11534833,11534902,0,0,5306,5375
24286,11518928,11534862,11534946,0,0,15934,16018
24356,11529851,11534902,11534972,0,0,5051,5121
24359,11529988,11534972,11535031,0,0,4984,5043
24363,11530640,11535031,11535077,0,0,4391,4437
24364,11530753,11535077,11535113,0,0,4324,4360
24287,11519071,11534946,11535146,0,0,15875,16075
24253,11510867,11529890,11535221,0,0,19023,24354
24312,11525600,11535221,11535242,0,0,9621,9642
24313,11526071,11535242,11535255,0,0,9171,9184
24315,11526090,11535255,11535270,0,0,9165,9180
24365,11530913,11535113,11535278,0,0,4200,4365
24316,11526113,11535270,11535283,0,0,9157,9170
24317,11526132,11535283,11535298,0,0,9151,9166
24318,11526137,11535298,11535973,0,0,9161,9836
24331,11528290,11534252,11536028,0,0,5962,7738
24374,11532792,11536028,11536104,0,0,3236,3312
24319,11526178,11531830,11536168,0,0,5652,9990
24373,11532467,11536028,11536215,0,0,3561,3748
24375,11533410,11536104,11536421,0,0,2694,3011
24378,11534735,11536215,11536527,0,0,1480,1792
24377,11533759,11536168,11536726,0,0,2409,2967
24370,11531466,11535278,11537674,0,0,3812,6208
24328,11527802,11537674,11537686,0,0,9872,9884
24326,11527755,11535973,11538013,0,0,8218,10258
24337,11528611,11538013,11538221,0,0,9402,9610
24352,11529555,11531222,11538739,0,0,1667,9184
24278,11517719,11534859,11539031,0,0,17140,21312
24341,11528848,11538221,11539188,0,0,9373,10340
24231,11505208,11518793,11539245,0,0,13585,34037
24354,11529590,11539031,11539607,0,0,9441,10017
24353,11529575,11531436,11539869,0,0,1861,10294
24332,11528326,11537686,11540169,0,0,9360,11843
24294,11520220,11535146,11540516,0,0,14926,20296
24380,11535035,11536421,11542348,0,0,1386,7313
24276,11517392,11534854,11543055,0,0,17462,25663
24376,11533503,11536168,11543626,0,0,2665,10123
24381,11536790,11539869,11543715,0,0,3079,6925
24384,11542428,11543055,11543784,0,0,627,1356
24386,11543795,11543795,11543907,0,0,0,112
24387,11543802,11543802,11544302,0,0,0,500
24265,11516055,11534828,11544370,0,0,18773,28315
24389,11544101,11544302,11545858,0,0,201,1757
24358,11529937,11539188,11546033,0,0,9251,16096
24360,11530358,11539607,11547059,0,0,9249,16701
24383,11540646,11540646,11547328,0,0,0,6682
24333,11528335,11547059,11548301,0,0,18724,19966
24388,11543892,11543892,11548492,0,0,0,4600
24305,11522326,11545858,11549056,0,0,23532,26730
24385,11543223,11543626,11550928,0,0,403,7705
24367,11531124,11533566,11559039,0,0,2442,27915
24391,11547013,11547013,11560094,0,0,0,13081
24393,11560061,11560061,11560199,0,0,0,138
24394,11560381,11560381,11560520,0,0,0,139
24395,11560955,11560955,11561040,0,0,0,85
24368,11531137,11534019,11561793,0,0,2882,30656
24372,11532250,11548301,11562211,0,0,16051,29961
24382,11540467,11540467,11562792,0,0,0,22325
24390,11546062,11549056,11565496,0,0,2994,19434
24277,11517403,11562211,11570240,0,0,44808,52837
24288,11519212,11570240,11570435,0,0,51028,51223
24321,11526381,11570435,11571364,0,0,44054,44983
24357,11529858,11571364,11571573,0,0,41506,41715
24361,11530453,11571573,11572041,0,0,41120,41588
24366,11530984,11572041,11572298,0,0,41057,41314
24369,11531237,11572298,11573724,0,0,41061,42487
24392,11558906,11558906,11582741,0,0,0,23835
24397,11583146,11583146,11583170,0,0,0,24
24399,11584531,11584531,11584557,0,0,0,26
24398,11584244,11584244,11585012,0,0,0,768
24403,11585731,11585731,11585789,0,0,0,58
24408,11587810,11587810,11588372,0,0,0,562
24400,11585349,11585349,11588438,0,0,0,3089
24410,11589021,11589021,11589420,0,0,0,399
24371,11531914,11573724,11590322,0,0,41810,58408
24406,11586078,11586078,11590699,0,0,0,4621
24405,11585986,11585986,11590706,0,0,0,4720
24407,11586830,11586830,11592369,0,0,0,5539
24409,11587848,11592369,11596846,0,0,4521,8998
24404,11585793,11585793,11597071,0,0,0,11278
24417,11591164,11597071,11597178,0,0,5907,6014
24414,11589591,11589591,11597288,0,0,0,7697
24418,11591729,11597178,11597436,0,0,5449,5707
24419,11591875,11597436,11597761,0,0,5561,5886
24413,11589556,11589556,11597884,0,0,0,8328
24430,11594988,11597884,11598057,0,0,2896,3069
24433,11595166,11598057,11598161,0,0,2891,2995
24436,11595430,11598161,11598195,0,0,2731,2765
24439,11596083,11598195,11599227,0,0,2112,3144
24443,11597139,11599227,11599245,0,0,2088,2106
24416,11591003,11597071,11600542,0,0,6068,9539
24412,11589496,11596846,11600547,0,0,7350,11051
24424,11594407,11600547,11600567,0,0,6140,6160
24425,11594508,11600547,11600583,0,0,6039,6075
24427,11594771,11600583,11600603,0,0,5812,5832
24426,11594541,11600567,11600606,0,0,6026,6065
24428,11594803,11600603,11600669,0,0,5800,5866
24432,11595159,11600606,11600676,0,0,5447,5517
24435,11595429,11600676,11600712,0,0,5247,5283
24434,11595304,11600669,11600716,0,0,5365,5412
24423,11594397,11597288,11600837,0,0,2891,6440
24422,11593323,11600542,11601180,0,0,7219,7857
24442,11597079,11601180,11601372,0,0,4101,4293
24421,11592469,11600542,11601401,0,0,8073,8932
24444,11597171,11599245,11601642,0,0,2074,4471
24446,11597508,11601372,11601742,0,0,3864,4234
24449,11598018,11601642,11601838,0,0,3624,3820
24454,11599914,11601742,11601955,0,0,1828,2041
24437,11595542,11600712,11601982,0,0,5170,6440
24457,11602160,11602160,11602530,0,0,0,370
24458,11602235,11602530,11602858,0,0,295,623
24460,11602770,11602858,11603068,0,0,88,298
24447,11597696,11601401,11603333,0,0,3705,5637
24440,11596195,11600716,11604103,0,0,4521,7908
24451,11598447,11601982,11604650,0,0,3535,6203
24429,11594859,11604650,11604732,0,0,9791,9873
24465,11604509,11604509,11604961,0,0,0,452
24471,11605129,11605129,11605576,0,0,0,447
24462,11602999,11603068,11607557,0,0,69,4558
24467,11604810,11607557,11607645,0,0,2747,2835
24420,11591966,11597761,11608043,0,0,5795,16077
24472,11605589,11607645,11609521,0,0,2056,3932
24448,11597902,11601372,11610912,0,0,3470,13010
24445,11597288,11600837,11611384,0,0,3549,14096
24484,11608547,11611384,11611637,0,0,2837,3090
24411,11589035,11589035,11611969,0,0,0,22934
24463,11603371,11603371,11612035,0,0,0,8664
24396,11582738,11582738,11612037,0,0,0,29299
24455,11600610,11601838,11613265,0,0,1228,12655
24479,11607810,11609521,11613613,0,0,1711,5803
24494,11612821,11613613,11613646,0,0,792,825
24490,11612502,11613613,11613648,0,0,1111,1146
24488,11609706,11612037,11614298,0,0,2331,4592
24503,11614195,11614298,11614316,0,0,103,121
24500,11613614,11613648,11614626,0,0,34,1012
24481,11607921,11610912,11614959,0,0,2991,7038
24485,11608613,11611637,11614991,0,0,3024,6378
24508,11614986,11614991,11615034,0,0,5,48
24487,11609005,11612035,11615066,0,0,3030,6061
24486,11608860,11611969,11615077,0,0,3109,6217
24509,11615094,11615094,11615254,0,0,0,160
24489,11612045,11613265,11615460,0,0,1220,3415
24431,11595048,11604732,11615868,0,0,9684,20820
24492,11612575,11615066,11616075,0,0,2491,3500
24495,11612864,11616075,11616388,0,0,3211,3524
24505,11614404,11614626,11616447,0,0,222,2043
24493,11612749,11615460,11616642,0,0,2711,3893
24499,11613608,11616642,11617738,0,0,3034,4130
24513,11617512,11617738,11617832,0,0,226,320
24514,11617876,11617876,11617930,0,0,0,54
24512,11617409,11617738,11618115,0,0,329,706
24515,11618201,11618201,11618261,0,0,0,60
24438,11595731,11608043,11618604,0,0,12312,22873
24518,11618603,11618603,11618618,0,0,0,15
24496,11613265,11616388,11618635,0,0,3123,5370
24519,11618626,11618626,11618851,0,0,0,225
24452,11598726,11618851,11618871,0,0,20125,20145
24498,11613364,11613646,11619358,0,0,282,5994
24504,11614336,11614336,11619392,0,0,0,5056
24379,11534944,11590322,11619915,0,0,55378,84971
24401,11585645,11619915,11619969,0,0,34270,34324
24523,11620101,11620101,11620116,0,0,0,15
24524,11620195,11620195,11620207,0,0,0,12
24441,11597061,11615868,11620272,0,0,18807,23211
24461,11602859,11620272,11620314,0,0,17413,17455
24466,11604560,11620314,11620585,0,0,15754,16025
24473,11606660,11620585,11620607,0,0,13925,13947
24474,11606805,11620607,11620653,0,0,13802,13848
24506,11614616,11614959,11620745,0,0,343,6129
24526,11620758,11620758,11620803,0,0,0,45
24528,11620862,11620862,11620915,0,0,0,53
24475,11606852,11620653,11620937,0,0,13801,14085
24529,11621488,11621488,11621551,0,0,0,63
24530,11621939,11621939,11622105,0,0,0,166
24453,11599064,11618871,11622126,0,0,19807,23062
24531,11622143,11622143,11622250,0,0,0,107
24532,11622472,11622472,11622737,0,0,0,265
24525,11620494,11620494,11622753,0,0,0,2259
24522,11619597,11619597,11622984,0,0,0,3387
24533,11623403,11623403,11623465,0,0,0,62
24534,11623931,11623931,11624110,0,0,0,179
24536,11624452,11624452,11624505,0,0,0,53
24402,11585681,11619969,11624579,0,0,34288,38898
24510,11616077,11616447,11624781,0,0,370,8704
24476,11607354,11620937,11625420,0,0,13583,18066
24450,11598031,11618604,11625432,0,0,20573,27401
24480,11607912,11625420,11625787,0,0,17508,17875
24477,11607481,11622126,11626481,0,0,14645,19000
24507,11614813,11625787,11627400,0,0,10974,12587
24478,11607630,11624781,11628985,0,0,17151,21355
24520,11618813,11626481,11631982,0,0,7668,13169
24538,11625168,11631982,11632024,0,0,6814,6856
24539,11625348,11631982,11632027,0,0,6634,6679
24540,11625464,11631982,11632049,0,0,6518,6585
24541,11625592,11632024,11632071,0,0,6432,6479
24544,11627125,11632049,11632104,0,0,4924,4979
24537,11624848,11631982,11632186,0,0,7134,7338
24543,11625993,11632027,11632536,0,0,6034,6543
24550,11631134,11632104,11632967,0,0,970,1833
24548,11629356,11632071,11633768,0,0,2715,4412
24551,11631561,11632186,11633779,0,0,625,2218
24535,11624323,11628985,11633823,0,0,4662,9500
24554,11632283,11633768,11633828,0,0,1485,1545
24527,11620855,11627400,11633861,0,0,6545,13006
24556,11632601,11633823,11633928,0,0,1222,1327
24502,11614019,11625432,11634803,0,0,11413,20784
24545,11628186,11633861,11635391,0,0,5675,7205
24559,11635361,11635361,11635677,0,0,0,316
24552,11632025,11632536,11636507,0,0,511,4482
24553,11632120,11632967,11636948,0,0,847,4828
24415,11590762,11624579,11636972,0,0,33817,46210
24561,11635990,11636507,11637091,0,0,517,1101
24563,11636870,11636948,11637159,0,0,78,289
24564,11637121,11637121,11637235,0,0,0,114
24566,11637466,11637466,11637683,0,0,0,217
24555,11632505,11633779,11637736,0,0,1274,5231
24456,11601311,11636972,11637955,0,0,35661,36644
24568,11637853,11637853,11638286,0,0,0,433
24569,11638451,11638451,11638908,0,0,0,457
24459,11602287,11636972,11639469,0,0,34685,37182
24469,11604885,11637955,11639739,0,0,33070,34854
24570,11639372,11639372,11639807,0,0,0,435
24542,11625632,11633823,11640142,0,0,8191,14510
24470,11604939,11639469,11640915,0,0,34530,35976
24565,11637401,11637401,11641067,0,0,0,3666
24567,11637575,11637575,11641240,0,0,0,3665
24558,11633498,11633828,11641282,0,0,330,7784
24491,11612547,11640915,11641654,0,0,28368,29107
24571,11640347,11641067,11642110,0,0,720,1763
24572,11640492,11641240,11642899,0,0,748,2407
24483,11608442,11639739,11643067,0,0,31297,34625
24573,11640811,11641282,11643092,0,0,471,2281
24501,11613758,11643067,11643157,0,0,29309,29399
24546,11629174,11634803,11643257,0,0,5629,14083
24497,11613272,11641654,11643503,0,0,28382,30231
24511,11616633,11643157,11643629,0,0,26524,26996
24547,11629177,11635391,11643835,0,0,6214,14658
24549,11630295,11643503,11646690,0,0,13208,16395
24557,11632925,11640142,11648768,0,0,7217,15843
24464,11603631,11648768,11649514,0,0,45137,45883
24468,11604817,11649514,11656380,0,0,44697,51563
24517,11618564,11643257,11657338,0,0,24693,38774
24560,11635808,11643629,11658989,0,0,7821,23181
24516,11618418,11658989,11659749,0,0,40571,41331
24482,11608337,11656380,11663110,0,0,48043,54773
24562,11636501,11663110,11676590,0,0,26609,40089
24574,11645949,11676590,11681428,0,0,30641,35479
24521,11619433,11659749,11684154,0,0,40316,64721
24583,11684455,11684455,11684574,0,0,0,119
24579,11682432,11684154,11684623,0,0,1722,2191
24575,11670371,11681428,11687190,0,0,11057,16819
24576,11678941,11681428,11689663,0,0,2487,10722
24577,11679666,11681428,11689801,0,0,1762,10135
24578,11681861,11681861,11690196,0,0,0,8335
24581,11682885,11682885,11691400,0,0,0,8515
24582,11683862,11683862,11692178,0,0,0,8316
24580,11682823,11684623,11692728,0,0,1800,9905
24585,11684960,11692728,11693565,0,0,7768,8605
24588,11692354,11693565,11693659,0,0,1211,1305
24595,11693521,11693659,11693707,0,0,138,186
24586,11690643,11693565,11693868,0,0,2922,3225
24590,11693101,11693101,11693948,0,0,0,847
24596,11693563,11693659,11694237,0,0,96,674
24597,11693871,11693871,11694256,0,0,0,385
24591,11693330,11693330,11694511,0,0,0,1181
24594,11693477,11693659,11694666,0,0,182,1189
24593,11693461,11693659,11694709,0,0,198,1248
24600,11694787,11694787,11694823,0,0,0,36
24599,11694375,11694375,11694979,0,0,0,604
24601,11694915,11694915,11695072,0,0,0,157
24602,11695107,11695107,11695265,0,0,0,158
24603,11695296,11695296,11695372,0,0,0,76
24605,11695521,11695521,11695646,0,0,0,125
24607,11695731,11695731,11695770,0,0,0,39
24608,11695778,11695778,11695913,0,0,0,135
24606,11695662,11695662,11695915,0,0,0,253
24604,11695495,11695495,11696261,0,0,0,766
24589,11693064,11693064,11697032,0,0,0,3968
24584,11684804,11689663,11697759,0,0,4859,12955
24592,11693449,11697032,11698612,0,0,3583,5163
24610,11699048,11699048,11699549,0,0,0,501
24613,11699302,11699302,11699864,0,0,0,562
24615,11699735,11699735,11700678,0,0,0,943
24617,11700395,11700395,11700976,0,0,0,581
24620,11703254,11703254,11703419,0,0,0,165
24587,11692042,11692042,11703545,0,0,0,11503
24621,11703429,11703429,11703630,0,0,0,201
24611,11699226,11703630,11703654,0,0,4404,4428
24612,11699233,11703654,11703801,0,0,4421,4568
24598,11694215,11694215,11704683,0,0,0,10468
24623,11703970,11704683,11704746,0,0,713,776
24616,11700139,11700139,11706544,0,0,0,6405
24628,11704585,11706544,11706556,0,0,1959,1971
24630,11704945,11706556,11706570,0,0,1611,1625
24625,11704214,11706544,11706578,0,0,2330,2364
24626,11704372,11706544,11706611,0,0,2172,2239
24632,11706046,11706578,11706693,0,0,532,647
24631,11705745,11706570,11706708,0,0,825,963
24635,11706254,11706611,11706732,0,0,357,478
24627,11704385,11706544,11706988,0,0,2159,2603
24609,11696106,11698612,11711239,0,0,2506,15133
24629,11704696,11706988,11719599,0,0,2292,14903
24633,11706104,11719599,11722667,0,0,13495,16563
24614,11699406,11703801,11727901,0,0,4395,28495
24636,11707052,11727901,11728845,0,0,20849,21793
24618,11701572,11711239,11729042,0,0,9667,27470
24640,11710818,11728845,11729237,0,0,18027,18419
24637,11707697,11727901,11729705,0,0,20204,22008
24641,11711843,11727901,11731725,0,0,16058,19882
24642,11713559,11729237,11736925,0,0,15678,23366
24643,11715693,11731725,11736991,0,0,16032,21298
24649,11729449,11736991,11737017,0,0,7542,7568
24650,11729577,11737017,11737039,0,0,7440,7462
24651,11729859,11737039,11737055,0,0,7180,7196
24652,11730062,11737055,11737066,0,0,6993,7004
24653,11730338,11737066,11737079,0,0,6728,6741
24654,11730464,11737079,11737093,0,0,6615,6629
24655,11731583,11737093,11737472,0,0,5510,5889
24657,11732104,11737472,11737486,0,0,5368,5382
24646,11721483,11736925,11737605,0,0,15442,16122
24645,11721423,11736925,11737618,0,0,15502,16195
24658,11733372,11737486,11738519,0,0,4114,5147
24639,11709713,11727901,11739024,0,0,18188,29311
24624,11704068,11704746,11739215,0,0,678,35147
24659,11733620,11737605,11744049,0,0,3985,10429
24644,11717315,11739215,11745857,0,0,21900,28542
24660,11738367,11745857,11745915,0,0,7490,7548
24661,11738673,11745915,11747139,0,0,7242,8466
24662,11740333,11747139,11748355,0,0,6806,8022
24656,11732091,11744049,11751395,0,0,11958,19304
24619,11702323,11729042,11751671,0,0,26719,49348
24638,11708395,11729705,11753376,0,0,21310,44981
24663,11754019,11754019,11754108,0,0,0,89
24664,11754073,11754073,11754407,0,0,0,334
24634,11706183,11722667,11754856,0,0,16484,48673
24622,11703835,11751671,11756571,0,0,47836,52736
24669,11756487,11756487,11756699,0,0,0,212
24670,11757138,11757138,11757494,0,0,0,356
24665,11754145,11754145,11757915,0,0,0,3770
24672,11757965,11757965,11758371,0,0,0,406
24667,11755476,11755476,11758695,0,0,0,3219
24673,11759066,11759066,11759692,0,0,0,626
24674,11759721,11759721,11759764,0,0,0,43
24678,11760474,11760474,11760537,0,0,0,63
24676,11760154,11760154,11760890,0,0,0,736
24677,11760408,11760408,11760890,0,0,0,482
24680,11760665,11760890,11760977,0,0,225,312
24675,11760070,11760070,11761473,0,0,0,1403
24671,11757721,11757721,11761725,0,0,0,4004
24681,11760707,11761725,11761863,0,0,1018,1156
24683,11762450,11762450,11762573,0,0,0,123
24684,11762504,11762504,11762578,0,0,0,74
24682,11762280,11762280,11762759,0,0,0,479
24687,11762894,11762894,11762966,0,0,0,72
24688,11763147,11763147,11763501,0,0,0,354
24685,11762592,11762592,11763832,0,0,0,1240
24686,11762804,11762804,11763860,0,0,0,1056
24693,11764062,11764062,11764454,0,0,0,392
24691,11763649,11763832,11764716,0,0,183,1067
24679,11760602,11760602,11765262,0,0,0,4660
24695,11764341,11764716,11765439,0,0,375,1098
24647,11723062,11751395,11765500,0,0,28333,42438
24696,11764464,11765439,11765501,0,0,975,1037
24698,11765095,11765501,11765569,0,0,406,474
24694,11764229,11764454,11765692,0,0,225,1463
24701,11765444,11765692,11765875,0,0,248,431
24699,11765399,11765569,11765888,0,0,170,489
24702,11765555,11765875,11766222,0,0,320,667
24703,11765704,11766222,11766942,0,0,518,1238
24690,11763432,11765262,11767966,0,0,1830,4534
24689,11763319,11763501,11769614,0,0,182,6295
24705,11768693,11769614,11769834,0,0,921,1141
24706,11770319,11770319,11770397,0,0,0,78
24666,11755450,11756571,11770421,0,0,1121,14971
24707,11770580,11770580,11770642,0,0,0,62
24700,11765441,11767966,11771464,0,0,2525,6023
24708,11770701,11770701,11771789,0,0,0,1088
24709,11770907,11770907,11771908,0,0,0,1001
24710,11770907,11770907,11771909,0,0,0,1002
24714,11772019,11772019,11772090,0,0,0,71
24717,11772458,11772458,11772528,0,0,0,70
24719,11772562,11772562,11772652,0,0,0,90
24712,11771789,11771789,11772656,0,0,0,867
24648,11728676,11756571,11772897,0,0,27895,44221
24724,11772911,11772911,11773026,0,0,0,115
24725,11773099,11773099,11773115,0,0,0,16
24721,11772655,11772655,11773333,0,0,0,678
24729,11773545,11773545,11773574,0,0,0,29
24728,11773474,11773474,11773581,0,0,0,107
24697,11765017,11765500,11773845,0,0,483,8828
24723,11772855,11773845,11773880,0,0,990,1025
24722,11772673,11772673,11773917,0,0,0,1244
24726,11773283,11773283,11773986,0,0,0,703
24730,11773981,11773981,11773998,0,0,0,17
24715,11772290,11772290,11774161,0,0,0,1871
24727,11773333,11773333,11774302,0,0,0,969
24735,11775008,11775008,11775027,0,0,0,19
24736,11775590,11775590,11775667,0,0,0,77
24738,11776964,11776964,11776980,0,0,0,16
24713,11771970,11771970,11779196,0,0,0,7226
24711,11771713,11771713,11779257,0,0,0,7544
24716,11772290,11772290,11779262,0,0,0,6972
24718,11772517,11772517,11779312,0,0,0,6795
24731,11774152,11774152,11779313,0,0,0,5161
24734,11774777,11779196,11779421,0,0,4419,4644
24732,11774302,11774302,11779428,0,0,0,5126
24737,11775820,11779257,11779453,0,0,3437,3633
24720,11772588,11772897,11779504,0,0,309,6916
24739,11777871,11779312,11779528,0,0,1441,1657
24741,11779202,11779453,11779534,0,0,251,332
24746,11779825,11779825,11779965,0,0,0,140
24750,11780325,11780325,11780403,0,0,0,78
24752,11780580,11780580,11780604,0,0,0,24
24742,11779534,11779534,11780605,0,0,0,1071
24754,11780645,11780645,11780749,0,0,0,104
24755,11780853,11780853,11780922,0,0,0,69
24756,11781008,11781008,11781054,0,0,0,46
24757,11781089,11781089,11781159,0,0,0,70
24759,11781260,11781260,11781345,0,0,0,85
24753,11780604,11780604,11781492,0,0,0,888
24761,11781490,11781490,11781512,0,0,0,22
24758,11781166,11781166,11781513,0,0,0,347
24763,11781601,11781601,11781706,0,0,0,105
24766,11781805,11781805,11781916,0,0,0,111
24668,11756249,11774161,11781972,0,0,17912,25723
24743,11779698,11779698,11781978,0,0,0,2280
24767,11781923,11781923,11782046,0,0,0,123
24762,11781492,11781492,11782160,0,0,0,668
24769,11782160,11782160,11783203,0,0,0,1043
24760,11781362,11781362,11783401,0,0,0,2039
24773,11782371,11783401,11783558,0,0,1030,1187
24774,11782511,11783558,11783677,0,0,1047,1166
24770,11782266,11782266,11783750,0,0,0,1484
24772,11782291,11783203,11783831,0,0,912,1540
24775,11782704,11783677,11783892,0,0,973,1188
24777,11782803,11783750,11783962,0,0,947,1159
24780,11783203,11783962,11784846,0,0,759,1643
24782,11783421,11784846,11784874,0,0,1425,1453
24783,11783439,11784874,11785043,0,0,1435,1604
24779,11783072,11783892,11785454,0,0,820,2382
24745,11779778,11779778,11785775,0,0,0,5997
24784,11784087,11785043,11785845,0,0,956,1758
24785,11784287,11785454,11785928,0,0,1167,1641
24789,11784889,11785928,11786001,0,0,1039,1112
24740,11778577,11779421,11786104,0,0,844,7527
24778,11783050,11783831,11786153,0,0,781,3103
24794,11785683,11786153,11786181,0,0,470,498
24787,11784636,11785845,11786216,0,0,1209,1580
24790,11785107,11786001,11786308,0,0,894,1201
24795,11785772,11786181,11786326,0,0,409,554
24796,11785897,11786216,11786591,0,0,319,694
24797,11786298,11786308,11786910,0,0,10,612
24692,11764059,11781972,11787121,0,0,17913,23062
24798,11786304,11786326,11787586,0,0,22,1282
24800,11787382,11787586,11787600,0,0,204,218
24771,11782282,11782282,11788407,0,0,0,6125
24768,11781971,11781978,11788887,0,0,7,6916
24765,11781783,11781978,11790497,0,0,195,8714
24805,11787566,11790497,11790723,0,0,2931,3157
24806,11787731,11790723,11790739,0,0,2992,3008
24764,11781657,11781657,11790775,0,0,0,9118
24811,11788217,11790775,11790787,0,0,2558,2570
24809,11788169,11790775,11790790,0,0,2606,2621
24812,11788396,11790787,11790839,0,0,2391,2443
24776,11782766,11786104,11791259,0,0,3338,8493
24792,11785373,11791259,11791541,0,0,5886,6168
24813,11788713,11790790,11791604,0,0,2077,2891
24815,11788916,11791604,11791619,0,0,2688,2703
24807,11787915,11790739,11791648,0,0,2824,3733
24799,11787310,11791541,11791688,0,0,4231,4378
24818,11788993,11791619,11791709,0,0,2626,2716
24819,11789000,11791648,11791748,0,0,2648,2748
24786,11784294,11785775,11792007,0,0,1481,7713
24823,11789683,11792007,11792040,0,0,2324,2357
24814,11788824,11790839,11792061,0,0,2015,3237
24825,11789859,11792061,11792108,0,0,2202,2249
24826,11790033,11792108,11792145,0,0,2075,2112
24824,11789842,11792040,11792169,0,0,2198,2327
24828,11790153,11792169,11792192,0,0,2016,2039
24781,11783371,11786910,11792360,0,0,3539,8989
24829,11790186,11792192,11792714,0,0,2006,2528
24827,11790045,11792145,11793114,0,0,2100,3069
24834,11791014,11792714,11793658,0,0,1700,2644
24836,11791219,11793658,11793737,0,0,2439,2518
24835,11791132,11793114,11794700,0,0,1982,3568
24839,11791723,11794700,11795173,0,0,2977,3450
24838,11791478,11793737,11795365,0,0,2259,3887
24820,11789135,11791709,11795460,0,0,2574,6325
24842,11792518,11795365,11795689,0,0,2847,3171
24841,11791958,11795173,11795733,0,0,3215,3775
24843,11792842,11795460,11796238,0,0,2618,3396
24847,11795095,11796238,11797001,0,0,1143,1906
24845,11793620,11795689,11797166,0,0,2069,3546
24822,11789472,11792360,11797196,0,0,2888,7724
24852,11796951,11797196,11797474,0,0,245,523
24848,11795856,11797001,11797602,0,0,1145,1746
24849,11796456,11797166,11797663,0,0,710,1207
24821,11789241,11791748,11798690,0,0,2507,9449
24854,11797524,11798690,11799163,0,0,1166,1639
24808,11787931,11791688,11800295,0,0,3757,12364
24846,11794721,11795733,11800746,0,0,1012,6025
24748,11780119,11780119,11802252,0,0,0,22133
24853,11796964,11797602,11802329,0,0,638,5365
24816,11788925,11802329,11802547,0,0,13404,13622
24830,11790497,11802547,11802900,0,0,12050,12403
24831,11790544,11802900,11803056,0,0,12356,12512
24832,11790983,11803056,11803372,0,0,12073,12389
24704,11766167,11787121,11804835,0,0,20954,38668
24851,11796635,11797196,11805885,0,0,561,9250
24857,11802681,11805885,11806502,0,0,3204,3821
24858,11802769,11806502,11806527,0,0,3733,3758
24859,11802847,11806527,11807106,0,0,3680,4259
24861,11803847,11807106,11807120,0,0,3259,3273
24862,11803915,11807120,11807170,0,0,3205,3255
24863,11804144,11807170,11807190,0,0,3026,3046
24865,11804972,11807190,11807211,0,0,2218,2239
24855,11801873,11801873,11808770,0,0,0,6897
24733,11774327,11804835,11809546,0,0,30508,35219
24744,11779722,11809546,11809702,0,0,29824,29980
24801,11787464,11787600,11809805,0,0,136,22341
24802,11787472,11788407,11810473,0,0,935,23001
24803,11787479,11788887,11811053,0,0,1408,23574
24747,11779854,11809702,11811278,0,0,29848,31424
24840,11791824,11803372,11811284,0,0,11548,19460
24817,11788953,11811278,11811304,0,0,22325,22351
24804,11787489,11790497,11812708,0,0,3008,25219
24793,11785435,11809702,11812876,0,0,24267,27441
24856,11802570,11812876,11812902,0,0,10306,10332
24864,11804945,11812902,11812911,0,0,7957,7966
24866,11805361,11812911,11812948,0,0,7550,7587
24867,11805959,11812948,11813033,0,0,6989,7074
24844,11793368,11809805,11813034,0,0,16437,19666
24868,11809997,11813033,11813640,0,0,3036,3643
24869,11810701,11813034,11813776,0,0,2333,3075
24850,11796545,11811284,11819052,0,0,14739,22507
24749,11780134,11780134,11819356,0,0,0,39222
24871,11819369,11819369,11819870,0,0,0,501
24874,11821180,11821180,11821242,0,0,0,62
24751,11780347,11819052,11821263,0,0,38705,40916
24788,11784732,11821263,11821672,0,0,36531,36940
24873,11821111,11821111,11821726,0,0,0,615
24810,11788201,11800295,11822116,0,0,12094,33915
24872,11820287,11822116,11822599,0,0,1829,2312
24833,11791001,11811304,11824781,0,0,20303,33780
24837,11791412,11824781,11831359,0,0,33369,39947
24860,11803424,11831359,11832203,0,0,27935,28779
24870,11810983,11832203,11832549,0,0,21220,21566
24791,11785126,11821672,11840087,0,0,36546,54961
24875,11842358,11842358,11844677,0,0,0,2319
24877,11845655,11845655,11845777,0,0,0,122
24878,11846064,11846064,11846213,0,0,0,149
24879,11846423,11846423,11846489,0,0,0,66
24881,11847303,11847303,11847318,0,0,0,15
24882,11847334,11847334,11847354,0,0,0,20
24876,11845606,11845606,11850626,0,0,0,5020
24880,11846702,11846702,11851482,0,0,0,4780
24887,11851434,11851434,11851684,0,0,0,250
24886,11851181,11851181,11851873,0,0,0,692
24885,11849994,11849994,11851910,0,0,0,1916
24889,11851817,11851817,11852009,0,0,0,192
24893,11852047,11852047,11852118,0,0,0,71
24884,11849553,11849553,11854005,0,0,0,4452
24888,11851469,11851482,11856179,0,0,13,4710
24883,11848986,11850626,11856540,0,0,1640,7554
24896,11856176,11856179,11857195,0,0,3,1019
24897,11857705,11857705,11858684,0,0,0,979
24895,11855682,11855682,11859466,0,0,0,3784
24899,11864051,11864051,11864145,0,0,0,94
24900,11864107,11864107,11864316,0,0,0,209
24903,11864305,11864305,11864347,0,0,0,42
24902,11864211,11864347,11866808,0,0,136,2597
24905,11864909,11866808,11866865,0,0,1899,1956
24909,11866040,11866865,11866884,0,0,825,844
24910,11866079,11866884,11866903,0,0,805,824
24904,11864602,11866808,11866906,0,0,2206,2304
24907,11865277,11866808,11866981,0,0,1531,1704
24908,11865984,11866808,11867154,0,0,824,1170
24911,11867620,11867620,11867658,0,0,0,38
24912,11867845,11867845,11867885,0,0,0,40
24913,11868061,11868061,11868136,0,0,0,75
24914,11868261,11868261,11868299,0,0,0,38
24915,11868419,11868419,11868558,0,0,0,139
24917,11868638,11868638,11868668,0,0,0,30
24894,11853198,11856540,11869018,0,0,3342,15820
24918,11869023,11869023,11869075,0,0,0,52
24906,11865006,11869018,11869976,0,0,4012,4970
24919,11869459,11869976,11870072,0,0,517,613
24920,11870569,11870569,11870779,0,0,0,210
24921,11870794,11870794,11871183,0,0,0,389
24923,11871228,11871228,11872104,0,0,0,876
24890,11851950,11851950,11872911,0,0,0,20961
24891,11851992,11851992,11873070,0,0,0,21078
24901,11864140,11864145,11874022,0,0,5,9882
24924,11874072,11874072,11874443,0,0,0,371
24922,11871069,11871069,11874814,0,0,0,3745
24898,11861022,11861022,11875641,0,0,0,14619
24928,11877689,11877689,11878483,0,0,0,794
24930,11878700,11878700,11879565,0,0,0,865
24929,11878157,11878157,11880032,0,0,0,1875
24931,11879931,11879931,11880231,0,0,0,300
24925,11874504,11874504,11881491,0,0,0,6987
24932,11880983,11880983,11881641,0,0,0,658
24935,11882138,11882138,11883067,0,0,0,929
24936,11883732,11883732,11883858,0,0,0,126
24939,11884414,11884414,11884494,0,0,0,80
24940,11885050,11885050,11885561,0,0,0,511
24942,11885997,11885997,11886031,0,0,0,34
24943,11886384,11886384,11887219,0,0,0,835
24944,11887209,11887209,11887315,0,0,0,106
24941,11885582,11885582,11887496,0,0,0,1914
24945,11887465,11887465,11887642,0,0,0,177
24937,11883777,11883777,11887765,0,0,0,3988
24947,11887992,11887992,11888039,0,0,0,47
24948,11888506,11888506,11888594,0,0,0,88
24949,11888805,11888805,11888853,0,0,0,48
24951,11888976,11888976,11889068,0,0,0,92
24946,11887641,11887641,11889355,0,0,0,1714
24916,11868617,11868617,11889527,0,0,0,20910
24953,11889533,11889533,11889818,0,0,0,285
24954,11890188,11890188,11890296,0,0,0,108
24956,11890638,11890638,11890677,0,0,0,39
24952,11889376,11889376,11890871,0,0,0,1495
24957,11890894,11890894,11890969,0,0,0,75
24958,11891349,11891349,11891478,0,0,0,129
24938,11884026,11884026,11892139,0,0,0,8113
24959,11891773,11891773,11892411,0,0,0,638
24960,11891973,11891973,11892432,0,0,0,459
24961,11892580,11892580,11892663,0,0,0,83
24926,11875873,11881491,11892943,0,0,5618,17070
24933,11881523,11892943,11892974,0,0,11420,11451
24962,11893001,11893001,11893104,0,0,0,103
24963,11893249,11893249,11893305,0,0,0,56
24964,11893767,11893767,11893843,0,0,0,76
24955,11890317,11890317,11894435,0,0,0,4118
24966,11895521,11895521,11895532,0,0,0,11
24934,11881581,11892974,11902554,0,0,11393,20973
24965,11894355,11902554,11902645,0,0,8199,8290
24927,11875993,11875993,11902685,0,0,0,26692
24950,11888850,11888850,11902900,0,0,0,14050
24892,11852000,11852000,11904160,0,0,0,52160
24968,11910348,11910348,11910367,0,0,0,19
24969,11910420,11910420,11910438,0,0,0,18
24970,11910822,11910822,11910885,0,0,0,63
24971,11911322,11911322,11911335,0,0,0,13
24973,11911999,11911999,11912073,0,0,0,74
24972,11911933,11911933,11912236,0,0,0,303
24974,11912288,11912288,11912350,0,0,0,62
24967,11896945,11896945,11912855,0,0,0,15910
24975,11914363,11914363,11914413,0,0,0,50
24976,11914669,11914669,11914719,0,0,0,50
24977,11915164,11915164,11915182,0,0,0,18
24978,11915235,11915235,11915252,0,0,0,17
24979,11915856,11915856,11915872,0,0,0,16
24980,11916326,11916326,11916343,0,0,0,17
24981,11916388,11916388,11916403,0,0,0,15
24982,11916687,11916687,11916699,0,0,0,12
24984,11932716,11932716,11932802,0,0,0,86
24985,11933401,11933401,11935362,0,0,0,1961
24988,11935592,11935592,11935984,0,0,0,392
24990,11936901,11936901,11937472,0,0,0,571
24986,11934058,11934058,11938465,0,0,0,4407
24989,11936003,11936003,11938879,0,0,0,2876
24991,11938480,11938480,11938922,0,0,0,442
24995,11939247,11939247,11939352,0,0,0,105
24992,11938510,11938510,11939393,0,0,0,883
24996,11939810,11939810,11940003,0,0,0,193
24997,11940248,11940248,11940474,0,0,0,226
24998,11940951,11940951,11941612,0,0,0,661
24999,11941564,11941564,11941620,0,0,0,56
25002,11942135,11942135,11942973,0,0,0,838
24994,11938906,11938906,11943478,0,0,0,4572
25003,11942973,11942973,11945316,0,0,0,2343
24993,11938749,11938749,11945631,0,0,0,6882
25008,11944024,11945631,11945665,0,0,1607,1641
25004,11943250,11945631,11945672,0,0,2381,2422
25009,11945090,11945665,11945699,0,0,575,609
25010,11945348,11945672,11946085,0,0,324,737
25005,11943344,11946085,11946896,0,0,2741,3552
25016,11947314,11947314,11947371,0,0,0,57
25017,11947484,11947484,11947499,0,0,0,15
25006,11943428,11943428,11947564,0,0,0,4136
24987,11935265,11935362,11947924,0,0,97,12659
25020,11948336,11948336,11948544,0,0,0,208
25023,11950749,11950749,11950765,0,0,0,16
25024,11951451,11951451,11951485,0,0,0,34
25007,11943466,11947924,11952254,0,0,4458,8788
25014,11946552,11952254,11952284,0,0,5702,5732
25021,11949071,11952254,11952304,0,0,3183,3233
25013,11946456,11952254,11952554,0,0,5798,6098
25018,11947525,11952554,11952837,0,0,5029,5312
25026,11952877,11952877,11952900,0,0,0,23
25027,11952925,11952925,11952966,0,0,0,41
24983,11932099,11932099,11952995,0,0,0,20896
25015,11946655,11952254,11953135,0,0,5599,6480
25028,11953086,11953086,11953223,0,0,0,137
25019,11947870,11947870,11954438,0,0,0,6568
25001,11941886,11941886,11954951,0,0,0,13065
25030,11954626,11954951,11955024,0,0,325,398
25032,11955311,11955311,11955367,0,0,0,56
25012,11946286,11946896,11955606,0,0,610,9320
25034,11955648,11955648,11955665,0,0,0,17
25036,11955829,11955829,11955844,0,0,0,15
25037,11955901,11955901,11955950,0,0,0,49
25022,11949695,11952284,11956055,0,0,2589,6360
25038,11956122,11956122,11956144,0,0,0,22
25039,11956283,11956283,11956350,0,0,0,67
25040,11956359,11956359,11956396,0,0,0,37
25041,11956422,11956422,11956434,0,0,0,12
25042,11956822,11956822,11956837,0,0,0,15
25029,11954570,11955606,11956858,0,0,1036,2288
25044,11956885,11956885,11956943,0,0,0,58
25031,11954879,11955606,11957404,0,0,727,2525
25043,11956845,11956845,11958097,0,0,0,1252
25049,11958727,11958727,11958783,0,0,0,56
25048,11958562,11958562,11959444,0,0,0,882
25052,11959469,11959469,11959513,0,0,0,44
25053,11959882,11959882,11959928,0,0,0,46
25054,11959979,11959979,11960266,0,0,0,287
25035,11955677,11957404,11960847,0,0,1727,5170
25055,11960333,11960333,11961662,0,0,0,1329
25056,11961759,11961759,11961885,0,0,0,126
25046,11958000,11958000,11962181,0,0,0,4181
25000,11941650,11941650,11962842,0,0,0,21192
25051,11959391,11962181,11963161,0,0,2790,3770
25011,11946235,11946235,11963245,0,0,0,17010
25047,11958340,11963245,11963636,0,0,4905,5296
25025,11952132,11954438,11967004,0,0,2306,14872
25033,11955568,11967004,11972268,0,0,11436,16700
25059,11964092,11972268,11972309,0,0,8176,8217
25050,11959120,11963636,11972338,0,0,4516,13218
25061,11968395,11972268,11972391,0,0,3873,3996
25060,11965375,11972268,11972510,0,0,6893,7135
25058,11964014,11972268,11973491,0,0,8254,9477
25045,11957657,11960847,11975304,0,0,3190,17647
25057,11963825,11972268,11975825,0,0,8443,12000
25062,11978197,11978197,11979653,0,0,0,1456
25063,11978604,11978604,11979831,0,0,0,1227
25064,11980468,11980468,11982902,0,0,0,2434
25066,11983157,11983157,11983189,0,0,0,32
25067,11983418,11983418,11983440,0,0,0,22
25068,11984444,11984444,11984493,0,0,0,49
25069,11984589,11984589,11984672,0,0,0,83
25070,11984877,11984877,11984987,0,0,0,110
25071,11985299,11985299,11985355,0,0,0,56
25072,11985401,11985401,11985448,0,0,0,47
25073,11985916,11985916,11985974,0,0,0,58
25076,11989313,11989313,11989352,0,0,0,39
25065,11980488,11980488,11989371,0,0,0,8883
25077,11989508,11989508,11989539,0,0,0,31
25078,11989782,11989782,11989807,0,0,0,25
25079,11989856,11989856,11989920,0,0,0,64
25080,11989945,11989945,11990019,0,0,0,74
25081,11990212,11990212,11990275,0,0,0,63
25074,11986449,11986449,11991368,0,0,0,4919
25083,11991538,11991538,11991652,0,0,0,114
25084,11994316,11994316,11994817,0,0,0,501
25085,11994569,11994569,11999469,0,0,0,4900
25086,12001033,12001033,12004774,0,0,0,3741
25087,12020278,12020278,12020811,0,0,0,533
25091,12024572,12024572,12024807,0,0,0,235
25093,12025924,12025924,12026048,0,0,0,124
25092,12025554,12025554,12026157,0,0,0,603
25088,12022278,12022278,12026158,0,0,0,3880
25094,12026062,12026062,12026205,0,0,0,143
25095,12026673,12026673,12026726,0,0,0,53
25089,12023669,12023669,12028019,0,0,0,4350
25096,12028453,12028453,12032426,0,0,0,3973
25097,12034409,12034409,12038526,0,0,0,4117
25100,12039591,12039591,12041115,0,0,0,1524
25075,11989196,11989196,12041215,0,0,0,52019
25099,12038982,12038982,12041497,0,0,0,2515
25098,12035024,12035024,12041499,0,0,0,6475
25082,11990605,11990605,12041566,0,0,0,50961
25103,12043687,12043687,12044490,0,0,0,803
25101,12042222,12042222,12044808,0,0,0,2586
25105,12045043,12045043,12046061,0,0,0,1018
25106,12045205,12045205,12046751,0,0,0,1546
25108,12047163,12047163,12047229,0,0,0,66
25110,12049459,12049459,12049510,0,0,0,51
25111,12050372,12050372,12050411,0,0,0,39
25112,12051185,12051185,12051780,0,0,0,595
25113,12051543,12051543,12052018,0,0,0,475
25115,12052391,12052391,12052488,0,0,0,97
25109,12048855,12048855,12053352,0,0,0,4497
25090,12024223,12041215,12053405,0,0,16992,29182
25104,12044637,12044637,12053812,0,0,0,9175
25117,12053720,12053812,12055370,0,0,92,1650
25102,12042450,12053405,12055382,0,0,10955,12932
25118,12053815,12055370,12055662,0,0,1555,1847
25119,12054262,12055662,12055739,0,0,1400,1477
25114,12051958,12051958,12055757,0,0,0,3799
25107,12046013,12055382,12057012,0,0,9369,10999
25121,12055570,12055757,12057294,0,0,187,1724
25122,12056940,12056940,12057500,0,0,0,560
25128,12058587,12058587,12058612,0,0,0,25
25126,12058364,12058364,12058674,0,0,0,310
25130,12058840,12058840,12058892,0,0,0,52
25120,12054369,12055662,12059350,0,0,1293,4981
25129,12058733,12058733,12059374,0,0,0,641
25131,12059409,12059409,12059443,0,0,0,34
25125,12058143,12058143,12059454,0,0,0,1311
25133,12059743,12059743,12059784,0,0,0,41
25134,12059815,12059815,12059829,0,0,0,14
25135,12059883,12059883,12059927,0,0,0,44
25132,12059508,12059508,12060809,0,0,0,1301
25137,12061760,12061760,12061833,0,0,0,73
25138,12061883,12061883,12062043,0,0,0,160
25139,12062117,12062117,12062315,0,0,0,198
25140,12062948,12062948,12063303,0,0,0,355
25136,12060863,12060863,12063927,0,0,0,3064
25142,12064721,12064721,12065258,0,0,0,537
25141,12064165,12064165,12067892,0,0,0,3727
25143,12067822,12067822,12068678,0,0,0,856
25146,12069465,12069465,12070007,0,0,0,542
25147,12069755,12069755,12070011,0,0,0,256
25149,12070500,12070500,12070776,0,0,0,276
25150,12071227,12071227,12071386,0,0,0,159
25144,12068426,12068426,12071445,0,0,0,3019
25148,12070070,12070070,12073020,0,0,0,2950
25145,12069018,12069018,12074182,0,0,0,5164
25123,12057043,12057043,12079247,0,0,0,22204
25151,12075560,12075560,12079274,0,0,0,3714
25152,12096715,12096715,12098581,0,0,0,1866
25124,12057131,12079247,12101299,0,0,22116,44168
25154,12101866,12101866,12102072,0,0,0,206
25155,12102169,12102169,12104095,0,0,0,1926
25163,12105662,12105662,12105878,0,0,0,216
25161,12105361,12105361,12105927,0,0,0,566
25165,12106405,12106405,12107644,0,0,0,1239
25166,12107253,12107253,12108169,0,0,0,916
25156,12104086,12104086,12108211,0,0,0,4125
25170,12108215,12108215,12108883,0,0,0,668
25172,12108899,12108899,12109023,0,0,0,124
25173,12108978,12108978,12109456,0,0,0,478
25175,12110638,12110638,12110720,0,0,0,82
25176,12110734,12110734,12110777,0,0,0,43
25177,12110790,12110790,12110832,0,0,0,42
25178,12110843,12110843,12110896,0,0,0,53
25180,12111583,12111583,12112274,0,0,0,691
25171,12108752,12108752,12112768,0,0,0,4016
25182,12112569,12112569,12112966,0,0,0,397
25181,12112339,12112339,12113595,0,0,0,1256
25157,12104094,12104094,12114373,0,0,0,10279
25169,12108203,12108203,12114601,0,0,0,6398
25168,12107949,12107949,12114875,0,0,0,6926
25187,12114211,12114211,12114919,0,0,0,708
25191,12114902,12114902,12115350,0,0,0,448
25194,12114981,12114981,12115629,0,0,0,648
25193,12114957,12114957,12115810,0,0,0,853
25198,12115609,12115609,12115852,0,0,0,243
25185,12113988,12113988,12116638,0,0,0,2650
25190,12114601,12114601,12116953,0,0,0,2352
25196,12115369,12115369,12117322,0,0,0,1953
25201,12118148,12118148,12118300,0,0,0,152
25189,12114576,12114576,12118993,0,0,0,4417
25205,12120660,12120660,12121148,0,0,0,488
25206,12120755,12120755,12121264,0,0,0,509
25127,12058569,12101299,12121701,0,0,42730,63132
25207,12121781,12121781,12122104,0,0,0,323
25211,12122201,12122201,12122263,0,0,0,62
25210,12122184,12122184,12122374,0,0,0,190
25212,12122373,12122374,12122440,0,0,1,67
25213,12122475,12122475,12123135,0,0,0,660
25208,12122033,12122033,12123367,0,0,0,1334
25214,12122494,12122494,12123720,0,0,0,1226
25197,12115564,12115852,12123939,0,0,288,8375
25158,12104832,12123939,12124024,0,0,19107,19192
25202,12118471,12118471,12124500,0,0,0,6029
25216,12124064,12124500,12124530,0,0,436,466
25219,12124404,12124404,12124568,0,0,0,164
25215,12123887,12123887,12124958,0,0,0,1071
25225,12125478,12125478,12125506,0,0,0,28
25224,12125333,12125333,12125573,0,0,0,240
25229,12125687,12125687,12125877,0,0,0,190
25231,12125868,12125877,12125988,0,0,9,120
25232,12125884,12125988,12126008,0,0,104,124
25233,12125958,12126008,12126117,0,0,50,159
25234,12126130,12126130,12126211,0,0,0,81
25235,12126241,12126241,12126307,0,0,0,66
25226,12125564,12125564,12126410,0,0,0,846
25153,12100612,12121701,12126424,0,0,21089,25812
25228,12125664,12126410,12126483,0,0,746,819
25223,12125067,12125067,12126756,0,0,0,1689
25160,12105257,12126424,12126908,0,0,21167,21651
25237,12126481,12126756,12126952,0,0,275,471
25230,12125795,12126483,12128944,0,0,688,3149
25159,12104941,12124024,12129416,0,0,19083,24475
25174,12110177,12129416,12129678,0,0,19239,19501
25239,12126618,12126952,12130950,0,0,334,4332
25179,12111248,12129678,12132143,0,0,18430,20895
25183,12113511,12132143,12132181,0,0,18632,18670
25184,12113710,12132181,12132467,0,0,18471,18757
25186,12114088,12132467,12133548,0,0,18379,19460
25188,12114540,12133548,12133759,0,0,19008,19219
25240,12126696,12130950,12134908,0,0,4254,8212
25242,12126940,12134908,12134968,0,0,7968,8028
25218,12124141,12124530,12135963,0,0,389,11822
25244,12127530,12134968,12136008,0,0,7438,8478
25248,12128379,12136008,12136101,0,0,7629,7722
25250,12128776,12136101,12136142,0,0,7325,7366
25252,12129342,12136142,12136184,0,0,6800,6842
25258,12130929,12136184,12136249,0,0,5255,5320
25259,12130960,12136249,12137762,0,0,5289,6802
25261,12131291,12137762,12138157,0,0,6471,6866
25264,12131806,12138157,12138236,0,0,6351,6430
25192,12114930,12133759,12138244,0,0,18829,23314
25238,12126582,12128944,12138814,0,0,2362,12232
25241,12126817,12138814,12139292,0,0,11997,12475
25265,12131977,12138236,12141146,0,0,6259,9169
25266,12132025,12141146,12141408,0,0,9121,9383
25245,12127637,12139292,12141694,0,0,11655,14057
25246,12128200,12141694,12144396,0,0,13494,16196
25203,12120454,12138244,12144669,0,0,17790,24215
25162,12105426,12126908,12144754,0,0,21482,39328
25251,12129173,12144396,12144927,0,0,15223,15754
25204,12120516,12144669,12145013,0,0,24153,24497
25220,12124757,12145013,12145127,0,0,20256,20370
25253,12130206,12144927,12145268,0,0,14721,15062
25236,12126423,12145127,12145314,0,0,18704,18891
25254,12130395,12145268,12145721,0,0,14873,15326
25255,12130546,12145721,12146124,0,0,15175,15578
25256,12130612,12146124,12146491,0,0,15512,15879
25260,12131016,12146491,12146879,0,0,15475,15863
25164,12105818,12144754,12147329,0,0,38936,41511
25222,12124894,12135963,12149706,0,0,11069,24812
25257,12130746,12149706,12150511,0,0,18960,19765
25262,12131431,12146879,12151310,0,0,15448,19879
25270,12132605,12151310,12151411,0,0,18705,18806
25263,12131570,12150511,12152460,0,0,18941,20890
25272,12133485,12152460,12152801,0,0,18975,19316
25267,12132314,12141408,12152812,0,0,9094,20498
25269,12132516,12151310,12153691,0,0,18794,21175
25271,12132895,12151411,12153790,0,0,18516,20895
25277,12135150,12153691,12153861,0,0,18541,18711
25227,12125585,12145127,12154110,0,0,19542,28525
25279,12135488,12153861,12154195,0,0,18373,18707
25281,12136997,12154195,12154269,0,0,17198,17272
25167,12107566,12147329,12154666,0,0,39763,47100
25273,12133696,12152801,12154791,0,0,19105,21095
25276,12135079,12152812,12154937,0,0,17733,19858
25247,12128231,12145314,12155482,0,0,17083,27251
25282,12137218,12154269,12155729,0,0,17051,18511
25195,12115340,12154666,12155775,0,0,39326,40435
25274,12133838,12154110,12156005,0,0,20272,22167
25285,12137791,12154937,12156342,0,0,17146,18551
25293,12143304,12155729,12157083,0,0,12425,13779
25296,12145065,12156342,12157296,0,0,11277,12231
25305,12151552,12157296,12157556,0,0,5744,6004
25280,12135739,12154791,12158967,0,0,19052,23228
25288,12138648,12158967,12158990,0,0,20319,20342
25300,12146051,12157083,12159047,0,0,11032,12996
25199,12115785,12155775,12159146,0,0,39990,43361
25292,12142341,12158967,12159631,0,0,16626,17290
25278,12135281,12153790,12160302,0,0,18509,25021
25302,12146829,12160302,12161184,0,0,13473,14355
25287,12138303,12155482,12163226,0,0,17179,24923
25200,12115811,12159146,12163645,0,0,43335,47834
25284,12137656,12156005,12163903,0,0,18349,26247
25310,12157999,12157999,12165003,0,0,0,7004
25294,12143522,12158990,12167400,0,0,15468,23878
25298,12145720,12159631,12169251,0,0,13911,23531
25289,12138754,12163903,12169812,0,0,25149,31058
25283,12137403,12155482,12170004,0,0,18079,32601
25309,12156418,12163226,12170247,0,0,6808,13829
25290,12139166,12169812,12171682,0,0,30646,32516
25291,12139963,12170247,12172935,0,0,30284,32972
25311,12163859,12167400,12174325,0,0,3541,10466
25297,12145561,12171682,12175045,0,0,26121,29484
25209,12122139,12163645,12175167,0,0,41506,53028
25303,12147484,12172935,12175372,0,0,25451,27888
25312,12165490,12169251,12177328,0,0,3761,11838
25307,12154019,12175045,12177492,0,0,21026,23473
25306,12152366,12161184,12182082,0,0,8818,29716
25217,12124138,12175167,12184134,0,0,51029,59996
25243,12127404,12177328,12188127,0,0,49924,60723
25221,12124851,12184134,12188578,0,0,59283,63727
25316,12189038,12189038,12189750,0,0,0,712
25268,12132458,12188578,12189971,0,0,56120,57513
25249,12128515,12188127,12190874,0,0,59612,62359
25320,12189947,12189947,12192359,0,0,0,2412
25314,12188109,12188109,12194874,0,0,0,6765
25286,12138169,12190874,12195894,0,0,52705,57725
25299,12145797,12195894,12195960,0,0,50097,50163
25325,12192440,12194874,12196151,0,0,2434,3711
25331,12193467,12196151,12196893,0,0,2684,3426
25333,12193517,12196893,12196930,0,0,3376,3413
25317,12189378,12189378,12197002,0,0,0,7624
25318,12189391,12197002,12197062,0,0,7611,7671
25337,12193738,12196930,12197156,0,0,3192,3418
25328,12193250,12194874,12199103,0,0,1624,5853
25301,12146131,12195960,12199554,0,0,49829,53423
25354,12197260,12197260,12199964,0,0,0,2704
25355,12197512,12199103,12200138,0,0,1591,2626
25322,12190531,12192359,12203604,0,0,1828,13073
25356,12197897,12199964,12203641,0,0,2067,5744
25361,12200101,12203641,12203896,0,0,3540,3795
25362,12200132,12203896,12204394,0,0,3764,4262
25359,12199931,12203604,12204833,0,0,3673,4902
25275,12134569,12189971,12204879,0,0,55402,70310
25366,12201149,12204394,12204957,0,0,3245,3808
25373,12201962,12204957,12205066,0,0,2995,3104
25295,12144428,12204879,12205276,0,0,60451,60848
25304,12150147,12199554,12205997,0,0,49407,55850
25313,12182889,12205997,12206716,0,0,23108,23827
25323,12191391,12206716,12206959,0,0,15325,15568
25326,12192509,12206959,12206991,0,0,14450,14482
25339,12193979,12206991,12207750,0,0,13012,13771
25321,12190195,12197062,12207799,0,0,6867,17604
25324,12191648,12206716,12207907,0,0,15068,16259
25329,12193324,12207907,12207967,0,0,14583,14643
25332,12193476,12207967,12208023,0,0,14491,14547
25334,12193519,12208023,12208078,0,0,14504,14559
25335,12193572,12208078,12208657,0,0,14506,15085
25336,12193706,12208657,12208764,0,0,14951,15058
25338,12193933,12208764,12208883,0,0,14831,14950
25327,12192883,12207799,12209119,0,0,14916,16236
25341,12194074,12209119,12209194,0,0,15045,15120
25342,12194240,12209194,12209477,0,0,14954,15237
25343,12194331,12209477,12209587,0,0,15146,15256
25372,12201935,12204833,12209596,0,0,2898,7661
25344,12194487,12209587,12209625,0,0,15100,15138
25348,12196973,12209625,12209680,0,0,12652,12707
25374,12202168,12205066,12211078,0,0,2898,8910
25340,12194073,12208883,12211339,0,0,14810,17266
25350,12197020,12211339,12211363,0,0,14319,14343
25364,12200730,12211363,12211379,0,0,10633,10649
25365,12200934,12211379,12211396,0,0,10445,10462
25351,12197031,12211363,12211398,0,0,14332,14367
25376,12202499,12211398,12211428,0,0,8899,8929
25379,12203127,12211428,12211450,0,0,8301,8323
25380,12203325,12211450,12211476,0,0,8125,8151
25378,12203113,12211078,12212057,0,0,7965,8944
25382,12204044,12212057,12212160,0,0,8013,8116
25330,12193440,12206959,12213157,0,0,13519,19717
25346,12194987,12207750,12213395,0,0,12763,18408
25387,12204666,12213395,12213640,0,0,8729,8974
25368,12201177,12211396,12214252,0,0,10219,13075
25388,12205538,12213640,12214559,0,0,8102,9021
25397,12208351,12214252,12214965,0,0,5901,6614
25390,12206176,12214252,12215062,0,0,8076,8886
25377,12202689,12209596,12216034,0,0,6907,13345
25407,12210234,12216034,12216045,0,0,5800,5811
25392,12206992,12214559,12216105,0,0,7567,9113
25384,12204184,12212160,12216270,0,0,7976,12086
25358,12199216,12200138,12216308,0,0,922,17092
25408,12210404,12216045,12216325,0,0,5641,5921
25413,12213177,12216308,12216435,0,0,3131,3258
25415,12213420,12216435,12216816,0,0,3015,3396
25383,12204069,12213157,12218108,0,0,9088,14039
25381,12203333,12211476,12218185,0,0,8143,14852
25401,12209312,12218185,12218251,0,0,8873,8939
25402,12209375,12218251,12218312,0,0,8876,8937
25400,12209028,12218108,12218380,0,0,9080,9352
25394,12207022,12216105,12218504,0,0,9083,11482
25403,12209431,12218312,12219790,0,0,8881,10359
25404,12209446,12218380,12219842,0,0,8934,10396
25405,12209460,12215062,12219949,0,0,5602,10489
25419,12214568,12219842,12220578,0,0,5274,6010
25398,12208503,12214965,12220642,0,0,6462,12139
25417,12213452,12219842,12220730,0,0,6390,7278
25428,12218260,12220642,12220956,0,0,2382,2696
25432,12218605,12220730,12220971,0,0,2125,2366
25416,12213427,12216816,12221001,0,0,3389,7574
25409,12210752,12216270,12221065,0,0,5518,10313
25426,12217702,12220578,12221340,0,0,2876,3638
25437,12219522,12220971,12221580,0,0,1449,2058
25422,12215754,12219949,12222356,0,0,4195,6602
25445,12221328,12222356,12222589,0,0,1028,1261
25349,12197008,12209680,12222626,0,0,12672,25618
25434,12218960,12220956,12222698,0,0,1996,3738
25438,12220020,12221001,12222742,0,0,981,2722
25418,12214020,12222698,12222958,0,0,8678,8938
25420,12214787,12222958,12223207,0,0,8171,8420
25429,12218311,12223207,12223237,0,0,4896,4926
25446,12223496,12223496,12223618,0,0,0,122
25447,12223587,12223618,12224133,0,0,31,546
25448,12223764,12224133,12224475,0,0,369,711
25449,12224078,12224475,12224855,0,0,397,777
25451,12224132,12224855,12225252,0,0,723,1120
25352,12197195,12222626,12225376,0,0,25431,28181
25353,12197207,12225376,12225431,0,0,28169,28224
25453,12224500,12225252,12225500,0,0,752,1000
25442,12220947,12221580,12225631,0,0,633,4684
25454,12225048,12225500,12225665,0,0,452,617
25431,12218535,12225665,12225705,0,0,7130,7170
25433,12218861,12225705,12225746,0,0,6844,6885
25435,12219161,12225746,12226135,0,0,6585,6974
25436,12219247,12226135,12226172,0,0,6888,6925
25444,12221236,12226172,12226256,0,0,4936,5020
25452,12224304,12226256,12227089,0,0,1952,2785
25414,12213185,12216325,12227228,0,0,3140,14043
25458,12226311,12227228,12227309,0,0,917,998
25459,12226595,12227309,12227376,0,0,714,781
25460,12226610,12227376,12227422,0,0,766,812
25462,12227917,12227917,12227968,0,0,0,51
25412,12213146,12219790,12228273,0,0,6644,15127
25457,12225915,12227089,12228814,0,0,1174,2899
25464,12228707,12228814,12230872,0,0,107,2165
25430,12218345,12223237,12233042,0,0,4892,14697
25360,12200041,12228273,12233472,0,0,28232,33431
25439,12220447,12221065,12233662,0,0,618,13215
25370,12201363,12233662,12234227,0,0,32299,32864
25375,12202442,12234227,12234740,0,0,31785,32298
25411,12210933,12218504,12235085,0,0,7571,24152
25385,12204470,12234740,12236362,0,0,30270,31892
25469,12235489,12235489,12237272,0,0,0,1783
25393,12207000,12236362,12238202,0,0,29362,31202
25357,12198313,12225431,12238910,0,0,27118,40597
25406,12209974,12238910,12239210,0,0,28936,29236
25440,12220469,12221340,12242437,0,0,871,21968
25472,12239964,12242437,12242840,0,0,2473,2876
25399,12208705,12238202,12243290,0,0,29497,34585
25471,12238142,12238142,12244011,0,0,0,5869
25473,12240302,12242840,12245858,0,0,2538,5556
25476,12240407,12245858,12245882,0,0,5451,5475
25363,12200665,12233472,12247152,0,0,32807,46487
25474,12240335,12244011,12248271,0,0,3676,7936
25410,12210926,12239210,12248315,0,0,28284,37389
25475,12240399,12248271,12248320,0,0,7872,7921
25478,12240632,12245882,12248869,0,0,5250,8237
25477,12240514,12248320,12249075,0,0,7806,8561
25480,12242052,12249075,12249126,0,0,7023,7074
25482,12246915,12249126,12253286,0,0,2211,6371
25423,12216696,12247152,12254245,0,0,30456,37549
25425,12217354,12254245,12254440,0,0,36891,37086
25421,12215039,12243290,12254560,0,0,28251,39521
25441,12220844,12254560,12254729,0,0,33716,33885
25424,12217165,12248315,12255539,0,0,31150,38374
25455,12225150,12255539,12256268,0,0,30389,31118
25456,12225355,12256268,12256281,0,0,30913,30926
25463,12228237,12256281,12259673,0,0,28044,31436
25443,12221034,12254729,12261918,0,0,33695,40884
25427,12217862,12254440,12263065,0,0,36578,45203
25481,12245309,12248869,12263339,0,0,3560,18030
25308,12154489,12205276,12266355,0,0,50787,111866
25345,12194661,12263065,12269685,0,0,68404,75024
25484,12267136,12267136,12269967,0,0,0,2831
25315,12188411,12266355,12273735,0,0,77944,85324
25369,12201300,12269685,12275187,0,0,68385,73887
25488,12277010,12277010,12277044,0,0,0,34
25467,12234555,12259673,12277252,0,0,25118,42697
25319,12189765,12273735,12278066,0,0,83970,88301
25347,12195902,12278066,12278094,0,0,82164,82192
25367,12201163,12278094,12278457,0,0,76931,77294
25371,12201425,12278457,12282864,0,0,77032,81439
25386,12204507,12282864,12284812,0,0,78357,80305
25391,12206493,12275187,12288491,0,0,68694,81998
25489,12279878,12279878,12288549,0,0,0,8671
25486,12273159,12277252,12289784,0,0,4093,16625
25116,12053161,12053161,12292631,0,0,0,239470
25495,12294566,12294566,12294770,0,0,0,204
25496,12294798,12294798,12294953,0,0,0,155
25497,12295064,12295064,12295130,0,0,0,66
25395,12207504,12288491,12295863,0,0,80987,88359
25503,12297656,12297656,12297868,0,0,0,212
25506,12298407,12298407,12298529,0,0,0,122
25507,12298577,12298577,12298600,0,0,0,23
25389,12205626,12284812,12298992,0,0,79186,93366
25498,12295632,12295632,12299440,0,0,0,3808
25490,12284372,12289784,12299461,0,0,5412,15089
25491,12293154,12293154,12299722,0,0,0,6568
25492,12293271,12299461,12299739,0,0,6190,6468
25509,12298902,12299722,12300060,0,0,820,1158
25502,12297150,12299440,12302948,0,0,2290,5798
25461,12227475,12295863,12303038,0,0,68388,75563
25396,12208003,12298992,12303356,0,0,90989,95353
25511,12299333,12302948,12303767,0,0,3615,4434
25510,12299091,12300060,12305121,0,0,969,6030
25515,12299711,12305121,12305218,0,0,5410,5507
25512,12299384,12303767,12306034,0,0,4383,6650
25519,12300379,12306034,12306051,0,0,5655,5672
25520,12300550,12306051,12306079,0,0,5501,5529
25521,12300663,12306079,12306127,0,0,5416,5464
25525,12301786,12306127,12306178,0,0,4341,4392
25528,12301883,12306178,12306317,0,0,4295,4434
25493,12293986,12299739,12306566,0,0,5753,12580
25526,12301809,12306178,12306628,0,0,4369,4819
25532,12303193,12306628,12307812,0,0,3435,4619
25536,12303843,12307812,12307836,0,0,3969,3993
25540,12304190,12307836,12307870,0,0,3646,3680
25531,12302791,12306317,12308729,0,0,3526,5938
25523,12301177,12305218,12309243,0,0,4041,8066
25499,12296393,12306566,12309652,0,0,10173,13259
25500,12296655,12309652,12309905,0,0,12997,13250
25468,12234656,12303038,12310259,0,0,68382,75603
25501,12296688,12309905,12310401,0,0,13217,13713
25504,12298256,12310401,12311729,0,0,12145,13473
25505,12298318,12311729,12312959,0,0,13411,14641
25513,12299563,12312959,12317349,0,0,13396,17786
25514,12299583,12317349,12317436,0,0,17766,17853
25450,12224109,12303356,12318352,0,0,79247,94243
25508,12298818,12298818,12318532,0,0,0,19714
25549,12307899,12308729,12319239,0,0,830,11340
25517,12300238,12317436,12321255,0,0,17198,21017
25544,12304609,12307870,12321674,0,0,3261,17065
25465,12232002,12318352,12322751,0,0,86350,90749
25529,12301971,12321674,12322907,0,0,19703,20936
25518,12300324,12321255,12322946,0,0,20931,22622
25530,12302063,12322907,12323768,0,0,20844,21705
25534,12303393,12323768,12325111,0,0,20375,21718
25537,12303891,12325111,12325136,0,0,21220,21245
25541,12304237,12325136,12325182,0,0,20899,20945
25522,12300811,12322946,12325454,0,0,22135,24643
25524,12301443,12325454,12326822,0,0,24011,25379
25466,12232021,12322751,12327149,0,0,90730,95128
25470,12236899,12310259,12328180,0,0,73360,91281
25483,12249041,12327149,12334286,0,0,78108,85245
25479,12241879,12327149,12334309,0,0,85270,92430
25538,12303941,12334286,12334346,0,0,30345,30405
25543,12304301,12334346,12334376,0,0,30045,30075
25535,12303636,12334286,12334938,0,0,30650,31302
25553,12311056,12334938,12334963,0,0,23882,23907
25527,12301857,12318532,12335090,0,0,16675,33233
25548,12307116,12334938,12335244,0,0,27822,28128
25550,12308256,12335244,12337327,0,0,26988,29071
25552,12310647,12337327,12337338,0,0,26680,26691
25547,12305230,12325182,12338362,0,0,19952,33132
25533,12303338,12326822,12341779,0,0,23484,38441
25554,12321663,12334963,12344312,0,0,13300,22649
25516,12299985,12328180,12346483,0,0,28195,46498
25546,12304750,12334376,12347918,0,0,29626,43168
25542,12304245,12334309,12348358,0,0,30064,44113
25539,12303952,12334309,12348650,0,0,30357,44698
25545,12304698,12341779,12354378,0,0,37081,49680
25487,12275558,12354378,12363258,0,0,78820,87700
25494,12294440,12363258,12363298,0,0,68818,68858
25485,12268691,12347918,12368754,0,0,79227,100063
25551,12308586,12363298,12375948,0,0,54712,67362
25567,12368734,12375948,12376018,0,0,7214,7284
25569,12368841,12376018,12376296,0,0,7177,7455
25570,12369306,12376296,12376369,0,0,6990,7063
25558,12362159,12375948,12376620,0,0,13789,14461
25559,12362385,12376620,12376709,0,0,14235,14324
25557,12361890,12375948,12377102,0,0,14058,15212
25571,12369652,12376369,12377305,0,0,6717,7653
25563,12364125,12375948,12377617,0,0,11823,13492
25573,12370771,12377617,12377700,0,0,6846,6929
25574,12370915,12377700,12377771,0,0,6785,6856
25572,12370113,12377305,12377784,0,0,7192,7671
25556,12361482,12375948,12378025,0,0,14466,16543
25575,12371047,12377771,12379153,0,0,6724,8106
25579,12371908,12379153,12379166,0,0,7245,7258
25555,12356782,12368754,12380442,0,0,11972,23660
25564,12365248,12376709,12380455,0,0,11461,15207
25583,12373238,12380455,12380459,0,0,7217,7221
25586,12373446,12380459,12380465,0,0,7013,7019
25587,12373472,12380465,12380474,0,0,6993,7002
25589,12373501,12380474,12380477,0,0,6973,6976
25590,12373533,12380477,12380479,0,0,6944,6946
25594,12373915,12380479,12380485,0,0,6564,6570
25584,12373306,12380455,12380562,0,0,7149,7256
25581,12372751,12379166,12380813,0,0,6415,8062
25601,12375460,12380813,12381057,0,0,5353,5597
25602,12376140,12381057,12381170,0,0,4917,5030
25596,12374833,12380485,12381269,0,0,5652,6436
25568,12368801,12375948,12381574,0,0,7147,12773
25599,12375278,12380562,12381971,0,0,5284,6693
25576,12371091,12377784,12382052,0,0,6693,10961
25612,12380343,12382052,12382177,0,0,1709,1834
25609,12378402,12381269,12382293,0,0,2867,3891
25616,12381848,12382177,12382340,0,0,329,492
25620,12382172,12382293,12382565,0,0,121,393
25623,12382557,12382565,12382600,0,0,8,43
25624,12382609,12382609,12383004,0,0,0,395
25611,12378663,12381971,12384172,0,0,3308,5509
25628,12383197,12384172,12384586,0,0,975,1389
25625,12382669,12383004,12384765,0,0,335,2096
25629,12383239,12384586,12384844,0,0,1347,1605
25561,12363184,12380442,12384940,0,0,17258,21756
25562,12363412,12384940,12384973,0,0,21528,21561
25631,12383567,12384765,12385078,0,0,1198,1511
25565,12366380,12384940,12385409,0,0,18560,19029
25634,12384038,12384844,12385493,0,0,806,1455
25610,12378591,12381574,12385510,0,0,2983,6919
25641,12385322,12385493,12385524,0,0,171,202
25638,12384754,12385078,12386779,0,0,324,2025
25643,12385853,12386779,12386844,0,0,926,991
25591,12373620,12385524,12386906,0,0,11904,13286
25578,12371818,12378025,12387163,0,0,6207,15345
25645,12386031,12387163,12387282,0,0,1132,1251
25592,12373649,12386906,12387373,0,0,13257,13724
25647,12386316,12387282,12387387,0,0,966,1071
25597,12375181,12387373,12387877,0,0,12192,12696
25648,12386416,12387387,12388080,0,0,971,1664
25650,12386471,12388080,12388206,0,0,1609,1735
25644,12386009,12386844,12388244,0,0,835,2235
25577,12371481,12380455,12388827,0,0,8974,17346
25652,12387050,12388206,12388939,0,0,1156,1889
25654,12387273,12388244,12388994,0,0,971,1721
25605,12377065,12388827,12389072,0,0,11762,12007
25560,12363130,12377102,12389088,0,0,13972,25958
25656,12387777,12388939,12389107,0,0,1162,1330
25598,12375255,12387877,12389244,0,0,12622,13989
25660,12388213,12389107,12389510,0,0,894,1297
25658,12387894,12388994,12389571,0,0,1100,1677
25663,12388937,12389571,12389604,0,0,634,667
25606,12377685,12389072,12389819,0,0,11387,12134
25585,12373356,12389088,12389849,0,0,15732,16493
25614,12380584,12389819,12390239,0,0,9235,9655
25661,12388400,12389510,12390467,0,0,1110,2067
25665,12389807,12390467,12390778,0,0,660,971
25613,12380558,12389244,12390970,0,0,8686,10412
25627,12383180,12390970,12390993,0,0,7790,7813
25666,12389829,12390778,12391513,0,0,949,1684
25632,12383574,12390993,12391527,0,0,7419,7953
25593,12373711,12389849,12391578,0,0,16138,17867
25667,12389843,12391513,12391779,0,0,1670,1936
25635,12384049,12391527,12392087,0,0,7478,8038
25664,12389492,12389604,12392391,0,0,112,2899
25595,12374422,12391578,12392408,0,0,17156,17986
25600,12375333,12392408,12392751,0,0,17075,17418
25668,12390187,12391779,12392981,0,0,1592,2794
25670,12390663,12392391,12393021,0,0,1728,2358
25673,12391226,12393021,12393056,0,0,1795,1830
25619,12382164,12390239,12393097,0,0,8075,10933
25672,12391117,12392981,12393106,0,0,1864,1989
25636,12384347,12392087,12393204,0,0,7740,8857
25674,12392234,12393056,12393343,0,0,822,1109
25679,12393008,12393343,12393403,0,0,335,395
25677,12392690,12393106,12393477,0,0,416,787
25640,12384848,12393204,12393531,0,0,8356,8683
25646,12386194,12393477,12393868,0,0,7283,7674
25566,12368155,12384973,12394502,0,0,16818,26347
25615,12380682,12394502,12394834,0,0,13820,14152
25582,12372843,12385409,12394846,0,0,12566,22003
25617,12381920,12394834,12394859,0,0,12914,12939
25618,12381954,12394846,12394927,0,0,12892,12973
25588,12373479,12389088,12395176,0,0,15609,21697
25626,12382791,12394927,12395493,0,0,12136,12702
25633,12383699,12395493,12396018,0,0,11794,12319
25608,12377957,12394502,12396549,0,0,16545,18592
25637,12384628,12396018,12396566,0,0,11390,11938
25659,12388165,12393531,12398132,0,0,5366,9967
25630,12383274,12395176,12398199,0,0,11902,14925
25580,12372601,12385409,12398212,0,0,12808,25611
25649,12386463,12396566,12398823,0,0,10103,12360
25621,12382378,12394859,12398843,0,0,12481,16465
25651,12386783,12398199,12398881,0,0,11416,12098
25639,12384821,12393097,12399207,0,0,8276,14386
25680,12393788,12399207,12399284,0,0,5419,5496
25683,12394253,12399207,12399291,0,0,4954,5038
25684,12394838,12399284,12399350,0,0,4446,4512
25687,12395395,12399291,12399354,0,0,3896,3959
25689,12395670,12399350,12399405,0,0,3680,3735
25675,12392448,12398843,12400146,0,0,6395,7698
25681,12393905,12400146,12400341,0,0,6241,6436
25690,12396457,12399354,12400633,0,0,2897,4176
25682,12394239,12400146,12400738,0,0,5907,6499
25688,12395411,12400738,12401010,0,0,5327,5599
25604,12376754,12381170,12401682,0,0,4416,24928
25655,12387724,12398212,12401829,0,0,10488,14105
25657,12387876,12398823,12402175,0,0,10947,14299
25686,12395370,12401829,12402341,0,0,6459,6971
25694,12397668,12402175,12402478,0,0,4507,4810
25671,12391004,12393868,12402507,0,0,2864,11503
25700,12400763,12402478,12402549,0,0,1715,1786
25701,12400841,12402507,12402601,0,0,1666,1760
25702,12400943,12402507,12402616,0,0,1564,1673
25697,12398542,12402341,12402899,0,0,3799,4357
25603,12376153,12392751,12403381,0,0,16598,27228
25691,12396786,12401010,12403777,0,0,4224,6991
25642,12385740,12396549,12403852,0,0,10809,18112
25676,12392547,12398881,12403905,0,0,6334,11358
25705,12404335,12404335,12405283,0,0,0,948
25699,12400668,12402478,12405719,0,0,1810,5051
25678,12392701,12398132,12406159,0,0,5431,13458
25698,12399629,12402341,12406513,0,0,2712,6884
25685,12394943,12400341,12406630,0,0,5398,11687
25704,12403967,12403967,12407106,0,0,0,3139
25708,12407974,12407974,12408159,0,0,0,185
25710,12408663,12408663,12408744,0,0,0,81
25711,12408775,12408775,12409163,0,0,0,388
25707,12407042,12407042,12410745,0,0,0,3703
25706,12405297,12405719,12411308,0,0,422,6011
25714,12410944,12410944,12411406,0,0,0,462
25716,12411243,12411406,12411546,0,0,163,303
25717,12412328,12412328,12412409,0,0,0,81
25713,12410938,12411308,12414516,0,0,370,3578
25720,12414843,12414843,12414947,0,0,0,104
25718,12412612,12414516,12415142,0,0,1904,2530
25669,12390299,12403905,12417533,0,0,13606,27234
25709,12408289,12417533,12418893,0,0,9244,10604
25719,12414140,12415142,12419016,0,0,1002,4876
25721,12414948,12418893,12419758,0,0,3945,4810
25723,12417951,12418893,12422065,0,0,942,4114
25695,12398012,12401682,12422620,0,0,3670,24608
25703,12403930,12410745,12423106,0,0,6815,19176
25722,12416293,12419758,12425083,0,0,3465,8790
25724,12421054,12422065,12425288,0,0,1011,4234
25726,12424187,12424187,12427314,0,0,0,3127
25607,12377745,12425083,12437533,0,0,47338,59788
25728,12442474,12442474,12446805,0,0,0,4331
25653,12387115,12437533,12451421,0,0,50418,64306
25696,12398033,12402341,12451691,0,0,4308,53658
25662,12388716,12403381,12452447,0,0,14665,63731
25730,12452112,12452447,12454761,0,0,335,2649
25731,12456440,12456440,12459588,0,0,0,3148
25727,12427309,12427309,12472193,0,0,0,44884
25622,12382396,12382396,12472249,0,0,0,89853
25712,12410880,12451421,12473502,0,0,40541,62622
25692,12396891,12399405,12474759,0,0,2514,77868
25693,12397661,12400633,12475222,0,0,2972,77561
25737,12477005,12477005,12477173,0,0,0,168
25735,12476599,12476599,12477395,0,0,0,796
25738,12479758,12479758,12479772,0,0,0,14
25736,12476655,12476655,12480563,0,0,0,3908
25741,12481566,12481566,12481583,0,0,0,17
25742,12481658,12481658,12481667,0,0,0,9
25743,12481816,12481816,12481829,0,0,0,13
25739,12480110,12480110,12482725,0,0,0,2615
25740,12480499,12480499,12484252,0,0,0,3753
25715,12411189,12473502,12485009,0,0,62313,73820
25745,12485043,12485043,12485110,0,0,0,67
25746,12485139,12485139,12485564,0,0,0,425
25747,12485538,12485538,12485911,0,0,0,373
25748,12485579,12485579,12486317,0,0,0,738
25749,12486898,12486898,12487023,0,0,0,125
25750,12487715,12487715,12488166,0,0,0,451
25751,12488743,12488743,12488856,0,0,0,113
25732,12470518,12470518,12489037,0,0,0,18519
25752,12489405,12489405,12489526,0,0,0,121
25744,12484189,12484189,12490127,0,0,0,5938
25734,12473654,12473654,12490379,0,0,0,16725
25755,12491008,12491008,12491071,0,0,0,63
25725,12422981,12485009,12491099,0,0,62028,68118
25756,12491144,12491144,12491321,0,0,0,177
25733,12470748,12470748,12491344,0,0,0,20596
25754,12490065,12490065,12495608,0,0,0,5543
25753,12489994,12495608,12507059,0,0,5614,17065
25759,12500028,12507059,12508903,0,0,7031,8875
25758,12499799,12507059,12509952,0,0,7260,10153
25729,12450160,12491099,12510775,0,0,40939,60615
25761,12506770,12507059,12512009,0,0,289,5239
25760,12501862,12507059,12512014,0,0,5197,10152
25757,12495723,12507059,12513208,0,0,11336,17485
25763,12514909,12514909,12514986,0,0,0,77
25762,12511769,12511769,12516727,0,0,0,4958
25764,12516671,12516671,12522017,0,0,0,5346
25765,12522019,12522019,12525199,0,0,0,3180
25766,12525200,12525200,12528391,0,0,0,3191
25767,12528327,12528327,12531499,0,0,0,3172
25768,12531436,12531436,12534840,0,0,0,3404
25769,12534777,12534777,12537965,0,0,0,3188
25772,12539844,12539844,12541090,0,0,0,1246
25771,12537902,12537902,12541091,0,0,0,3189
25775,12542628,12542628,12542923,0,0,0,295
25774,12541030,12541030,12544216,0,0,0,3186
25777,12544218,12544218,12544577,0,0,0,359
25776,12544168,12544168,12547288,0,0,0,3120
25780,12547288,12547288,12547647,0,0,0,359
25770,12537120,12537120,12549089,0,0,0,11969
25782,12549026,12549026,12549300,0,0,0,274
25783,12551621,12551621,12551678,0,0,0,57
25773,12540869,12540869,12552325,0,0,0,11456
25781,12548831,12548831,12552327,0,0,0,3496
25779,12547281,12547281,12552331,0,0,0,5050
25784,12552308,12552308,12555485,0,0,0,3177
25787,12555674,12555674,12555994,0,0,0,320
25789,12556837,12556837,12557012,0,0,0,175
25793,12557524,12557524,12557543,0,0,0,19
25794,12557529,12557529,12557547,0,0,0,18
25795,12557538,12557538,12557561,0,0,0,23
25796,12557541,12557541,12557712,0,0,0,171
25797,12558208,12558208,12558459,0,0,0,251
25786,12555440,12555440,12560518,0,0,0,5078
25791,12557166,12557166,12563507,0,0,0,6341
25800,12563825,12563825,12565086,0,0,0,1261
25802,12565476,12565476,12565501,0,0,0,25
25803,12565486,12565486,12565504,0,0,0,18
25804,12565493,12565493,12565511,0,0,0,18
25805,12565611,12565611,12565738,0,0,0,127
25806,12565747,12565747,12566142,0,0,0,395
25801,12565325,12565325,12566416,0,0,0,1091
25798,12560458,12560458,12566466,0,0,0,6008
25808,12566524,12566524,12566614,0,0,0,90
25810,12566863,12566863,12566889,0,0,0,26
25811,12566930,12566930,12566993,0,0,0,63
25809,12566642,12566642,12567630,0,0,0,988
25814,12568711,12568711,12568766,0,0,0,55
25815,12568844,12568844,12568875,0,0,0,31
25816,12569097,12569097,12569132,0,0,0,35
25812,12567768,12567768,12569332,0,0,0,1564
25817,12569305,12569305,12569334,0,0,0,29
25819,12569691,12569691,12569723,0,0,0,32
25820,12569831,12569831,12569862,0,0,0,31
25821,12569906,12569906,12570019,0,0,0,113
25822,12570266,12570266,12570301,0,0,0,35
25823,12570277,12570277,12570346,0,0,0,69
25824,12570543,12570543,12570584,0,0,0,41
25825,12571386,12571386,12571428,0,0,0,42
25818,12569411,12569411,12571524,0,0,0,2113
25826,12571584,12571584,12571601,0,0,0,17
25827,12571803,12571803,12571821,0,0,0,18
25828,12572364,12572364,12572386,0,0,0,22
25829,12572624,12572624,12572642,0,0,0,18
25830,12572677,12572677,12572813,0,0,0,136
25831,12572835,12572835,12572851,0,0,0,16
25807,12566522,12566522,12572952,0,0,0,6430
25788,12556538,12556538,12573280,0,0,0,16742
25834,12573690,12573690,12573720,0,0,0,30
25835,12573873,12573873,12573901,0,0,0,28
25813,12567923,12567923,12574283,0,0,0,6360
25836,12574329,12574329,12574359,0,0,0,30
25837,12574515,12574515,12574541,0,0,0,26
25838,12574822,12574822,12574844,0,0,0,22
25839,12574955,12574955,12574978,0,0,0,23
25840,12575166,12575166,12575189,0,0,0,23
25841,12575439,12575439,12575468,0,0,0,29
25778,12544682,12552325,12575542,0,0,7643,30860
25842,12575795,12575795,12575827,0,0,0,32
25843,12575889,12575889,12575907,0,0,0,18
25833,12572897,12572897,12576201,0,0,0,3304
25844,12576225,12576225,12576264,0,0,0,39
25846,12576266,12576266,12576327,0,0,0,61
25832,12572872,12572872,12578777,0,0,0,5905
25845,12576253,12576253,12579448,0,0,0,3195
25848,12579616,12579616,12581191,0,0,0,1575
25849,12581270,12581270,12581314,0,0,0,44
25850,12581874,12581874,12581913,0,0,0,39
25851,12582160,12582160,12582204,0,0,0,44
25852,12582455,12582455,12582490,0,0,0,35
25854,12582559,12582559,12582597,0,0,0,38
25847,12579428,12579428,12582601,0,0,0,3173
25856,12582940,12582940,12582983,0,0,0,43
25858,12583272,12583272,12583304,0,0,0,32
25859,12583646,12583646,12583680,0,0,0,34
25860,12583986,12583986,12584116,0,0,0,130
25861,12584246,12584246,12584741,0,0,0,495
25857,12583236,12583236,12584825,0,0,0,1589
25785,12553582,12575542,12585010,0,0,21960,31428
25790,12556942,12585010,12585020,0,0,28068,28078
25863,12585501,12585501,12585528,0,0,0,27
25862,12585403,12585403,12585878,0,0,0,475
25853,12582545,12582545,12585879,0,0,0,3334
25855,12582566,12582566,12585974,0,0,0,3408
25865,12586277,12586277,12586538,0,0,0,261
25867,12586771,12586771,12586997,0,0,0,226
25868,12587170,12587170,12587299,0,0,0,129
25869,12587470,12587470,12587499,0,0,0,29
25799,12563795,12563795,12587679,0,0,0,23884
25870,12587711,12587711,12587845,0,0,0,134
25871,12588054,12588054,12588220,0,0,0,166
25866,12586440,12586440,12588312,0,0,0,1872
25872,12588332,12588332,12588487,0,0,0,155
25873,12588767,12588767,12588824,0,0,0,57
25874,12588964,12588964,12588996,0,0,0,32
25875,12589116,12589116,12589160,0,0,0,44
25876,12589292,12589292,12589365,0,0,0,73
25877,12589459,12589459,12589499,0,0,0,40
25878,12589515,12589515,12589548,0,0,0,33
25879,12589579,12589579,12589611,0,0,0,32
25880,12589668,12589668,12589703,0,0,0,35
25882,12589908,12589908,12589964,0,0,0,56
25883,12589992,12589992,12590031,0,0,0,39
25864,12585912,12585912,12590048,0,0,0,4136
25884,12590071,12590071,12590116,0,0,0,45
25885,12590177,12590177,12590222,0,0,0,45
25886,12590273,12590273,12590305,0,0,0,32
25881,12589726,12589726,12590603,0,0,0,877
25887,12590610,12590610,12590659,0,0,0,49
25888,12590678,12590678,12590714,0,0,0,36
25889,12590918,12590918,12590951,0,0,0,33
25890,12590977,12590977,12591013,0,0,0,36
25892,12591433,12591433,12591476,0,0,0,43
25893,12591613,12591613,12591658,0,0,0,45
25891,12591387,12591387,12592161,0,0,0,774
25792,12557429,12585020,12596521,0,0,27591,39092
25894,12613041,12613041,12616256,0,0,0,3215
25897,12616196,12616196,12619387,0,0,0,3191
25895,12613296,12613296,12621155,0,0,0,7859
25902,12621785,12621785,12621919,0,0,0,134
25899,12619325,12619325,12622465,0,0,0,3140
25906,12622893,12622893,12622926,0,0,0,33
25907,12622933,12622933,12622957,0,0,0,24
25903,12621845,12621845,12623184,0,0,0,1339
25908,12623291,12623291,12623531,0,0,0,240
25910,12623885,12623885,12623915,0,0,0,30
25911,12624167,12624167,12624280,0,0,0,113
25912,12624326,12624326,12624368,0,0,0,42
25913,12624386,12624386,12624419,0,0,0,33
25914,12624430,12624430,12624468,0,0,0,38
25915,12624633,12624633,12624660,0,0,0,27
25916,12624918,12624918,12624951,0,0,0,33
25917,12624943,12624943,12624954,0,0,0,11
25918,12624959,12624959,12624983,0,0,0,24
25920,12625018,12625018,12625049,0,0,0,31
25923,12625077,12625077,12625104,0,0,0,27
25919,12625014,12625014,12625222,0,0,0,208
25926,12625284,12625284,12625315,0,0,0,31
25922,12625041,12625222,12625317,0,0,181,276
25909,12623647,12623647,12626088,0,0,0,2441
25904,12622460,12622460,12626089,0,0,0,3629
25921,12625030,12625030,12627136,0,0,0,2106
25924,12625116,12625116,12627669,0,0,0,2553
25925,12625280,12625317,12628346,0,0,37,3066
25927,12626814,12626814,12628566,0,0,0,1752
25896,12614191,12621155,12629090,0,0,6964,14899
25931,12627664,12627664,12629212,0,0,0,1548
25936,12628568,12629212,12629351,0,0,644,783
25932,12627676,12628346,12629370,0,0,670,1694
25941,12629062,12629370,12629517,0,0,308,455
25945,12629647,12629647,12629706,0,0,0,59
25928,12626889,12626889,12629774,0,0,0,2885
25942,12629256,12629774,12629846,0,0,518,590
25939,12628734,12629351,12629968,0,0,617,1234
25946,12629861,12629861,12630854,0,0,0,993
25940,12628883,12629370,12631057,0,0,487,2174
25952,12630988,12631057,12631079,0,0,69,91
25949,12630390,12630854,12631204,0,0,464,814
25954,12631187,12631204,12631243,0,0,17,56
25953,12631170,12631170,12631277,0,0,0,107
25951,12630756,12631277,12631326,0,0,521,570
25930,12627654,12627654,12631574,0,0,0,3920
25929,12627547,12627547,12631914,0,0,0,4367
25947,12629907,12629907,12631933,0,0,0,2026
25898,12616636,12616636,12632293,0,0,0,15657
25956,12631303,12631326,12632537,0,0,23,1234
25937,12628587,12629212,12632543,0,0,625,3956
25950,12630443,12632543,12632822,0,0,2100,2379
25960,12631947,12631947,12632846,0,0,0,899
25962,12632630,12632822,12632858,0,0,192,228
25935,12628335,12628566,12633127,0,0,231,4792
25964,12632798,12632846,12633177,0,0,48,379
25967,12633229,12633229,12633540,0,0,0,311
25963,12632792,12632822,12633719,0,0,30,927
25971,12634307,12634307,12634335,0,0,0,28
25968,12633270,12633540,12634362,0,0,270,1092
25972,12634545,12634545,12634670,0,0,0,125
25961,12632603,12632822,12635205,0,0,219,2602
25959,12631847,12631847,12635462,0,0,0,3615
25965,12632916,12632916,12635560,0,0,0,2644
25948,12630093,12630093,12635634,0,0,0,5541
25974,12635638,12635638,12636085,0,0,0,447
25966,12632922,12633127,12636273,0,0,205,3351
25944,12629523,12632293,12636318,0,0,2770,6795
25977,12636264,12636264,12636405,0,0,0,141
25975,12635872,12636273,12636874,0,0,401,1002
25981,12636709,12636874,12637008,0,0,165,299
25980,12636694,12636874,12637237,0,0,180,543
25982,12636954,12637237,12637333,0,0,283,379
25979,12636519,12636519,12637404,0,0,0,885
25978,12636301,12636301,12637468,0,0,0,1167
25984,12637563,12637563,12637829,0,0,0,266
25985,12638439,12638439,12638505,0,0,0,66
25973,12635460,12635460,12638829,0,0,0,3369
25976,12636137,12636318,12639620,0,0,181,3483
25970,12634296,12634296,12640157,0,0,0,5861
25992,12639913,12640157,12640202,0,0,244,289
25996,12640161,12640202,12640258,0,0,41,97
25989,12638887,12639620,12640266,0,0,733,1379
25997,12640324,12640324,12640407,0,0,0,83
25999,12640706,12640706,12640772,0,0,0,66
26000,12640796,12640796,12641259,0,0,0,463
25987,12638748,12638748,12641313,0,0,0,2565
26002,12641346,12641346,12641577,0,0,0,231
25900,12619895,12629090,12641803,0,0,9195,21908
25969,12633492,12635560,12642058,0,0,2068,8566
26005,12642199,12642199,12642468,0,0,0,269
26006,12642657,12642657,12642763,0,0,0,106
26004,12642076,12642076,12642924,0,0,0,848
26008,12643013,12643013,12643115,0,0,0,102
26009,12643159,12643159,12643220,0,0,0,61
26010,12643410,12643410,12643429,0,0,0,19
26011,12643452,12643452,12643475,0,0,0,23
25988,12638826,12638829,12643542,0,0,3,4716
26007,12642947,12642947,12643669,0,0,0,722
26013,12643829,12643829,12643905,0,0,0,76
25983,12637351,12637351,12643935,0,0,0,6584
25990,12639318,12640266,12644068,0,0,948,4750
26015,12644235,12644235,12644268,0,0,0,33
26014,12644097,12644097,12644414,0,0,0,317
26017,12644354,12644414,12644468,0,0,60,114
26018,12644525,12644525,12644577,0,0,0,52
26020,12644592,12644592,12644990,0,0,0,398
26021,12645001,12645001,12645031,0,0,0,30
25986,12638500,12638505,12645104,0,0,5,6604
26022,12645139,12645139,12645166,0,0,0,27
26024,12645259,12645259,12645308,0,0,0,49
26023,12645239,12645239,12645572,0,0,0,333
26016,12644291,12644291,12645943,0,0,0,1652
26012,12643474,12643542,12647793,0,0,68,4319
26027,12646067,12647793,12647807,0,0,1726,1740
26026,12646037,12647793,12647824,0,0,1756,1787
26028,12646109,12647807,12647836,0,0,1698,1727
26029,12646256,12647824,12647886,0,0,1568,1630
26031,12646410,12647886,12647901,0,0,1476,1491
26030,12646310,12647836,12648500,0,0,1526,2190
26033,12646777,12648500,12648546,0,0,1723,1769
26034,12646820,12648546,12648559,0,0,1726,1739
26032,12646696,12647901,12649000,0,0,1205,2304
26036,12646879,12648559,12649096,0,0,1680,2217
26038,12647270,12649096,12649610,0,0,1826,2340
26039,12647347,12649610,12649832,0,0,2263,2485
26041,12647681,12649832,12649875,0,0,2151,2194
26044,12647994,12649875,12649948,0,0,1881,1954
25901,12621266,12641803,12650103,0,0,20537,28837
25905,12622516,12650103,12651090,0,0,27587,28574
26045,12648010,12649948,12651317,0,0,1938,3307
26025,12645965,12645965,12654836,0,0,0,8871
26048,12648221,12654836,12654887,0,0,6615,6666
26049,12648374,12654887,12654960,0,0,6513,6586
26047,12648203,12651317,12654963,0,0,3114,6760
26051,12648818,12654960,12655002,0,0,6142,6184
26054,12648981,12654963,12655039,0,0,5982,6058
26056,12649308,12655039,12655045,0,0,5731,5737
26057,12649397,12655045,12655118,0,0,5648,5721
26058,12649544,12655118,12655121,0,0,5574,5577
26059,12649565,12655121,12655124,0,0,5556,5559
25991,12639439,12642058,12655238,0,0,2619,15799
25995,12640156,12655238,12655241,0,0,15082,15085
25994,12639972,12645943,12655375,0,0,5971,15403
26060,12649843,12655124,12655412,0,0,5281,5569
26061,12649878,12655412,12655416,0,0,5534,5538
26037,12647126,12649000,12655511,0,0,1874,8385
26065,12650477,12655511,12655547,0,0,5034,5070
26066,12650551,12655547,12655577,0,0,4996,5026
25933,12627911,12651090,12655597,0,0,23179,27686
26068,12650727,12655577,12655604,0,0,4850,4877
26040,12647437,12655375,12655643,0,0,7938,8206
26071,12650965,12655604,12655737,0,0,4639,4772
26064,12650164,12655416,12655782,0,0,5252,5618
26035,12646831,12655375,12655807,0,0,8544,8976
26046,12648156,12655807,12655846,0,0,7651,7690
26042,12647716,12655643,12656153,0,0,7927,8437
26079,12653212,12655737,12656166,0,0,2525,2954
26062,12649993,12655846,12656253,0,0,5853,6260
26069,12650810,12656253,12656275,0,0,5443,5465
26073,12651025,12656275,12656308,0,0,5250,5283
26086,12656085,12656166,12656618,0,0,81,533
26083,12654896,12655782,12657287,0,0,886,2391
26067,12650650,12656153,12657444,0,0,5503,6794
26087,12656938,12656938,12657469,0,0,0,531
26084,12655310,12657469,12657680,0,0,2159,2370
25993,12639956,12644068,12658159,0,0,4112,18203
25934,12628246,12655597,12658687,0,0,27351,30441
25955,12631199,12658687,12658940,0,0,27488,27741
25998,12640368,12658940,12658958,0,0,18572,18590
26043,12647835,12658159,12659553,0,0,10324,11718
26063,12650042,12659553,12659714,0,0,9511,9672
26085,12656024,12657680,12659862,0,0,1656,3838
26055,12649048,12655002,12660098,0,0,5954,11050
26082,12654261,12657444,12660830,0,0,3183,6569
26091,12658206,12660830,12660989,0,0,2624,2783
26019,12644534,12655241,12661464,0,0,10707,16930
26072,12651002,12661464,12661661,0,0,10462,10659
26080,12653547,12656308,12662506,0,0,2761,8959
26095,12660566,12662506,12662698,0,0,1940,2132
26097,12661933,12661933,12662960,0,0,0,1027
26098,12662858,12662960,12663805,0,0,102,947
26101,12663563,12663805,12663999,0,0,242,436
26076,12652197,12661661,12664594,0,0,9464,12397
26077,12652365,12664594,12664697,0,0,12229,12332
26089,12657645,12659862,12665295,0,0,2217,7650
25943,12629504,12655597,12665780,0,0,26093,36276
26070,12650957,12659714,12665823,0,0,8757,14866
26104,12663946,12665295,12666018,0,0,1349,2072
26003,12641769,12658958,12666033,0,0,17189,24264
26078,12652618,12664697,12666523,0,0,12079,13905
26088,12657345,12666523,12667247,0,0,9178,9902
26094,12659749,12660989,12667264,0,0,1240,7515
26050,12648624,12665780,12667389,0,0,17156,18765
26053,12648941,12667389,12667412,0,0,18448,18471
26096,12660999,12662698,12668600,0,0,1699,7601
26102,12663712,12663999,12668632,0,0,287,4920
26108,12666045,12668600,12668660,0,0,2555,2615
26110,12667492,12668660,12668766,0,0,1168,1274
26111,12667880,12668766,12668800,0,0,886,920
26109,12666976,12668632,12668837,0,0,1656,1861
26105,12664769,12666018,12668894,0,0,1249,4125
26113,12668556,12668894,12668929,0,0,338,373
26114,12668797,12668800,12668947,0,0,3,150
26103,12663903,12665295,12669307,0,0,1392,5404
26092,12658505,12667247,12670038,0,0,8742,11533
26117,12670495,12670495,12670532,0,0,0,37
26093,12658526,12669307,12671087,0,0,10781,12561
26116,12670374,12670374,12671244,0,0,0,870
26120,12671927,12671927,12671967,0,0,0,40
26107,12665966,12667264,12672161,0,0,1298,6195
26119,12671822,12671822,12672176,0,0,0,354
26099,12662866,12672176,12672320,0,0,9310,9454
26100,12662872,12672320,12672470,0,0,9448,9598
26112,12668267,12668800,12672555,0,0,533,4288
26052,12648870,12666033,12673571,0,0,17163,24701
26081,12654124,12665823,12674170,0,0,11699,20046
26123,12672719,12674170,12674745,0,0,1451,2026
26115,12669308,12673571,12674816,0,0,4263,5508
26124,12672992,12674816,12674853,0,0,1824,1861
26090,12658044,12667412,12674970,0,0,9368,16926
26126,12674908,12674908,12675076,0,0,0,168
25938,12628704,12675076,12675196,0,0,46372,46492
25957,12631729,12675196,12675323,0,0,43467,43594
26121,12672196,12672555,12676124,0,0,359,3928
26118,12670862,12670862,12677121,0,0,0,6259
26106,12665605,12672470,12679559,0,0,6865,13954
26122,12672680,12674170,12680368,0,0,1490,7688
26130,12677195,12680368,12680468,0,0,3173,3273
26128,12676516,12676516,12681826,0,0,0,5310
26129,12677055,12677121,12682008,0,0,66,4953
26125,12673349,12674170,12684333,0,0,821,10984
26127,12675690,12679559,12688175,0,0,3869,12485
26074,12651657,12675323,12689084,0,0,23666,37427
26075,12652050,12689084,12703103,0,0,37034,51053
26134,12708104,12708104,12708503,0,0,0,399
26137,12709435,12709435,12710108,0,0,0,673
26131,12705560,12705560,12710502,0,0,0,4942
26136,12708191,12708191,12712789,0,0,0,4598
26138,12710370,12712789,12712957,0,0,2419,2587
26140,12710773,12712957,12713095,0,0,2184,2322
26141,12711315,12713095,12713196,0,0,1780,1881
26142,12711442,12713196,12713422,0,0,1754,1980
26145,12713166,12713422,12713433,0,0,256,267
26146,12713282,12713422,12713435,0,0,140,153
26144,12713123,12713422,12713436,0,0,299,313
26147,12713666,12713666,12713741,0,0,0,75
26132,12705805,12705805,12714043,0,0,0,8238
26148,12713753,12713753,12714294,0,0,0,541
26150,12714206,12714206,12714296,0,0,0,90
26151,12714418,12714418,12714487,0,0,0,69
26135,12708128,12708128,12714747,0,0,0,6619
26155,12715214,12715214,12715249,0,0,0,35
26156,12715331,12715331,12715379,0,0,0,48
26154,12715175,12715175,12715440,0,0,0,265
26158,12715506,12715506,12715597,0,0,0,91
26152,12714497,12714497,12716343,0,0,0,1846
26157,12715458,12715458,12716465,0,0,0,1007
26143,12712687,12712687,12716994,0,0,0,4307
26149,12714039,12714039,12717136,0,0,0,3097
26163,12716680,12717136,12717160,0,0,456,480
26164,12716875,12717136,12717169,0,0,261,294
26161,12716519,12716994,12717467,0,0,475,948
26153,12715164,12715164,12718788,0,0,0,3624
26169,12719107,12719107,12719580,0,0,0,473
26170,12719282,12719580,12719633,0,0,298,351
26162,12716545,12716994,12720973,0,0,449,4428
26174,12719596,12719633,12721115,0,0,37,1519
26165,12717496,12717496,12721117,0,0,0,3621
26175,12720105,12721115,12721165,0,0,1010,1060
26159,12716225,12716225,12721360,0,0,0,5135
26160,12716494,12716494,12721386,0,0,0,4892
26173,12719417,12721386,12721463,0,0,1969,2046
26172,12719341,12721360,12721473,0,0,2019,2132
26176,12720197,12721117,12721506,0,0,920,1309
26178,12721483,12721483,12721545,0,0,0,62
26177,12720866,12721463,12721581,0,0,597,715
26166,12717705,12717705,12721706,0,0,0,4001
26167,12718712,12718712,12721724,0,0,0,3012
26180,12721819,12721819,12722038,0,0,0,219
26179,12721570,12721581,12722154,0,0,11,584
26168,12719056,12721545,12722194,0,0,2489,3138
26185,12722159,12722194,12722260,0,0,35,101
26184,12722144,12722194,12722321,0,0,50,177
26182,12722087,12722087,12722402,0,0,0,315
26187,12722525,12722525,12722767,0,0,0,242
26133,12706599,12710502,12723850,0,0,3903,17251
26191,12723426,12723426,12724080,0,0,0,654
26192,12723788,12723788,12724120,0,0,0,332
26190,12723378,12723378,12724338,0,0,0,960
26196,12724825,12724825,12724952,0,0,0,127
26188,12722831,12722831,12725198,0,0,0,2367
26200,12725375,12725375,12725588,0,0,0,213
26201,12725438,12725438,12725654,0,0,0,216
26197,12724900,12724900,12726013,0,0,0,1113
26198,12725062,12725062,12726264,0,0,0,1202
26205,12726008,12726008,12726329,0,0,0,321
26195,12724708,12724708,12726343,0,0,0,1635
26202,12725492,12726264,12726422,0,0,772,930
26183,12722122,12722154,12726869,0,0,32,4747
26210,12726695,12726695,12726873,0,0,0,178
26209,12726604,12726604,12727175,0,0,0,571
26203,12725667,12726422,12727267,0,0,755,1600
26204,12725718,12726873,12727601,0,0,1155,1883
26181,12722052,12722052,12727689,0,0,0,5637
26208,12726533,12727689,12727773,0,0,1156,1240
26207,12726299,12727601,12727834,0,0,1302,1535
26212,12726867,12727773,12727868,0,0,906,1001
26216,12727580,12727834,12727924,0,0,254,344
26215,12727522,12727868,12727946,0,0,346,424
26219,12727793,12727834,12727971,0,0,41,178
26221,12727935,12727935,12728005,0,0,0,70
26220,12727813,12727946,12728045,0,0,133,232
26186,12722184,12722260,12728270,0,0,76,6086
26222,12728119,12728119,12728739,0,0,0,620
26214,12727444,12727834,12728868,0,0,390,1424
26206,12726033,12727267,12728966,0,0,1234,2933
26223,12728144,12728739,12729100,0,0,595,956
26224,12728194,12728194,12729395,0,0,0,1201
26226,12728817,12728966,12729464,0,0,149,647
26236,12729648,12729648,12729754,0,0,0,106
26239,12729779,12729779,12729966,0,0,0,187
26235,12729588,12729588,12730052,0,0,0,464
26234,12729582,12729582,12730287,0,0,0,705
26218,12727764,12727834,12730365,0,0,70,2601
26237,12729685,12730052,12730444,0,0,367,759
26241,12730267,12730287,12730557,0,0,20,290
26227,12728864,12728864,12730845,0,0,0,1981
26243,12730827,12730827,12730964,0,0,0,137
26245,12730935,12730935,12731043,0,0,0,108
26213,12726946,12727175,12731091,0,0,229,4145
26238,12729725,12730444,12731122,0,0,719,1397
26250,12731529,12731529,12731704,0,0,0,175
26252,12731681,12731704,12731732,0,0,23,51
26253,12731695,12731732,12731777,0,0,37,82
26254,12731702,12731777,12731806,0,0,75,104
26225,12728210,12728270,12731825,0,0,60,3615
26240,12729835,12731043,12731825,0,0,1208,1990
26257,12732463,12732463,12732614,0,0,0,151
26244,12730926,12731122,12732744,0,0,196,1818
26256,12732424,12732424,12733211,0,0,0,787
26265,12733597,12733597,12733651,0,0,0,54
26261,12733285,12733285,12733760,0,0,0,475
26264,12733566,12733760,12733850,0,0,194,284
26266,12733660,12733850,12733866,0,0,190,206
26268,12733793,12733866,12733879,0,0,73,86
26247,12731194,12732744,12734273,0,0,1550,3079
26248,12731348,12734273,12734891,0,0,2925,3543
26249,12731503,12734891,12735214,0,0,3388,3711
26228,12729004,12729004,12735326,0,0,0,6322
26139,12710610,12723850,12735366,0,0,13240,24756
26246,12731030,12731825,12736191,0,0,795,5161
26272,12734303,12735326,12736496,0,0,1023,2193
26275,12735860,12736496,12736709,0,0,636,849
26259,12732973,12732973,12737285,0,0,0,4312
26171,12719294,12735366,12737294,0,0,16072,18000
26193,12724121,12737294,12737642,0,0,13173,13521
26189,12723001,12737294,12737963,0,0,14293,14962
26277,12736190,12737285,12738141,0,0,1095,1951
26194,12724613,12737642,12738270,0,0,13029,13657
26279,12736493,12738141,12738505,0,0,1648,2012
26251,12731570,12735214,12738587,0,0,3644,7017
26276,12736085,12736709,12739041,0,0,624,2956
26283,12737034,12739041,12739088,0,0,2007,2054
26199,12725236,12737963,12739301,0,0,12727,14065
26229,12729067,12739301,12739659,0,0,10234,10592
26258,12732674,12738587,12739756,0,0,5913,7082
26270,12733878,12739756,12740425,0,0,5878,6547
26233,12729430,12729430,12740576,0,0,0,11146
26211,12726742,12738270,12740599,0,0,11528,13857
26278,12736297,12740576,12740632,0,0,4279,4335
26230,12729154,12739659,12740776,0,0,10505,11622
26273,12735244,12740425,12740849,0,0,5181,5605
26291,12738177,12740849,12740886,0,0,2672,2709
26289,12737935,12740849,12740892,0,0,2914,2957
26287,12737590,12740632,12740959,0,0,3042,3369
26232,12729408,12729408,12741047,0,0,0,11639
26260,12733144,12740776,12741052,0,0,7632,7908
26262,12733416,12741052,12741083,0,0,7636,7667
26263,12733469,12741083,12741183,0,0,7614,7714
26281,12736838,12738505,12741242,0,0,1667,4404
26267,12733673,12741183,12741261,0,0,7510,7588
26255,12731720,12736191,12741464,0,0,4471,9744
26231,12729269,12740599,12741564,0,0,11330,12295
26280,12736539,12741564,12741982,0,0,5025,5443
26271,12734251,12741261,12742242,0,0,7010,7991
26284,12737231,12741982,12742294,0,0,4751,5063
26294,12739826,12740892,12742355,0,0,1066,2529
26274,12735327,12740425,12742671,0,0,5098,7344
26286,12737516,12739088,12743707,0,0,1572,6191
26288,12737831,12740632,12745363,0,0,2801,7532
26295,12741106,12741106,12745812,0,0,0,4706
26282,12736990,12741464,12746523,0,0,4474,9533
26290,12737976,12741982,12746547,0,0,4006,8571
26285,12737451,12742242,12746931,0,0,4791,9480
26217,12727680,12746931,12747110,0,0,19251,19430
26292,12738655,12740886,12747136,0,0,2231,8481
26298,12748140,12748140,12748160,0,0,0,20
26293,12739274,12742294,12748316,0,0,3020,9042
26269,12733838,12733879,12748740,0,0,41,14902
26242,12730429,12747110,12748747,0,0,16681,18318
26001,12641304,12641304,12748753,0,0,0,107449
26300,12751098,12751098,12751243,0,0,0,145
26301,12751982,12751982,12753326,0,0,0,1344
26296,12742552,12748747,12754118,0,0,6195,11566
26304,12754139,12754139,12754162,0,0,0,23
26305,12754311,12754311,12754660,0,0,0,349
26307,12756487,12756487,12756687,0,0,0,200
26308,12756670,12756687,12756877,0,0,17,207
26309,12756679,12756877,12756947,0,0,198,268
26302,12752951,12752951,12757084,0,0,0,4133
26311,12757152,12757152,12757231,0,0,0,79
26297,12745222,12745222,12757513,0,0,0,12291
26313,12757471,12757513,12757564,0,0,42,93
26306,12754975,12754975,12757609,0,0,0,2634
26310,12757074,12757074,12757809,0,0,0,735
26312,12757458,12757458,12757855,0,0,0,397
26314,12757685,12757855,12757879,0,0,170,194
26316,12758039,12758039,12758059,0,0,0,20
26315,12757703,12757879,12758065,0,0,176,362
26299,12749400,12749400,12758111,0,0,0,8711
26320,12758465,12758465,12758490,0,0,0,25
26319,12758448,12758448,12758492,0,0,0,44
26321,12758608,12758608,12758954,0,0,0,346
26317,12758115,12758115,12758968,0,0,0,853
26318,12758425,12758425,12759003,0,0,0,578
26303,12753844,12753844,12759055,0,0,0,5211
26324,12759245,12759245,12759537,0,0,0,292
26327,12759971,12759971,12760032,0,0,0,61
26328,12760007,12760007,12760118,0,0,0,111
26329,12760358,12760358,12760421,0,0,0,63
26330,12760440,12760440,12760819,0,0,0,379
26331,12760943,12760943,12761001,0,0,0,58
26325,12759548,12759548,12761648,0,0,0,2100
26333,12761784,12761784,12761844,0,0,0,60
26334,12761864,12761864,12761901,0,0,0,37
26335,12762060,12762060,12762122,0,0,0,62
26336,12762362,12762362,12762421,0,0,0,59
26337,12762417,12762417,12762513,0,0,0,96
26338,12762700,12762700,12762758,0,0,0,58
26339,12762738,12762738,12762794,0,0,0,56
26340,12762957,12762957,12762970,0,0,0,13
26341,12762970,12762970,12762993,0,0,0,23
26342,12762987,12762987,12763035,0,0,0,48
26343,12763210,12763210,12763305,0,0,0,95
26344,12763426,12763426,12763616,0,0,0,190
26345,12763624,12763624,12763681,0,0,0,57
26346,12763856,12763856,12763920,0,0,0,64
26347,12764032,12764032,12764241,0,0,0,209
26348,12764577,12764577,12764675,0,0,0,98
26350,12765151,12765151,12765217,0,0,0,66
26349,12764700,12764700,12765231,0,0,0,531
26351,12765373,12765373,12765727,0,0,0,354
26322,12758993,12758993,12766217,0,0,0,7224
26326,12759805,12759805,12767461,0,0,0,7656
26332,12761030,12761030,12769660,0,0,0,8630
26352,12766220,12766220,12770668,0,0,0,4448
26353,12770727,12770727,12773922,0,0,0,3195
26354,12773856,12773856,12776958,0,0,0,3102
26355,12776951,12776951,12780378,0,0,0,3427
26323,12759238,12759238,12781598,0,0,0,22360
26356,12780308,12780308,12783501,0,0,0,3193
26357,12783441,12783441,12786647,0,0,0,3206
26358,12786580,12786580,12789767,0,0,0,3187
26363,12791780,12791780,12791846,0,0,0,66
26359,12789696,12789696,12792838,0,0,0,3142
26364,12792713,12792713,12793058,0,0,0,345
26362,12791442,12791442,12795959,0,0,0,4517
26365,12792820,12792820,12796236,0,0,0,3416
26370,12796521,12796521,12796674,0,0,0,153
26371,12796635,12796635,12796674,0,0,0,39
26373,12796985,12796985,12797183,0,0,0,198
26372,12796876,12796876,12797241,0,0,0,365
26374,12797177,12797183,12797327,0,0,6,150
26366,12793658,12795959,12798451,0,0,2301,4793
26367,12795984,12798451,12798462,0,0,2467,2478
26377,12798138,12798462,12798551,0,0,324,413
26360,12789841,12789841,12798632,0,0,0,8791
26386,12798651,12798651,12798670,0,0,0,19
26381,12798503,12798503,12798676,0,0,0,173
26389,12798818,12798818,12799009,0,0,0,191
26379,12798466,12798466,12799156,0,0,0,690
26376,12797878,12797878,12799324,0,0,0,1446
26391,12799398,12799398,12799517,0,0,0,119
26369,12796179,12796179,12799519,0,0,0,3340
26387,12798670,12798670,12799635,0,0,0,965
26393,12799649,12799649,12800394,0,0,0,745
26397,12800792,12800792,12800900,0,0,0,108
26396,12800665,12800665,12800903,0,0,0,238
26398,12800991,12800991,12801179,0,0,0,188
26399,12801005,12801005,12801195,0,0,0,190
26368,12796049,12796049,12801336,0,0,0,5287
26401,12801382,12801382,12801458,0,0,0,76
26400,12801375,12801375,12801549,0,0,0,174
26402,12801438,12801438,12801579,0,0,0,141
26375,12797287,12797287,12801924,0,0,0,4637
26378,12798143,12801924,12801927,0,0,3781,3784
26380,12798486,12801927,12801929,0,0,3441,3443
26382,12798525,12801929,12801932,0,0,3404,3407
26383,12798579,12801932,12801935,0,0,3353,3356
26385,12798642,12801935,12801937,0,0,3293,3295
26395,12800477,12800477,12802379,0,0,0,1902
26404,12802167,12802379,12802441,0,0,212,274
26392,12799463,12799463,12802678,0,0,0,3215
26388,12798793,12801937,12802734,0,0,3144,3941
26361,12791404,12798632,12803013,0,0,7228,11609
26410,12804305,12804305,12804716,0,0,0,411
26403,12801794,12801794,12805053,0,0,0,3259
26413,12805465,12805465,12806035,0,0,0,570
26414,12806077,12806077,12806317,0,0,0,240
26407,12802714,12802714,12806866,0,0,0,4152
26412,12804747,12804747,12807145,0,0,0,2398
26416,12806891,12807145,12808947,0,0,254,2056
26417,12807141,12808947,12809244,0,0,1806,2103
26419,12807636,12809244,12809378,0,0,1608,1742
26384,12798607,12798607,12810577,0,0,0,11970
26421,12808293,12809378,12810966,0,0,1085,2673
26423,12808604,12810966,12811739,0,0,2362,3135
26424,12808734,12811739,12812065,0,0,3005,3331
26415,12806830,12810577,12812201,0,0,3747,5371
26418,12807168,12812201,12812440,0,0,5033,5272
26420,12807976,12812201,12812517,0,0,4225,4541
26427,12809369,12812517,12813167,0,0,3148,3798
26430,12810172,12813167,12813328,0,0,2995,3156
26431,12810314,12813328,12813682,0,0,3014,3368
26405,12802478,12803013,12813982,0,0,535,11504
26390,12798830,12802734,12814215,0,0,3904,15385
26435,12811132,12813682,12815224,0,0,2550,4092
26425,12808783,12812065,12816418,0,0,3282,7635
26406,12802645,12802645,12816436,0,0,0,13791
26394,12800059,12803013,12816607,0,0,2954,16548
26447,12814373,12816418,12816669,0,0,2045,2296
26436,12811219,12816607,12816690,0,0,5388,5471
26422,12808420,12812440,12816696,0,0,4020,8276
26437,12811465,12816607,12816717,0,0,5142,5252
26450,12815072,12816669,12816729,0,0,1597,1657
26451,12815165,12816729,12816765,0,0,1564,1600
26445,12813927,12816717,12816807,0,0,2790,2880
26448,12814762,12816807,12816885,0,0,2045,2123
26440,12812490,12816690,12816975,0,0,4200,4485
26426,12808893,12812517,12817011,0,0,3624,8118
26449,12814893,12816436,12817130,0,0,1543,2237
26433,12810818,12816607,12817198,0,0,5789,6380
26439,12811981,12817198,12817371,0,0,5217,5390
26429,12809964,12814215,12817682,0,0,4251,7718
26443,12813499,12817682,12817716,0,0,4183,4217
26461,12817649,12817716,12818004,0,0,67,355
26456,12816308,12816885,12818209,0,0,577,1901
26411,12804376,12806866,12818378,0,0,2490,14002
26438,12811792,12815224,12818667,0,0,3432,6875
26464,12818259,12818378,12818712,0,0,119,453
26463,12818185,12818185,12819306,0,0,0,1121
26459,12816847,12816975,12819388,0,0,128,2541
26467,12818716,12818716,12819819,0,0,0,1103
26470,12819857,12819857,12819949,0,0,0,92
26468,12818996,12819306,12820167,0,0,310,1171
26462,12818034,12818034,12820203,0,0,0,2169
26457,12816467,12816885,12820254,0,0,418,3787
26471,12819934,12819949,12820284,0,0,15,350
26428,12809695,12813982,12820530,0,0,4287,10835
26466,12818491,12818491,12820656,0,0,0,2165
26453,12815646,12816765,12820699,0,0,1119,5053
26475,12820425,12820425,12820966,0,0,0,541
26476,12820913,12820966,12821151,0,0,53,238
26460,12817186,12817186,12821169,0,0,0,3983
26477,12820940,12821151,12821713,0,0,211,773
26480,12821529,12821529,12821856,0,0,0,327
26441,12812622,12816696,12821994,0,0,4074,9372
26479,12821169,12821994,12822073,0,0,825,904
26465,12818311,12818712,12822887,0,0,401,4576
26472,12820030,12820030,12823373,0,0,0,3343
26488,12823298,12823298,12823461,0,0,0,163
26482,12821985,12821985,12823512,0,0,0,1527
26486,12822743,12822887,12823533,0,0,144,790
26490,12823739,12823739,12823908,0,0,0,169
26491,12823756,12823908,12823931,0,0,152,175
26492,12824179,12824179,12824341,0,0,0,162
26489,12823723,12823723,12824876,0,0,0,1153
26487,12822934,12823461,12825661,0,0,527,2727
26496,12824720,12825661,12825850,0,0,941,1130
26500,12825589,12825850,12825924,0,0,261,335
26495,12824626,12824876,12825978,0,0,250,1352
26474,12820251,12820251,12826018,0,0,0,5767
26483,12822408,12826018,12826070,0,0,3610,3662
26502,12825905,12825978,12826092,0,0,73,187
26485,12822614,12826070,12826096,0,0,3456,3482
26503,12825982,12826092,12826213,0,0,110,231
26454,12815803,12820530,12826217,0,0,4727,10414
26442,12813469,12817371,12826248,0,0,3902,12779
26494,12824258,12826096,12826408,0,0,1838,2150
26498,12825252,12826408,12826481,0,0,1156,1229
26505,12826089,12826408,12826491,0,0,319,402
26493,12824192,12824341,12826506,0,0,149,2314
26507,12826241,12826481,12826573,0,0,240,332
26508,12826529,12826529,12826671,0,0,0,142
26458,12816731,12817682,12827009,0,0,951,10278
26409,12803744,12803744,12827026,0,0,0,23282
26501,12825652,12825924,12827193,0,0,272,1541
26506,12826095,12826408,12827255,0,0,313,1160
26497,12825189,12826248,12827382,0,0,1059,2193
26511,12827266,12827266,12827383,0,0,0,117
26499,12825416,12825661,12827564,0,0,245,2148
26509,12826925,12826925,12827879,0,0,0,954
26515,12827997,12827997,12828245,0,0,0,248
26518,12828209,12828245,12828326,0,0,36,117
26484,12822489,12822489,12828366,0,0,0,5877
26517,12828061,12828245,12828569,0,0,184,508
26513,12827375,12827375,12828652,0,0,0,1277
26521,12828600,12828652,12828765,0,0,52,165
26510,12827116,12827116,12828862,0,0,0,1746
26522,12828657,12828862,12828934,0,0,205,277
26523,12828878,12828878,12828983,0,0,0,105
26504,12826042,12826213,12829033,0,0,171,2991
26481,12821864,12826217,12829227,0,0,4353,7363
26514,12827869,12827869,12829395,0,0,0,1526
26519,12828366,12828366,12830640,0,0,0,2274
26524,12829418,12830640,12830945,0,0,1222,1527
26516,12828041,12828041,12831344,0,0,0,3303
26529,12829857,12831344,12831380,0,0,1487,1523
26530,12829902,12831380,12831411,0,0,1478,1509
26528,12829764,12831344,12831424,0,0,1580,1660
26478,12821034,12821713,12831441,0,0,679,10407
26536,12831190,12831441,12831651,0,0,251,461
26527,12829755,12831344,12831919,0,0,1589,2164
26534,12830969,12831441,12832049,0,0,472,1080
26526,12829703,12830945,12832345,0,0,1242,2642
26525,12829439,12830945,12832348,0,0,1506,2909
26533,12830859,12831424,12834086,0,0,565,3227
26520,12828406,12828569,12835210,0,0,163,6804
26535,12831099,12832049,12838418,0,0,950,7319
26531,12830377,12831380,12838919,0,0,1003,8542
26540,12838878,12838878,12838956,0,0,0,78
26541,12838963,12838963,12839113,0,0,0,150
26408,12803621,12829395,12839352,0,0,25774,35731
26432,12810589,12839352,12839374,0,0,28763,28785
26434,12811069,12839374,12840054,0,0,28305,28985
26537,12834904,12834904,12841580,0,0,0,6676
26544,12839485,12841580,12841639,0,0,2095,2154
26538,12835008,12835210,12842239,0,0,202,7231
26548,12843205,12843205,12843389,0,0,0,184
26542,12839293,12839293,12843575,0,0,0,4282
26549,12843269,12843575,12843727,0,0,306,458
26545,12840471,12841639,12843982,0,0,1168,3511
26550,12844051,12844051,12844157,0,0,0,106
26444,12813707,12840054,12844349,0,0,26347,30642
26446,12814078,12844349,12844372,0,0,30271,30294
26552,12844433,12844433,12844494,0,0,0,61
26543,12839471,12841580,12845121,0,0,2109,5650
26539,12837962,12838418,12845412,0,0,456,7450
26532,12830657,12845412,12845427,0,0,14755,14770
26547,12842855,12845427,12845455,0,0,2572,2600
26452,12815631,12844372,12845764,0,0,28741,30133
26455,12815820,12845764,12845834,0,0,29944,30014
26551,12844419,12844419,12846961,0,0,0,2542
26553,12847295,12847295,12847402,0,0,0,107
26546,12842041,12842239,12850379,0,0,198,8338
26554,12848670,12848670,12851103,0,0,0,2433
26512,12827312,12827382,12851641,0,0,70,24329
26557,12851562,12851641,12851775,0,0,79,213
26469,12819207,12845834,12853023,0,0,26627,33816
26556,12850180,12850379,12855632,0,0,199,5452
26559,12855434,12855434,12860777,0,0,0,5343
26560,12860713,12860713,12865726,0,0,0,5013
26555,12849120,12849120,12866812,0,0,0,17692
26561,12865662,12865662,12869763,0,0,0,4101
26558,12851914,12869763,12869839,0,0,17849,17925
26473,12820085,12853023,12877525,0,0,32938,57440
26562,12869832,12869839,12878784,0,0,7,8952
25958,12631761,12878784,12878932,0,0,247023,247171
26565,12883152,12883152,12883253,0,0,0,101
26564,12880918,12880918,12885319,0,0,0,4401
26566,12885511,12885511,12885604,0,0,0,93
26563,12880884,12880884,12891539,0,0,0,10655
26567,12888905,12888905,12892661,0,0,0,3756
26570,12892267,12892267,12896162,0,0,0,3895
26573,12897051,12897051,12897454,0,0,0,403
26574,12897577,12897577,12897598,0,0,0,21
26569,12891989,12891989,12898076,0,0,0,6087
26577,12898701,12898701,12898989,0,0,0,288
26578,12898707,12898707,12899684,0,0,0,977
26579,12898955,12898955,12899856,0,0,0,901
26582,12899587,12899587,12899927,0,0,0,340
26583,12899777,12899777,12900383,0,0,0,606
26581,12899272,12899272,12900497,0,0,0,1225
26580,12899236,12899236,12900866,0,0,0,1630
26586,12900820,12900820,12901195,0,0,0,375
26576,12898540,12898540,12901384,0,0,0,2844
26572,12895589,12895589,12903159,0,0,0,7570
26585,12900591,12900591,12903330,0,0,0,2739
26595,12902705,12903330,12903502,0,0,625,797
26571,12893930,12893930,12903830,0,0,0,9900
26590,12902418,12902418,12903888,0,0,0,1470
26600,12903942,12903942,12904034,0,0,0,92
26599,12903908,12903908,12904371,0,0,0,463
26575,12898077,12898077,12904379,0,0,0,6302
26588,12901643,12901643,12904761,0,0,0,3118
26592,12902503,12902503,12904793,0,0,0,2290
26589,12902307,12904761,12904926,0,0,2454,2619
26587,12901505,12901505,12905090,0,0,0,3585
26605,12904988,12904988,12905242,0,0,0,254
26607,12905241,12905241,12905367,0,0,0,126
26568,12891981,12891981,12905395,0,0,0,13414
26591,12902474,12904926,12906649,0,0,2452,4175
26594,12902626,12906649,12906701,0,0,4023,4075
26584,12900351,12903159,12908729,0,0,2808,8378
26613,12906866,12906866,12909363,0,0,0,2497
26609,12905500,12908729,12909719,0,0,3229,4219
26603,12904520,12904520,12910849,0,0,0,6329
26608,12905411,12905411,12910919,0,0,0,5508
26602,12904370,12904370,12910920,0,0,0,6550
26606,12905063,12905063,12910920,0,0,0,5857
26610,12905646,12905646,12910922,0,0,0,5276
26604,12904541,12908729,12910991,0,0,4188,6450
26598,12903887,12903887,12910992,0,0,0,7105
26624,12908963,12910920,12911015,0,0,1957,2052
26612,12906614,12910991,12911221,0,0,4377,4607
26616,12907311,12911221,12911344,0,0,3910,4033
26597,12903076,12908729,12911377,0,0,5653,8301
26596,12902885,12906701,12911621,0,0,3816,8736
26619,12907630,12910849,12911628,0,0,3219,3998
26617,12907394,12911344,12911649,0,0,3950,4255
26626,12910985,12910985,12911794,0,0,0,809
26628,12911128,12911128,12911833,0,0,0,705
26614,12906953,12909363,12911843,0,0,2410,4890
26632,12911444,12911628,12911902,0,0,184,458
26621,12907806,12911621,12912012,0,0,3815,4206
26640,12912659,12912659,12912807,0,0,0,148
26593,12902606,12905090,12913276,0,0,2484,10670
26641,12913189,12913189,12913344,0,0,0,155
26615,12906960,12909719,12913609,0,0,2759,6649
26631,12911393,12911393,12913638,0,0,0,2245
26642,12913284,12913344,12913725,0,0,60,441
26636,12912013,12912013,12913727,0,0,0,1714
26645,12913738,12913738,12913815,0,0,0,77
26643,12913297,12913638,12913924,0,0,341,627
26644,12913666,12913725,12914015,0,0,59,349
26611,12906484,12909719,12914079,0,0,3235,7595
26646,12914058,12914058,12914345,0,0,0,287
26630,12911343,12913276,12914394,0,0,1933,3051
26622,12908238,12910919,12914498,0,0,2681,6260
26634,12911782,12914394,12914550,0,0,2612,2768
26618,12907613,12911377,12914556,0,0,3764,6943
26629,12911275,12914556,12914578,0,0,3281,3303
26601,12904210,12908729,12914760,0,0,4519,10550
26639,12912316,12913924,12914838,0,0,1608,2522
26633,12911528,12914578,12915082,0,0,3050,3554
26647,12914674,12914760,12915323,0,0,86,649
26649,12915015,12915015,12915522,0,0,0,507
26650,12915047,12915047,12915916,0,0,0,869
26625,12910948,12911833,12915937,0,0,885,4989
26654,12915541,12915916,12915950,0,0,375,409
26638,12912053,12913609,12915995,0,0,1556,3942
26653,12915483,12915522,12916271,0,0,39,788
26648,12914994,12914994,12916709,0,0,0,1715
26651,12915250,12915323,12916984,0,0,73,1734
26657,12916731,12916731,12917124,0,0,0,393
26656,12916141,12916141,12917312,0,0,0,1171
26658,12916897,12916897,12917750,0,0,0,853
26659,12917266,12917266,12918051,0,0,0,785
26652,12915262,12915323,12918469,0,0,61,3207
26623,12908796,12911649,12918514,0,0,2853,9718
26635,12911989,12914498,12918579,0,0,2509,6590
26627,12911010,12912012,12920149,0,0,1002,9139
26637,12912031,12915082,12920960,0,0,3051,8929
26662,12920616,12920616,12920965,0,0,0,349
26664,12921297,12921297,12921332,0,0,0,35
26665,12921533,12921533,12921569,0,0,0,36
26660,12918608,12918608,12922168,0,0,0,3560
26666,12922134,12922134,12922387,0,0,0,253
26663,12921009,12921009,12923245,0,0,0,2236
26669,12923172,12923172,12923689,0,0,0,517
26661,12919282,12920149,12923732,0,0,867,4450
26670,12923554,12923732,12924295,0,0,178,741
26667,12922703,12922703,12924688,0,0,0,1985
26672,12924506,12924506,12924855,0,0,0,349
26673,12925585,12925585,12925748,0,0,0,163
26668,12922876,12922876,12927078,0,0,0,4202
26671,12924123,12924295,12933108,0,0,172,8985
26674,12932973,12932973,12937533,0,0,0,4560
26676,12936161,12936161,12938793,0,0,0,2632
26620,12907676,12918579,12943370,0,0,10903,35694
26677,12957425,12957425,12957475,0,0,0,50
26678,12957723,12957723,12957827,0,0,0,104
26680,12960013,12960013,12962741,0,0,0,2728
26681,12963360,12963360,12963710,0,0,0,350
26675,12933010,12933108,12964026,0,0,98,31016
26679,12958112,12958112,12965766,0,0,0,7654
26683,12965795,12965795,12965903,0,0,0,108
26684,12965998,12965998,12966134,0,0,0,136
26687,12966299,12966299,12966660,0,0,0,361
26682,12965361,12965361,12967020,0,0,0,1659
26688,12966761,12966761,12967193,0,0,0,432
26691,12967545,12967545,12967581,0,0,0,36
26693,12967832,12967832,12967861,0,0,0,29
26655,12915791,12915937,12968006,0,0,146,52215
26694,12967895,12967895,12968396,0,0,0,501
26696,12968113,12968396,12968419,0,0,283,306
26695,12967901,12968006,12968801,0,0,105,900
26699,12969051,12969051,12969066,0,0,0,15
26702,12969239,12969239,12969250,0,0,0,11
26703,12969294,12969294,12969305,0,0,0,11
26698,12968422,12968422,12969756,0,0,0,1334
26700,12969143,12969143,12969914,0,0,0,771
26706,12970003,12970003,12970118,0,0,0,115
26686,12966203,12966203,12970837,0,0,0,4634
26705,12969655,12969655,12973366,0,0,0,3711
26711,12971302,12973366,12973443,0,0,2064,2141
26713,12972062,12973443,12973663,0,0,1381,1601
26714,12972258,12973663,12973769,0,0,1405,1511
26716,12972380,12973769,12974109,0,0,1389,1729
26717,12972398,12974109,12974643,0,0,1711,2245
26723,12973394,12974643,12974688,0,0,1249,1294
26727,12973848,12974688,12974759,0,0,840,911
26728,12973938,12974759,12976916,0,0,821,2978
26708,12970575,12970575,12977251,0,0,0,6676
26730,12974033,12976916,12977583,0,0,2883,3550
26685,12966150,12966150,12977796,0,0,0,11646
26692,12967817,12967817,12977848,0,0,0,10031
26732,12974588,12977251,12978243,0,0,2663,3655
26709,12971130,12971130,12978519,0,0,0,7389
26720,12972897,12978519,12978624,0,0,5622,5727
26735,12975595,12978243,12978878,0,0,2648,3283
26710,12971263,12977848,12978887,0,0,6585,7624
26736,12975713,12978878,12978905,0,0,3165,3192
26737,12975716,12978905,12978932,0,0,3189,3216
26725,12973732,12978624,12979377,0,0,4892,5645
26729,12973994,12979377,12979434,0,0,5383,5440
26731,12974482,12979434,12979702,0,0,4952,5220
26733,12975068,12979702,12979736,0,0,4634,4668
26738,12976090,12978932,12979923,0,0,2842,3833
26740,12976200,12979736,12979927,0,0,3536,3727
26744,12977344,12979927,12980036,0,0,2583,2692
26734,12975212,12977583,12980065,0,0,2371,4853
26689,12966960,12977796,12980564,0,0,10836,13604
26697,12968285,12980564,12980698,0,0,12279,12413
26707,12970270,12970270,12980773,0,0,0,10503
26704,12969423,12980698,12980846,0,0,11275,11423
26718,12972500,12980773,12980902,0,0,8273,8402
26721,12972936,12980846,12980911,0,0,7910,7975
26722,12973152,12980902,12981109,0,0,7750,7957
26719,12972773,12980846,12981187,0,0,8073,8414
26690,12967461,12967461,12981241,0,0,0,13780
26750,12978431,12981241,12981272,0,0,2810,2841
26753,12978850,12981272,12981303,0,0,2422,2453
26724,12973397,12980911,12981323,0,0,7514,7926
26751,12978646,12981272,12981524,0,0,2626,2878
26757,12979209,12981524,12981536,0,0,2315,2327
26759,12979283,12981536,12981547,0,0,2253,2264
26760,12979401,12981547,12981557,0,0,2146,2156
26754,12978900,12981303,12981565,0,0,2403,2665
26762,12979495,12981565,12981576,0,0,2070,2081
26761,12979419,12981557,12981584,0,0,2138,2165
26763,12979600,12981576,12981590,0,0,1976,1990
26747,12977946,12981187,12981649,0,0,3241,3703
26715,12972353,12978887,12981820,0,0,6534,9467
26726,12973751,12981109,12981842,0,0,7358,8091
26741,12976244,12979736,12981860,0,0,3492,5616
26749,12978377,12980065,12981899,0,0,1688,3522
26764,12979712,12981584,12981958,0,0,1872,2246
26769,12981021,12981860,12982054,0,0,839,1033
26771,12981155,12981899,12982342,0,0,744,1187
26767,12980296,12981590,12982458,0,0,1294,2162
26746,12977934,12980036,12982484,0,0,2102,4550
26752,12978696,12981820,12982595,0,0,3124,3899
26780,12982460,12982484,12982602,0,0,24,142
26779,12982443,12982458,12982626,0,0,15,183
26743,12976609,12979923,12982844,0,0,3314,6235
26755,12978915,12981649,12983136,0,0,2734,4221
26765,12979807,12983136,12983467,0,0,3329,3660
26783,12983411,12983411,12983567,0,0,0,156
26766,12980129,12983467,12983806,0,0,3338,3677
26758,12979238,12982595,12983836,0,0,3357,4598
26772,12981420,12983836,12984057,0,0,2416,2637
26770,12981119,12983806,12984192,0,0,2687,3073
26776,12981802,12984192,12984327,0,0,2390,2525
26786,12984356,12984356,12984770,0,0,0,414
26712,12971564,12978519,12985183,0,0,6955,13619
26742,12976418,12981187,12985985,0,0,4769,9567
26774,12981655,12981958,12986210,0,0,303,4555
26784,12983553,12985183,12986471,0,0,1630,2918
26788,12985069,12985985,12986560,0,0,916,1491
26790,12985627,12986210,12986738,0,0,583,1111
26793,12986139,12986471,12986893,0,0,332,754
26778,12981939,12986893,12986917,0,0,4954,4978
26782,12983100,12986917,12987128,0,0,3817,4028
26789,12985083,12987128,12987565,0,0,2045,2482
26775,12981768,12982342,12987695,0,0,574,5927
26773,12981570,12984057,12987701,0,0,2487,6131
26798,12987299,12987695,12987897,0,0,396,598
26804,12988219,12988219,12988471,0,0,0,252
26803,12988139,12988139,12988535,0,0,0,396
26794,12986171,12987565,12988733,0,0,1394,2562
26787,12984968,12984968,12988768,0,0,0,3800
26802,12987865,12988733,12988972,0,0,868,1107
26806,12988690,12988690,12989128,0,0,0,438
26805,12988547,12988547,12989457,0,0,0,910
26810,12989013,12989457,12989503,0,0,444,490
26813,12989144,12989503,12989575,0,0,359,431
26812,12989085,12989457,12989816,0,0,372,731
26796,12986491,12986491,12989942,0,0,0,3451
26816,12989362,12989575,12990241,0,0,213,879
26820,12990395,12990395,12990524,0,0,0,129
26823,12990684,12990684,12990999,0,0,0,315
26777,12981919,12984327,12991009,0,0,2408,9090
26756,12979172,12981842,12991380,0,0,2670,12208
26822,12990606,12991380,12991423,0,0,774,817
26817,12989514,12991380,12991444,0,0,1866,1930
26799,12987345,12987695,12991481,0,0,350,4136
26825,12990861,12990999,12991488,0,0,138,627
26815,12989242,12991009,12991726,0,0,1767,2484
26827,12991073,12991444,12991774,0,0,371,701
26832,12991765,12991765,12991811,0,0,0,46
26824,12990782,12991423,12992015,0,0,641,1233
26834,12992020,12992020,12992069,0,0,0,49
26835,12992096,12992096,12992151,0,0,0,55
26831,12991275,12991481,12992280,0,0,206,1005
26830,12991258,12991444,12992329,0,0,186,1071
26839,12992828,12992828,12993796,0,0,0,968
26840,12992882,12993796,12993841,0,0,914,959
26821,12990497,12992280,12993869,0,0,1783,3372
26808,12988843,12988843,12993932,0,0,0,5089
26842,12992979,12993932,12993991,0,0,953,1012
26826,12990870,12993869,12994090,0,0,2999,3220
26819,12990070,12991726,12994193,0,0,1656,4123
26829,12991157,12994193,12994219,0,0,3036,3062
26843,12993052,12993991,12994408,0,0,939,1356
26841,12992924,12993841,12994999,0,0,917,2075
26828,12991107,12994090,12995148,0,0,2983,4041
26847,12993815,12994999,12995384,0,0,1184,1569
26701,12969218,12980564,12995421,0,0,11346,26203
26809,12988913,12989128,12995759,0,0,215,6846
26739,12976150,12995421,12995860,0,0,19271,19710
26833,12991977,12991977,12996087,0,0,0,4110
26850,12994520,12995759,12996659,0,0,1239,2139
26748,12978241,12981323,12996949,0,0,3082,18708
26836,12992178,12994219,12996962,0,0,2041,4784
26845,12993456,12994408,12997017,0,0,952,3561
26837,12992463,12995148,12997091,0,0,2685,4628
26854,12995389,12996087,12997305,0,0,698,1916
26858,12997147,12997305,12997337,0,0,158,190
26768,12980815,12995860,12997442,0,0,15045,16627
26844,12993268,12996962,12997450,0,0,3694,4182
26838,12992528,12996949,12997473,0,0,4421,4945
26852,12995012,12997473,12997513,0,0,2461,2501
26856,12996235,12997513,12997565,0,0,1278,1330
26791,12985651,12997442,12997589,0,0,11791,11938
26848,12994022,12995384,12997618,0,0,1362,3596
26849,12994126,12997017,12998056,0,0,2891,3930
26853,12995183,12997473,12998416,0,0,2290,3233
26807,12988719,12988972,12998433,0,0,253,9714
26797,12986780,12997589,12998526,0,0,10809,11746
26857,12996765,12998433,12998749,0,0,1668,1984
26860,12997402,12997565,12998886,0,0,163,1484
26855,12996083,12998416,12998911,0,0,2333,2828
26861,12997664,12997664,12999070,0,0,0,1406
26864,12999101,12999101,12999211,0,0,0,110
26865,12999372,12999372,12999725,0,0,0,353
26800,12987379,12987701,12999816,0,0,322,12437
26863,12998515,12998749,12999880,0,0,234,1365
26866,12999443,12999443,13000018,0,0,0,575
26868,12999858,12999858,13000246,0,0,0,388
26869,13000661,13000661,13000828,0,0,0,167
26870,13000859,13000859,13001193,0,0,0,334
26872,13001072,13001072,13001205,0,0,0,133
26851,12994973,12997450,13001669,0,0,2477,6696
26859,12997316,12997337,13002345,0,0,21,5029
26871,13000930,13000930,13002879,0,0,0,1949
26867,12999759,12999759,13002921,0,0,0,3162
26846,12993799,12997091,13003072,0,0,3292,9273
26814,12989157,12999880,13003342,0,0,10723,14185
26873,13002389,13002879,13003519,0,0,490,1130
26811,12989019,12989942,13003648,0,0,923,14629
26874,13002442,13002921,13004177,0,0,479,1735
26876,13004559,13004559,13004653,0,0,0,94
26875,13002904,13003072,13005320,0,0,168,2416
26745,12977849,13005320,13007316,0,0,27471,29467
26781,12982922,13007316,13007841,0,0,24394,24919
26785,12983906,13007841,13009507,0,0,23935,25601
26801,12987822,12998526,13010217,0,0,10704,22395
26881,13009367,13010217,13010726,0,0,850,1359
26879,13006969,13010217,13010772,0,0,3248,3803
26878,13006552,13010217,13012303,0,0,3665,5751
26877,13005345,13010217,13012742,0,0,4872,7397
26880,13009254,13012303,13014420,0,0,3049,5166
26792,12985750,13009507,13015354,0,0,23757,29604
26883,13018172,13018172,13020261,0,0,0,2089
26882,13015563,13015563,13020473,0,0,0,4910
26885,13021488,13021488,13024205,0,0,0,2717
26818,12989587,13002345,13025736,0,0,12758,36149
26884,13020443,13020443,13025763,0,0,0,5320
26795,12986179,13015354,13025911,0,0,29175,39732
26886,13025741,13025741,13030595,0,0,0,4854
26888,13030591,13030591,13035468,0,0,0,4877
26862,12997832,13025911,13036163,0,0,28079,38331
26889,13035475,13035475,13040359,0,0,0,4884
26890,13040369,13040369,13045404,0,0,0,5035
26891,13045393,13045393,13049848,0,0,0,4455
26887,13030422,13030422,13050033,0,0,0,19611
26893,13050752,13050752,13052076,0,0,0,1324
26892,13049859,13049859,13053018,0,0,0,3159
26896,13052991,13052991,13056130,0,0,0,3139
26894,13052267,13052267,13057436,0,0,0,5169
26898,13057865,13057865,13058330,0,0,0,465
26899,13058326,13058330,13058394,0,0,4,68
26900,13058683,13058683,13059294,0,0,0,611
26897,13056109,13056109,13059506,0,0,0,3397
26905,13061166,13061166,13061191,0,0,0,25
26902,13059298,13059298,13061497,0,0,0,2199
26906,13061637,13061637,13061663,0,0,0,26
26907,13061984,13061984,13061996,0,0,0,12
26904,13059484,13059484,13063079,0,0,0,3595
26903,13059310,13059310,13063911,0,0,0,4601
26895,13052536,13052536,13063966,0,0,0,11430
26908,13062013,13062013,13065286,0,0,0,3273
26911,13065374,13065374,13065436,0,0,0,62
26912,13065515,13065515,13065569,0,0,0,54
26913,13065954,13065954,13065968,0,0,0,14
26914,13066007,13066007,13066021,0,0,0,14
26901,13059208,13059208,13066804,0,0,0,7596
26916,13070158,13070158,13070172,0,0,0,14
26909,13063057,13063057,13072444,0,0,0,9387
26915,13066076,13066076,13073155,0,0,0,7079
26917,13073417,13073417,13074063,0,0,0,646
26910,13063660,13063911,13075647,0,0,251,11987
26922,13081747,13081747,13082289,0,0,0,542
26923,13082473,13082473,13084019,0,0,0,1546
26925,13084130,13084130,13085025,0,0,0,895
26926,13085167,13085167,13085429,0,0,0,262
26918,13079013,13079013,13085621,0,0,0,6608
26927,13085762,13085762,13086075,0,0,0,313
26924,13083594,13083594,13087765,0,0,0,4171
26929,13087564,13087564,13088090,0,0,0,526
26921,13081205,13081205,13088529,0,0,0,7324
26919,13080749,13080749,13092173,0,0,0,11424
26932,13088547,13092173,13092233,0,0,3626,3686
26934,13090554,13092233,13093850,0,0,1679,3296
26928,13087268,13087268,13094103,0,0,0,6835
26933,13089614,13092173,13094248,0,0,2559,4634
26931,13088535,13088535,13095009,0,0,0,6474
26920,13081037,13081037,13103733,0,0,0,22696
26935,13094271,13095009,13105681,0,0,738,11410
26944,13103056,13105681,13105894,0,0,2625,2838
26943,13102631,13105681,13106089,0,0,3050,3458
26942,13102522,13105681,13106510,0,0,3159,3988
26940,13101564,13105681,13106724,0,0,4117,5160
26937,13095283,13103733,13106958,0,0,8450,11675
26936,13095018,13103733,13107104,0,0,8715,12086
26938,13098447,13103733,13107177,0,0,5286,8730
26945,13103288,13105681,13108703,0,0,2393,5415
26941,13101829,13105681,13108887,0,0,3852,7058
26946,13104971,13105681,13108887,0,0,710,3916
26930,13088531,13088531,13109054,0,0,0,20523
26939,13101488,13105681,13109674,0,0,4193,8186
26947,13108113,13108113,13111284,0,0,0,3171
26948,13111220,13111220,13114369,0,0,0,3149
26949,13114333,13114333,13117754,0,0,0,3421
26952,13117690,13117690,13120879,0,0,0,3189
26953,13120814,13120814,13124012,0,0,0,3198
26950,13115511,13115511,13126951,0,0,0,11440
26954,13123949,13123949,13127126,0,0,0,3177
26951,13116389,13116389,13127758,0,0,0,11369
26955,13127061,13127061,13130475,0,0,0,3414
26956,13130411,13130411,13133647,0,0,0,3236
26957,13133583,13133583,13136791,0,0,0,3208
26960,13139798,13139798,13139859,0,0,0,61
26958,13136729,13136729,13139939,0,0,0,3210
26962,13141063,13141063,13142394,0,0,0,1331
26963,13142561,13142561,13142894,0,0,0,333
26959,13139786,13139786,13143199,0,0,0,3413
26961,13139876,13139876,13143248,0,0,0,3372
26964,13143245,13143245,13146426,0,0,0,3181
26968,13147348,13147348,13147515,0,0,0,167
26965,13145019,13145019,13148990,0,0,0,3971
26967,13146366,13146366,13149581,0,0,0,3215
26966,13145032,13145032,13149951,0,0,0,4919
26972,13151216,13151216,13152414,0,0,0,1198
26971,13149708,13149708,13152883,0,0,0,3175
26973,13152080,13152414,13152906,0,0,334,826
26969,13147680,13147680,13153341,0,0,0,5661
26975,13152606,13153341,13153435,0,0,735,829
26977,13153180,13153435,13153511,0,0,255,331
26980,13154633,13154633,13154668,0,0,0,35
26979,13153471,13153471,13155144,0,0,0,1673
26976,13152848,13152848,13156249,0,0,0,3401
26970,13148469,13148469,13156895,0,0,0,8426
26974,13152446,13152446,13157685,0,0,0,5239
26982,13156188,13156188,13159378,0,0,0,3190
26981,13155260,13156895,13161039,0,0,1635,5779
26986,13164037,13164037,13165807,0,0,0,1770
26984,13159316,13159316,13166082,0,0,0,6766
26978,13153306,13153511,13169233,0,0,205,15927
26985,13163624,13163624,13169255,0,0,0,5631
26988,13172926,13172926,13173119,0,0,0,193
26989,13173227,13173227,13173959,0,0,0,732
26983,13156675,13161039,13174631,0,0,4364,17956
26990,13174412,13174412,13175199,0,0,0,787
26992,13175947,13175947,13176015,0,0,0,68
26991,13175448,13175448,13176598,0,0,0,1150
26987,13172184,13172184,13178074,0,0,0,5890
26996,13177614,13177614,13178422,0,0,0,808
26997,13178530,13178530,13178588,0,0,0,58
26998,13178638,13178638,13179390,0,0,0,752
26993,13176665,13176665,13179845,0,0,0,3180
26999,13182805,13182805,13185997,0,0,0,3192
27001,13187305,13187305,13187401,0,0,0,96
27000,13185933,13185933,13189333,0,0,0,3400
26994,13176927,13176927,13190234,0,0,0,13307
27002,13187987,13187987,13191397,0,0,0,3410
27003,13189270,13189270,13192452,0,0,0,3182
27006,13194084,13194084,13194587,0,0,0,503
27004,13192389,13192389,13195656,0,0,0,3267
27007,13195593,13195593,13198781,0,0,0,3188
26995,13177551,13177551,13200235,0,0,0,22684
27011,13200374,13200374,13200390,0,0,0,16
27012,13200403,13200403,13201787,0,0,0,1384
27010,13198719,13198719,13202293,0,0,0,3574
27005,13192879,13192879,13204253,0,0,0,11374
27009,13196618,13196618,13204553,0,0,0,7935
27008,13196590,13204253,13204596,0,0,7663,8006
27013,13202228,13202228,13205408,0,0,0,3180
27014,13205344,13205344,13208537,0,0,0,3193
27015,13208474,13208474,13211657,0,0,0,3183
27016,13211594,13211594,13214766,0,0,0,3172
27017,13214701,13214701,13218116,0,0,0,3415
27019,13218743,13218743,13218950,0,0,0,207
27018,13218052,13218052,13221298,0,0,0,3246
27022,13223142,13223142,13223284,0,0,0,142
27021,13221235,13221235,13224439,0,0,0,3204
27023,13223671,13223671,13225105,0,0,0,1434
27025,13226149,13226149,13226761,0,0,0,612
27024,13224374,13224374,13227596,0,0,0,3222
27026,13226682,13226682,13229062,0,0,0,2380
27030,13229447,13229447,13229551,0,0,0,104
27032,13229675,13229675,13229739,0,0,0,64
27029,13229367,13229367,13229986,0,0,0,619
27028,13228715,13228715,13231270,0,0,0,2555
27027,13227532,13227532,13231937,0,0,0,4405
27035,13230886,13231937,13231968,0,0,1051,1082
27037,13231864,13231937,13232008,0,0,73,144
27031,13229629,13229986,13232036,0,0,357,2407
27036,13231709,13232008,13232259,0,0,299,550
27039,13232558,13232558,13232887,0,0,0,329
27038,13231906,13232036,13237323,0,0,130,5417
27042,13234264,13237323,13237441,0,0,3059,3177
27020,13220570,13220570,13237572,0,0,0,17002
27041,13233363,13237323,13237623,0,0,3960,4260
27044,13234763,13237572,13237693,0,0,2809,2930
27043,13234502,13237441,13237702,0,0,2939,3200
27051,13236348,13237572,13237810,0,0,1224,1462
27045,13234884,13237572,13237811,0,0,2688,2927
27056,13237446,13237810,13237823,0,0,364,377
27052,13236564,13237702,13237910,0,0,1138,1346
27047,13235834,13237572,13237937,0,0,1738,2103
27050,13236199,13237693,13238059,0,0,1494,1860
27055,13237194,13237910,13238127,0,0,716,933
27059,13237760,13238059,13238159,0,0,299,399
27053,13236772,13237811,13238233,0,0,1039,1461
27061,13237799,13238127,13238255,0,0,328,456
27057,13237448,13237937,13238288,0,0,489,840
27062,13237972,13238233,13238579,0,0,261,607
27063,13238318,13238579,13238813,0,0,261,495
27064,13238612,13238813,13239113,0,0,201,501
27034,13230644,13237572,13239256,0,0,6928,8612
27065,13238912,13239113,13239377,0,0,201,465
27046,13235713,13237572,13239493,0,0,1859,3780
27067,13239175,13239256,13239599,0,0,81,424
27068,13239518,13239518,13239749,0,0,0,231
27040,13232945,13232945,13239888,0,0,0,6943
27071,13239844,13239844,13240036,0,0,0,192
27070,13239748,13239748,13240100,0,0,0,352
27072,13240160,13240160,13240366,0,0,0,206
27073,13240366,13240366,13240994,0,0,0,628
27074,13240779,13240779,13241223,0,0,0,444
27075,13240993,13240993,13241226,0,0,0,233
27076,13241050,13241050,13241371,0,0,0,321
27078,13241270,13241270,13241558,0,0,0,288
27077,13241239,13241239,13241771,0,0,0,532
27079,13241770,13241770,13241897,0,0,0,127
27080,13241791,13241791,13241997,0,0,0,206
27083,13242128,13242128,13242172,0,0,0,44
27084,13242252,13242252,13242404,0,0,0,152
27054,13237136,13238288,13243279,0,0,1152,6143
27087,13243405,13243405,13243641,0,0,0,236
27048,13235855,13237623,13243783,0,0,1768,7928
27091,13244474,13244474,13244666,0,0,0,192
27081,13241798,13241798,13244891,0,0,0,3093
27058,13237483,13237823,13244896,0,0,340,7413
27088,13244345,13244345,13244963,0,0,0,618
27092,13244820,13244891,13245072,0,0,71,252
27060,13237797,13238059,13245175,0,0,262,7378
27033,13230507,13231270,13245361,0,0,763,14854
27093,13245039,13245039,13245455,0,0,0,416
27096,13246507,13246507,13246949,0,0,0,442
27085,13242687,13242687,13247270,0,0,0,4583
27097,13246568,13246949,13247329,0,0,381,761
27094,13245627,13247270,13247899,0,0,1643,2272
27099,13246853,13247899,13248102,0,0,1046,1249
27103,13247036,13248102,13248293,0,0,1066,1257
27095,13246357,13247899,13248395,0,0,1542,2038
27104,13247112,13248395,13248691,0,0,1283,1579
27106,13247408,13248691,13248904,0,0,1283,1496
27107,13247681,13248904,13249248,0,0,1223,1567
27108,13248025,13249248,13249492,0,0,1223,1467
27090,13244460,13244460,13249645,0,0,0,5185
27110,13248280,13249645,13249821,0,0,1365,1541
27105,13247157,13248293,13249899,0,0,1136,2742
27109,13248269,13249492,13249948,0,0,1223,1679
27115,13248725,13249948,13250032,0,0,1223,1307
27100,13246938,13247329,13250332,0,0,391,3394
27111,13248354,13249821,13250333,0,0,1467,1979
27112,13248354,13249899,13250412,0,0,1545,2058
27049,13236078,13245361,13250420,0,0,9283,14342
27116,13248831,13250032,13250477,0,0,1201,1646
27118,13249275,13250477,13250719,0,0,1202,1444
27119,13249536,13250719,13251119,0,0,1183,1583
27123,13250338,13250338,13251140,0,0,0,802
27122,13250279,13250332,13251193,0,0,53,914
27120,13249936,13251119,13251328,0,0,1183,1392
27126,13250601,13251328,13251568,0,0,727,967
27121,13250164,13251140,13251577,0,0,976,1413
27128,13251321,13251577,13251816,0,0,256,495
27127,13250840,13251568,13252049,0,0,728,1209
27129,13251559,13251816,13252323,0,0,257,764
27134,13252065,13252323,13252552,0,0,258,487
27131,13251939,13251939,13252651,0,0,0,712
27132,13251939,13252049,13252762,0,0,110,823
27136,13252294,13252651,13253127,0,0,357,833
27138,13252913,13252913,13253127,0,0,0,214
27137,13252769,13253127,13253333,0,0,358,564
27139,13252975,13253333,13253651,0,0,358,676
27140,13253278,13253278,13253968,0,0,0,690
27141,13253293,13253651,13253985,0,0,358,692
27148,13253798,13253985,13254550,0,0,187,752
27143,13253410,13253968,13254797,0,0,558,1387
27144,13253410,13253985,13254814,0,0,575,1404
27150,13254330,13254550,13255156,0,0,220,826
27069,13239747,13250420,13255269,0,0,10673,15522
27153,13254348,13254797,13255384,0,0,449,1036
27082,13242074,13242074,13255528,0,0,0,13454
27066,13239116,13239256,13255670,0,0,140,16554
27146,13253410,13255156,13256042,0,0,1746,2632
27147,13253627,13255670,13256181,0,0,2043,2554
27149,13254137,13256042,13256360,0,0,1905,2223
27135,13252220,13252552,13256510,0,0,332,4290
27160,13255311,13255384,13256545,0,0,73,1234
27155,13254455,13256360,13256899,0,0,1905,2444
27154,13254348,13256181,13257084,0,0,1833,2736
27101,13246947,13248102,13257116,0,0,1155,10169
27164,13255547,13256545,13257138,0,0,998,1591
27156,13254994,13256899,13257156,0,0,1905,2162
27098,13246627,13255528,13257171,0,0,8901,10544
27089,13244382,13244382,13257236,0,0,0,12854
27133,13251954,13252049,13257513,0,0,95,5559
27161,13255311,13256510,13257672,0,0,1199,2361
27158,13255311,13257084,13257737,0,0,1773,2426
27102,13247012,13257171,13258064,0,0,10159,11052
27159,13255311,13257156,13258086,0,0,1845,2775
27165,13255963,13257737,13258195,0,0,1774,2232
27114,13248365,13258064,13258301,0,0,9699,9936
27117,13249139,13258301,13258395,0,0,9162,9256
27113,13248354,13257236,13258548,0,0,8882,10194
27168,13256442,13258195,13258648,0,0,1753,2206
27178,13257161,13257672,13258784,0,0,511,1623
27173,13256935,13257138,13259128,0,0,203,2193
27171,13256895,13258648,13259432,0,0,1753,2537
27177,13256971,13257513,13259449,0,0,542,2478
27130,13251938,13258548,13259585,0,0,6610,7647
27124,13250338,13258395,13259678,0,0,8057,9340
27166,13256264,13258086,13259799,0,0,1822,3535
27175,13256971,13259432,13260089,0,0,2461,3118
27181,13257703,13259799,13260173,0,0,2096,2470
27184,13258025,13259128,13260244,0,0,1103,2219
27185,13258077,13260173,13260247,0,0,2096,2170
27142,13253409,13259585,13260473,0,0,6176,7064
27145,13253410,13259678,13260508,0,0,6268,7098
27187,13258171,13260247,13260610,0,0,2076,2439
27189,13258534,13260610,13260688,0,0,2076,2154
27190,13258631,13260688,13261048,0,0,2057,2417
27152,13254347,13260508,13261350,0,0,6161,7003
27151,13254330,13260473,13261395,0,0,6143,7065
27195,13258991,13261048,13261597,0,0,2057,2606
27183,13257899,13260089,13262055,0,0,2190,4156
27170,13256806,13257116,13262127,0,0,310,5321
27157,13255310,13261350,13262281,0,0,6040,6971
27194,13258971,13260244,13262425,0,0,1273,3454
27191,13258930,13259449,13262454,0,0,519,3524
27196,13259012,13261597,13262489,0,0,2585,3477
27199,13259365,13262055,13262738,0,0,2690,3373
27182,13257813,13258784,13262779,0,0,971,4966
27200,13259578,13262489,13262957,0,0,2911,3379
27162,13255311,13261395,13262980,0,0,6084,7669
27201,13260046,13262957,13263152,0,0,2911,3106
27167,13256302,13262980,13263163,0,0,6678,6861
27202,13260259,13263152,13263222,0,0,2893,2963
27172,13256934,13263163,13263857,0,0,6229,6923
27174,13256939,13263857,13264021,0,0,6918,7082
27203,13260337,13263222,13264112,0,0,2885,3775
27198,13259012,13262055,13264194,0,0,3043,5182
27207,13261174,13262127,13264385,0,0,953,3211
27204,13260434,13264112,13264635,0,0,3678,4201
27211,13261210,13262425,13264646,0,0,1215,3436
27220,13262878,13264194,13264698,0,0,1316,1820
27205,13260957,13264635,13264852,0,0,3678,3895
27208,13261192,13264852,13265480,0,0,3660,4288
27176,13256971,13264021,13265719,0,0,7050,8748
27242,13266016,13266016,13266163,0,0,0,147
27244,13266035,13266163,13266290,0,0,128,255
27247,13266219,13266290,13266420,0,0,71,201
27209,13261210,13265480,13266491,0,0,4270,5281
27249,13266254,13266420,13266533,0,0,166,279
27224,13263485,13264385,13266607,0,0,900,3122
27252,13266441,13266533,13266664,0,0,92,223
27256,13266563,13266664,13266760,0,0,101,197
27227,13263522,13264646,13266830,0,0,1124,3308
27215,13261987,13262738,13267115,0,0,751,5128
27259,13267217,13267217,13267281,0,0,0,64
27214,13261820,13266830,13267360,0,0,5010,5540
27255,13266477,13266607,13267496,0,0,130,1019
27260,13267384,13267384,13267509,0,0,0,125
27262,13267415,13267496,13267539,0,0,81,124
27266,13267471,13267539,13267571,0,0,68,100
27263,13267416,13267509,13267588,0,0,93,172
27267,13267515,13267571,13267601,0,0,56,86
27268,13267558,13267588,13267617,0,0,30,59
27217,13262368,13267360,13267746,0,0,4992,5378
27219,13262754,13267617,13267820,0,0,4863,5066
27221,13262992,13267746,13268096,0,0,4754,5104
27222,13263342,13267820,13268399,0,0,4478,5057
27228,13263939,13268399,13268966,0,0,4460,5027
27226,13263522,13268096,13268990,0,0,4574,5468
27229,13264506,13268966,13269197,0,0,4460,4691
27230,13264737,13268990,13269345,0,0,4253,4608
27231,13265092,13269197,13269410,0,0,4105,4318
27216,13261995,13262779,13269585,0,0,784,7590
27269,13267671,13269585,13269626,0,0,1914,1955
27271,13267877,13269626,13269654,0,0,1749,1777
27272,13267948,13269654,13269679,0,0,1706,1731
27232,13265323,13269345,13269690,0,0,4022,4367
27273,13268004,13269679,13269704,0,0,1675,1700
27274,13268065,13269704,13269729,0,0,1639,1664
27275,13268171,13269729,13269756,0,0,1558,1585
27276,13268273,13269756,13269783,0,0,1483,1510
27279,13269813,13269813,13269852,0,0,0,39
27234,13265623,13269690,13270132,0,0,4067,4509
27235,13265667,13270132,13270481,0,0,4465,4814
27237,13265777,13270481,13270675,0,0,4704,4898
27086,13243246,13255269,13271033,0,0,12023,27787
27239,13265942,13270675,13271726,0,0,4733,5784
27241,13266015,13271726,13272276,0,0,5711,6261
27245,13266053,13272276,13272367,0,0,6223,6314
27248,13266254,13272367,13272461,0,0,6113,6207
27253,13266476,13272461,13272556,0,0,5985,6080
27257,13266564,13272556,13272602,0,0,5992,6038
27163,13255471,13262281,13272779,0,0,6810,17308
27180,13257671,13272779,13272885,0,0,15108,15214
27186,13258118,13272885,13272920,0,0,14767,14802
27192,13258963,13272920,13273183,0,0,13957,14220
27258,13266853,13272602,13273295,0,0,5749,6442
27280,13269868,13269868,13273622,0,0,0,3754
27281,13269894,13273622,13273640,0,0,3728,3746
27282,13270156,13273640,13273676,0,0,3484,3520
27193,13258971,13273183,13274116,0,0,14212,15145
27233,13265499,13269410,13274683,0,0,3911,9184
27179,13257447,13265719,13275349,0,0,8272,17902
27213,13261810,13266491,13275459,0,0,4681,13649
27125,13250339,13271033,13275578,0,0,20694,25239
27284,13271115,13275459,13275648,0,0,4344,4533
27290,13271309,13275648,13275668,0,0,4339,4359
27291,13271472,13275668,13275687,0,0,4196,4215
27197,13259012,13274116,13275718,0,0,15104,16706
27286,13271135,13275648,13275738,0,0,4513,4603
27188,13258294,13275578,13275781,0,0,17284,17487
27285,13271115,13273676,13276128,0,0,2561,5013
27206,13261174,13275349,13276396,0,0,14175,15222
27299,13276008,13276128,13276558,0,0,120,550
27223,13263485,13275781,13276694,0,0,12296,13209
27265,13267416,13273295,13276853,0,0,5879,9437
27236,13265741,13276694,13276899,0,0,10953,11158
27287,13271135,13276853,13276944,0,0,5718,5809
27238,13265777,13276899,13277093,0,0,11122,11316
27240,13266015,13277093,13277223,0,0,11078,11208
27210,13261210,13275718,13277280,0,0,14508,16070
27243,13266034,13277223,13277371,0,0,11189,11337
27246,13266218,13277280,13277411,0,0,11062,11193
27250,13266254,13277371,13277522,0,0,11117,11268
27251,13266440,13277411,13277543,0,0,10971,11103
27261,13267384,13277543,13277669,0,0,10159,10285
27254,13266476,13277522,13277676,0,0,11046,11200
27292,13272209,13277676,13277702,0,0,5467,5493
27264,13267416,13277669,13277749,0,0,10253,10333
27293,13272246,13277702,13277823,0,0,5456,5577
27218,13262689,13275781,13277827,0,0,13092,15138
27294,13272382,13277749,13277895,0,0,5367,5513
27289,13271243,13277676,13278043,0,0,6433,6800
27225,13263504,13276396,13278162,0,0,12892,14658
27277,13268655,13278162,13278257,0,0,9507,9602
27278,13269199,13274683,13278272,0,0,5484,9073
27288,13271153,13276944,13279348,0,0,5791,8195
27302,13276044,13276558,13280241,0,0,514,4197
27212,13261563,13262454,13280673,0,0,891,19110
27297,13274491,13275738,13280973,0,0,1247,6482
27304,13279918,13279918,13281110,0,0,0,1192
27300,13276044,13277827,13281433,0,0,1783,5389
27301,13276044,13277827,13281434,0,0,1783,5390
27298,13276007,13277823,13281467,0,0,1816,5460
27295,13273654,13275687,13281759,0,0,2033,8105
27310,13281056,13281434,13281810,0,0,378,754
27305,13279942,13280673,13281840,0,0,731,1898
27309,13280765,13281433,13281930,0,0,668,1165
27308,13280167,13281110,13281999,0,0,943,1832
27303,13279917,13279917,13282011,0,0,0,2094
27306,13279942,13279942,13282011,0,0,0,2069
27311,13281449,13281467,13282226,0,0,18,777
27296,13274332,13277749,13283067,0,0,3417,8735
27316,13282208,13283067,13283313,0,0,859,1105
27312,13282066,13282066,13283324,0,0,0,1258
27319,13283080,13283324,13283344,0,0,244,264
27321,13283273,13283344,13283376,0,0,71,103
27314,13282102,13282226,13283448,0,0,124,1346
27322,13283478,13283478,13283513,0,0,0,35
27315,13282102,13282102,13283996,0,0,0,1894
27313,13282066,13282066,13284013,0,0,0,1947
27317,13282473,13283313,13284020,0,0,840,1547
27320,13283180,13283996,13284408,0,0,816,1228
27323,13283609,13284013,13284561,0,0,404,952
27324,13284050,13284050,13285181,0,0,0,1131
27329,13284570,13285181,13285381,0,0,611,811
27332,13285379,13285381,13285584,0,0,2,205
27326,13284085,13284561,13285657,0,0,476,1572
27318,13282822,13283448,13285872,0,0,626,3050
27328,13284156,13285657,13286115,0,0,1501,1959
27327,13284085,13284085,13286130,0,0,0,2045
27331,13285322,13286115,13286446,0,0,793,1124
27325,13284050,13284408,13286489,0,0,358,2439
27330,13284632,13285872,13286562,0,0,1240,1930
27333,13285671,13286130,13286682,0,0,459,1011
27338,13286241,13286682,13286917,0,0,441,676
27283,13270687,13278257,13287082,0,0,7570,16395
27339,13286495,13286917,13287619,0,0,422,1124
27341,13287196,13287196,13287625,0,0,0,429
27334,13286168,13286446,13287631,0,0,278,1463
27336,13286187,13286562,13287728,0,0,375,1541
27342,13287640,13287640,13288153,0,0,0,513
27337,13286187,13286446,13288217,0,0,259,2030
27335,13286168,13286489,13288279,0,0,321,2111
27348,13288153,13288153,13288305,0,0,0,152
27349,13288324,13288324,13288949,0,0,0,625
27169,13256518,13275578,13289175,0,0,19060,32657
27346,13288051,13288051,13289194,0,0,0,1143
27350,13288949,13288949,13289194,0,0,0,245
27345,13288015,13288015,13289195,0,0,0,1180
27340,13287042,13287082,13289685,0,0,40,2643
27344,13288014,13288014,13289854,0,0,0,1840
27347,13288052,13288052,13289854,0,0,0,1802
27351,13289213,13289685,13290158,0,0,472,945
27352,13289686,13289854,13290186,0,0,168,500
27353,13289890,13289890,13290989,0,0,0,1099
27355,13289909,13290186,13291266,0,0,277,1357
27356,13289909,13289909,13291808,0,0,0,1899
27343,13287907,13287907,13291809,0,0,0,3902
27357,13290037,13291266,13291920,0,0,1229,1883
27354,13289890,13290158,13292077,0,0,268,2187
27360,13291753,13291920,13292082,0,0,167,329
27358,13290691,13291808,13292254,0,0,1117,1563
27359,13291156,13291809,13292407,0,0,653,1251
27366,13291933,13292407,13293089,0,0,474,1156
27367,13292344,13293089,13293136,0,0,745,792
27370,13293061,13293089,13293138,0,0,28,77
27361,13291865,13292077,13293271,0,0,212,1406
27368,13292634,13293138,13293374,0,0,504,740
27365,13291914,13292254,13293398,0,0,340,1484
27372,13293456,13293456,13293502,0,0,0,46
27371,13293449,13293449,13293626,0,0,0,177
27369,13292889,13293374,13293934,0,0,485,1045
27374,13293917,13293917,13293939,0,0,0,22
27364,13291893,13292077,13294146,0,0,184,2253
27373,13293644,13293644,13294192,0,0,0,548
27362,13291865,13292082,13294197,0,0,217,2332
27379,13294192,13294197,13294457,0,0,5,265
27375,13294015,13294015,13295258,0,0,0,1243
27381,13294410,13295258,13295298,0,0,848,888
27377,13294052,13294192,13295397,0,0,140,1345
27382,13294470,13295397,13296111,0,0,927,1641
27376,13294034,13294034,13296173,0,0,0,2139
27378,13294052,13294146,13296266,0,0,94,2214
27384,13295183,13296111,13296372,0,0,928,1189
27386,13296057,13296372,13296603,0,0,315,546
27385,13295462,13296173,13296768,0,0,711,1306
27387,13296188,13296188,13297506,0,0,0,1318
27392,13296916,13297506,13297538,0,0,590,622
27389,13296230,13296768,13298044,0,0,538,1814
27390,13296230,13296266,13298256,0,0,36,2026
27270,13267763,13289194,13298264,0,0,21431,30501
27363,13291869,13298264,13298385,0,0,6395,6516
27393,13296951,13298264,13298574,0,0,1313,1623
27388,13296211,13296603,13298613,0,0,392,2402
27395,13297856,13298385,13298627,0,0,529,771
27391,13296309,13298044,13298687,0,0,1735,2378
27394,13297296,13298264,13298824,0,0,968,1528
27396,13298116,13298385,13298985,0,0,269,869
27401,13298716,13298716,13299018,0,0,0,302
27397,13298239,13298239,13299491,0,0,0,1252
27402,13299036,13299036,13299664,0,0,0,628
27399,13298257,13298613,13299847,0,0,356,1590
27403,13299664,13299664,13299909,0,0,0,245
27400,13298257,13298257,13300308,0,0,0,2051
27404,13299927,13299927,13300450,0,0,0,523
27398,13298239,13298574,13300644,0,0,335,2405
27409,13300449,13300449,13300648,0,0,0,199
27380,13294361,13294457,13301335,0,0,96,6974
27407,13300379,13300379,13301889,0,0,0,1510
27405,13300344,13300344,13301890,0,0,0,1546
27410,13301150,13301150,13304213,0,0,0,3063
27406,13300344,13300344,13304214,0,0,0,3870
27307,13279969,13281999,13304551,0,0,2030,24582
27411,13303123,13303123,13306263,0,0,0,3140
27413,13307082,13307082,13307159,0,0,0,77
27414,13307122,13307122,13307535,0,0,0,413
27408,13300379,13300379,13307832,0,0,0,7453
27416,13307885,13307885,13307970,0,0,0,85
27383,13294733,13298264,13309668,0,0,3531,14935
27419,13310432,13310432,13310443,0,0,0,11
27420,13310685,13310685,13310751,0,0,0,66
27412,13306244,13306244,13310863,0,0,0,4619
27417,13307902,13307902,13311123,0,0,0,3221
27415,13307867,13307867,13311124,0,0,0,3257
27422,13311240,13311240,13311286,0,0,0,46
27423,13312453,13312453,13312548,0,0,0,95
27425,13312636,13312636,13312726,0,0,0,90
27429,13315141,13315141,13315517,0,0,0,376
27431,13315553,13315553,13315575,0,0,0,22
27430,13315226,13315517,13315648,0,0,291,422
27427,13313835,13313835,13315693,0,0,0,1858
27426,13313556,13313556,13316043,0,0,0,2487
27437,13316055,13316055,13316329,0,0,0,274
27438,13316366,13316366,13316407,0,0,0,41
27433,13315587,13315648,13316474,0,0,61,887
27432,13315579,13316474,13316527,0,0,895,948
27434,13315668,13316527,13316578,0,0,859,910
27421,13310837,13310837,13316807,0,0,0,5970
27435,13315746,13316578,13317003,0,0,832,1257
27439,13316383,13317003,13317531,0,0,620,1148
27428,13314243,13314243,13319589,0,0,0,5346
27445,13319010,13319589,13319647,0,0,579,637
27443,13318322,13319589,13319666,0,0,1267,1344
27418,13308467,13308467,13319979,0,0,0,11512
27448,13319729,13319729,13320600,0,0,0,871
27449,13319854,13320600,13320722,0,0,746,868
27442,13318237,13318237,13321853,0,0,0,3616
27452,13321342,13321342,13322055,0,0,0,713
27453,13321381,13322055,13322728,0,0,674,1347
27424,13312562,13312562,13323885,0,0,0,11323
27440,13316778,13317531,13323907,0,0,753,7129
27441,13317100,13323885,13324575,0,0,6785,7475
27444,13318416,13323885,13324696,0,0,5469,6280
27446,13319271,13323907,13325023,0,0,4636,5752
27450,13320885,13321853,13325028,0,0,968,4143
27451,13321124,13324575,13325130,0,0,3451,4006
27456,13321678,13325023,13325263,0,0,3345,3585
27454,13321501,13322728,13325661,0,0,1227,4160
27465,13322053,13325661,13326109,0,0,3608,4056
27458,13321763,13325028,13326397,0,0,3265,4634
27466,13322221,13326397,13326657,0,0,4176,4436
27469,13322627,13326657,13326712,0,0,4030,4085
27470,13322658,13326712,13326837,0,0,4054,4179
27447,13319668,13319668,13326893,0,0,0,7225
27471,13322930,13326837,13327262,0,0,3907,4332
27457,13321736,13325130,13327403,0,0,3394,5667
27436,13315920,13319979,13327583,0,0,4059,11663
27463,13321985,13327583,13327615,0,0,5598,5630
27462,13321939,13327583,13327629,0,0,5644,5690
27461,13321860,13327403,13328695,0,0,5543,6835
27474,13323357,13328695,13329562,0,0,5338,6205
27475,13323369,13328695,13329841,0,0,5326,6472
27481,13324980,13329841,13329861,0,0,4861,4881
27482,13325273,13329861,13329924,0,0,4588,4651
27459,13321771,13327583,13329936,0,0,5812,8165
27484,13325431,13329936,13330023,0,0,4505,4592
27488,13326330,13330023,13330042,0,0,3693,3712
27489,13327952,13330042,13330055,0,0,2090,2103
27486,13326032,13329936,13330062,0,0,3904,4030
27483,13325369,13329924,13330093,0,0,4555,4724
27479,13324003,13329841,13330185,0,0,5838,6182
27478,13323899,13329562,13330532,0,0,5663,6633
27480,13324416,13329936,13330633,0,0,5520,6217
27464,13322016,13327615,13331081,0,0,5599,9065
27492,13329884,13330062,13335019,0,0,178,5135
27490,13328557,13330055,13335087,0,0,1498,6530
27491,13329620,13330532,13335355,0,0,912,5735
27497,13333743,13335355,13335399,0,0,1612,1656
27493,13330567,13330633,13335510,0,0,66,4943
27496,13332629,13335019,13335846,0,0,2390,3217
27455,13321546,13324696,13336159,0,0,3150,14613
27495,13331264,13331264,13336213,0,0,0,4949
27460,13321845,13325263,13336424,0,0,3418,14579
27487,13326180,13329936,13336821,0,0,3756,10641
27476,13323536,13327262,13336857,0,0,3726,13321
27473,13323171,13326893,13336930,0,0,3722,13759
27467,13322292,13326109,13337031,0,0,3817,14739
27498,13337242,13337242,13337283,0,0,0,41
27468,13322312,13326657,13337479,0,0,4345,15167
27472,13323150,13327629,13337486,0,0,4479,14336
27499,13337327,13337327,13337488,0,0,0,161
27485,13325535,13329936,13337607,0,0,4401,12072
27501,13337612,13337612,13337650,0,0,0,38
27502,13337650,13337650,13337670,0,0,0,20
27503,13337670,13337670,13337730,0,0,0,60
27504,13337881,13337881,13337918,0,0,0,37
27505,13338065,13338065,13338481,0,0,0,416
27477,13323860,13329562,13338832,0,0,5702,14972
27494,13330631,13335846,13340562,0,0,5215,9931
27510,13340023,13340023,13340638,0,0,0,615
27512,13340345,13340345,13341145,0,0,0,800
27500,13337332,13337332,13342321,0,0,0,4989
27509,13339499,13339499,13342827,0,0,0,3328
27508,13338402,13338402,13342892,0,0,0,4490
27507,13338139,13338139,13342910,0,0,0,4771
27506,13338113,13338113,13342912,0,0,0,4799
27515,13342934,13342934,13342974,0,0,0,40
27516,13343012,13343012,13343048,0,0,0,36
27517,13343067,13343067,13343102,0,0,0,35
27518,13343121,13343121,13344147,0,0,0,1026
27511,13340046,13340046,13345628,0,0,0,5582
27519,13345586,13345586,13345777,0,0,0,191
27521,13345787,13345787,13345864,0,0,0,77
27522,13345958,13345958,13346584,0,0,0,626
27513,13341031,13341031,13346740,0,0,0,5709
27514,13341605,13341605,13347049,0,0,0,5444
27524,13346756,13346756,13348309,0,0,0,1553
27523,13346421,13346584,13350685,0,0,163,4264
27527,13347128,13347128,13351741,0,0,0,4613
27531,13352565,13352565,13352602,0,0,0,37
27532,13352704,13352704,13352733,0,0,0,29
27530,13351247,13351741,13353428,0,0,494,2181
27526,13346913,13347049,13354109,0,0,136,7196
27533,13353017,13353017,13356190,0,0,0,3173
27529,13351117,13351117,13356663,0,0,0,5546
27525,13346896,13347049,13356749,0,0,153,9853
27528,13347199,13350685,13357706,0,0,3486,10507
27535,13359367,13359367,13359384,0,0,0,17
27536,13359529,13359529,13359542,0,0,0,13
27537,13360015,13360015,13360166,0,0,0,151
27538,13360290,13360290,13360458,0,0,0,168
27534,13357894,13357894,13364873,0,0,0,6979
27542,13361913,13364873,13364952,0,0,2960,3039
27540,13361474,13364873,13364982,0,0,3399,3508
27544,13362864,13364873,13364987,0,0,2009,2123
27545,13362921,13364873,13365036,0,0,1952,2115
27546,13363483,13364987,13365082,0,0,1504,1599
27548,13364649,13364982,13365289,0,0,333,640
27549,13364835,13365082,13365427,0,0,247,592
27543,13362013,13364873,13365756,0,0,2860,3743
27551,13364892,13365289,13365875,0,0,397,983
27552,13365345,13365427,13366472,0,0,82,1127
27553,13365496,13365875,13366685,0,0,379,1189
27554,13366350,13366350,13367016,0,0,0,666
27555,13367228,13367228,13367469,0,0,0,241
27520,13345730,13345730,13368530,0,0,0,22800
27558,13368931,13368931,13369002,0,0,0,71
27556,13368117,13368117,13369008,0,0,0,891
27557,13368848,13368848,13369019,0,0,0,171
27559,13370159,13370159,13370231,0,0,0,72
27541,13361690,13364873,13371313,0,0,3183,9623
27562,13371991,13371991,13372074,0,0,0,83
27563,13372499,13372499,13372573,0,0,0,74
27561,13371808,13371808,13372907,0,0,0,1099
27564,13372904,13372904,13372946,0,0,0,42
27566,13373028,13373028,13373099,0,0,0,71
27565,13372954,13372954,13373612,0,0,0,658
27567,13373608,13373608,13374090,0,0,0,482
27568,13374089,13374089,13374690,0,0,0,601
27569,13374686,13374686,13375243,0,0,0,557
27550,13364875,13368530,13375432,0,0,3655,10557
27570,13375240,13375240,13375786,0,0,0,546
27571,13375781,13375781,13376419,0,0,0,638
27572,13376417,13376417,13377254,0,0,0,837
27573,13377250,13377250,13382255,0,0,0,5005
27539,13360407,13360458,13383054,0,0,51,22647
27574,13383388,13383388,13383410,0,0,0,22
27576,13384098,13384098,13384115,0,0,0,17
27577,13384223,13384223,13384238,0,0,0,15
27578,13384515,13384515,13384757,0,0,0,242
27560,13371780,13375432,13385448,0,0,3652,13668
27575,13383694,13385448,13386940,0,0,1754,3246
27579,13386648,13386648,13389703,0,0,0,3055
27580,13393004,13393004,13393329,0,0,0,325
27581,13393567,13393567,13393658,0,0,0,91
27584,13397063,13397063,13397201,0,0,0,138
27582,13396358,13396358,13398181,0,0,0,1823
27585,13397105,13397105,13398367,0,0,0,1262
27588,13398491,13398491,13398775,0,0,0,284
27586,13398379,13398379,13399317,0,0,0,938
27591,13399542,13399542,13399942,0,0,0,400
27592,13399745,13399745,13400105,0,0,0,360
27593,13400049,13400049,13400367,0,0,0,318
27594,13400174,13400174,13400503,0,0,0,329
27587,13398428,13398428,13400618,0,0,0,2190
27596,13400666,13400666,13400989,0,0,0,323
27598,13401056,13401056,13401300,0,0,0,244
27600,13401224,13401224,13401303,0,0,0,79
27601,13401278,13401278,13401310,0,0,0,32
27602,13401323,13401323,13401437,0,0,0,114
27603,13401478,13401478,13401590,0,0,0,112
27595,13400380,13400380,13401617,0,0,0,1237
27604,13401825,13401825,13402056,0,0,0,231
27606,13402076,13402076,13402326,0,0,0,250
27605,13401951,13401951,13402405,0,0,0,454
27589,13399170,13399170,13402728,0,0,0,3558
27608,13402520,13402520,13402771,0,0,0,251
27590,13399336,13400618,13403017,0,0,1282,3681
27612,13402986,13402986,13403210,0,0,0,224
27609,13402587,13402587,13403267,0,0,0,680
27613,13403010,13403010,13403309,0,0,0,299
27614,13403196,13403196,13403351,0,0,0,155
27615,13403300,13403300,13403369,0,0,0,69
27616,13403356,13403356,13403427,0,0,0,71
27618,13403403,13403403,13403446,0,0,0,43
27617,13403374,13403374,13403568,0,0,0,194
27622,13403753,13403753,13403870,0,0,0,117
27620,13403644,13403644,13404003,0,0,0,359
27624,13404042,13404042,13404098,0,0,0,56
27623,13404017,13404017,13404254,0,0,0,237
27621,13403668,13403668,13404273,0,0,0,605
27627,13404268,13404268,13404297,0,0,0,29
27626,13404228,13404228,13404449,0,0,0,221
27628,13404423,13404423,13404506,0,0,0,83
27611,13402889,13402889,13404530,0,0,0,1641
27630,13404552,13404552,13404627,0,0,0,75
27631,13404567,13404567,13404684,0,0,0,117
27632,13404685,13404685,13404902,0,0,0,217
27633,13404897,13404897,13404975,0,0,0,78
27629,13404528,13404528,13405061,0,0,0,533
27636,13404970,13404975,13405086,0,0,5,116
27635,13404940,13404940,13405210,0,0,0,270
27638,13405114,13405114,13405232,0,0,0,118
27639,13405130,13405130,13405277,0,0,0,147
27641,13405300,13405300,13405370,0,0,0,70
27637,13404997,13405061,13405595,0,0,64,598
27640,13405236,13405236,13405772,0,0,0,536
27642,13405836,13405836,13405912,0,0,0,76
27644,13406087,13406087,13406093,0,0,0,6
27649,13406418,13406418,13406427,0,0,0,9
27645,13406198,13406198,13406428,0,0,0,230
27646,13406221,13406221,13406428,0,0,0,207
27650,13406624,13406624,13406691,0,0,0,67
27651,13406702,13406702,13406713,0,0,0,11
27652,13406870,13406870,13406878,0,0,0,8
27653,13406901,13406901,13407021,0,0,0,120
27655,13407221,13407221,13407304,0,0,0,83
27619,13403491,13403491,13407741,0,0,0,4250
27657,13407394,13407741,13407753,0,0,347,359
27660,13407869,13407869,13407878,0,0,0,9
27583,13396475,13396475,13407911,0,0,0,11436
27654,13407032,13407032,13407940,0,0,0,908
27656,13407329,13407329,13407997,0,0,0,668
27661,13407890,13407890,13408025,0,0,0,135
27662,13407942,13407942,13408029,0,0,0,87
27663,13407994,13407994,13408103,0,0,0,109
27658,13407521,13407911,13408429,0,0,390,908
27667,13408352,13408429,13408436,0,0,77,84
27668,13408399,13408429,13408462,0,0,30,63
27669,13408487,13408487,13408555,0,0,0,68
27671,13408696,13408696,13408790,0,0,0,94
27610,13402700,13402700,13408794,0,0,0,6094
27673,13408838,13408838,13408867,0,0,0,29
27676,13408930,13408930,13408942,0,0,0,12
27674,13408922,13408922,13408996,0,0,0,74
27679,13409150,13409150,13409163,0,0,0,13
27643,13406037,13406037,13409230,0,0,0,3193
27647,13406266,13406266,13409474,0,0,0,3208
27681,13409439,13409474,13409567,0,0,35,128
27683,13409666,13409666,13410570,0,0,0,904
27686,13409930,13410570,13410662,0,0,640,732
27689,13410603,13410662,13410999,0,0,59,396
27691,13410945,13410999,13412052,0,0,54,1107
27678,13409129,13409129,13412284,0,0,0,3155
27694,13411285,13412284,13412297,0,0,999,1012
27634,13404923,13404923,13412333,0,0,0,7410
27698,13411637,13412297,13412386,0,0,660,749
27692,13411031,13412052,13412418,0,0,1021,1387
27696,13411564,13412284,13412556,0,0,720,992
27670,13408670,13412333,13412561,0,0,3663,3891
27701,13411946,13412556,13412610,0,0,610,664
27700,13411917,13412418,13412639,0,0,501,722
27703,13412292,13412610,13412676,0,0,318,384
27706,13412594,13412676,13412692,0,0,82,98
27699,13411652,13412386,13412774,0,0,734,1122
27666,13408121,13412333,13412883,0,0,4212,4762
27607,13402128,13402128,13412907,0,0,0,10779
27710,13412808,13412808,13412914,0,0,0,106
27675,13408925,13412561,13413202,0,0,3636,4277
27682,13409565,13413202,13413505,0,0,3637,3940
27684,13409781,13413505,13413959,0,0,3724,4178
27685,13409888,13413959,13414647,0,0,4071,4759
27677,13408949,13412883,13415162,0,0,3934,6213
27704,13412382,13412639,13415378,0,0,257,2996
27688,13410575,13415162,13415440,0,0,4587,4865
27672,13408786,13408786,13415483,0,0,0,6697
27695,13411435,13415440,13415866,0,0,4005,4431
27687,13409967,13414647,13415963,0,0,4680,5996
27697,13411629,13415866,13416034,0,0,4237,4405
27680,13409297,13409297,13416043,0,0,0,6746
27690,13410880,13415378,13416131,0,0,4498,5251
27705,13412426,13416034,13416212,0,0,3608,3786
27723,13416313,13416313,13416327,0,0,0,14
27708,13412633,13416212,13416549,0,0,3579,3916
27707,13412603,13416131,13416571,0,0,3528,3968
27720,13415734,13416043,13416579,0,0,309,845
27702,13411964,13415963,13416633,0,0,3999,4669
27726,13416916,13416916,13416943,0,0,0,27
27709,13412798,13416549,13416957,0,0,3751,4159
27711,13412990,13416571,13417034,0,0,3581,4044
27714,13414117,13417034,13417335,0,0,2917,3218
27547,13363509,13364952,13417423,0,0,1443,53914
27713,13413473,13416957,13417562,0,0,3484,4089
27730,13417511,13417511,13417582,0,0,0,71
27716,13414838,13417562,13417899,0,0,2724,3061
27715,13414417,13417335,13418032,0,0,2918,3615
27733,13418011,13418011,13418034,0,0,0,23
27665,13408061,13408429,13418116,0,0,368,10055
27717,13415114,13417899,13418202,0,0,2785,3088
27732,13417616,13417616,13418416,0,0,0,800
27721,13415849,13418202,13418559,0,0,2353,2710
27718,13415417,13418032,13418786,0,0,2615,3369
27722,13416169,13418559,13418844,0,0,2390,2675
27734,13418069,13418116,13419177,0,0,47,1108
27719,13415563,13415563,13419239,0,0,0,3676
27741,13418987,13419239,13419259,0,0,252,272
27739,13418447,13419239,13419268,0,0,792,821
27742,13419111,13419259,13419278,0,0,148,167
27743,13419187,13419268,13419288,0,0,81,101
27659,13407540,13408029,13419395,0,0,489,11855
27737,13418232,13419177,13419515,0,0,945,1283
27728,13417314,13419395,13419559,0,0,2081,2245
27724,13416454,13418786,13419587,0,0,2332,3133
27747,13419528,13419528,13419756,0,0,0,228
27749,13419765,13419765,13419790,0,0,0,25
27725,13416807,13418844,13420002,0,0,2037,3195
27751,13420011,13420011,13420042,0,0,0,31
27736,13418163,13418416,13420159,0,0,253,1996
27738,13418366,13420002,13420239,0,0,1636,1873
27735,13418098,13419587,13420260,0,0,1489,2162
27727,13416948,13419395,13420360,0,0,2447,3412
27729,13417494,13419559,13420432,0,0,2065,2938
27744,13419200,13420260,13420505,0,0,1060,1305
27752,13420281,13420505,13420692,0,0,224,411
27746,13419301,13420360,13420723,0,0,1059,1422
27754,13420527,13420692,13420807,0,0,165,280
27740,13418602,13420239,13420938,0,0,1637,2336
27748,13419663,13420432,13421052,0,0,769,1389
27731,13417590,13417590,13421154,0,0,0,3564
27664,13408039,13408103,13421173,0,0,64,13134
27756,13420734,13420734,13421311,0,0,0,577
27758,13421311,13421311,13421506,0,0,0,195
27760,13421531,13421531,13421714,0,0,0,183
27755,13420640,13420938,13421932,0,0,298,1292
27764,13421848,13421848,13421939,0,0,0,91
27761,13421531,13421531,13422050,0,0,0,519
27766,13422024,13422024,13422087,0,0,0,63
27768,13422201,13422201,13422252,0,0,0,51
27767,13422050,13422050,13422324,0,0,0,274
27772,13422382,13422382,13422455,0,0,0,73
27771,13422352,13422352,13422461,0,0,0,109
27765,13421877,13421932,13422653,0,0,55,776
27774,13422604,13422604,13422970,0,0,0,366
27770,13422336,13422336,13422974,0,0,0,638
27757,13420951,13421052,13423083,0,0,101,2132
27777,13422973,13422974,13423216,0,0,1,243
27773,13422526,13422526,13423590,0,0,0,1064
27781,13423633,13423633,13423741,0,0,0,108
27648,13406282,13406282,13423757,0,0,0,17475
27750,13419976,13419976,13423803,0,0,0,3827
27779,13423270,13423270,13423906,0,0,0,636
27783,13423906,13423906,13423963,0,0,0,57
27782,13423832,13423832,13424002,0,0,0,170
27775,13422777,13422777,13424141,0,0,0,1364
27780,13423529,13423529,13424673,0,0,0,1144
27785,13424255,13424255,13424736,0,0,0,481
27753,13420395,13420395,13424765,0,0,0,4370
27787,13424858,13424858,13425449,0,0,0,591
27791,13425041,13425041,13425476,0,0,0,435
27778,13423191,13423191,13425560,0,0,0,2369
27788,13424908,13424908,13425633,0,0,0,725
27794,13425686,13425686,13425866,0,0,0,180
27795,13425699,13425866,13426034,0,0,167,335
27799,13426132,13426132,13426454,0,0,0,322
27763,13421714,13421714,13426472,0,0,0,4758
27801,13426546,13426546,13426592,0,0,0,46
27745,13419242,13419288,13426670,0,0,46,7428
27759,13421393,13421393,13426690,0,0,0,5297
27803,13426721,13426721,13426753,0,0,0,32
27792,13425082,13425449,13426758,0,0,367,1676
27800,13426207,13426454,13426908,0,0,247,701
27796,13425781,13426034,13426929,0,0,253,1148
27804,13426749,13426758,13427095,0,0,9,346
27776,13422802,13422970,13427254,0,0,168,4452
27797,13425881,13426670,13427380,0,0,789,1499
27807,13427110,13427254,13427534,0,0,144,424
27802,13426568,13426568,13427634,0,0,0,1066
27811,13427622,13427634,13429293,0,0,12,1671
27793,13425592,13425592,13429386,0,0,0,3794
27762,13421640,13421640,13429415,0,0,0,7775
27806,13427043,13427095,13429460,0,0,52,2417
27817,13428899,13429460,13429547,0,0,561,648
27819,13429330,13429460,13429596,0,0,130,266
27798,13426088,13426088,13429628,0,0,0,3540
27820,13429357,13429547,13429856,0,0,190,499
27815,13428461,13429415,13429924,0,0,954,1463
27810,13427585,13427585,13429934,0,0,0,2349
27818,13429287,13429924,13430046,0,0,637,759
27821,13429548,13429934,13430238,0,0,386,690
27823,13430143,13430238,13430552,0,0,95,409
27786,13424713,13424713,13430573,0,0,0,5860
27789,13424978,13424978,13430621,0,0,0,5643
27824,13430334,13430334,13430744,0,0,0,410
27790,13425025,13430621,13430780,0,0,5596,5755
27814,13428071,13429386,13430812,0,0,1315,2741
27816,13428687,13429293,13430839,0,0,606,2152
27825,13430415,13430552,13430871,0,0,137,456
27809,13427466,13427534,13430942,0,0,68,3476
27828,13430674,13430744,13430964,0,0,70,290
27831,13430910,13430910,13431077,0,0,0,167
27833,13431112,13431112,13431289,0,0,0,177
27826,13430460,13430552,13431373,0,0,92,913
27835,13431314,13431314,13431502,0,0,0,188
27837,13431430,13431502,13431522,0,0,72,92
27836,13431386,13431386,13431734,0,0,0,348
27839,13431558,13431734,13431847,0,0,176,289
27838,13431519,13431522,13431994,0,0,3,475
27712,13413240,13416633,13432231,0,0,3393,18991
27845,13431971,13432231,13432268,0,0,260,297
27847,13432176,13432268,13432370,0,0,92,194
27846,13432036,13432231,13432376,0,0,195,340
27808,13427302,13427380,13432446,0,0,78,5144
27832,13431027,13432231,13432488,0,0,1204,1461
27840,13431652,13431847,13432506,0,0,195,854
27850,13432487,13432488,13432620,0,0,1,133
27852,13432661,13432661,13432774,0,0,0,113
27834,13431117,13432446,13432993,0,0,1329,1876
27854,13432854,13432854,13433175,0,0,0,321
27841,13431678,13432993,13434566,0,0,1315,2888
27843,13431837,13434566,13434587,0,0,2729,2750
27844,13431938,13434587,13434605,0,0,2649,2667
27842,13431738,13431994,13434925,0,0,256,3187
27861,13435146,13435146,13435717,0,0,0,571
27848,13432204,13434605,13435793,0,0,2401,3589
27864,13435565,13435717,13436779,0,0,152,1214
27867,13436625,13436779,13436818,0,0,154,193
27805,13426794,13426908,13437342,0,0,114,10548
27830,13430748,13430964,13437918,0,0,216,7170
27851,13432646,13437918,13437954,0,0,5272,5308
27868,13436725,13436818,13438008,0,0,93,1283
27822,13429832,13430046,13438078,0,0,214,8246
27853,13432726,13437918,13438106,0,0,5192,5380
27871,13437913,13438008,13438130,0,0,95,217
27858,13434361,13438106,13438133,0,0,3745,3772
27859,13434707,13438133,13438155,0,0,3426,3448
27856,13433617,13438078,13438801,0,0,4461,5184
27829,13430723,13430812,13438828,0,0,89,8105
27849,13432243,13435793,13439115,0,0,3550,6872
27872,13438033,13438130,13439198,0,0,97,1165
27873,13439100,13439100,13439221,0,0,0,121
27855,13433607,13437954,13439388,0,0,4347,5781
27863,13435477,13439115,13439922,0,0,3638,4445
27866,13436317,13439922,13440241,0,0,3605,3924
27876,13440119,13440119,13440274,0,0,0,155
27874,13439219,13439219,13440339,0,0,0,1120
27877,13440271,13440271,13440340,0,0,0,69
27879,13440337,13440339,13440413,0,0,2,76
27878,13440332,13440332,13440415,0,0,0,83
27880,13440395,13440395,13440459,0,0,0,64
27882,13440423,13440423,13440470,0,0,0,47
27883,13440468,13440468,13440533,0,0,0,65
27884,13440530,13440530,13440592,0,0,0,62
27885,13440590,13440590,13440654,0,0,0,64
27886,13440649,13440649,13440714,0,0,0,65
27887,13440714,13440714,13440741,0,0,0,27
27888,13440735,13440735,13440758,0,0,0,23
27889,13440759,13440759,13440782,0,0,0,23
27890,13440779,13440779,13440807,0,0,0,28
27891,13440799,13440799,13440831,0,0,0,32
27892,13440828,13440828,13440854,0,0,0,26
27893,13440849,13440849,13440871,0,0,0,22
27894,13440870,13440870,13440896,0,0,0,26
27895,13440891,13440891,13440916,0,0,0,25
27896,13440913,13440913,13440936,0,0,0,23
27897,13440937,13440937,13440963,0,0,0,26
27898,13440958,13440958,13440984,0,0,0,26
27899,13440981,13440981,13441017,0,0,0,36
27900,13441009,13441009,13441033,0,0,0,24
27901,13441030,13441030,13441054,0,0,0,24
27902,13441051,13441051,13441068,0,0,0,17
27881,13440421,13440421,13441367,0,0,0,946
27903,13441366,13441366,13441488,0,0,0,122
27860,13434715,13438155,13441863,0,0,3440,7148
27904,13441485,13441485,13442423,0,0,0,938
27907,13442421,13442421,13442457,0,0,0,36
27905,13442227,13442227,13442687,0,0,0,460
27908,13442448,13442448,13442773,0,0,0,325
27909,13442466,13442466,13443557,0,0,0,1091
27912,13443555,13443555,13443731,0,0,0,176
27911,13443423,13443423,13444660,0,0,0,1237
27913,13443729,13443729,13444789,0,0,0,1060
27915,13444787,13444787,13444850,0,0,0,63
27914,13444715,13444715,13445167,0,0,0,452
27916,13444849,13444849,13445968,0,0,0,1119
27917,13445957,13445957,13446012,0,0,0,55
27919,13446076,13446076,13446104,0,0,0,28
27920,13446319,13446319,13446719,0,0,0,400
27921,13446356,13446356,13446931,0,0,0,575
27918,13446011,13446011,13447235,0,0,0,1224
27922,13447233,13447233,13447318,0,0,0,85
27910,13443251,13443251,13447485,0,0,0,4234
27865,13435819,13439388,13448161,0,0,3569,12342
27862,13435233,13438801,13448163,0,0,3568,12930
27925,13448038,13448161,13448361,0,0,123,323
27923,13447331,13447331,13448547,0,0,0,1216
27926,13448545,13448545,13448598,0,0,0,53
27927,13448659,13448659,13449763,0,0,0,1104
27931,13449759,13449763,13449817,0,0,4,58
27933,13450346,13450346,13450645,0,0,0,299
27875,13439371,13440241,13451085,0,0,870,11714
27932,13449880,13449880,13451156,0,0,0,1276
27928,13448818,13451085,13451285,0,0,2267,2467
27937,13451586,13451586,13452155,0,0,0,569
27929,13449084,13449084,13452599,0,0,0,3515
27935,13451155,13452599,13452727,0,0,1444,1572
27936,13451324,13452727,13453791,0,0,1403,2467
27939,13452387,13453791,13453855,0,0,1404,1468
27940,13452471,13453855,13454960,0,0,1384,2489
27942,13452681,13454960,13455290,0,0,2279,2609
27934,13450929,13451156,13462055,0,0,227,11126
27943,13453574,13462055,13462119,0,0,8481,8545
27870,13437696,13448361,13462596,0,0,10665,24900
27930,13449721,13451285,13462969,0,0,1564,13248
27947,13462206,13462596,13463126,0,0,390,920
27946,13454142,13462596,13463405,0,0,8454,9263
27812,13427658,13430780,13476317,0,0,3122,48659
27597,13400789,13476317,13477520,0,0,75528,76731
27599,13401065,13477520,13480454,0,0,76455,79389
27948,13487438,13487438,13489119,0,0,0,1681
27625,13404115,13480454,13493088,0,0,76339,88973
27950,13492392,13492392,13493545,0,0,0,1153
27693,13411038,13493088,13497033,0,0,82050,85995
27857,13434090,13434090,13497413,0,0,0,63323
27924,13448032,13448032,13497459,0,0,0,49427
27906,13442351,13442351,13497476,0,0,0,55125
27869,13437261,13437342,13497555,0,0,81,60294
27953,13495593,13497459,13497632,0,0,1866,2039
27949,13488387,13497632,13497979,0,0,9245,9592
27954,13498073,13498073,13498105,0,0,0,32
27945,13453745,13455290,13499022,0,0,1545,45277
27769,13422335,13497033,13499081,0,0,74698,76746
27941,13452626,13454960,13499811,0,0,2334,47185
27961,13501862,13501862,13502038,0,0,0,176
27962,13503248,13503248,13503861,0,0,0,613
27964,13503545,13503861,13503903,0,0,316,358
27957,13501561,13501561,13504114,0,0,0,2553
27967,13503763,13504114,13504141,0,0,351,378
27968,13503983,13504141,13504174,0,0,158,191
27951,13493838,13493838,13504553,0,0,0,10715
27969,13504031,13504174,13504604,0,0,143,573
27970,13504446,13504604,13504650,0,0,158,204
27971,13504472,13504650,13504685,0,0,178,213
27972,13504563,13504685,13504981,0,0,122,418
27944,13453636,13462119,13505962,0,0,8483,52326
27976,13505229,13505962,13506001,0,0,733,772
27978,13505786,13506001,13506032,0,0,215,246
27952,13495238,13495238,13506082,0,0,0,10844
27784,13424064,13499081,13506850,0,0,75017,82786
27981,13507920,13507920,13507958,0,0,0,38
27982,13508509,13508509,13508539,0,0,0,30
27980,13506587,13506587,13510526,0,0,0,3939
27955,13501535,13501535,13511959,0,0,0,10424
27956,13501547,13511959,13512186,0,0,10412,10639
27963,13503474,13512186,13512362,0,0,8712,8888
27965,13503725,13503903,13512728,0,0,178,9003
27977,13505236,13512728,13512757,0,0,7492,7521
27973,13504614,13504981,13512912,0,0,367,8298
27983,13512975,13512975,13513123,0,0,0,148
27966,13503735,13504553,13513251,0,0,818,9516
27984,13513216,13513216,13513290,0,0,0,74
27985,13513451,13513451,13513693,0,0,0,242
27974,13504852,13505962,13513712,0,0,1110,8860
27959,13501721,13513712,13513718,0,0,11991,11997
27960,13501737,13513718,13513742,0,0,11981,12005
27989,13513991,13513991,13514080,0,0,0,89
27990,13514052,13514052,13514141,0,0,0,89
27993,13514395,13514395,13514568,0,0,0,173
27986,13513753,13513753,13516294,0,0,0,2541
27997,13514876,13516294,13516348,0,0,1418,1472
27995,13514412,13514568,13517646,0,0,156,3234
28001,13515062,13517646,13518808,0,0,2584,3746
28000,13515009,13516348,13518939,0,0,1339,3930
28010,13516852,13518939,13519092,0,0,2087,2240
27975,13505215,13512362,13519517,0,0,7147,14302
28012,13517098,13519092,13520247,0,0,1994,3149
27813,13428057,13506850,13522068,0,0,78793,94011
27827,13430622,13522068,13522080,0,0,91446,91458
28013,13517940,13520247,13522492,0,0,2307,4552
28014,13517972,13522492,13522623,0,0,4520,4651
28017,13518669,13522623,13522707,0,0,3954,4038
27958,13501570,13511959,13522764,0,0,10389,21194
27998,13514888,13522764,13522844,0,0,7876,7956
28018,13518685,13522707,13522870,0,0,4022,4185
27999,13514900,13522844,13522881,0,0,7944,7981
28019,13518697,13522870,13522906,0,0,4173,4209
28005,13515593,13522881,13522940,0,0,7288,7347
28007,13516519,13522940,13523028,0,0,6421,6509
28020,13518903,13522906,13523067,0,0,4003,4164
27987,13513823,13513823,13523104,0,0,0,9281
28024,13519199,13523067,13523423,0,0,3868,4224
28025,13519247,13523423,13523442,0,0,4176,4195
28008,13516581,13523028,13523448,0,0,6447,6867
28026,13519264,13523442,13523577,0,0,4178,4313
28027,13519479,13523577,13523667,0,0,4098,4188
28028,13520100,13523667,13524463,0,0,3567,4363
28011,13516933,13523448,13525376,0,0,6515,8443
28015,13518300,13525376,13525611,0,0,7076,7311
28021,13518921,13525611,13525674,0,0,6690,6753
27991,13514081,13514081,13526218,0,0,0,12137
28030,13520987,13524463,13526361,0,0,3476,5374
27992,13514318,13522764,13526705,0,0,8446,12387
28033,13523872,13526705,13526804,0,0,2833,2932
28035,13524445,13526361,13527064,0,0,1916,2619
28006,13516065,13518808,13527895,0,0,2743,11830
28038,13525907,13527064,13527940,0,0,1157,2033
28023,13519128,13525674,13527975,0,0,6546,8847
28040,13526284,13527975,13528015,0,0,1691,1731
28029,13520523,13526218,13528024,0,0,5695,7501
28042,13526973,13528015,13528051,0,0,1042,1078
28031,13522175,13528051,13528562,0,0,5876,6387
28032,13523645,13528562,13529112,0,0,4917,5467
28043,13527730,13527940,13529147,0,0,210,1417
28036,13524583,13529112,13529296,0,0,4529,4713
27988,13513901,13519517,13529590,0,0,5616,15689
28034,13524321,13526804,13530885,0,0,2483,6564
28047,13530399,13530399,13530889,0,0,0,490
28039,13526214,13527895,13530999,0,0,1681,4785
28046,13529743,13530889,13531040,0,0,1146,1297
28048,13531461,13531461,13531641,0,0,0,180
28004,13515586,13523104,13531861,0,0,7518,16275
27938,13451932,13522080,13532752,0,0,70148,80820
27979,13506128,13532752,13533463,0,0,26624,27335
28037,13524910,13529296,13533769,0,0,4386,8859
28049,13531965,13533769,13533941,0,0,1804,1976
28052,13533554,13533941,13533970,0,0,387,416
28053,13533710,13533970,13534308,0,0,260,598
28050,13532184,13532184,13534368,0,0,0,2184
28054,13534364,13534364,13535876,0,0,0,1512
28051,13532942,13533769,13535889,0,0,827,2947
28044,13528335,13529590,13535976,0,0,1255,7641
27996,13514610,13531861,13536585,0,0,17251,21975
28056,13536248,13536248,13536811,0,0,0,563
28055,13535874,13535874,13537061,0,0,0,1187
28057,13536590,13536590,13537726,0,0,0,1136
28058,13537056,13537056,13538460,0,0,0,1404
28059,13537599,13537599,13538967,0,0,0,1368
28045,13529475,13529475,13539185,0,0,0,9710
28060,13538455,13538455,13539439,0,0,0,984
28062,13539436,13539436,13540032,0,0,0,596
28063,13540028,13540028,13540682,0,0,0,654
28065,13540679,13540679,13541365,0,0,0,686
28068,13541738,13541738,13541966,0,0,0,228
28067,13541358,13541358,13542595,0,0,0,1237
27994,13514402,13533463,13543066,0,0,19061,28664
28002,13515176,13543066,13543273,0,0,27890,28097
28070,13542590,13542595,13545662,0,0,5,3072
28003,13515396,13543273,13546702,0,0,27877,31306
28066,13540929,13540929,13547215,0,0,0,6286
28071,13543864,13547215,13547572,0,0,3351,3708
28069,13542041,13542041,13549598,0,0,0,7557
28016,13518391,13536585,13550216,0,0,18194,31825
28074,13545646,13545662,13552173,0,0,16,6527
28061,13539182,13539182,13553112,0,0,0,13930
28064,13540604,13553112,13553399,0,0,12508,12795
28072,13544287,13553399,13553657,0,0,9112,9370
28073,13544589,13547572,13556412,0,0,2983,11823
28075,13564451,13564451,13567626,0,0,0,3175
28076,13567564,13567564,13570750,0,0,0,3186
28082,13570943,13570943,13571226,0,0,0,283
28009,13516833,13546702,13571319,0,0,29869,54486
28084,13571424,13571424,13571629,0,0,0,205
28085,13571755,13571755,13571988,0,0,0,233
28086,13572127,13572127,13572330,0,0,0,203
28087,13572403,13572403,13572661,0,0,0,258
28041,13526580,13550216,13572781,0,0,23636,46201
28081,13570686,13570686,13574053,0,0,0,3367
28093,13574531,13574531,13574564,0,0,0,33
28088,13573867,13573867,13574905,0,0,0,1038
28091,13574055,13574905,13575031,0,0,850,976
28097,13575504,13575504,13575605,0,0,0,101
28098,13575593,13575605,13576175,0,0,12,582
28100,13575804,13576175,13576209,0,0,371,405
28101,13576041,13576209,13576245,0,0,168,204
28102,13576308,13576308,13576347,0,0,0,39
28103,13576507,13576507,13576793,0,0,0,286
28096,13575083,13575083,13577180,0,0,0,2097
28105,13576982,13576982,13577206,0,0,0,224
28090,13574037,13574053,13577320,0,0,16,3283
28109,13577699,13577699,13577802,0,0,0,103
28113,13578231,13578231,13578487,0,0,0,256
28110,13577899,13577899,13579090,0,0,0,1191
28079,13569854,13569854,13579517,0,0,0,9663
28118,13579495,13579495,13579561,0,0,0,66
28080,13570311,13579517,13579571,0,0,9206,9260
28116,13578923,13578923,13579594,0,0,0,671
28111,13577944,13579594,13579897,0,0,1650,1953
28117,13579054,13579897,13580019,0,0,843,965
28123,13579833,13580019,13580056,0,0,186,223
28127,13580235,13580235,13580258,0,0,0,23
28121,13579781,13580019,13580445,0,0,238,664
28129,13580460,13580460,13580478,0,0,0,18
28130,13580556,13580556,13580573,0,0,0,17
28131,13580608,13580608,13580671,0,0,0,63
28106,13577237,13577237,13580850,0,0,0,3613
28133,13580868,13580868,13580902,0,0,0,34
28136,13581075,13581075,13581087,0,0,0,12
28126,13580198,13580850,13581202,0,0,652,1004
28128,13580256,13580258,13581632,0,0,2,1376
28143,13581652,13581652,13581837,0,0,0,185
28141,13581539,13581539,13581916,0,0,0,377
28089,13574023,13579571,13583354,0,0,5548,9331
28092,13574404,13583354,13583406,0,0,8950,9002
28077,13567811,13572781,13584284,0,0,4970,16473
28095,13574880,13584284,13584536,0,0,9404,9656
28099,13575602,13584284,13584540,0,0,8682,8938
28108,13577631,13584540,13584785,0,0,6909,7154
28104,13576726,13584536,13584804,0,0,7810,8078
28114,13578370,13584804,13584979,0,0,6434,6609
28145,13581824,13581916,13585009,0,0,92,3185
28022,13518977,13571319,13585119,0,0,52342,66142
28115,13578664,13584979,13585472,0,0,6315,6808
28119,13579622,13585472,13585595,0,0,5850,5973
28122,13579798,13585595,13585638,0,0,5797,5840
28112,13578181,13584785,13586405,0,0,6604,8224
28124,13579964,13585638,13586716,0,0,5674,6752
28137,13581147,13586716,13586812,0,0,5569,5665
28134,13580877,13586716,13586868,0,0,5839,5991
28144,13581676,13581837,13586875,0,0,161,5199
28139,13581385,13586868,13587010,0,0,5483,5625
28142,13581648,13587010,13587070,0,0,5362,5422
28094,13574751,13583406,13587240,0,0,8655,12489
28078,13568594,13585119,13587356,0,0,16525,18762
28138,13581333,13586812,13587642,0,0,5479,6309
28147,13582208,13585009,13588103,0,0,2801,5895
28152,13583067,13588103,13588223,0,0,5036,5156
28149,13582338,13586875,13588382,0,0,4537,6044
28159,13584460,13588382,13588433,0,0,3922,3973
28160,13584539,13588433,13588461,0,0,3894,3922
28163,13585411,13588461,13588574,0,0,3050,3163
28146,13581866,13587070,13589639,0,0,5204,7773
28150,13582502,13589639,13589693,0,0,7137,7191
28157,13583842,13588223,13589825,0,0,4381,5983
28135,13581057,13587240,13590581,0,0,6183,9524
28132,13580786,13581202,13590663,0,0,416,9877
28154,13583148,13590663,13590694,0,0,7515,7546
28125,13580083,13586405,13590721,0,0,6322,10638
28156,13583750,13590694,13590733,0,0,6944,6983
28161,13584825,13590721,13591387,0,0,5896,6562
28165,13586116,13591387,13591398,0,0,5271,5282
28167,13586927,13588574,13591813,0,0,1647,4886
28148,13582240,13587642,13591820,0,0,5402,9580
28172,13588914,13591820,13591874,0,0,2906,2960
28179,13592136,13592136,13592234,0,0,0,98
28169,13587520,13591813,13592567,0,0,4293,5047
28168,13587288,13589825,13593232,0,0,2537,5944
28174,13590245,13592567,13594095,0,0,2322,3850
28177,13591716,13591820,13594125,0,0,104,2409
28140,13581417,13590581,13594670,0,0,9164,13253
28175,13590996,13594095,13594972,0,0,3099,3976
28182,13592706,13593232,13595577,0,0,526,2871
28183,13593113,13594125,13596271,0,0,1012,3158
28186,13594437,13596271,13596367,0,0,1834,1930
28187,13594675,13596367,13596409,0,0,1692,1734
28166,13586353,13591398,13598282,0,0,5045,11929
28189,13594755,13596409,13598814,0,0,1654,4059
28192,13595242,13598814,13598910,0,0,3572,3668
28083,13571010,13587356,13598912,0,0,16346,27902
28184,13593188,13595577,13600179,0,0,2389,6991
28194,13595925,13600179,13600216,0,0,4254,4291
28195,13596210,13600216,13600310,0,0,4006,4100
28196,13596665,13600310,13600396,0,0,3645,3731
28198,13597196,13600396,13600433,0,0,3200,3237
28193,13595506,13598910,13600998,0,0,3404,5492
28201,13597623,13600998,13601034,0,0,3375,3411
28202,13597647,13601034,13601834,0,0,3387,4187
28203,13597672,13601834,13601866,0,0,4162,4194
28107,13577617,13598912,13602404,0,0,21295,24787
28162,13585116,13590733,13603023,0,0,5617,17907
28204,13597766,13601866,13603164,0,0,4100,5398
28205,13598050,13603164,13603216,0,0,5114,5166
28206,13598426,13603216,13603251,0,0,4790,4825
28176,13591260,13594972,13603255,0,0,3712,11995
28185,13594128,13603255,13603424,0,0,9127,9296
28188,13594688,13603424,13603609,0,0,8736,8921
28200,13597564,13600433,13603638,0,0,2869,6074
28208,13598697,13603638,13603670,0,0,4941,4973
28210,13598822,13603670,13603744,0,0,4848,4922
28190,13594934,13603609,13603781,0,0,8675,8847
28217,13599023,13603744,13603786,0,0,4721,4763
28218,13599474,13603786,13603824,0,0,4312,4350
28191,13594948,13603781,13603825,0,0,8833,8877
28221,13599644,13603825,13604358,0,0,4181,4714
28224,13600181,13604358,13604390,0,0,4177,4209
28207,13598443,13603251,13604454,0,0,4808,6011
28225,13600601,13604390,13604455,0,0,3789,3854
28226,13600679,13604454,13604558,0,0,3775,3879
28223,13600171,13603825,13604630,0,0,3654,4459
28233,13601842,13604630,13604732,0,0,2788,2890
28151,13582805,13589693,13604762,0,0,6888,21957
28181,13592362,13603023,13604776,0,0,10661,12414
28235,13602111,13604776,13604883,0,0,2665,2772
28228,13600972,13604455,13604997,0,0,3483,4025
28236,13602562,13604883,13605066,0,0,2321,2504
28232,13601510,13604558,13605105,0,0,3048,3595
28234,13602052,13604732,13605378,0,0,2680,3326
28230,13601283,13604762,13605388,0,0,3479,4105
28242,13603743,13605378,13605472,0,0,1635,1729
28237,13602697,13604997,13605710,0,0,2300,3013
28171,13588671,13598282,13605772,0,0,9611,17101
28170,13587704,13594670,13605773,0,0,6966,18069
28178,13591942,13605773,13606405,0,0,13831,14463
28197,13596909,13606405,13606607,0,0,9496,9698
28239,13603402,13605105,13606609,0,0,1703,3207
28247,13604903,13605472,13606633,0,0,569,1730
28199,13597317,13606607,13606792,0,0,9290,9475
28209,13598811,13606792,13606807,0,0,7981,7996
28211,13598831,13606807,13606821,0,0,7976,7990
28212,13598849,13606821,13606833,0,0,7972,7984
28213,13598865,13606833,13606845,0,0,7968,7980
28214,13598881,13606845,13606860,0,0,7964,7979
28238,13602875,13605066,13607561,0,0,2191,4686
28120,13579657,13598912,13607821,0,0,19255,28164
28248,13606056,13606056,13608118,0,0,0,2062
28251,13606840,13608118,13608366,0,0,1278,1526
28215,13598936,13606860,13608486,0,0,7924,9550
28220,13599579,13608486,13608617,0,0,8907,9038
28222,13599844,13608617,13608713,0,0,8773,8869
28219,13599548,13603824,13609166,0,0,4276,9618
28255,13608468,13609166,13609410,0,0,698,942
28241,13603568,13605388,13609550,0,0,1820,5982
28254,13608110,13608366,13613505,0,0,256,5395
28180,13592162,13607821,13613554,0,0,15659,21392
28229,13601236,13613554,13613603,0,0,12318,12367
28158,13584193,13602404,13613817,0,0,18211,29624
28245,13604824,13606633,13614520,0,0,1809,9696
28173,13588956,13605772,13615000,0,0,16816,26044
28227,13600954,13608713,13615030,0,0,7759,14076
28249,13606248,13607561,13615078,0,0,1313,8830
28252,13606872,13614520,13615302,0,0,7648,8430
28231,13601365,13613603,13615894,0,0,12238,14529
28243,13603977,13613817,13615934,0,0,9840,11957
28250,13606282,13615894,13616136,0,0,9612,9854
28257,13613244,13613244,13617671,0,0,0,4427
28256,13608696,13616136,13618455,0,0,7440,9759
28260,13617667,13617667,13619593,0,0,0,1926
28262,13619590,13619590,13620590,0,0,0,1000
28263,13620585,13620585,13621505,0,0,0,920
28264,13621501,13621501,13622284,0,0,0,783
28258,13615213,13615213,13622527,0,0,0,7314
28265,13622277,13622277,13622937,0,0,0,660
28261,13617710,13617710,13623027,0,0,0,5317
28266,13622933,13622933,13623580,0,0,0,647
28244,13604209,13613817,13624075,0,0,9608,19866
28268,13623577,13623577,13624189,0,0,0,612
28259,13617468,13617468,13624416,0,0,0,6948
28253,13607645,13615000,13624438,0,0,7355,16793
28269,13624187,13624187,13624799,0,0,0,612
28240,13603560,13613603,13625247,0,0,10043,21687
28270,13624795,13624795,13625363,0,0,0,568
28271,13625357,13625357,13625898,0,0,0,541
28272,13625888,13625888,13626335,0,0,0,447
28267,13623069,13623069,13628767,0,0,0,5698
28274,13628700,13628700,13633488,0,0,0,4788
28273,13628315,13628315,13636018,0,0,0,7703
28275,13633475,13633475,13638728,0,0,0,5253
28276,13638670,13638670,13643479,0,0,0,4809
28153,13583135,13624075,13645985,0,0,40940,62850
28277,13643479,13643479,13646307,0,0,0,2828
28278,13646242,13646242,13649289,0,0,0,3047
28279,13649226,13649226,13652042,0,0,0,2816
28280,13651979,13651979,13654758,0,0,0,2779
28155,13583342,13645985,13657468,0,0,62643,74126
28281,13654747,13654747,13657568,0,0,0,2821
28282,13657517,13657517,13660327,0,0,0,2810
28283,13660265,13660265,13663674,0,0,0,3409
28289,13663611,13663611,13666779,0,0,0,3168
28286,13662302,13662302,13669002,0,0,0,6700
28285,13662067,13662067,13669241,0,0,0,7174
28287,13663091,13669002,13669257,0,0,5911,6166
28291,13666716,13666716,13669916,0,0,0,3200
28164,13585432,13657468,13672800,0,0,72036,87368
28216,13598949,13672800,13672867,0,0,73851,73918
28292,13669245,13669245,13673273,0,0,0,4028
28293,13669851,13669851,13673297,0,0,0,3446
28295,13671806,13673273,13673624,0,0,1467,1818
28288,13663395,13669257,13675981,0,0,5862,12586
28297,13672347,13672347,13677147,0,0,0,4800
28298,13673278,13673624,13677343,0,0,346,4065
28299,13673292,13673297,13678493,0,0,5,5201
28301,13677001,13677343,13681108,0,0,342,4107
28302,13678430,13678430,13681628,0,0,0,3198
28294,13670120,13675981,13682668,0,0,5861,12548
28303,13681564,13681564,13684755,0,0,0,3191
28246,13604834,13672867,13686645,0,0,68033,81811
28304,13682335,13682335,13687015,0,0,0,4680
28307,13684693,13684693,13687879,0,0,0,3186
28300,13676807,13682668,13689339,0,0,5861,12532
28315,13687814,13687814,13691221,0,0,0,3407
28284,13661476,13686645,13692491,0,0,25169,31015
28318,13691158,13691158,13694354,0,0,0,3196
28308,13685089,13687015,13694620,0,0,1926,9531
28309,13687020,13694620,13694638,0,0,7600,7618
28310,13687043,13694638,13694654,0,0,7595,7611
28311,13687063,13694654,13694671,0,0,7591,7608
28312,13687085,13694671,13694687,0,0,7586,7602
28313,13687096,13694687,13694722,0,0,7591,7626
28305,13683484,13689339,13696047,0,0,5855,12563
28319,13694042,13696047,13697350,0,0,2005,3308
28321,13694290,13694290,13697466,0,0,0,3176
28316,13689697,13696047,13699094,0,0,6350,9397
28323,13697404,13699094,13699681,0,0,1690,2277
28314,13687436,13694722,13701409,0,0,7286,13973
28320,13694128,13697350,13701878,0,0,3222,7750
28324,13697430,13697430,13702891,0,0,0,5461
28317,13690195,13701878,13703327,0,0,11683,13132
28290,13666327,13692491,13704020,0,0,26164,37693
28327,13705941,13705941,13706275,0,0,0,334
28325,13698661,13699681,13706770,0,0,1020,8109
28326,13702130,13703327,13710269,0,0,1197,8139
28330,13713399,13713399,13713683,0,0,0,284
28328,13706971,13706971,13714036,0,0,0,7065
28331,13714196,13714196,13714293,0,0,0,97
28329,13709085,13710269,13717223,0,0,1184,8138
28333,13716960,13717223,13717664,0,0,263,704
28334,13717563,13717563,13717867,0,0,0,304
28335,13718623,13718623,13718659,0,0,0,36
28336,13719042,13719042,13719078,0,0,0,36
28337,13719093,13719093,13719296,0,0,0,203
28338,13719636,13719636,13719844,0,0,0,208
28339,13719680,13719680,13719901,0,0,0,221
28340,13720693,13720693,13721136,0,0,0,443
28341,13720873,13720873,13721476,0,0,0,603
28342,13721266,13721266,13721707,0,0,0,441
28343,13722418,13722418,13722866,0,0,0,448
28332,13716042,13716042,13722877,0,0,0,6835
28344,13722458,13722458,13722886,0,0,0,428
28346,13723015,13723015,13723462,0,0,0,447
28347,13723959,13723959,13724405,0,0,0,446
28348,13724736,13724736,13725762,0,0,0,1026
28296,13671837,13704020,13728911,0,0,32183,57074
28345,13722878,13722878,13735307,0,0,0,12429
28349,13732515,13732515,13735758,0,0,0,3243
28351,13735697,13735697,13738878,0,0,0,3181
28306,13684050,13728911,13740444,0,0,44861,56394
28352,13738812,13738812,13742230,0,0,0,3418
28353,13742166,13742166,13745348,0,0,0,3182
28350,13735312,13735312,13745631,0,0,0,10319
28322,13696474,13740444,13746101,0,0,43970,49627
28356,13747976,13747976,13748789,0,0,0,813
28354,13745290,13745290,13748792,0,0,0,3502
28360,13751152,13751152,13751214,0,0,0,62
28355,13745634,13745634,13751872,0,0,0,6238
28358,13748786,13748786,13751965,0,0,0,3179
28357,13748312,13748312,13752124,0,0,0,3812
28359,13748919,13748919,13753521,0,0,0,4602
28363,13753954,13753954,13754178,0,0,0,224
28364,13754751,13754751,13754987,0,0,0,236
28361,13751905,13751905,13755315,0,0,0,3410
28362,13752129,13752129,13755650,0,0,0,3521
28368,13755799,13755799,13757252,0,0,0,1453
28370,13758284,13758284,13758374,0,0,0,90
28366,13755597,13755597,13758628,0,0,0,3031
28365,13755251,13755251,13758629,0,0,0,3378
28369,13757340,13757340,13758756,0,0,0,1416
28372,13758816,13758816,13758910,0,0,0,94
28367,13755654,13755654,13759276,0,0,0,3622
28374,13759243,13759243,13759445,0,0,0,202
28376,13759770,13759770,13759843,0,0,0,73
28377,13759786,13759786,13759933,0,0,0,147
28379,13760247,13760247,13760316,0,0,0,69
28380,13760573,13760573,13760743,0,0,0,170
28382,13760796,13760796,13760866,0,0,0,70
28381,13760758,13760758,13761134,0,0,0,376
28378,13760053,13760053,13761245,0,0,0,1192
28386,13762377,13762377,13762574,0,0,0,197
28385,13761378,13761378,13762774,0,0,0,1396
28389,13763439,13763439,13763514,0,0,0,75
28388,13763040,13763040,13763618,0,0,0,578
28390,13763813,13763813,13763978,0,0,0,165
28391,13764074,13764074,13764161,0,0,0,87
28392,13764237,13764237,13764295,0,0,0,58
28393,13764526,13764526,13764581,0,0,0,55
28394,13764637,13764637,13764674,0,0,0,37
28387,13762934,13762934,13764691,0,0,0,1757
28395,13764671,13764671,13764755,0,0,0,84
28397,13765061,13765061,13765104,0,0,0,43
28371,13758585,13758585,13765866,0,0,0,7281
28399,13765851,13765851,13765923,0,0,0,72
28398,13765666,13765666,13765976,0,0,0,310
28400,13766085,13766085,13766215,0,0,0,130
28402,13766410,13766410,13766541,0,0,0,131
28401,13766362,13766362,13766718,0,0,0,356
28404,13768366,13768366,13768505,0,0,0,139
28405,13768599,13768599,13768764,0,0,0,165
28406,13769030,13769030,13769061,0,0,0,31
28396,13764707,13764707,13769107,0,0,0,4400
28408,13769222,13769222,13769430,0,0,0,208
28407,13769178,13769178,13769841,0,0,0,663
28410,13769584,13769584,13769841,0,0,0,257
28412,13769987,13769987,13770101,0,0,0,114
28409,13769552,13769552,13770281,0,0,0,729
28403,13767066,13767066,13770334,0,0,0,3268
28415,13770438,13770438,13770557,0,0,0,119
28373,13758904,13758904,13770613,0,0,0,11709
28414,13770355,13770355,13770624,0,0,0,269
28411,13769965,13769965,13770694,0,0,0,729
28416,13770860,13770860,13771057,0,0,0,197
28417,13771371,13771371,13771753,0,0,0,382
28419,13771788,13771788,13772011,0,0,0,223
28375,13759272,13770613,13772096,0,0,11341,12824
28420,13772143,13772143,13772476,0,0,0,333
28421,13772488,13772488,13772522,0,0,0,34
28413,13770349,13770349,13772810,0,0,0,2461
28424,13773427,13773427,13773576,0,0,0,149
28422,13772608,13772608,13773674,0,0,0,1066
28423,13772953,13772953,13773836,0,0,0,883
28425,13773668,13773668,13773942,0,0,0,274
28426,13774070,13774070,13774190,0,0,0,120
28427,13774565,13774565,13774686,0,0,0,121
28428,13774871,13774871,13775253,0,0,0,382
28429,13774901,13774901,13776080,0,0,0,1179
28432,13775505,13775505,13776175,0,0,0,670
28431,13775233,13775233,13776302,0,0,0,1069
28435,13776436,13776436,13776487,0,0,0,51
28436,13776496,13776496,13776533,0,0,0,37
28418,13771622,13771622,13776589,0,0,0,4967
28437,13776747,13776747,13776781,0,0,0,34
28434,13776418,13776418,13776784,0,0,0,366
28433,13776112,13776112,13776791,0,0,0,679
28438,13776807,13776807,13776912,0,0,0,105
28440,13776983,13776983,13777357,0,0,0,374
28441,13777559,13777559,13777718,0,0,0,159
28444,13777671,13777671,13777792,0,0,0,121
28446,13777987,13777987,13778188,0,0,0,201
28445,13777774,13777774,13779050,0,0,0,1276
28447,13778645,13778645,13779236,0,0,0,591
28449,13779216,13779216,13779471,0,0,0,255
28450,13780859,13780859,13780877,0,0,0,18
28451,13780958,13780958,13780977,0,0,0,19
28453,13781281,13781281,13781298,0,0,0,17
28454,13781321,13781321,13781343,0,0,0,22
28452,13781162,13781162,13781794,0,0,0,632
28455,13782055,13782055,13782077,0,0,0,22
28456,13782363,13782363,13782381,0,0,0,18
28457,13782750,13782750,13782836,0,0,0,86
28383,13761140,13772096,13783039,0,0,10956,21899
28458,13783147,13783147,13783253,0,0,0,106
28443,13777656,13777656,13783317,0,0,0,5661
28460,13783449,13783449,13783519,0,0,0,70
28459,13783188,13783188,13784227,0,0,0,1039
28461,13784771,13784771,13785866,0,0,0,1095
28462,13786072,13786072,13786194,0,0,0,122
28463,13786200,13786200,13786499,0,0,0,299
28464,13788119,13788119,13788137,0,0,0,18
28465,13788616,13788616,13788637,0,0,0,21
28466,13788930,13788930,13788994,0,0,0,64
28448,13778962,13778962,13789061,0,0,0,10099
28467,13789579,13789579,13789780,0,0,0,201
28468,13790665,13790665,13790900,0,0,0,235
28430,13775144,13775144,13792145,0,0,0,17001
28469,13790921,13790921,13793103,0,0,0,2182
28384,13761285,13783039,13805624,0,0,21754,44339
28439,13776814,13793103,13807123,0,0,16289,30309
28474,13796755,13807123,13807236,0,0,10368,10481
28478,13798360,13807123,13807291,0,0,8763,8931
28480,13798929,13807236,13807315,0,0,8307,8386
28470,13795110,13807123,13807423,0,0,12013,12313
28483,13802187,13807423,13807564,0,0,5236,5377
28484,13802424,13807564,13807639,0,0,5140,5215
28485,13803515,13807639,13807708,0,0,4124,4193
28486,13804328,13807708,13807804,0,0,3380,3476
28487,13805429,13807804,13807878,0,0,2375,2449
28471,13795427,13807123,13807951,0,0,11696,12524
28489,13805997,13807878,13807953,0,0,1881,1956
28491,13806618,13807953,13808029,0,0,1335,1411
28490,13806185,13807951,13808215,0,0,1766,2030
28494,13807121,13808215,13808284,0,0,1094,1163
28492,13806969,13808029,13808315,0,0,1060,1346
28496,13807686,13808315,13808418,0,0,629,732
28499,13808119,13808418,13808519,0,0,299,400
28497,13807778,13808418,13808528,0,0,640,750
28477,13798063,13807315,13808575,0,0,9252,10512
28495,13807477,13808284,13808590,0,0,807,1113
28500,13808214,13808575,13808642,0,0,361,428
28501,13808247,13808590,13808690,0,0,343,443
28472,13796276,13807123,13808779,0,0,10847,12503
28502,13808592,13808642,13808899,0,0,50,307
28498,13807931,13808528,13808976,0,0,597,1045
28473,13796505,13808779,13808984,0,0,12274,12479
28475,13797342,13808984,13809003,0,0,11642,11661
28476,13797973,13809003,13809026,0,0,11030,11053
28504,13809118,13809118,13809238,0,0,0,120
28503,13808965,13808965,13809326,0,0,0,361
28481,13799644,13809026,13809441,0,0,9382,9797
28488,13805669,13809441,13810863,0,0,3772,5194
28482,13800086,13809326,13814855,0,0,9240,14769
28506,13809501,13814855,13814880,0,0,5354,5379
28505,13809389,13814855,13814886,0,0,5466,5497
28507,13809660,13814880,13815132,0,0,5220,5472
28508,13810097,13814886,13815208,0,0,4789,5111
28509,13810673,13815132,13815214,0,0,4459,4541
28511,13810886,13815214,13815310,0,0,4328,4424
28512,13811040,13815310,13815369,0,0,4270,4329
28510,13810755,13815208,13815499,0,0,4453,4744
28514,13811715,13815499,13815571,0,0,3784,3856
28517,13812515,13815499,13815587,0,0,2984,3072
28519,13812761,13815571,13815642,0,0,2810,2881
28513,13811204,13815369,13815994,0,0,4165,4790
28515,13811921,13815642,13816088,0,0,3721,4167
28518,13812533,13816088,13816425,0,0,3555,3892
28516,13812372,13815994,13816621,0,0,3622,4249
28520,13819167,13819167,13822387,0,0,0,3220
28493,13807115,13810863,13823114,0,0,3748,15999
28521,13822324,13822324,13825539,0,0,0,3215
28523,13825474,13825474,13828871,0,0,0,3397
28522,13823900,13823900,13829728,0,0,0,5828
28526,13829531,13829728,13829966,0,0,197,435
28442,13777584,13805624,13830547,0,0,28040,52963
28528,13831494,13831494,13833407,0,0,0,1913
28530,13832670,13833407,13833827,0,0,737,1157
28529,13831793,13833407,13834202,0,0,1614,2409
28525,13828808,13828808,13834487,0,0,0,5679
28524,13827125,13827125,13836738,0,0,0,9613
28532,13833090,13833407,13838454,0,0,317,5364
28538,13834538,13838454,13838552,0,0,3916,4014
28540,13835542,13838552,13838638,0,0,3010,3096
28542,13835930,13838638,13838727,0,0,2708,2797
28533,13833099,13833827,13838855,0,0,728,5756
28546,13837575,13838855,13838936,0,0,1280,1361
28548,13837781,13838855,13838944,0,0,1074,1163
28550,13838543,13838944,13839021,0,0,401,478
28547,13837699,13838855,13839031,0,0,1156,1332
28551,13838615,13839021,13839089,0,0,406,474
28544,13837221,13838855,13839106,0,0,1634,1885
28552,13838908,13839031,13839122,0,0,123,214
28539,13835131,13838454,13839259,0,0,3323,4128
28554,13839661,13839661,13839736,0,0,0,75
28549,13838198,13838936,13840246,0,0,738,2048
28556,13840198,13840198,13840272,0,0,0,74
28536,13834158,13834202,13840275,0,0,44,6117
28558,13840496,13840496,13840568,0,0,0,72
28559,13840498,13840498,13840568,0,0,0,70
28557,13840482,13840482,13840609,0,0,0,127
28560,13840589,13840589,13840757,0,0,0,168
28562,13841463,13841463,13841539,0,0,0,76
28561,13841099,13841099,13841550,0,0,0,451
28535,13833548,13836738,13841656,0,0,3190,8108
28553,13838914,13839089,13841717,0,0,175,2803
28479,13798732,13830547,13842309,0,0,31815,43577
28563,13842280,13842280,13842682,0,0,0,402
28543,13836250,13838727,13842684,0,0,2477,6434
28537,13834428,13834487,13842971,0,0,59,8543
28555,13839692,13839692,13843603,0,0,0,3911
28569,13843746,13843746,13843767,0,0,0,21
28566,13843130,13843130,13844192,0,0,0,1062
28571,13844410,13844410,13844490,0,0,0,80
28564,13842287,13842287,13845065,0,0,0,2778
28575,13845092,13845092,13845114,0,0,0,22
28576,13845171,13845171,13845291,0,0,0,120
28573,13844705,13844705,13845308,0,0,0,603
28577,13845649,13845649,13848320,0,0,0,2671
28581,13847733,13848320,13848438,0,0,587,705
28534,13833445,13841656,13848851,0,0,8211,15406
28572,13844538,13844538,13848996,0,0,0,4458
28578,13846868,13846868,13849554,0,0,0,2686
28565,13842912,13842912,13850368,0,0,0,7456
28586,13849647,13850368,13850427,0,0,721,780
28587,13849868,13850427,13852076,0,0,559,2208
28527,13829693,13829693,13853871,0,0,0,24178
28567,13843291,13849554,13855430,0,0,6263,12139
28568,13843615,13855430,13855850,0,0,11815,12235
28592,13851896,13853871,13857660,0,0,1975,5764
28531,13832860,13842309,13857760,0,0,9449,24900
28588,13850354,13852076,13858072,0,0,1722,7718
28595,13853102,13857660,13858192,0,0,4558,5090
28596,13853266,13858072,13858222,0,0,4806,4956
28604,13855195,13858222,13858397,0,0,3027,3202
28608,13856151,13858222,13858540,0,0,2071,2389
28570,13844375,13855850,13858721,0,0,11475,14346
28612,13857802,13858397,13858773,0,0,595,971
28605,13855860,13858773,13858839,0,0,2913,2979
28607,13856125,13858839,13858903,0,0,2714,2778
28574,13844948,13858721,13859613,0,0,13773,14665
28545,13837265,13848851,13860668,0,0,11586,23403
28609,13856362,13858903,13862399,0,0,2541,6037
28603,13855101,13858192,13862645,0,0,3091,7544
28614,13859123,13862399,13862679,0,0,3276,3556
28602,13854878,13857660,13862873,0,0,2782,7995
28616,13859542,13862645,13862873,0,0,3103,3331
28617,13859574,13862679,13863520,0,0,3105,3946
28622,13860856,13863520,13864335,0,0,2664,3479
28623,13861064,13864335,13864457,0,0,3271,3393
28625,13861689,13864457,13864578,0,0,2768,2889
28615,13859339,13862399,13864589,0,0,3060,5250
28632,13863493,13864589,13864610,0,0,1096,1117
28579,13847602,13859613,13864673,0,0,12011,17071
28621,13860576,13862873,13865115,0,0,2297,4539
28636,13863784,13865115,13865198,0,0,1331,1414
28582,13848009,13864673,13865558,0,0,16664,17549
28583,13848098,13865558,13865595,0,0,17460,17497
28626,13862182,13864578,13866157,0,0,2396,3975
28584,13848225,13865595,13866312,0,0,17370,18087
28637,13864024,13865198,13866533,0,0,1174,2509
28641,13865328,13866533,13866542,0,0,1205,1214
28642,13865365,13866542,13866556,0,0,1177,1191
28635,13863694,13864610,13866727,0,0,916,3033
28585,13849383,13866312,13866758,0,0,16929,17375
28644,13865747,13866556,13866779,0,0,809,1032
28619,13860170,13862873,13866793,0,0,2703,6623
28589,13851342,13866758,13867129,0,0,15416,15787
28645,13866027,13866727,13867283,0,0,700,1256
28639,13864362,13866157,13867547,0,0,1795,3185
28618,13859796,13866793,13869926,0,0,6997,10130
28541,13835745,13857760,13870258,0,0,22015,34513
28594,13852259,13870258,13870304,0,0,17999,18045
28598,13853503,13870258,13870735,0,0,16755,17232
28593,13852006,13870258,13871565,0,0,18252,19559
28606,13856067,13871565,13871594,0,0,15498,15527
28591,13851791,13870258,13871955,0,0,18467,20164
28580,13847649,13860668,13872173,0,0,13019,24524
28627,13862688,13872173,13872232,0,0,9485,9544
28630,13862922,13867547,13872602,0,0,4625,9680
28628,13862773,13872232,13872683,0,0,9459,9910
28599,13853646,13870304,13872717,0,0,16658,19071
28600,13853721,13870735,13872737,0,0,17014,19016
28629,13862781,13872683,13872812,0,0,9902,10031
28631,13862927,13872717,13872862,0,0,9790,9935
28633,13863608,13872737,13872902,0,0,9129,9294
28638,13864297,13872862,13872998,0,0,8565,8701
28640,13865066,13872902,13873035,0,0,7836,7969
28634,13863615,13872812,13873464,0,0,9197,9849
28649,13873142,13873142,13873847,0,0,0,705
28647,13867913,13869926,13875532,0,0,2013,7619
28590,13851388,13867129,13875817,0,0,15741,24429
28643,13865394,13872998,13875993,0,0,7604,10599
28651,13875395,13875395,13876942,0,0,0,1547
28620,13860483,13872173,13877047,0,0,11690,16564
28648,13869186,13872602,13877183,0,0,3416,7997
28646,13866564,13873035,13877578,0,0,6471,11014
28611,13857747,13871955,13877693,0,0,14208,19946
28653,13878782,13878782,13879275,0,0,0,493
28655,13879403,13879403,13879447,0,0,0,44
28656,13879654,13879654,13879840,0,0,0,186
28658,13880032,13880032,13880132,0,0,0,100
28659,13880140,13880140,13880227,0,0,0,87
28610,13856813,13871594,13880878,0,0,14781,24065
28657,13879697,13879697,13884023,0,0,0,4326
28652,13877029,13877047,13885691,0,0,18,8662
28663,13885966,13885966,13886758,0,0,0,792
28660,13881310,13881310,13889635,0,0,0,8325
28662,13884912,13884912,13890753,0,0,0,5841
28661,13884383,13884383,13893435,0,0,0,9052
28597,13853483,13893435,13893820,0,0,39952,40337
28601,13854167,13893820,13895962,0,0,39653,41795
28650,13874869,13875817,13898463,0,0,948,23594
28664,13887240,13887240,13902756,0,0,0,15516
28613,13858679,13895962,13910859,0,0,37283,52180
28624,13861090,13902756,13916718,0,0,41666,55628
28665,13906570,13916718,13920924,0,0,10148,14354
28670,13911828,13920924,13921039,0,0,9096,9211
28675,13921343,13921343,13921427,0,0,0,84
28674,13917614,13920924,13921473,0,0,3310,3859
28672,13913747,13920924,13922227,0,0,7177,8480
28666,13907244,13920924,13924123,0,0,13680,16879
28668,13910380,13920924,13924354,0,0,10544,13974
28667,13909839,13920924,13926077,0,0,11085,16238
28654,13879229,13910859,13929990,0,0,31630,50761
28678,13922932,13922932,13932854,0,0,0,9922
28683,13924496,13932854,13933374,0,0,8358,8878
28682,13923726,13924354,13933434,0,0,628,9708
28681,13923725,13924354,13933435,0,0,629,9710
28680,13923111,13924123,13933865,0,0,1012,10754
28685,13926023,13933374,13933884,0,0,7351,7861
28669,13910885,13929990,13934094,0,0,19105,23209
28689,13926532,13933865,13934153,0,0,7333,7621
28695,13927364,13934153,13934373,0,0,6789,7009
28705,13929180,13934373,13934396,0,0,5193,5216
28691,13926819,13933884,13934429,0,0,7065,7610
28714,13933162,13934396,13934432,0,0,1234,1270
28716,13933366,13934432,13934748,0,0,1066,1382
28698,13927668,13934429,13934866,0,0,6761,7198
28699,13928105,13934866,13934938,0,0,6761,6833
28697,13927607,13934373,13935122,0,0,6766,7515
28700,13928199,13934938,13935494,0,0,6739,7295
28718,13934314,13934748,13935555,0,0,434,1241
28719,13934580,13935122,13935590,0,0,542,1010
28721,13934790,13935590,13935669,0,0,800,879
28722,13934945,13935669,13935697,0,0,724,752
28723,13935623,13935697,13935763,0,0,74,140
28725,13935654,13935763,13935824,0,0,109,170
28679,13922993,13926077,13935938,0,0,3084,12945
28720,13934636,13935555,13936096,0,0,919,1460
28727,13936244,13936244,13936296,0,0,0,52
28726,13936079,13936079,13936524,0,0,0,445
28687,13926284,13935938,13937486,0,0,9654,11202
28728,13936512,13936512,13937781,0,0,0,1269
28730,13936726,13937781,13937838,0,0,1055,1112
28731,13936923,13937838,13937910,0,0,915,987
28732,13937370,13937910,13937965,0,0,540,595
28690,13926653,13937486,13938134,0,0,10833,11481
28729,13936715,13936715,13938305,0,0,0,1590
28734,13937682,13938305,13938346,0,0,623,664
28694,13927300,13938134,13938418,0,0,10834,11118
28733,13937445,13937965,13938520,0,0,520,1075
28735,13937902,13938346,13938743,0,0,444,841
28736,13938340,13938520,13938768,0,0,180,428
28740,13938703,13938768,13938911,0,0,65,208
28741,13938722,13938911,13938949,0,0,189,227
28696,13927586,13938418,13939031,0,0,10832,11445
28684,13924804,13932854,13939142,0,0,8050,14338
28701,13928258,13939031,13939227,0,0,10773,10969
28693,13926939,13933435,13939301,0,0,6496,12362
28743,13938904,13939301,13939407,0,0,397,503
28692,13926820,13933434,13939419,0,0,6614,12599
28746,13939112,13939419,13939457,0,0,307,345
28704,13929123,13939227,13939467,0,0,10104,10344
28745,13939012,13939407,13939470,0,0,395,458
28747,13939126,13939457,13939485,0,0,331,359
28748,13939167,13939470,13939529,0,0,303,362
28702,13928514,13939142,13939752,0,0,10628,11238
28703,13928754,13935494,13939754,0,0,6740,11000
28744,13938970,13939754,13939942,0,0,784,972
28707,13930053,13939752,13939953,0,0,9699,9900
28751,13939610,13939942,13939999,0,0,332,389
28738,13938402,13938743,13940001,0,0,341,1599
28752,13939671,13939999,13940026,0,0,328,355
28749,13939545,13939942,13940035,0,0,397,490
28755,13939771,13940026,13940066,0,0,255,295
28671,13912548,13934094,13940156,0,0,21546,27608
28706,13929362,13939467,13940158,0,0,10105,10796
28756,13939843,13940035,13940221,0,0,192,378
28709,13930844,13940158,13940390,0,0,9314,9546
28708,13930314,13939953,13940483,0,0,9639,10169
28739,13938697,13939529,13940552,0,0,832,1855
28757,13939855,13940066,13940561,0,0,211,706
28711,13931842,13940483,13940716,0,0,8641,8874
28763,13940331,13940561,13940755,0,0,230,424
28764,13940338,13940755,13940980,0,0,417,642
28765,13940358,13940980,13941042,0,0,622,684
28766,13940395,13941042,13941066,0,0,647,671
28710,13931097,13940390,13941135,0,0,9293,10038
28768,13940790,13941066,13941218,0,0,276,428
28713,13932708,13941135,13941280,0,0,8427,8572
28712,13932135,13940716,13941289,0,0,8581,9154
28742,13938787,13938949,13941305,0,0,162,2518
28769,13940811,13941218,13941320,0,0,407,509
28770,13940961,13941305,13941329,0,0,344,368
28771,13941070,13941320,13941361,0,0,250,291
28754,13939710,13940552,13941431,0,0,842,1721
28773,13941229,13941361,13941527,0,0,132,298
28775,13941445,13941527,13941563,0,0,82,118
28776,13941540,13941563,13941599,0,0,23,59
28772,13941199,13941329,13941617,0,0,130,418
28761,13940025,13940221,13941690,0,0,196,1665
28777,13941701,13941701,13941817,0,0,0,116
28737,13938378,13941289,13941906,0,0,2911,3528
28778,13941781,13941817,13941968,0,0,36,187
28760,13940003,13941906,13942220,0,0,1903,2217
28780,13942310,13942310,13942353,0,0,0,43
28753,13939692,13940001,13942379,0,0,309,2687
28759,13939937,13941617,13942388,0,0,1680,2451
28686,13926071,13933374,13942550,0,0,7303,16479
28673,13917520,13940156,13943916,0,0,22636,26396
28676,13921583,13943916,13944756,0,0,22333,23173
28724,13935630,13941280,13945053,0,0,5650,9423
28781,13942546,13942550,13945363,0,0,4,2817
28758,13939913,13941431,13945406,0,0,1518,5493
28774,13941275,13945053,13945472,0,0,3778,4197
28783,13942574,13945363,13945522,0,0,2789,2948
28787,13942935,13945522,13946006,0,0,2587,3071
28779,13942141,13945472,13946014,0,0,3331,3873
28782,13942553,13942553,13946203,0,0,0,3650
28786,13942779,13945406,13946579,0,0,2627,3800
28762,13940179,13942220,13946786,0,0,2041,6607
28788,13942949,13946786,13946872,0,0,3837,3923
28789,13943256,13946006,13947089,0,0,2750,3833
28793,13944759,13946872,13947106,0,0,2113,2347
28792,13943750,13946579,13947305,0,0,2829,3555
28799,13945397,13947089,13947355,0,0,1692,1958
28784,13942615,13945406,13947367,0,0,2791,4752
28801,13945675,13947355,13947950,0,0,1680,2275
28798,13945386,13946872,13947951,0,0,1486,2565
28807,13947244,13947951,13948135,0,0,707,891
28785,13942638,13946014,13948164,0,0,3376,5526
28805,13946937,13947367,13948242,0,0,430,1305
28800,13945578,13947305,13948501,0,0,1727,2923
28795,13944933,13946872,13948860,0,0,1939,3927
28811,13948256,13948860,13949048,0,0,604,792
28809,13947789,13948242,13949247,0,0,453,1458
28806,13947006,13947950,13949331,0,0,944,2325
28816,13948712,13949331,13949369,0,0,619,657
28814,13948451,13949247,13949409,0,0,796,958
28810,13948059,13948501,13949553,0,0,442,1494
28818,13948960,13949369,13949621,0,0,409,661
28819,13949022,13949409,13950247,0,0,387,1225
28823,13949811,13950247,13950286,0,0,436,475
28812,13948326,13949048,13950964,0,0,722,2638
28794,13944827,13948164,13950989,0,0,3337,6162
28797,13945143,13950989,13951471,0,0,5846,6328
28803,13945785,13951471,13951599,0,0,5686,5814
28804,13945834,13951471,13951615,0,0,5637,5781
28767,13940657,13942388,13951908,0,0,1731,11251
28808,13947403,13948135,13952081,0,0,732,4678
28802,13945767,13949621,13952272,0,0,3854,6505
28813,13948400,13951908,13952321,0,0,3508,3921
28828,13950790,13952272,13952359,0,0,1482,1569
28831,13951032,13952359,13952375,0,0,1327,1343
28829,13950834,13952359,13952403,0,0,1525,1569
28832,13951064,13952375,13952420,0,0,1311,1356
28817,13948943,13952321,13952502,0,0,3378,3559
28815,13948523,13951599,13952722,0,0,3076,4199
28820,13949121,13952502,13952828,0,0,3381,3707
28833,13951166,13952403,13952941,0,0,1237,1775
28836,13951760,13952941,13953008,0,0,1181,1248
28796,13945055,13947106,13953024,0,0,2051,7969
28791,13943619,13946203,13953028,0,0,2584,9409
28838,13952255,13953028,13953075,0,0,773,820
28822,13949762,13951615,13953086,0,0,1853,3324
28837,13951826,13953008,13953086,0,0,1182,1260
28839,13952285,13953075,13953154,0,0,790,869
28825,13950089,13950964,13953256,0,0,875,3167
28840,13952367,13953086,13953500,0,0,719,1133
28835,13951745,13952420,13953801,0,0,675,2056
28844,13953516,13953516,13953892,0,0,0,376
28826,13950443,13952081,13954603,0,0,1638,4160
28824,13950079,13950286,13954695,0,0,207,4616
28677,13922423,13944756,13955188,0,0,22333,32765
28847,13955538,13955538,13955726,0,0,0,188
28834,13951273,13953024,13956240,0,0,1751,4967
28830,13950997,13952722,13956868,0,0,1725,5871
28849,13956424,13956868,13957099,0,0,444,675
28843,13953279,13956240,13957278,0,0,2961,3999
28841,13952413,13953086,13958295,0,0,673,5882
28827,13950781,13953892,13960399,0,0,3111,9618
28845,13954338,13957278,13960499,0,0,2940,6161
28852,13958630,13960499,13960554,0,0,1869,1924
28848,13955703,13958295,13961659,0,0,2592,5956
28853,13959069,13960554,13962042,0,0,1485,2973
28821,13949301,13952828,13962460,0,0,3527,13159
28855,13960143,13961659,13963361,0,0,1516,3218
28856,13962259,13962259,13963851,0,0,0,1592
28715,13933199,13963851,13964071,0,0,30652,30872
28860,13965479,13965479,13965499,0,0,0,20
28859,13965340,13965340,13965646,0,0,0,306
28861,13965696,13965696,13965825,0,0,0,129
28851,13958221,13960399,13966222,0,0,2178,8001
28857,13962651,13962651,13968015,0,0,0,5364
28688,13926456,13955188,13968061,0,0,28732,41605
28864,13966242,13966242,13969215,0,0,0,2973
28862,13965715,13965715,13969538,0,0,0,3823
28869,13968691,13969538,13969705,0,0,847,1014
28871,13970166,13970166,13970218,0,0,0,52
28863,13966043,13968015,13971002,0,0,1972,4959
28866,13967357,13971002,13971773,0,0,3645,4416
28872,13970404,13970404,13972449,0,0,0,2045
28873,13971151,13972449,13972471,0,0,1298,1320
28874,13971388,13972471,13972488,0,0,1083,1100
28876,13971896,13972488,13972510,0,0,592,614
28877,13972271,13972510,13972566,0,0,239,295
28878,13972459,13972566,13972673,0,0,107,214
28880,13972882,13972882,13973032,0,0,0,150
28858,13965110,13966222,13973099,0,0,1112,7989
28717,13934054,13964071,13973310,0,0,30017,39256
28881,13973206,13973206,13973355,0,0,0,149
28882,13973834,13973834,13973983,0,0,0,149
28868,13968558,13971773,13974271,0,0,3215,5713
28883,13974137,13974137,13974287,0,0,0,150
28867,13967431,13973099,13974359,0,0,5668,6928
28870,13969055,13974271,13974774,0,0,5216,5719
28885,13974712,13974774,13974920,0,0,62,208
28886,13975052,13975052,13975197,0,0,0,145
28875,13971857,13974359,13977076,0,0,2502,5219
28890,13975892,13977076,13977127,0,0,1184,1235
28865,13966479,13969215,13977159,0,0,2736,10680
28891,13976293,13977076,13977219,0,0,783,926
28892,13976551,13977127,13977267,0,0,576,716
28893,13976785,13977159,13977298,0,0,374,513
28895,13976999,13977219,13977359,0,0,220,360
28899,13978632,13978632,13978776,0,0,0,144
28879,13972522,13974359,13978908,0,0,1837,6386
28900,13979343,13979343,13979439,0,0,0,96
28901,13979441,13979441,13979582,0,0,0,141
28902,13980084,13980084,13980230,0,0,0,146
28903,13980371,13980371,13980515,0,0,0,144
28904,13980583,13980583,13980726,0,0,0,143
28905,13980823,13980823,13980966,0,0,0,143
28906,13981086,13981086,13981232,0,0,0,146
28907,13981266,13981266,13981410,0,0,0,144
28908,13981845,13981845,13981990,0,0,0,145
28884,13974482,13974482,13982144,0,0,0,7662
28910,13982260,13982260,13982406,0,0,0,146
28790,13943291,13973310,13982447,0,0,30019,39156
28896,13977258,13977298,13983015,0,0,40,5757
28887,13975406,13983015,13983032,0,0,7609,7626
28888,13975523,13983032,13983275,0,0,7509,7752
28894,13976874,13983275,13983562,0,0,6401,6688
28897,13977399,13983562,13983818,0,0,6163,6419
28898,13977832,13983818,13984111,0,0,5986,6279
28750,13939585,13968061,13985133,0,0,28476,45548
28889,13975804,13975804,13986736,0,0,0,10932
28842,13952429,13982447,13989187,0,0,30018,36758
28909,13982085,13982085,13989998,0,0,0,7913
28850,13956701,13985133,13993164,0,0,28432,36463
28846,13954689,13985133,13993910,0,0,30444,39221
28912,13995174,13995174,13995306,0,0,0,132
28913,13995307,13995307,13995405,0,0,0,98
28914,13995465,13995465,13995684,0,0,0,219
28916,13995708,13995708,13995745,0,0,0,37
28915,13995692,13995692,13995828,0,0,0,136
28918,13996120,13996120,13996618,0,0,0,498
28854,13959819,13989187,13997926,0,0,29368,38107
28921,13998252,13998252,13998390,0,0,0,138
28919,13996234,13996234,13998703,0,0,0,2469
28920,13997128,13997128,13999089,0,0,0,1961
28924,13999679,13999679,13999894,0,0,0,215
28917,13996085,13996085,14000136,0,0,0,4051
28923,13999390,13999390,14000191,0,0,0,801
28925,14000490,14000490,14000617,0,0,0,127
28926,14001394,14001394,14001523,0,0,0,129
28927,14002211,14002211,14002443,0,0,0,232
28922,13999260,13999260,14003222,0,0,0,3962
28911,13990000,13990000,14004228,0,0,0,14228
28930,14004208,14004208,14004733,0,0,0,525
28931,14004734,14004734,14004745,0,0,0,11
28928,14003839,14003839,14004779,0,0,0,940
28932,14004783,14004783,14004908,0,0,0,125
28933,14004924,14004924,14004941,0,0,0,17
28934,14004961,14004961,14005046,0,0,0,85
28929,14004192,14004192,14005668,0,0,0,1476
28938,14006455,14006455,14006529,0,0,0,74
28942,14008102,14008102,14008313,0,0,0,211
28939,14007174,14007174,14008347,0,0,0,1173
28944,14008840,14008840,14008854,0,0,0,14
28946,14008917,14008917,14009362,0,0,0,445
28947,14009231,14009231,14009392,0,0,0,161
28935,14005589,14005589,14009534,0,0,0,3945
28948,14009476,14009476,14009704,0,0,0,228
28937,14006062,14006062,14009729,0,0,0,3667
28949,14009740,14009740,14009996,0,0,0,256
28950,14009864,14009864,14010599,0,0,0,735
28952,14010376,14010376,14011489,0,0,0,1113
28956,14011359,14011359,14011580,0,0,0,221
28957,14011379,14011489,14011631,0,0,110,252
28958,14011455,14011580,14011646,0,0,125,191
28959,14011619,14011631,14011691,0,0,12,72
28960,14011679,14011679,14011739,0,0,0,60
28936,14005611,14005611,14012625,0,0,0,7014
28962,14011794,14012625,14012711,0,0,831,917
28964,14012122,14012625,14012740,0,0,503,618
28963,14011796,14012625,14012829,0,0,829,1033
28955,14011264,14011264,14012835,0,0,0,1571
28966,14012357,14012711,14012835,0,0,354,478
28968,14012745,14012745,14012837,0,0,0,92
28972,14012887,14012887,14013057,0,0,0,170
28969,14012807,14012829,14013075,0,0,22,268
28965,14012237,14012625,14013134,0,0,388,897
28971,14012886,14012886,14013151,0,0,0,265
28961,14011779,14011779,14013327,0,0,0,1548
28976,14013598,14013598,14013631,0,0,0,33
28974,14013478,14013478,14013654,0,0,0,176
28977,14013617,14013631,14013674,0,0,14,57
28973,14013458,14013458,14013796,0,0,0,338
28970,14012863,14012863,14013847,0,0,0,984
28951,14010265,14010265,14014113,0,0,0,3848
28981,14013851,14014113,14014401,0,0,262,550
28982,14013891,14014401,14014424,0,0,510,533
28980,14013849,14014113,14014492,0,0,264,643
28984,14014138,14014492,14014582,0,0,354,444
28983,14013927,14014424,14014626,0,0,497,699
28988,14014288,14014582,14014729,0,0,294,441
28990,14014359,14014729,14015045,0,0,370,686
28953,14010840,14010840,14015235,0,0,0,4395
28989,14014295,14014626,14015501,0,0,331,1206
28975,14013553,14013654,14015656,0,0,101,2103
28987,14014191,14015656,14015724,0,0,1465,1533
28992,14014688,14015501,14015837,0,0,813,1149
28998,14015176,14015837,14015948,0,0,661,772
28985,14014144,14015235,14016129,0,0,1091,1985
28993,14014696,14015724,14016264,0,0,1028,1568
28999,14015236,14015948,14016336,0,0,712,1100
29000,14015301,14016129,14016410,0,0,828,1109
28991,14014386,14015045,14016412,0,0,659,2026
28954,14011240,14012625,14016677,0,0,1385,5437
28979,14013794,14013847,14017661,0,0,53,3867
28978,14013726,14013726,14018308,0,0,0,4582
28943,14008400,14008400,14018420,0,0,0,10020
29009,14016423,14018308,14019352,0,0,1885,2929
29012,14017066,14019352,14019411,0,0,2286,2345
29010,14016424,14018420,14019415,0,0,1996,2991
29014,14017089,14019415,14019476,0,0,2326,2387
29013,14017081,14019411,14019570,0,0,2330,2489
29016,14017537,14019570,14020315,0,0,2033,2778
29015,14017419,14019476,14020339,0,0,2057,2920
29019,14017944,14020339,14020432,0,0,2395,2488
28940,14007520,14007520,14020458,0,0,0,12938
29018,14017791,14020315,14020477,0,0,2524,2686
29023,14018282,14020477,14020506,0,0,2195,2224
29022,14018281,14020432,14020519,0,0,2151,2238
29024,14018415,14020506,14020564,0,0,2091,2149
29025,14018421,14020519,14020611,0,0,2098,2190
29026,14018423,14020564,14020624,0,0,2141,2201
29027,14018483,14020611,14020640,0,0,2128,2157
28941,14008049,14020458,14020692,0,0,12409,12643
29029,14018509,14020640,14020748,0,0,2131,2239
29003,14015481,14016412,14020770,0,0,931,5289
29030,14018512,14020748,14020869,0,0,2236,2357
29031,14018616,14020869,14020892,0,0,2253,2276
29032,14018633,14020892,14020969,0,0,2259,2336
29033,14018639,14020969,14021040,0,0,2330,2401
29034,14018710,14021040,14021070,0,0,2330,2360
29035,14018710,14021070,14021219,0,0,2360,2509
29036,14018740,14021219,14021338,0,0,2479,2598
29037,14018858,14021338,14021389,0,0,2480,2531
29038,14018859,14021389,14021595,0,0,2530,2736
28945,14008903,14020692,14022142,0,0,11789,13239
29002,14015442,14016336,14022432,0,0,894,6990
29005,14015597,14016129,14023099,0,0,532,7502
28986,14014175,14016677,14023159,0,0,2502,8984
29020,14017954,14022432,14023214,0,0,4478,5260
29040,14018909,14023099,14023255,0,0,4190,4346
29042,14019346,14023255,14023324,0,0,3909,3978
29028,14018507,14020624,14023471,0,0,2117,4964
29043,14019346,14023324,14023553,0,0,3978,4207
29045,14019457,14023553,14023602,0,0,4096,4145
29044,14019411,14023471,14023634,0,0,4060,4223
29046,14019574,14023602,14023716,0,0,4028,4142
29039,14018871,14021595,14023744,0,0,2724,4873
29047,14019574,14023634,14023814,0,0,4060,4240
29021,14017970,14023214,14023859,0,0,5244,5889
29048,14019687,14023716,14023877,0,0,4029,4190
29007,14015893,14020770,14023879,0,0,4877,7986
29049,14019754,14023744,14023949,0,0,3990,4195
29052,14020029,14023879,14023997,0,0,3850,3968
29050,14019846,14023814,14023998,0,0,3968,4152
29054,14020146,14023879,14024003,0,0,3733,3857
29051,14019959,14023877,14024065,0,0,3918,4106
29057,14020268,14023997,14024132,0,0,3729,3864
29059,14020403,14024003,14024136,0,0,3600,3733
29055,14020146,14023949,14024138,0,0,3803,3992
29058,14020335,14023998,14024221,0,0,3663,3886
29062,14020558,14024136,14024268,0,0,3578,3710
29061,14020536,14024132,14024352,0,0,3596,3816
29065,14021110,14024268,14024475,0,0,3158,3365
29067,14021128,14024475,14024540,0,0,3347,3412
29066,14021111,14024352,14024558,0,0,3241,3447
29063,14020690,14024138,14024560,0,0,3448,3870
29064,14020743,14024221,14024590,0,0,3478,3847
29069,14021316,14024558,14024717,0,0,3242,3401
29068,14021181,14024540,14024744,0,0,3359,3563
29070,14021316,14024560,14024784,0,0,3244,3468
29071,14021475,14024590,14024828,0,0,3115,3353
29072,14021539,14024717,14024890,0,0,3178,3351
29076,14021692,14024784,14024913,0,0,3092,3221
29077,14021712,14024828,14024947,0,0,3116,3235
29079,14022006,14024890,14025030,0,0,2884,3024
29081,14022142,14024947,14025112,0,0,2805,2970
29080,14022024,14024913,14025128,0,0,2889,3104
29083,14022282,14025112,14025184,0,0,2830,2902
29082,14022239,14025030,14025191,0,0,2791,2952
29075,14021588,14024744,14025276,0,0,3156,3688
29086,14022400,14025191,14025310,0,0,2791,2910
29060,14020406,14024065,14025312,0,0,3659,4906
29085,14022307,14025184,14025336,0,0,2877,3029
29089,14022539,14025312,14025375,0,0,2773,2836
29091,14022648,14025375,14025428,0,0,2727,2780
29088,14022519,14025310,14025439,0,0,2791,2920
29087,14022458,14025276,14025444,0,0,2818,2986
29090,14022624,14025336,14025472,0,0,2712,2848
29092,14022700,14025428,14025570,0,0,2728,2870
29097,14023050,14025570,14025606,0,0,2520,2556
29093,14022756,14025439,14025611,0,0,2683,2855
29100,14023647,14025606,14025625,0,0,1959,1978
29101,14023699,14025611,14025628,0,0,1912,1929
29096,14022928,14025472,14025631,0,0,2544,2703
28994,14014712,14015724,14025651,0,0,1012,10939
29094,14022842,14025444,14025652,0,0,2602,2810
29107,14024675,14025628,14025702,0,0,953,1027
29111,14025171,14025702,14025761,0,0,531,590
29102,14023737,14025625,14025815,0,0,1888,2078
29110,14025099,14025652,14026092,0,0,553,993
29084,14022293,14025128,14026243,0,0,2835,3950
28995,14014726,14017661,14026478,0,0,2935,11752
29112,14025860,14026092,14026529,0,0,232,669
29115,14026246,14026529,14026651,0,0,283,405
29041,14019090,14023859,14026831,0,0,4769,7741
29113,14025883,14026243,14026929,0,0,360,1046
29104,14024353,14026929,14026981,0,0,2576,2628
29108,14024891,14025631,14027193,0,0,740,2302
29053,14020054,14026478,14027262,0,0,6424,7208
29074,14021557,14027262,14027384,0,0,5705,5827
29109,14025037,14025651,14027425,0,0,614,2388
28967,14012624,14022142,14028128,0,0,9518,15504
28997,14015147,14028128,14028150,0,0,12981,13003
29001,14015336,14028150,14028191,0,0,12814,12855
29011,14016916,14023159,14028273,0,0,6243,11357
29073,14021546,14025815,14028289,0,0,4269,6743
28996,14015114,14028128,14028330,0,0,13014,13216
29117,14026824,14028289,14028331,0,0,1465,1507
29004,14015593,14028191,14028344,0,0,12598,12751
29121,14027721,14028331,14028355,0,0,610,634
29006,14015769,14028330,14028413,0,0,12561,12644
29103,14023944,14028273,14028495,0,0,4329,4551
29105,14024568,14028495,14028695,0,0,3927,4127
29106,14024578,14028695,14028892,0,0,4117,4314
29017,14017619,14028413,14029101,0,0,10794,11482
29008,14016074,14028344,14029279,0,0,12270,13205
29127,14028783,14029279,14029337,0,0,496,554
29124,14027937,14029279,14029346,0,0,1342,1409
29130,14029308,14029308,14029395,0,0,0,87
29125,14028326,14029279,14029910,0,0,953,1584
29114,14025918,14026981,14029979,0,0,1063,4061
29078,14021811,14026831,14030011,0,0,5020,8200
29099,14023635,14027384,14030022,0,0,3749,6387
29119,14026894,14029279,14030181,0,0,2385,3287
29132,14029560,14029560,14030219,0,0,0,659
29128,14028862,14030181,14030236,0,0,1319,1374
29123,14027841,14028355,14030246,0,0,514,2405
29134,14030606,14030606,14030630,0,0,0,24
29122,14027807,14028331,14030872,0,0,524,3065
29137,14030835,14030835,14030933,0,0,0,98
29140,14031007,14031007,14031039,0,0,0,32
29116,14026392,14027425,14031490,0,0,1033,5098
29143,14031230,14031490,14031657,0,0,260,427
29141,14031016,14031039,14031694,0,0,23,678
29142,14031068,14031490,14031964,0,0,422,896
29152,14031953,14031953,14032080,0,0,0,127
29149,14031772,14032080,14032147,0,0,308,375
29129,14029072,14030219,14032817,0,0,1147,3745
29118,14026883,14028892,14032854,0,0,2009,5971
29144,14031265,14032817,14032864,0,0,1552,1599
29136,14030744,14030744,14033021,0,0,0,2277
29146,14031630,14032854,14033047,0,0,1224,1417
29158,14032322,14033021,14033064,0,0,699,742
29147,14031631,14032864,14033098,0,0,1233,1467
29164,14032639,14033064,14033121,0,0,425,482
29138,14030853,14030853,14033213,0,0,0,2360
29165,14032640,14033121,14033213,0,0,481,573
29145,14031548,14031694,14033223,0,0,146,1675
29155,14032169,14032169,14033256,0,0,0,1087
29168,14032732,14033213,14033285,0,0,481,553
29170,14032804,14033256,14033315,0,0,452,511
29169,14032803,14033256,14033317,0,0,453,514
29166,14032692,14033213,14033325,0,0,521,633
29150,14031822,14033098,14033361,0,0,1276,1539
29171,14032863,14033285,14033379,0,0,422,516
29173,14032953,14033317,14033381,0,0,364,428
29172,14032924,14033315,14033414,0,0,391,490
29174,14032957,14033325,14033449,0,0,368,492
29178,14033081,14033381,14033460,0,0,300,379
29175,14033020,14033379,14033519,0,0,359,499
29180,14033160,14033449,14033538,0,0,289,378
29181,14033249,14033460,14033560,0,0,211,311
29179,14033158,14033414,14033605,0,0,256,447
29184,14033356,14033560,14033612,0,0,204,256
29151,14031865,14033361,14033619,0,0,1496,1754
29182,14033336,14033519,14033620,0,0,183,284
29183,14033348,14033538,14033626,0,0,190,278
29186,14033507,14033612,14033694,0,0,105,187
29153,14032084,14033619,14033696,0,0,1535,1612
29154,14032123,14033696,14033733,0,0,1573,1610
29188,14033589,14033626,14033764,0,0,37,175
29190,14033742,14033764,14033824,0,0,22,82
29187,14033507,14033620,14033857,0,0,113,350
29189,14033726,14033726,14033862,0,0,0,136
29156,14032199,14033733,14033862,0,0,1534,1663
29139,14030870,14030870,14033885,0,0,0,3015
29157,14032200,14033862,14034001,0,0,1662,1801
29159,14032328,14033885,14034047,0,0,1557,1719
29161,14032489,14034047,14034075,0,0,1558,1586
29162,14032489,14034075,14034104,0,0,1586,1615
29160,14032339,14034001,14034151,0,0,1662,1812
29177,14033036,14034104,14034166,0,0,1068,1130
29194,14034016,14034151,14034229,0,0,135,213
29191,14033888,14034151,14034328,0,0,263,440
29192,14033920,14034151,14034335,0,0,231,415
29195,14034055,14034166,14034345,0,0,111,290
29196,14034065,14034166,14034412,0,0,101,347
29199,14034240,14034345,14034414,0,0,105,174
29197,14034101,14034166,14034458,0,0,65,357
29200,14034311,14034328,14034531,0,0,17,220
29202,14034514,14034514,14034565,0,0,0,51
29201,14034458,14034458,14034595,0,0,0,137
29203,14034565,14034565,14034639,0,0,0,74
29185,14033435,14033605,14034731,0,0,170,1296
29204,14034595,14034595,14034775,0,0,0,180
29206,14034639,14034639,14034775,0,0,0,136
29209,14034775,14034775,14034905,0,0,0,130
29208,14034774,14034774,14034915,0,0,0,141
29212,14034905,14034905,14034947,0,0,0,42
29056,14020213,14029101,14035045,0,0,8888,14832
29214,14034947,14034947,14035065,0,0,0,118
29213,14034915,14034915,14035123,0,0,0,208
29215,14035062,14035062,14035135,0,0,0,73
29217,14035123,14035123,14035198,0,0,0,75
29216,14035065,14035065,14035251,0,0,0,186
29219,14035251,14035251,14035309,0,0,0,58
29218,14035195,14035195,14035338,0,0,0,143
29207,14034721,14034721,14035418,0,0,0,697
29193,14033940,14034151,14035529,0,0,211,1589
29220,14035547,14035547,14035585,0,0,0,38
29221,14035787,14035787,14035827,0,0,0,40
29205,14034635,14034635,14035948,0,0,0,1313
29211,14034902,14035309,14035957,0,0,407,1055
29210,14034776,14034776,14036025,0,0,0,1249
29198,14034213,14034229,14036304,0,0,16,2091
29226,14036238,14036304,14036418,0,0,66,180
29135,14030648,14030648,14036535,0,0,0,5887
29229,14036588,14036588,14036716,0,0,0,128
29133,14029619,14029979,14036788,0,0,360,7169
29223,14035915,14035915,14036812,0,0,0,897
29224,14035925,14035925,14037145,0,0,0,1220
29231,14037159,14037159,14037331,0,0,0,172
29227,14036352,14036418,14037492,0,0,66,1140
29233,14037494,14037494,14037528,0,0,0,34
29131,14029399,14029399,14037723,0,0,0,8324
29235,14037734,14037734,14037770,0,0,0,36
29167,14032710,14033223,14037807,0,0,513,5097
29232,14037290,14037723,14037844,0,0,433,554
29237,14037837,14037837,14038038,0,0,0,201
29239,14038022,14038038,14038068,0,0,16,46
29238,14037853,14038038,14038226,0,0,185,373
29240,14038175,14038175,14038307,0,0,0,132
29236,14037800,14037800,14038330,0,0,0,530
29225,14035956,14035956,14038335,0,0,0,2379
29241,14038266,14038307,14038565,0,0,41,299
29148,14031702,14033047,14038825,0,0,1345,7123
29244,14038762,14038762,14038851,0,0,0,89
29230,14036909,14036909,14038861,0,0,0,1952
29243,14038660,14038660,14039118,0,0,0,458
29245,14039179,14039179,14039269,0,0,0,90
29222,14035907,14036025,14039406,0,0,118,3499
29126,14028495,14030022,14041302,0,0,1527,12807
29247,14041204,14041204,14041311,0,0,0,107
29248,14041850,14041850,14041942,0,0,0,92
29228,14036501,14036788,14042352,0,0,287,5851
29249,14042337,14042337,14042484,0,0,0,147
29246,14039823,14039823,14043642,0,0,0,3819
29120,14027649,14035045,14044005,0,0,7396,16356
29234,14037606,14037844,14044532,0,0,238,6926
29163,14032630,14038861,14045590,0,0,6231,12960
29252,14048445,14048445,14048522,0,0,0,77
29253,14049081,14049081,14049139,0,0,0,58
29254,14049445,14049445,14049508,0,0,0,63
29250,14043339,14043339,14051421,0,0,0,8082
29256,14049804,14051421,14051473,0,0,1617,1669
29257,14051307,14051421,14051482,0,0,114,175
29258,14051609,14051609,14051670,0,0,0,61
29095,14022887,14045590,14051837,0,0,22703,28950
29259,14051831,14051831,14051889,0,0,0,58
29261,14052635,14052635,14052681,0,0,0,46
29098,14023564,14051837,14052878,0,0,28273,29314
29262,14053799,14053799,14053915,0,0,0,116
29176,14033030,14052878,14054294,0,0,19848,21264
29263,14054244,14054244,14054363,0,0,0,119
29242,14038280,14054294,14054571,0,0,16014,16291
29264,14054567,14054567,14054684,0,0,0,117
29251,14044304,14044304,14055348,0,0,0,11044
29265,14057211,14057211,14057321,0,0,0,110
29260,14051879,14051879,14057593,0,0,0,5714
29267,14057699,14057699,14057753,0,0,0,54
29269,14058269,14058269,14058488,0,0,0,219
29270,14058980,14058980,14059100,0,0,0,120
29271,14059406,14059406,14059467,0,0,0,61
29272,14060043,14060043,14060125,0,0,0,82
29255,14049761,14049761,14060605,0,0,0,10844
29266,14057665,14057665,14060679,0,0,0,3014
29274,14061993,14061993,14062035,0,0,0,42
29273,14060834,14060834,14063979,0,0,0,3145
29275,14064811,14064811,14065079,0,0,0,268
29276,14065643,14065643,14065826,0,0,0,183
29277,14067606,14067606,14067777,0,0,0,171
29278,14068976,14068976,14069074,0,0,0,98
29279,14069507,14069507,14069630,0,0,0,123
29280,14070320,14070320,14070491,0,0,0,171
29281,14070668,14070668,14070950,0,0,0,282
29268,14057810,14057810,14071272,0,0,0,13462
29282,14071301,14071301,14071425,0,0,0,124
29284,14074959,14074959,14077599,0,0,0,2640
29285,14078621,14078621,14078742,0,0,0,121
29287,14078741,14078741,14078833,0,0,0,92
29286,14078621,14078621,14078834,0,0,0,213
29288,14079339,14079339,14079398,0,0,0,59
29289,14079997,14079997,14080062,0,0,0,65
29290,14080062,14080062,14080115,0,0,0,53
29291,14080297,14080297,14080415,0,0,0,118
29292,14080749,14080749,14080809,0,0,0,60
29283,14071679,14071679,14080946,0,0,0,9267
29293,14080880,14080880,14081049,0,0,0,169
29294,14080880,14080880,14081050,0,0,0,170
29295,14081191,14081191,14081252,0,0,0,61
29297,14081373,14081373,14081491,0,0,0,118
29296,14081311,14081311,14081492,0,0,0,181
29298,14081491,14081491,14081554,0,0,0,63
29299,14081554,14081554,14081672,0,0,0,118
29300,14081554,14081554,14081791,0,0,0,237
29301,14081672,14081672,14081855,0,0,0,183
29302,14081791,14081791,14081912,0,0,0,121
29303,14081854,14081854,14082092,0,0,0,238
29304,14081912,14081912,14082152,0,0,0,240
29305,14082092,14082092,14082211,0,0,0,119
29306,14082211,14082211,14082392,0,0,0,181
29307,14082211,14082211,14082392,0,0,0,181
29308,14082392,14082392,14082575,0,0,0,183
29309,14082392,14082392,14082575,0,0,0,183
29310,14082575,14082575,14082733,0,0,0,158
29311,14082575,14082575,14082734,0,0,0,159
29312,14082733,14082733,14082853,0,0,0,120
29313,14082733,14082733,14082924,0,0,0,191
29314,14082924,14082924,14083097,0,0,0,173
29315,14082924,14082924,14083163,0,0,0,239
29316,14083097,14083097,14083276,0,0,0,179
29317,14083162,14083162,14083333,0,0,0,171
29318,14083276,14083276,14083454,0,0,0,178
29319,14083333,14083333,14083454,0,0,0,121
29320,14083753,14083753,14083873,0,0,0,120
29321,14085396,14085396,14090828,0,0,0,5432
29323,14093048,14093048,14093107,0,0,0,59
29324,14093048,14093048,14093108,0,0,0,60
29325,14093107,14093107,14093163,0,0,0,56
29327,14093163,14093163,14093224,0,0,0,61
29326,14093107,14093107,14093225,0,0,0,118
29328,14093224,14093224,14093285,0,0,0,61
29329,14093224,14093224,14093286,0,0,0,62
29330,14093343,14093343,14093404,0,0,0,61
29331,14093344,14093344,14093404,0,0,0,60
29332,14093403,14093403,14093498,0,0,0,95
29333,14093403,14093404,14093499,0,0,1,96
29334,14093498,14093498,14093799,0,0,0,301
29335,14093498,14093498,14093800,0,0,0,302
29336,14093738,14093738,14093979,0,0,0,241
29337,14093799,14093799,14094105,0,0,0,306
29339,14094024,14094024,14094105,0,0,0,81
29338,14093799,14093800,14094107,0,0,1,308
29340,14094104,14094105,14094165,0,0,1,61
29341,14094104,14094105,14094166,0,0,1,62
29343,14094284,14094284,14094344,0,0,0,60
29342,14094226,14094226,14094345,0,0,0,119
29344,14094344,14094344,14094585,0,0,0,241
29345,14094344,14094344,14094585,0,0,0,241
29346,14094404,14094404,14094645,0,0,0,241
29347,14094585,14094585,14094691,0,0,0,106
29348,14094585,14094585,14094692,0,0,0,107
29349,14094691,14094691,14094750,0,0,0,59
29351,14094750,14094750,14094832,0,0,0,82
29350,14094749,14094749,14094891,0,0,0,142
29352,14094750,14094750,14094891,0,0,0,141
29353,14094890,14094890,14095137,0,0,0,247
29354,14094890,14094891,14095139,0,0,1,249
29322,14087303,14087303,14095214,0,0,0,7911
29355,14095137,14095137,14095432,0,0,0,295
29356,14095137,14095137,14095433,0,0,0,296
29357,14095432,14095432,14095490,0,0,0,58
29359,14095490,14095490,14095550,0,0,0,60
29360,14095550,14095550,14095610,0,0,0,60
29358,14095432,14095432,14095733,0,0,0,301
29361,14095671,14095671,14095733,0,0,0,62
29364,14095732,14095732,14095791,0,0,0,59
29362,14095672,14095733,14095794,0,0,61,122
29366,14095791,14095791,14095850,0,0,0,59
29367,14095791,14095791,14095851,0,0,0,60
29363,14095731,14095794,14095855,0,0,63,124
29370,14095850,14095850,14095911,0,0,0,61
29365,14095732,14095855,14095915,0,0,123,183
29368,14095791,14095915,14095975,0,0,124,184
29371,14095850,14095851,14096091,0,0,1,241
29369,14095791,14095975,14096095,0,0,184,304
29375,14096090,14096091,14096152,0,0,1,62
29373,14095910,14095911,14096153,0,0,1,243
29376,14096151,14096152,14096215,0,0,1,64
29377,14096151,14096153,14096216,0,0,2,65
29380,14096214,14096215,14096275,0,0,1,61
29382,14096272,14096272,14096357,0,0,0,85
29383,14096272,14096275,14096360,0,0,3,88
29372,14095850,14096095,14096397,0,0,245,547
29384,14096274,14096357,14096415,0,0,83,141
29385,14096332,14096360,14096423,0,0,28,91
29386,14096332,14096415,14096488,0,0,83,156
29387,14096377,14096423,14096669,0,0,46,292
29374,14095910,14096397,14096702,0,0,487,792
29389,14096405,14096669,14096729,0,0,264,324
29388,14096377,14096488,14096734,0,0,111,357
29390,14096464,14096729,14097004,0,0,265,540
29391,14096464,14096734,14097009,0,0,270,545
29378,14096151,14096702,14097016,0,0,551,865
29394,14096622,14097004,14097066,0,0,382,444
29395,14096623,14097009,14097070,0,0,386,447
29396,14096738,14097066,14097126,0,0,328,388
29397,14096738,14097070,14097130,0,0,332,392
29379,14096211,14097016,14097308,0,0,805,1097
29398,14096738,14097126,14097323,0,0,388,585
29399,14096738,14097130,14097328,0,0,392,590
29393,14096502,14097328,14097564,0,0,826,1062
29392,14096464,14097308,14097584,0,0,844,1120
29381,14096270,14097584,14097602,0,0,1314,1332
29400,14099447,14099447,14100720,0,0,0,1273
29406,14101175,14101175,14101277,0,0,0,102
29404,14101133,14101133,14101278,0,0,0,145
29407,14101274,14101274,14101403,0,0,0,129
29408,14101277,14101277,14101403,0,0,0,126
29410,14101402,14101402,14101525,0,0,0,123
29411,14101402,14101402,14101525,0,0,0,123
29409,14101341,14101341,14101635,0,0,0,294
29415,14101525,14101525,14101704,0,0,0,179
29412,14101403,14101403,14101705,0,0,0,302
29413,14101441,14101441,14101705,0,0,0,264
29414,14101524,14101524,14101705,0,0,0,181
29416,14101703,14101703,14101825,0,0,0,122
29418,14101704,14101704,14101895,0,0,0,191
29420,14101823,14101823,14102045,0,0,0,222
29422,14101894,14101894,14102045,0,0,0,151
29417,14101703,14101703,14102046,0,0,0,343
29419,14101704,14101704,14102046,0,0,0,342
29425,14102045,14102045,14102224,0,0,0,179
29423,14102044,14102044,14102225,0,0,0,181
29426,14102045,14102045,14102371,0,0,0,326
29424,14102044,14102044,14102372,0,0,0,328
29427,14102224,14102224,14102425,0,0,0,201
29428,14102224,14102224,14102425,0,0,0,201
29421,14101826,14101826,14102458,0,0,0,632
29429,14102370,14102370,14102479,0,0,0,109
29434,14102478,14102478,14102595,0,0,0,117
29435,14102478,14102478,14102596,0,0,0,118
29432,14102424,14102424,14102648,0,0,0,224
29433,14102425,14102425,14102687,0,0,0,262
29436,14102581,14102581,14102728,0,0,0,147
29431,14102371,14102371,14102757,0,0,0,386
29437,14102581,14102581,14102757,0,0,0,176
29430,14102370,14102370,14102758,0,0,0,388
29440,14102716,14102716,14102872,0,0,0,156
29441,14102739,14102739,14102915,0,0,0,176
29438,14102648,14102648,14102944,0,0,0,296
29439,14102686,14102686,14102977,0,0,0,291
29444,14102844,14102844,14102977,0,0,0,133
29445,14102903,14102903,14103018,0,0,0,115
29447,14102964,14102964,14103090,0,0,0,126
29449,14103006,14103006,14103116,0,0,0,110
29442,14102757,14102757,14103117,0,0,0,360
29443,14102757,14102757,14103153,0,0,0,396
29448,14102976,14102976,14103161,0,0,0,185
29446,14102944,14102944,14103184,0,0,0,240
29450,14103074,14103074,14103224,0,0,0,150
29451,14103116,14103116,14103224,0,0,0,108
29456,14103215,14103215,14103328,0,0,0,113
29457,14103221,14103221,14103328,0,0,0,107
29455,14103184,14103184,14103388,0,0,0,204
29454,14103161,14103161,14103389,0,0,0,228
29458,14103327,14103327,14103446,0,0,0,119
29459,14103327,14103327,14103446,0,0,0,119
29462,14103440,14103440,14103485,0,0,0,45
29453,14103150,14103150,14103501,0,0,0,351
29463,14103443,14103443,14103501,0,0,0,58
29452,14103116,14103116,14103502,0,0,0,386
29465,14103501,14103501,14103522,0,0,0,21
29460,14103387,14103387,14103546,0,0,0,159
29461,14103388,14103388,14103552,0,0,0,164
29401,14099912,14099912,14103591,0,0,0,3679
29466,14103544,14103544,14103677,0,0,0,133
29467,14103552,14103552,14103699,0,0,0,147
29468,14103698,14103698,14103867,0,0,0,169
29469,14103698,14103698,14103867,0,0,0,169
29472,14103867,14103867,14104043,0,0,0,176
29471,14103865,14103865,14104085,0,0,0,220
29473,14104042,14104042,14104207,0,0,0,165
29474,14104083,14104083,14104271,0,0,0,188
29475,14104223,14104223,14104366,0,0,0,143
29476,14104265,14104265,14104431,0,0,0,166
29477,14104396,14104396,14104533,0,0,0,137
29478,14104431,14104431,14104592,0,0,0,161
29402,14100711,14100711,14104628,0,0,0,3917
29479,14104533,14104533,14104678,0,0,0,145
29480,14104592,14104592,14104751,0,0,0,159
29482,14104678,14104678,14104819,0,0,0,141
29481,14104616,14104616,14104823,0,0,0,207
29483,14104751,14104751,14104934,0,0,0,183
29484,14104819,14104819,14104967,0,0,0,148
29403,14101068,14101068,14105019,0,0,0,3951
29485,14104932,14104932,14105087,0,0,0,155
29405,14101169,14101169,14105103,0,0,0,3934
29486,14104967,14104967,14105119,0,0,0,152
29489,14105087,14105087,14105246,0,0,0,159
29490,14105119,14105119,14105282,0,0,0,163
29491,14105262,14105262,14105457,0,0,0,195
29492,14105282,14105282,14105493,0,0,0,211
29493,14105456,14105456,14105663,0,0,0,207
29494,14105492,14105492,14105750,0,0,0,258
29495,14105663,14105663,14105880,0,0,0,217
29496,14105750,14105750,14105931,0,0,0,181
29497,14105871,14105871,14106059,0,0,0,188
29499,14105954,14105954,14106092,0,0,0,138
29498,14105931,14105931,14106105,0,0,0,174
29502,14106179,14106179,14106289,0,0,0,110
29500,14106059,14106059,14106300,0,0,0,241
29501,14106104,14106104,14106311,0,0,0,207
29504,14106365,14106365,14106516,0,0,0,151
29503,14106363,14106363,14106542,0,0,0,179
29508,14106644,14106644,14106696,0,0,0,52
29505,14106516,14106516,14106733,0,0,0,217
29506,14106540,14106540,14106769,0,0,0,229
29510,14106733,14106733,14106924,0,0,0,191
29512,14106764,14106764,14107004,0,0,0,240
29511,14106758,14106758,14107084,0,0,0,326
29507,14106540,14106540,14107088,0,0,0,548
29516,14107016,14107016,14107126,0,0,0,110
29513,14106924,14106924,14107156,0,0,0,232
29515,14107004,14107004,14107257,0,0,0,253
29517,14107074,14107074,14107370,0,0,0,296
29518,14107155,14107155,14107370,0,0,0,215
29519,14107248,14107248,14107456,0,0,0,208
29520,14107369,14107369,14107581,0,0,0,212
29522,14107454,14107454,14107686,0,0,0,232
29526,14107690,14107690,14107752,0,0,0,62
29524,14107581,14107581,14107771,0,0,0,190
29525,14107677,14107677,14107915,0,0,0,238
29521,14107373,14107373,14107964,0,0,0,591
29527,14107770,14107770,14108047,0,0,0,277
29529,14107951,14107951,14108047,0,0,0,96
29528,14107900,14107900,14108116,0,0,0,216
29530,14108047,14108047,14108254,0,0,0,207
29532,14108140,14108140,14108343,0,0,0,203
29514,14106925,14106925,14108432,0,0,0,1507
29534,14108254,14108254,14108497,0,0,0,243
29535,14108339,14108339,14108558,0,0,0,219
29533,14108181,14108181,14108568,0,0,0,387
29531,14108076,14108076,14108603,0,0,0,527
29537,14108497,14108497,14108711,0,0,0,214
29539,14108621,14108621,14108831,0,0,0,210
29538,14108558,14108558,14108832,0,0,0,274
29540,14108711,14108711,14108988,0,0,0,277
29541,14108819,14108819,14109038,0,0,0,219
29544,14108957,14108957,14109089,0,0,0,132
29523,14107527,14107527,14109151,0,0,0,1624
29546,14109035,14109035,14109260,0,0,0,225
29545,14109007,14109007,14109301,0,0,0,294
29547,14109176,14109176,14109303,0,0,0,127
29549,14109283,14109283,14109397,0,0,0,114
29551,14109487,14109487,14109517,0,0,0,30
29542,14108860,14108860,14109519,0,0,0,659
29550,14109300,14109300,14109567,0,0,0,267
29548,14109258,14109258,14109568,0,0,0,310
29536,14108344,14108344,14109911,0,0,0,1567
29556,14110317,14110317,14110359,0,0,0,42
29557,14110872,14110872,14111127,0,0,0,255
29558,14112665,14112665,14112708,0,0,0,43
29543,14108937,14108937,14112874,0,0,0,3937
29560,14113427,14113427,14113475,0,0,0,48
29561,14113466,14113466,14113936,0,0,0,470
29509,14106679,14106679,14114591,0,0,0,7912
29554,14109554,14109554,14114596,0,0,0,5042
29553,14109515,14109515,14114597,0,0,0,5082
29470,14103742,14103742,14114602,0,0,0,10860
29487,14105029,14105029,14114620,0,0,0,9591
29488,14105041,14105041,14114628,0,0,0,9587
29555,14109567,14109567,14114628,0,0,0,5061
29562,14114636,14114636,14114654,0,0,0,18
29563,14114658,14114658,14114670,0,0,0,12
29564,14114674,14114674,14114687,0,0,0,13
29565,14114814,14114814,14114894,0,0,0,80
29566,14115111,14115111,14115146,0,0,0,35
29552,14109493,14109493,14115176,0,0,0,5683
29568,14115403,14115403,14115437,0,0,0,34
29570,14115667,14115667,14115709,0,0,0,42
29567,14115276,14115276,14115772,0,0,0,496
29571,14115911,14115911,14115944,0,0,0,33
29572,14116155,14116155,14116185,0,0,0,30
29569,14115657,14115657,14116202,0,0,0,545
29573,14116371,14116371,14116432,0,0,0,61
29464,14103479,14103479,14117742,0,0,0,14263
29574,14118093,14118093,14118109,0,0,0,16
29576,14118302,14118302,14118334,0,0,0,32
29580,14118553,14118553,14118608,0,0,0,55
29578,14118512,14118512,14118671,0,0,0,159
29579,14118512,14118512,14118687,0,0,0,175
29581,14118670,14118670,14118851,0,0,0,181
29582,14118670,14118670,14118852,0,0,0,182
29583,14118851,14118851,14119015,0,0,0,164
29584,14118851,14118851,14119043,0,0,0,192
29585,14119043,14119043,14119064,0,0,0,21
29586,14119043,14119043,14119113,0,0,0,70
29577,14118380,14118380,14130495,0,0,0,12115
29589,14119811,14130495,14130508,0,0,10684,10697
29590,14120110,14130495,14130512,0,0,10385,10402
29588,14119517,14130495,14130513,0,0,10978,10996
29597,14120591,14130512,14130586,0,0,9921,9995
29591,14120191,14130495,14130614,0,0,10304,10423
29598,14120729,14130513,14130640,0,0,9784,9911
29600,14120841,14130614,14130650,0,0,9773,9809
29592,14120191,14130495,14130673,0,0,10304,10482
29593,14120310,14130495,14130673,0,0,10185,10363
29594,14120369,14130495,14130674,0,0,10126,10305
29596,14120548,14130508,14130689,0,0,9960,10141
29605,14121913,14130673,14130703,0,0,8760,8790
29606,14121913,14130674,14130705,0,0,8761,8792
29607,14121924,14130689,14130729,0,0,8765,8805
29595,14120487,14130495,14130737,0,0,10008,10250
29599,14120729,14130586,14130737,0,0,9857,10008
29604,14121789,14130673,14130740,0,0,8884,8951
29608,14121924,14130703,14130743,0,0,8779,8819
29609,14121943,14130705,14130743,0,0,8762,8800
29610,14121963,14130729,14130761,0,0,8766,8798
29611,14121964,14130737,14130767,0,0,8773,8803
29615,14121994,14130743,14130802,0,0,8749,8808
29612,14121981,14130737,14130810,0,0,8756,8829
29613,14121981,14130740,14130813,0,0,8759,8832
29614,14121981,14130743,14130817,0,0,8762,8836
29616,14121994,14130761,14130821,0,0,8767,8827
29617,14122113,14130767,14130880,0,0,8654,8767
29619,14122226,14130810,14130927,0,0,8584,8701
29620,14122282,14130813,14130938,0,0,8531,8656
29623,14122548,14130880,14130938,0,0,8332,8390
29626,14123542,14130938,14130956,0,0,7396,7414
29622,14122407,14130821,14130962,0,0,8414,8555
29618,14122113,14130802,14130971,0,0,8689,8858
29625,14123533,14130938,14131010,0,0,7405,7477
29627,14123544,14130956,14131016,0,0,7412,7472
29621,14122343,14130817,14131023,0,0,8474,8680
29630,14123772,14131010,14131130,0,0,7238,7358
29628,14123604,14130962,14131131,0,0,7358,7527
29631,14123772,14131016,14131136,0,0,7244,7364
29629,14123604,14130971,14131140,0,0,7367,7536
29632,14123892,14131023,14131164,0,0,7131,7272
29633,14123950,14131130,14131258,0,0,7180,7308
29634,14124033,14131131,14131288,0,0,7098,7255
29636,14124078,14131140,14131305,0,0,7062,7227
29638,14124243,14131258,14131339,0,0,7015,7096
29637,14124190,14131164,14131361,0,0,6974,7171
29639,14124387,14131288,14131421,0,0,6901,7034
29640,14124387,14131305,14131438,0,0,6918,7051
29641,14124520,14131339,14131505,0,0,6819,6985
29642,14124520,14131361,14131528,0,0,6841,7008
29643,14124686,14131421,14131558,0,0,6735,6872
29645,14124823,14131505,14131613,0,0,6682,6790
29644,14124686,14131438,14131637,0,0,6752,6951
29646,14125901,14131528,14131648,0,0,5627,5747
29647,14125901,14131558,14131679,0,0,5657,5778
29602,14120879,14130650,14131684,0,0,9771,10805
29601,14120856,14130640,14131697,0,0,9784,10841
29648,14126021,14131613,14131794,0,0,5592,5773
29649,14126021,14131637,14131818,0,0,5616,5797
29650,14126201,14131648,14131831,0,0,5447,5630
29651,14126202,14131679,14131861,0,0,5477,5659
29652,14126384,14131684,14131875,0,0,5300,5491
29624,14122548,14130927,14131892,0,0,8379,9344
29654,14126935,14131794,14131918,0,0,4859,4983
29655,14126935,14131818,14131942,0,0,4883,5007
29653,14126384,14131697,14131948,0,0,5313,5564
29662,14127540,14131948,14132005,0,0,4408,4465
29656,14127058,14131831,14132015,0,0,4773,4957
29660,14127416,14131918,14132042,0,0,4502,4626
29657,14127059,14131861,14132043,0,0,4802,4984
29658,14127241,14131875,14132050,0,0,4634,4809
29659,14127241,14131892,14132067,0,0,4651,4826
29663,14127597,14132005,14132120,0,0,4408,4523
29661,14127416,14131942,14132124,0,0,4526,4708
29664,14127597,14132015,14132155,0,0,4418,4558
29665,14128547,14132042,14132163,0,0,3495,3616
29668,14128727,14132067,14132189,0,0,3340,3462
29666,14128548,14132043,14132222,0,0,3495,3674
29667,14128668,14132050,14132232,0,0,3382,3564
29669,14128849,14132120,14132238,0,0,3271,3389
29670,14128849,14132124,14132242,0,0,3275,3393
29671,14128966,14132155,14132277,0,0,3189,3311
29673,14129088,14132189,14132312,0,0,3101,3224
29672,14128967,14132163,14132343,0,0,3196,3376
29676,14129687,14132238,14132360,0,0,2551,2673
29678,14129809,14132277,14132394,0,0,2468,2585
29677,14129687,14132242,14132425,0,0,2555,2738
29679,14129870,14132312,14132429,0,0,2442,2559
29681,14129987,14132360,14132499,0,0,2373,2512
29682,14130126,14132394,14132510,0,0,2268,2384
29680,14129926,14132343,14132544,0,0,2417,2618
29683,14130126,14132425,14132600,0,0,2299,2474
29684,14130242,14132429,14132610,0,0,2187,2368
29685,14130301,14132499,14132620,0,0,2198,2319
29675,14129211,14132232,14132647,0,0,3021,3436
29686,14130422,14132510,14132692,0,0,2088,2270
29674,14129147,14132222,14132702,0,0,3075,3555
29688,14130603,14132600,14132717,0,0,1997,2114
29687,14130422,14132544,14132726,0,0,2122,2304
29690,14130782,14132620,14132739,0,0,1838,1957
29691,14130782,14132647,14132766,0,0,1865,1984
29689,14130603,14132610,14132789,0,0,2007,2186
29692,14130900,14132692,14132877,0,0,1792,1977
29693,14130901,14132702,14132885,0,0,1801,1984
29694,14131084,14132717,14132894,0,0,1633,1810
29695,14131084,14132726,14132904,0,0,1642,1820
29635,14124069,14131136,14133483,0,0,7067,9414
29559,14113197,14113197,14133505,0,0,0,20308
29603,14121273,14132877,14134153,0,0,11604,12880
29696,14131261,14132739,14135293,0,0,1478,4032
29697,14131261,14132766,14135321,0,0,1505,4060
29700,14137035,14137035,14137146,0,0,0,111
29701,14137359,14137359,14137470,0,0,0,111
29702,14137690,14137690,14137805,0,0,0,115
29699,14136760,14136760,14138124,0,0,0,1364
29698,14135587,14135587,14138612,0,0,0,3025
29575,14118285,14118285,14138642,0,0,0,20357
29703,14138526,14138526,14138827,0,0,0,301
29705,14140139,14140139,14140269,0,0,0,130
29704,14139191,14139191,14140527,0,0,0,1336
29706,14140478,14140478,14140553,0,0,0,75
29587,14119489,14119489,14141726,0,0,0,22237
29707,14140604,14140604,14143262,0,0,0,2658
29709,14144447,14144447,14144461,0,0,0,14
29710,14145482,14145482,14145496,0,0,0,14
29711,14145920,14145920,14145933,0,0,0,13
29712,14145941,14145941,14146107,0,0,0,166
29713,14146165,14146165,14146256,0,0,0,91
29714,14146465,14146465,14146630,0,0,0,165
29715,14147119,14147119,14147222,0,0,0,103
29716,14147509,14147509,14147790,0,0,0,281
29717,14148508,14148508,14148535,0,0,0,27
29718,14148672,14148672,14148688,0,0,0,16
29719,14148977,14148977,14148999,0,0,0,22
29720,14149073,14149073,14149093,0,0,0,20
29721,14149234,14149234,14149254,0,0,0,20
29722,14149656,14149656,14149680,0,0,0,24
29723,14149856,14149856,14149877,0,0,0,21
29724,14150271,14150271,14150295,0,0,0,24
29725,14150427,14150427,14150450,0,0,0,23
29726,14151341,14151341,14151370,0,0,0,29
29727,14151551,14151551,14151576,0,0,0,25
29728,14151823,14151823,14151848,0,0,0,25
29708,14143148,14143148,14152146,0,0,0,8998
29729,14152178,14152178,14152205,0,0,0,27
29731,14152325,14152325,14152351,0,0,0,26
29732,14152491,14152491,14152518,0,0,0,27
29733,14152599,14152599,14152625,0,0,0,26
29734,14152957,14152957,14152990,0,0,0,33
29735,14153270,14153270,14153298,0,0,0,28
29736,14153866,14153866,14153900,0,0,0,34
29737,14153996,14153996,14154026,0,0,0,30
29738,14154093,14154093,14154129,0,0,0,36
29739,14154214,14154214,14154254,0,0,0,40
29740,14154468,14154468,14154528,0,0,0,60
29741,14154868,14154868,14154931,0,0,0,63
29742,14155019,14155019,14155070,0,0,0,51
29743,14155148,14155148,14155199,0,0,0,51
29744,14155255,14155255,14155306,0,0,0,51
29745,14155504,14155504,14155597,0,0,0,93
29730,14152203,14152203,14161496,0,0,0,9293
29747,14168906,14168906,14170402,0,0,0,1496
29746,14161441,14161441,14170531,0,0,0,9090
29751,14172238,14172238,14172501,0,0,0,263
29749,14170764,14170764,14172700,0,0,0,1936
29753,14174528,14174528,14174705,0,0,0,177
29752,14174139,14174139,14176015,0,0,0,1876
29754,14174817,14174817,14178444,0,0,0,3627
29756,14179401,14179401,14179437,0,0,0,36
29748,14170532,14170532,14179654,0,0,0,9122
29755,14177047,14177047,14179801,0,0,0,2754
29760,14180141,14180141,14180179,0,0,0,38
29763,14180387,14180387,14180402,0,0,0,15
29762,14180297,14180297,14180425,0,0,0,128
29758,14179799,14179799,14181235,0,0,0,1436
29766,14181572,14181572,14181595,0,0,0,23
29750,14171122,14171122,14181921,0,0,0,10799
29769,14181981,14181981,14182222,0,0,0,241
29761,14180222,14181921,14182855,0,0,1699,2633
29770,14182388,14182388,14183198,0,0,0,810
29767,14181826,14181826,14185902,0,0,0,4076
29774,14184342,14185902,14185943,0,0,1560,1601
29771,14183932,14185902,14185976,0,0,1970,2044
29775,14184454,14185902,14185980,0,0,1448,1526
29778,14185316,14185980,14185999,0,0,664,683
29776,14184480,14185943,14186694,0,0,1463,2214
29772,14184211,14185902,14186845,0,0,1691,2634
29780,14185641,14186694,14186922,0,0,1053,1281
29781,14185767,14186845,14186979,0,0,1078,1212
29782,14186297,14186922,14187168,0,0,625,871
29785,14187154,14187168,14187269,0,0,14,115
29759,14180087,14180087,14187644,0,0,0,7557
29757,14179781,14179781,14187665,0,0,0,7884
29788,14187312,14187665,14187700,0,0,353,388
29783,14186451,14187665,14187921,0,0,1214,1470
29794,14187822,14187822,14187926,0,0,0,104
29795,14187934,14187934,14187954,0,0,0,20
29789,14187451,14187665,14187956,0,0,214,505
29786,14187215,14187956,14188468,0,0,741,1253
29784,14186643,14186979,14188639,0,0,336,1996
29777,14185175,14185976,14188895,0,0,801,3720
29764,14180809,14180809,14188924,0,0,0,8115
29787,14187306,14187306,14190226,0,0,0,2920
29798,14189547,14190226,14190260,0,0,679,713
29773,14184235,14187644,14191341,0,0,3409,7106
29800,14190009,14190260,14191681,0,0,251,1672
29801,14190774,14191681,14192437,0,0,907,1663
29796,14187997,14191341,14192691,0,0,3344,4694
29779,14185363,14185999,14193193,0,0,636,7830
29804,14192124,14193193,14193216,0,0,1069,1092
29805,14193156,14193216,14193242,0,0,60,86
29802,14190999,14192437,14193390,0,0,1438,2391
29765,14180929,14180929,14193789,0,0,0,12860
29808,14194489,14194489,14194518,0,0,0,29
29799,14189846,14193390,14194531,0,0,3544,4685
29809,14194647,14194647,14195335,0,0,0,688
29811,14195041,14195335,14195507,0,0,294,466
29768,14181832,14183198,14195741,0,0,1366,13909
29790,14187615,14195741,14196060,0,0,8126,8445
29812,14195597,14195597,14197608,0,0,0,2011
29807,14194003,14194003,14197950,0,0,0,3947
29806,14193610,14196060,14199232,0,0,2450,5622
29817,14199560,14199560,14199653,0,0,0,93
29813,14197279,14197279,14199769,0,0,0,2490
29818,14199747,14199747,14199990,0,0,0,243
29791,14187621,14188468,14200488,0,0,847,12867
29816,14199266,14199266,14200659,0,0,0,1393
29792,14187651,14195741,14201080,0,0,8090,13429
29820,14200841,14200841,14201166,0,0,0,325
29793,14187674,14188924,14201693,0,0,1250,14019
29821,14201255,14201255,14201714,0,0,0,459
29814,14197622,14197622,14202152,0,0,0,4530
29822,14202210,14202210,14202632,0,0,0,422
29815,14198975,14198975,14202744,0,0,0,3769
29819,14200486,14200486,14202799,0,0,0,2313
29797,14188186,14192691,14202824,0,0,4505,14638
29823,14202521,14202521,14203054,0,0,0,533
29827,14202971,14202971,14203098,0,0,0,127
29829,14203818,14203818,14203968,0,0,0,150
29830,14203982,14203982,14204297,0,0,0,315
29831,14204098,14204098,14204325,0,0,0,227
29828,14203157,14203157,14204501,0,0,0,1344
29833,14204772,14204772,14204828,0,0,0,56
29832,14204308,14204308,14205320,0,0,0,1012
29837,14205212,14205320,14205594,0,0,108,382
29836,14205202,14205202,14206018,0,0,0,816
29838,14205341,14205594,14206027,0,0,253,686
29840,14205652,14206027,14206205,0,0,375,553
29841,14205873,14206027,14206454,0,0,154,581
29843,14206688,14206688,14206957,0,0,0,269
29825,14202670,14202799,14207125,0,0,129,4455
29835,14205147,14205147,14207576,0,0,0,2429
29845,14207133,14207576,14207713,0,0,443,580
29846,14207483,14207713,14207810,0,0,230,327
29842,14206497,14206497,14207821,0,0,0,1324
29810,14195022,14201693,14207941,0,0,6671,12919
29848,14207823,14207823,14208038,0,0,0,215
29847,14207698,14207941,14208067,0,0,243,369
29849,14207979,14207979,14208199,0,0,0,220
29839,14205412,14206018,14208231,0,0,606,2819
29803,14191635,14196060,14208240,0,0,4425,16605
29852,14208200,14208200,14208269,0,0,0,69
29853,14208266,14208266,14208289,0,0,0,23
29854,14208514,14208514,14208675,0,0,0,161
29857,14208711,14208711,14208784,0,0,0,73
29860,14208853,14208853,14208959,0,0,0,106
29867,14209062,14209062,14209152,0,0,0,90
29859,14208841,14208841,14209168,0,0,0,327
29851,14208094,14208094,14209187,0,0,0,1093
29868,14209146,14209146,14209216,0,0,0,70
29862,14208932,14208932,14209273,0,0,0,341
29870,14209210,14209210,14209420,0,0,0,210
29863,14208938,14208938,14209750,0,0,0,812
29876,14210437,14210437,14210469,0,0,0,32
29878,14210613,14210613,14210742,0,0,0,129
29877,14210560,14210560,14210810,0,0,0,250
29834,14204979,14207125,14210988,0,0,2146,6009
29879,14211744,14211744,14212116,0,0,0,372
29875,14210428,14210428,14212371,0,0,0,1943
29880,14212053,14212053,14212401,0,0,0,348
29881,14212652,14212652,14213094,0,0,0,442
29882,14213056,14213056,14213221,0,0,0,165
29884,14213265,14213265,14214074,0,0,0,809
29885,14214157,14214157,14215269,0,0,0,1112
29869,14209172,14209172,14215717,0,0,0,6545
29850,14208089,14208089,14216140,0,0,0,8051
29887,14216021,14216021,14216572,0,0,0,551
29888,14216618,14216618,14216866,0,0,0,248
29886,14215727,14215727,14219292,0,0,0,3565
29824,14202557,14207941,14219320,0,0,5384,16763
29844,14206953,14219292,14219910,0,0,12339,12957
29855,14208524,14219910,14220014,0,0,11386,11490
29856,14208626,14220014,14220122,0,0,11388,11496
29858,14208778,14220122,14220236,0,0,11344,11458
29861,14208889,14220236,14220296,0,0,11347,11407
29864,14208968,14220296,14220343,0,0,11328,11375
29865,14209001,14220343,14220375,0,0,11342,11374
29866,14209013,14220375,14220731,0,0,11362,11718
29871,14209647,14220731,14221230,0,0,11084,11583
29872,14210183,14221230,14221417,0,0,11047,11234
29890,14221307,14221307,14221426,0,0,0,119
29873,14210367,14221417,14221450,0,0,11050,11083
29889,14220963,14220963,14221807,0,0,0,844
29874,14210370,14221450,14221929,0,0,11080,11559
29826,14202675,14202824,14225202,0,0,149,22527
29895,14226847,14226847,14227187,0,0,0,340
29897,14227499,14227499,14227546,0,0,0,47
29896,14227478,14227478,14227879,0,0,0,401
29899,14228107,14228107,14228194,0,0,0,87
29898,14227613,14227613,14228451,0,0,0,838
29900,14228447,14228447,14228811,0,0,0,364
29893,14223880,14223880,14228993,0,0,0,5113
29883,14213128,14213128,14229192,0,0,0,16064
29902,14229546,14229546,14229574,0,0,0,28
29903,14229709,14229709,14229929,0,0,0,220
29901,14229303,14229303,14230004,0,0,0,701
29904,14229976,14229976,14231069,0,0,0,1093
29891,14221847,14221847,14231335,0,0,0,9488
29905,14231350,14231350,14231443,0,0,0,93
29892,14222609,14222609,14231519,0,0,0,8910
29908,14232237,14232237,14232249,0,0,0,12
29906,14231385,14231385,14232268,0,0,0,883
29909,14233141,14233141,14233233,0,0,0,92
29910,14233380,14233380,14233466,0,0,0,86
29911,14233714,14233714,14233804,0,0,0,90
29912,14233917,14233917,14234003,0,0,0,86
29913,14234299,14234299,14234390,0,0,0,91
29914,14234736,14234736,14234749,0,0,0,13
29894,14225503,14225503,14234846,0,0,0,9343
29916,14234912,14234912,14234923,0,0,0,11
29917,14235026,14235026,14235117,0,0,0,91
29918,14235150,14235150,14235161,0,0,0,11
29919,14236357,14236357,14236623,0,0,0,266
29920,14236741,14236741,14237116,0,0,0,375
29907,14231520,14231520,14238328,0,0,0,6808
29921,14237315,14237315,14238672,0,0,0,1357
29915,14234858,14234858,14243993,0,0,0,9135
29922,14238335,14238335,14245169,0,0,0,6834
29924,14245172,14245172,14252123,0,0,0,6951
29923,14243996,14243996,14253357,0,0,0,9361
29927,14260728,14260728,14260944,0,0,0,216
29928,14261009,14261009,14261141,0,0,0,132
29926,14253360,14253360,14262503,0,0,0,9143
29929,14261166,14261166,14264570,0,0,0,3404
29930,14262504,14262504,14271586,0,0,0,9082
29931,14267655,14267655,14274413,0,0,0,6758
29925,14252126,14252126,14276024,0,0,0,23898
29935,14276769,14276769,14278217,0,0,0,1448
29938,14279027,14279027,14279975,0,0,0,948
29933,14271586,14271586,14280931,0,0,0,9345
29934,14274410,14274413,14281230,0,0,3,6820
29941,14281393,14281393,14281959,0,0,0,566
29942,14282071,14282071,14282596,0,0,0,525
29944,14282609,14282609,14282668,0,0,0,59
29943,14282599,14282599,14283089,0,0,0,490
29945,14283649,14283649,14284995,0,0,0,1346
29936,14278666,14278666,14287243,0,0,0,8577
29940,14281231,14281231,14288030,0,0,0,6799
29932,14268149,14276024,14288206,0,0,7875,20057
29947,14288140,14288140,14288496,0,0,0,356
29949,14289257,14289257,14289540,0,0,0,283
29939,14280934,14280934,14290027,0,0,0,9093
29952,14291123,14291123,14291575,0,0,0,452
29954,14291589,14291589,14291647,0,0,0,58
29953,14291580,14291580,14291705,0,0,0,125
29956,14293304,14293304,14293645,0,0,0,341
29957,14293648,14293648,14294002,0,0,0,354
29959,14294072,14294072,14295002,0,0,0,930
29960,14294225,14294225,14295819,0,0,0,1594
29951,14290113,14290113,14295862,0,0,0,5749
29961,14297247,14297247,14297264,0,0,0,17
29962,14297278,14297278,14297892,0,0,0,614
29950,14290055,14290055,14299399,0,0,0,9344
29948,14288395,14288395,14300527,0,0,0,12132
29955,14293203,14300527,14300973,0,0,7324,7770
29937,14279011,14279011,14301225,0,0,0,22214
29946,14288032,14288032,14301394,0,0,0,13362
29963,14298739,14300527,14304328,0,0,1788,5589
29967,14304618,14304618,14304679,0,0,0,61
29958,14293668,14300527,14305581,0,0,6859,11913
29966,14303152,14303152,14306605,0,0,0,3453
29965,14301396,14301396,14306850,0,0,0,5454
29964,14299372,14299372,14308504,0,0,0,9132
29968,14304849,14304849,14309058,0,0,0,4209
29971,14316115,14316115,14316679,0,0,0,564
29970,14308504,14308504,14317590,0,0,0,9086
29972,14317437,14317437,14317713,0,0,0,276
29969,14306851,14306851,14317950,0,0,0,11099
29975,14322937,14322937,14322946,0,0,0,9
29976,14323037,14323037,14323050,0,0,0,13
29974,14317952,14317952,14324010,0,0,0,6058
29973,14317593,14317593,14326920,0,0,0,9327
29977,14326926,14326926,14336061,0,0,0,9135
29980,14343413,14343413,14343447,0,0,0,34
29978,14336061,14336061,14345376,0,0,0,9315
29979,14343343,14343343,14347577,0,0,0,4234
29982,14347752,14347752,14347826,0,0,0,74
29984,14349071,14349071,14349187,0,0,0,116
29983,14347805,14347805,14351019,0,0,0,3214
29985,14350416,14350416,14354331,0,0,0,3915
29986,14350958,14350958,14354354,0,0,0,3396
29981,14345380,14345380,14355196,0,0,0,9816
29991,14355320,14355320,14355641,0,0,0,321
29987,14352011,14352011,14356575,0,0,0,4564
29988,14354356,14354356,14357580,0,0,0,3224
29995,14357715,14357715,14357774,0,0,0,59
29996,14358303,14358303,14358340,0,0,0,37
29997,14358631,14358631,14358663,0,0,0,32
29989,14355180,14355180,14359076,0,0,0,3896
29999,14360272,14360272,14360327,0,0,0,55
29992,14356070,14356070,14361597,0,0,0,5527
30000,14360407,14360407,14361763,0,0,0,1356
30002,14362273,14362273,14362382,0,0,0,109
29998,14358883,14358883,14362468,0,0,0,3585
30005,14362938,14362938,14362989,0,0,0,51
29994,14357579,14357579,14363403,0,0,0,5824
30003,14362563,14362563,14363658,0,0,0,1095
29990,14355196,14355196,14365248,0,0,0,10052
30011,14366430,14366430,14366689,0,0,0,259
30006,14363405,14363405,14366792,0,0,0,3387
30001,14361612,14361612,14366846,0,0,0,5234
30009,14366327,14366327,14366932,0,0,0,605
30004,14362926,14362926,14367059,0,0,0,4133
30013,14367342,14367342,14367648,0,0,0,306
29993,14356422,14356575,14368561,0,0,153,12139
30015,14368675,14368675,14368710,0,0,0,35
30010,14366425,14366425,14369101,0,0,0,2676
30008,14365832,14365832,14369928,0,0,0,4096
30016,14368872,14368872,14370135,0,0,0,1263
30012,14366791,14366791,14370595,0,0,0,3804
30020,14371434,14371434,14371467,0,0,0,33
30021,14372333,14372333,14372368,0,0,0,35
30017,14370648,14370648,14373892,0,0,0,3244
30022,14373603,14373603,14373989,0,0,0,386
30024,14373977,14373977,14374051,0,0,0,74
30007,14365248,14365248,14375015,0,0,0,9767
30026,14375387,14375387,14375772,0,0,0,385
30027,14376485,14376485,14377098,0,0,0,613
30019,14371038,14371038,14377199,0,0,0,6161
30023,14373843,14373843,14377575,0,0,0,3732
30018,14370661,14370661,14377679,0,0,0,7018
30030,14378102,14378102,14379179,0,0,0,1077
30014,14367532,14368561,14380110,0,0,1029,12578
30031,14380323,14380323,14380502,0,0,0,179
30032,14380419,14380419,14381290,0,0,0,871
30029,14377728,14377728,14381715,0,0,0,3987
30028,14377602,14377602,14382054,0,0,0,4452
30036,14382127,14382127,14382186,0,0,0,59
30037,14382619,14382619,14382786,0,0,0,167
30038,14382905,14382905,14382941,0,0,0,36
30039,14383163,14383163,14383215,0,0,0,52
30025,14375019,14375019,14384798,0,0,0,9779
30035,14382049,14382049,14385381,0,0,0,3332
30034,14381766,14381766,14387417,0,0,0,5651
30041,14385328,14385328,14388505,0,0,0,3177
30040,14383170,14383170,14388561,0,0,0,5391
30046,14389763,14389763,14389782,0,0,0,19
30047,14390220,14390220,14390259,0,0,0,39
30048,14390257,14390257,14390275,0,0,0,18
30045,14389708,14389708,14390376,0,0,0,668
30049,14390380,14390380,14390408,0,0,0,28
30050,14390528,14390528,14390694,0,0,0,166
30051,14391556,14391556,14391788,0,0,0,232
30043,14388533,14388533,14391881,0,0,0,3348
30053,14391919,14391919,14391944,0,0,0,25
30044,14388574,14388574,14392021,0,0,0,3447
30054,14393698,14393698,14393749,0,0,0,51
30055,14394699,14394699,14394727,0,0,0,28
30056,14394711,14394711,14394730,0,0,0,19
30057,14394722,14394722,14394741,0,0,0,19
30052,14391854,14391854,14395083,0,0,0,3229
30059,14395085,14395085,14395145,0,0,0,60
30058,14395019,14395019,14398301,0,0,0,3282
30061,14398303,14398303,14398361,0,0,0,58
30060,14398234,14398234,14401439,0,0,0,3205
30062,14401376,14401376,14404693,0,0,0,3317
30033,14380536,14380536,14405119,0,0,0,24583
30063,14404691,14404691,14407908,0,0,0,3217
30065,14407911,14407911,14407970,0,0,0,59
30042,14385749,14385749,14409010,0,0,0,23261
30064,14407843,14407843,14411076,0,0,0,3233
30067,14411080,14411080,14411141,0,0,0,61
30066,14411013,14411013,14414292,0,0,0,3279
30069,14414294,14414294,14414354,0,0,0,60
30068,14414227,14414227,14417436,0,0,0,3209
30070,14417373,14417373,14420573,0,0,0,3200
30071,14420510,14420510,14423719,0,0,0,3209
30073,14423721,14423721,14423782,0,0,0,61
30072,14423655,14423655,14426834,0,0,0,3179
30076,14429524,14429524,14429647,0,0,0,123
30074,14426788,14426788,14430101,0,0,0,3313
30078,14430104,14430104,14430164,0,0,0,60
30077,14430039,14430039,14433363,0,0,0,3324
30080,14433329,14433329,14436596,0,0,0,3267
30081,14436551,14436551,14436798,0,0,0,247
30085,14437586,14437586,14437842,0,0,0,256
30086,14437879,14437879,14438513,0,0,0,634
30088,14439325,14439325,14439476,0,0,0,151
30089,14439584,14439584,14439616,0,0,0,32
30082,14436559,14436559,14439854,0,0,0,3295
30091,14439857,14439857,14439910,0,0,0,53
30083,14436843,14436843,14440353,0,0,0,3510
30093,14441016,14441016,14441110,0,0,0,94
30094,14441216,14441216,14441261,0,0,0,45
30087,14438889,14438889,14442006,0,0,0,3117
30096,14441769,14441769,14442081,0,0,0,312
30095,14441739,14441739,14442265,0,0,0,526
30098,14442011,14442011,14442504,0,0,0,493
30100,14442368,14442368,14442796,0,0,0,428
30099,14442041,14442081,14442892,0,0,40,851
30102,14442674,14442892,14442906,0,0,218,232
30101,14442461,14442796,14442909,0,0,335,448
30104,14442812,14442909,14442960,0,0,97,148
30097,14441893,14441893,14443060,0,0,0,1167
30090,14439789,14439789,14443334,0,0,0,3545
30110,14443338,14443338,14443402,0,0,0,64
30111,14443634,14443634,14443762,0,0,0,128
30112,14443635,14443635,14443780,0,0,0,145
30114,14443761,14443762,14443971,0,0,1,210
30115,14443774,14443780,14444014,0,0,6,240
30117,14443864,14444014,14444052,0,0,150,188
30118,14443969,14444052,14444150,0,0,83,181
30116,14443780,14443971,14444161,0,0,191,381
30120,14443971,14444161,14444254,0,0,190,283
30119,14443970,14444150,14444304,0,0,180,334
30121,14444066,14444254,14444379,0,0,188,313
30122,14444124,14444304,14444489,0,0,180,365
30124,14444187,14444489,14444624,0,0,302,437
30079,14433159,14433159,14444732,0,0,0,11573
30106,14442824,14444732,14444762,0,0,1908,1938
30105,14442813,14444732,14444770,0,0,1919,1957
30108,14442967,14444762,14444815,0,0,1795,1848
30123,14444171,14444379,14444915,0,0,208,744
30126,14444309,14444770,14444938,0,0,461,629
30128,14444321,14444770,14444949,0,0,449,628
30113,14443646,14444762,14444975,0,0,1116,1329
30134,14444728,14444770,14445020,0,0,42,292
30129,14444477,14444770,14445021,0,0,293,544
30130,14444500,14444770,14445045,0,0,270,545
30136,14444774,14444774,14445089,0,0,0,315
30137,14445000,14445000,14445224,0,0,0,224
30107,14442927,14442960,14445227,0,0,33,2300
30138,14445089,14445089,14445349,0,0,0,260
30139,14445224,14445224,14445349,0,0,0,125
30092,14440945,14440945,14445468,0,0,0,4523
30140,14445341,14445341,14445533,0,0,0,192
30141,14445349,14445349,14445533,0,0,0,184
30142,14445410,14445468,14445596,0,0,58,186
30127,14444320,14444975,14445629,0,0,655,1309
30144,14445533,14445533,14445678,0,0,0,145
30143,14445531,14445531,14445746,0,0,0,215
30147,14445677,14445677,14445746,0,0,0,69
30148,14445678,14445678,14445861,0,0,0,183
30149,14445745,14445745,14445957,0,0,0,212
30150,14445861,14445861,14446035,0,0,0,174
30152,14445957,14445957,14446140,0,0,0,183
30153,14446034,14446034,14446162,0,0,0,128
30154,14446069,14446069,14446357,0,0,0,288
30155,14446134,14446134,14446451,0,0,0,317
30156,14446162,14446162,14446458,0,0,0,296
30075,14426899,14426899,14446629,0,0,0,19730
30157,14446441,14446441,14446669,0,0,0,228
30159,14446466,14446466,14446669,0,0,0,203
30084,14437109,14437109,14446699,0,0,0,9590
30135,14444761,14444770,14446774,0,0,9,2013
30161,14446668,14446668,14446781,0,0,0,113
30162,14446668,14446668,14446811,0,0,0,143
30163,14446781,14446781,14446938,0,0,0,157
30145,14445561,14445596,14446942,0,0,35,1381
30164,14446811,14446811,14446990,0,0,0,179
30166,14446904,14446904,14446995,0,0,0,91
30158,14446462,14446462,14447014,0,0,0,552
30131,14444504,14444770,14447061,0,0,266,2557
30167,14446937,14446937,14447070,0,0,0,133
30168,14446986,14446986,14447125,0,0,0,139
30165,14446874,14446874,14447126,0,0,0,252
30169,14447070,14447070,14447252,0,0,0,182
30170,14447125,14447125,14447252,0,0,0,127
30171,14447252,14447252,14447413,0,0,0,161
30172,14447252,14447252,14447414,0,0,0,162
30174,14447413,14447413,14447595,0,0,0,182
30173,14447401,14447401,14447596,0,0,0,195
30176,14447595,14447595,14447664,0,0,0,69
30177,14447595,14447595,14447720,0,0,0,125
30178,14447658,14447658,14447782,0,0,0,124
30179,14447720,14447720,14447873,0,0,0,153
30180,14447777,14447777,14447873,0,0,0,96
30181,14447869,14447869,14448021,0,0,0,152
30182,14447872,14447872,14448021,0,0,0,149
30183,14448020,14448020,14448094,0,0,0,74
30184,14448020,14448020,14448219,0,0,0,199
30103,14442737,14442906,14448324,0,0,169,5587
30187,14448219,14448219,14448344,0,0,0,125
30186,14448093,14448093,14448345,0,0,0,252
30188,14448340,14448340,14448463,0,0,0,123
30125,14444197,14444624,14448516,0,0,427,4319
30189,14448344,14448344,14448521,0,0,0,177
30190,14448459,14448459,14448571,0,0,0,112
30191,14448521,14448521,14448629,0,0,0,108
30192,14448570,14448570,14448767,0,0,0,197
30193,14448629,14448629,14448826,0,0,0,197
30194,14448758,14448758,14448989,0,0,0,231
30195,14448825,14448825,14449052,0,0,0,227
30196,14448989,14448989,14449110,0,0,0,121
30197,14449051,14449051,14449171,0,0,0,120
30198,14449110,14449110,14449231,0,0,0,121
30200,14449231,14449231,14449351,0,0,0,120
30199,14449171,14449171,14449352,0,0,0,181
30201,14449333,14449333,14449417,0,0,0,84
30202,14449346,14449346,14449503,0,0,0,157
30203,14449351,14449351,14449528,0,0,0,177
30185,14448039,14448039,14449565,0,0,0,1526
30205,14449503,14449503,14449639,0,0,0,136
30207,14449542,14449542,14449649,0,0,0,107
30206,14449528,14449528,14449722,0,0,0,194
30208,14449639,14449639,14449782,0,0,0,143
30209,14449722,14449722,14449887,0,0,0,165
30210,14449782,14449782,14449887,0,0,0,105
30146,14445661,14445661,14449909,0,0,0,4248
30211,14449884,14449884,14450017,0,0,0,133
30212,14449887,14449887,14450017,0,0,0,130
30215,14450016,14450016,14450128,0,0,0,112
30216,14450016,14450016,14450198,0,0,0,182
30219,14450128,14450128,14450331,0,0,0,203
30220,14450198,14450198,14450404,0,0,0,206
30213,14449895,14449895,14450413,0,0,0,518
30222,14450331,14450331,14450476,0,0,0,145
30221,14450327,14450327,14450541,0,0,0,214
30223,14450402,14450402,14450589,0,0,0,187
30224,14450476,14450476,14450589,0,0,0,113
30225,14450493,14450493,14450687,0,0,0,194
30217,14450023,14450023,14450696,0,0,0,673
30227,14450588,14450588,14450785,0,0,0,197
30228,14450588,14450588,14450808,0,0,0,220
30133,14444606,14445227,14450816,0,0,621,6210
30229,14450773,14450773,14450935,0,0,0,162
30230,14450806,14450806,14450966,0,0,0,160
30231,14450808,14450808,14450972,0,0,0,164
30204,14449382,14449382,14451012,0,0,0,1630
30232,14450935,14450935,14451044,0,0,0,109
30233,14450972,14450972,14451135,0,0,0,163
30234,14450987,14450987,14451178,0,0,0,191
30236,14451040,14451040,14451197,0,0,0,157
30237,14451135,14451135,14451267,0,0,0,132
30238,14451197,14451197,14451339,0,0,0,142
30239,14451266,14451266,14451464,0,0,0,198
30241,14451339,14451339,14451627,0,0,0,288
30242,14451464,14451464,14451664,0,0,0,200
30243,14451619,14451619,14451738,0,0,0,119
30240,14451268,14451268,14451787,0,0,0,519
30244,14451663,14451663,14451824,0,0,0,161
30245,14451729,14451729,14451948,0,0,0,219
30235,14451002,14451002,14451983,0,0,0,981
30246,14451824,14451824,14452011,0,0,0,187
30247,14451944,14451944,14452128,0,0,0,184
30249,14452128,14452128,14452250,0,0,0,122
30248,14452011,14452011,14452251,0,0,0,240
30250,14452248,14452248,14452378,0,0,0,130
30251,14452250,14452250,14452378,0,0,0,128
30252,14452373,14452373,14452544,0,0,0,171
30253,14452378,14452378,14452610,0,0,0,232
30255,14452544,14452544,14452663,0,0,0,119
30257,14452610,14452610,14452735,0,0,0,125
30259,14452663,14452663,14452796,0,0,0,133
30261,14452796,14452796,14452907,0,0,0,111
30260,14452735,14452735,14452908,0,0,0,173
30262,14452903,14452903,14453029,0,0,0,126
30263,14452907,14452907,14453063,0,0,0,156
30267,14453063,14453063,14453122,0,0,0,59
30268,14453127,14453127,14453163,0,0,0,36
30266,14453025,14453029,14453170,0,0,4,145
30264,14452980,14452980,14453352,0,0,0,372
30218,14450127,14450127,14453716,0,0,0,3589
30269,14453567,14453567,14453736,0,0,0,169
30271,14453795,14453795,14453819,0,0,0,24
30272,14453918,14453918,14453958,0,0,0,40
30109,14443270,14443270,14454081,0,0,0,10811
30214,14450015,14450015,14454121,0,0,0,4106
30151,14445949,14445949,14454228,0,0,0,8279
30258,14452662,14452662,14454292,0,0,0,1630
30254,14452415,14452415,14454330,0,0,0,1915
30175,14447415,14447415,14454539,0,0,0,7124
30274,14455531,14455531,14455693,0,0,0,162
30275,14455531,14455531,14455694,0,0,0,163
30276,14455693,14455693,14455839,0,0,0,146
30277,14455693,14455693,14455839,0,0,0,146
30278,14455838,14455838,14455994,0,0,0,156
30279,14455839,14455839,14456056,0,0,0,217
30280,14455994,14455994,14456178,0,0,0,184
30281,14456056,14456056,14456178,0,0,0,122
30283,14456178,14456178,14456234,0,0,0,56
30282,14456177,14456177,14456235,0,0,0,58
30284,14456234,14456234,14456360,0,0,0,126
30285,14456294,14456294,14456415,0,0,0,121
30286,14456360,14456360,14456535,0,0,0,175
30287,14456415,14456415,14456595,0,0,0,180
30288,14456534,14456534,14456656,0,0,0,122
30289,14456595,14456595,14456715,0,0,0,120
30290,14456656,14456656,14456835,0,0,0,179
30291,14456714,14456714,14456895,0,0,0,181
30292,14456835,14456835,14456956,0,0,0,121
30293,14456895,14456895,14457015,0,0,0,120
30294,14456956,14456956,14457074,0,0,0,118
30295,14457015,14457015,14457197,0,0,0,182
30296,14457074,14457074,14457256,0,0,0,182
30297,14457197,14457197,14457318,0,0,0,121
30298,14457256,14457256,14457383,0,0,0,127
30300,14457383,14457383,14457435,0,0,0,52
30299,14457318,14457318,14457464,0,0,0,146
30301,14457434,14457434,14457526,0,0,0,92
30303,14457691,14457691,14457792,0,0,0,101
30304,14457691,14457691,14457792,0,0,0,101
30306,14457848,14457848,14457971,0,0,0,123
30305,14457792,14457792,14457972,0,0,0,180
30307,14457971,14457971,14458088,0,0,0,117
30308,14457971,14457971,14458149,0,0,0,178
30310,14458149,14458149,14458209,0,0,0,60
30309,14458088,14458088,14458210,0,0,0,122
30273,14453961,14453961,14458389,0,0,0,4428
30311,14458299,14458299,14458541,0,0,0,242
30312,14458361,14458361,14458607,0,0,0,246
30313,14458541,14458541,14458638,0,0,0,97
30314,14458700,14458700,14458810,0,0,0,110
30315,14458700,14458700,14458883,0,0,0,183
30316,14458810,14458810,14459115,0,0,0,305
30317,14458883,14458883,14459231,0,0,0,348
30318,14459115,14459115,14459641,0,0,0,526
30319,14459231,14459231,14459701,0,0,0,470
30321,14459641,14459641,14459880,0,0,0,239
30322,14459701,14459701,14459912,0,0,0,211
30323,14459880,14459880,14460032,0,0,0,152
30324,14459912,14459912,14460072,0,0,0,160
30325,14460032,14460032,14460231,0,0,0,199
30326,14460071,14460071,14460231,0,0,0,160
30328,14460231,14460231,14460416,0,0,0,185
30327,14460230,14460230,14460417,0,0,0,187
30329,14460416,14460416,14460535,0,0,0,119
30330,14460416,14460416,14460535,0,0,0,119
30256,14452545,14454228,14460568,0,0,1683,8023
30331,14460534,14460534,14460713,0,0,0,179
30332,14460594,14460594,14460866,0,0,0,272
30333,14460713,14460713,14460964,0,0,0,251
30336,14460964,14460964,14461068,0,0,0,104
30265,14453018,14453018,14462272,0,0,0,9254
30270,14453722,14453722,14463266,0,0,0,9544
30335,14460866,14460866,14464333,0,0,0,3467
30226,14450587,14450816,14464348,0,0,229,13761
30337,14460982,14460982,14464935,0,0,0,3953
30340,14465766,14465766,14465822,0,0,0,56
30339,14465162,14465162,14465908,0,0,0,746
30341,14466100,14466100,14466140,0,0,0,40
30342,14466433,14466433,14467292,0,0,0,859
30302,14457630,14457630,14467306,0,0,0,9676
30344,14467288,14467288,14467339,0,0,0,51
30338,14464451,14464451,14467467,0,0,0,3016
30347,14467663,14467663,14467683,0,0,0,20
30320,14459460,14460568,14467904,0,0,1108,8444
30343,14467152,14467152,14467939,0,0,0,787
30346,14467502,14467502,14468033,0,0,0,531
30345,14467355,14467355,14468055,0,0,0,700
30349,14468071,14468071,14468390,0,0,0,319
30348,14467894,14467894,14468713,0,0,0,819
30351,14468753,14468753,14468842,0,0,0,89
30353,14468917,14468917,14468999,0,0,0,82
30355,14469081,14469081,14469226,0,0,0,145
30350,14468188,14468188,14469252,0,0,0,1064
30358,14469498,14469498,14469527,0,0,0,29
30357,14469470,14469470,14469557,0,0,0,87
30354,14469040,14469040,14469630,0,0,0,590
30359,14469645,14469645,14469684,0,0,0,39
30356,14469375,14469375,14469728,0,0,0,353
30361,14469812,14469812,14470205,0,0,0,393
30363,14470754,14470754,14470799,0,0,0,45
30360,14469696,14469696,14470877,0,0,0,1181
30364,14470804,14470804,14470902,0,0,0,98
30365,14470972,14470972,14471102,0,0,0,130
30368,14471491,14471491,14471630,0,0,0,139
30367,14471271,14471271,14472266,0,0,0,995
30369,14472355,14472355,14472492,0,0,0,137
30352,14468828,14468828,14472627,0,0,0,3799
30370,14472569,14472569,14472678,0,0,0,109
30372,14473220,14473220,14473295,0,0,0,75
30132,14444584,14464348,14473698,0,0,19764,29114
30373,14473716,14473716,14473822,0,0,0,106
30374,14473906,14473906,14474011,0,0,0,105
30375,14474379,14474379,14474542,0,0,0,163
30376,14475794,14475794,14475822,0,0,0,28
30366,14471036,14471036,14476272,0,0,0,5236
30371,14472616,14472616,14477752,0,0,0,5136
30381,14481312,14481312,14481759,0,0,0,447
30379,14480625,14480625,14482114,0,0,0,1489
30382,14482173,14482173,14482186,0,0,0,13
30383,14482229,14482229,14483414,0,0,0,1185
30384,14484098,14484098,14484158,0,0,0,60
30386,14485852,14485852,14485888,0,0,0,36
30377,14477744,14477744,14485916,0,0,0,8172
30391,14487327,14487327,14487453,0,0,0,126
30160,14446528,14473698,14487609,0,0,27170,41081
30334,14460789,14487609,14487663,0,0,26820,26874
30385,14485729,14485729,14488767,0,0,0,3038
30362,14469951,14487663,14489283,0,0,17712,19332
30390,14487201,14489283,14489376,0,0,2082,2175
30392,14489253,14489376,14489438,0,0,123,185
30378,14479946,14479946,14493554,0,0,0,13608
30387,14485881,14485888,14493995,0,0,7,8114
30388,14485914,14485914,14497538,0,0,0,11624
30380,14481107,14481107,14510986,0,0,0,29879
30394,14513667,14513667,14513687,0,0,0,20
30395,14513960,14513960,14514185,0,0,0,225
30396,14514253,14514253,14514279,0,0,0,26
30389,14486402,14488767,14514998,0,0,2365,28596
30397,14516157,14516157,14516372,0,0,0,215
30398,14516217,14516217,14516432,0,0,0,215
30399,14516372,14516372,14516554,0,0,0,182
30400,14516431,14516431,14516614,0,0,0,183
30401,14516554,14516554,14516791,0,0,0,237
30402,14516614,14516614,14516851,0,0,0,237
30404,14516851,14516851,14516982,0,0,0,131
30403,14516791,14516791,14517032,0,0,0,241
30405,14516982,14516982,14517032,0,0,0,50
30406,14517948,14517948,14518069,0,0,0,121
30407,14518009,14518009,14518131,0,0,0,122
30408,14518069,14518069,14518250,0,0,0,181
30409,14518131,14518131,14518310,0,0,0,179
30410,14518250,14518250,14518370,0,0,0,120
30411,14518310,14518310,14518430,0,0,0,120
30412,14518370,14518370,14518551,0,0,0,181
30413,14518430,14518430,14518610,0,0,0,180
30414,14518550,14518550,14518668,0,0,0,118
30415,14518610,14518610,14518733,0,0,0,123
30417,14518733,14518733,14518866,0,0,0,133
30416,14518668,14518668,14518867,0,0,0,199
30418,14518866,14518866,14518969,0,0,0,103
30419,14518866,14518866,14519190,0,0,0,324
30420,14519312,14519312,14519421,0,0,0,109
30421,14519312,14519312,14519421,0,0,0,109
30422,14519421,14519421,14519538,0,0,0,117
30423,14519421,14519421,14519598,0,0,0,177
30424,14519538,14519538,14519676,0,0,0,138
30425,14519598,14519598,14519735,0,0,0,137
30427,14519676,14519676,14519835,0,0,0,159
30428,14519735,14519735,14519893,0,0,0,158
30429,14519835,14519835,14520017,0,0,0,182
30430,14519893,14519893,14520074,0,0,0,181
30431,14520017,14520017,14520138,0,0,0,121
30432,14520074,14520074,14520254,0,0,0,180
30433,14520138,14520138,14520254,0,0,0,116
30435,14526536,14526536,14526626,0,0,0,90
30434,14521469,14521469,14529009,0,0,0,7540
30437,14529092,14529092,14529859,0,0,0,767
30439,14529977,14529977,14530357,0,0,0,380
30440,14530433,14530433,14530517,0,0,0,84
30442,14530646,14530646,14530682,0,0,0,36
30443,14530717,14530717,14530770,0,0,0,53
30444,14530876,14530876,14530911,0,0,0,35
30445,14530930,14530930,14530965,0,0,0,35
30446,14531000,14531000,14531034,0,0,0,34
30447,14531071,14531071,14531106,0,0,0,35
30426,14519614,14519614,14531283,0,0,0,11669
30436,14528527,14531283,14531339,0,0,2756,2812
30448,14531192,14531339,14531374,0,0,147,182
30449,14531262,14531374,14531409,0,0,112,147
30450,14531334,14531409,14531444,0,0,75,110
30451,14531404,14531444,14531478,0,0,40,74
30452,14531553,14531553,14531629,0,0,0,76
30457,14531955,14531955,14532078,0,0,0,123
30455,14531802,14531802,14532093,0,0,0,291
30456,14531829,14531829,14532108,0,0,0,279
30453,14531692,14531692,14532388,0,0,0,696
30462,14532424,14532424,14532460,0,0,0,36
30461,14532397,14532397,14532467,0,0,0,70
30460,14532374,14532374,14532518,0,0,0,144
30464,14532500,14532500,14532567,0,0,0,67
30463,14532471,14532471,14532658,0,0,0,187
30465,14532613,14532613,14532690,0,0,0,77
30466,14532656,14532656,14532692,0,0,0,36
30468,14532698,14532698,14532799,0,0,0,101
30393,14513616,14513616,14532813,0,0,0,19197
30472,14532968,14532968,14533141,0,0,0,173
30473,14533284,14533284,14533454,0,0,0,170
30470,14532772,14532772,14533653,0,0,0,881
30469,14532723,14532723,14533800,0,0,0,1077
30476,14533862,14533862,14533895,0,0,0,33
30475,14533800,14533800,14534022,0,0,0,222
30471,14532957,14532957,14534377,0,0,0,1420
30474,14533670,14533670,14534445,0,0,0,775
30477,14533911,14533911,14534462,0,0,0,551
30479,14534519,14534519,14534548,0,0,0,29
30482,14534633,14534633,14534691,0,0,0,58
30478,14534500,14534500,14534712,0,0,0,212
30481,14534549,14534549,14534781,0,0,0,232
30483,14534732,14534732,14534812,0,0,0,80
30484,14534836,14534836,14534921,0,0,0,85
30488,14534966,14534966,14534985,0,0,0,19
30485,14534938,14534938,14535012,0,0,0,74
30459,14532293,14532293,14535014,0,0,0,2721
30487,14534951,14534951,14535261,0,0,0,310
30490,14535051,14535051,14535307,0,0,0,256
30486,14534942,14534942,14535354,0,0,0,412
30493,14535426,14535426,14535486,0,0,0,60
30491,14535105,14535105,14535540,0,0,0,435
30495,14535592,14535592,14535749,0,0,0,157
30496,14535635,14535635,14535763,0,0,0,128
30494,14535581,14535581,14535782,0,0,0,201
30497,14535718,14535718,14535807,0,0,0,89
30498,14535782,14535782,14535810,0,0,0,28
30499,14535902,14535902,14535912,0,0,0,10
30458,14531994,14531994,14535914,0,0,0,3920
30501,14535949,14535949,14535964,0,0,0,15
30500,14535904,14535904,14536028,0,0,0,124
30502,14536166,14536166,14536187,0,0,0,21
30503,14536251,14536251,14536312,0,0,0,61
30504,14536340,14536340,14536358,0,0,0,18
30505,14536449,14536449,14536466,0,0,0,17
30507,14536543,14536543,14536561,0,0,0,18
30480,14534533,14534533,14536657,0,0,0,2124
30506,14536467,14536467,14536703,0,0,0,236
30508,14536561,14536561,14536717,0,0,0,156
30509,14536665,14536665,14536757,0,0,0,92
30511,14536715,14536715,14536892,0,0,0,177
30454,14531796,14531796,14537014,0,0,0,5218
30489,14535039,14535039,14537304,0,0,0,2265
30467,14532670,14532670,14537352,0,0,0,4682
30512,14537134,14537304,14537390,0,0,170,256
30513,14537413,14537413,14537464,0,0,0,51
30514,14537753,14537753,14537894,0,0,0,141
30515,14538118,14538118,14538175,0,0,0,57
30510,14536683,14536683,14538328,0,0,0,1645
30516,14538310,14538310,14538365,0,0,0,55
30518,14538425,14538425,14538502,0,0,0,77
30441,14530645,14530645,14538507,0,0,0,7862
30517,14538317,14538317,14538644,0,0,0,327
30520,14538530,14538530,14538671,0,0,0,141
30438,14529362,14529362,14538857,0,0,0,9495
30521,14538833,14538833,14538901,0,0,0,68
30524,14539082,14539082,14539135,0,0,0,53
30525,14539200,14539200,14539219,0,0,0,19
30528,14539546,14539546,14539689,0,0,0,143
30529,14539700,14539700,14539801,0,0,0,101
30531,14539825,14539825,14539878,0,0,0,53
30522,14538936,14538936,14540053,0,0,0,1117
30532,14539831,14539878,14540366,0,0,47,535
30535,14540041,14540366,14540447,0,0,325,406
30537,14540211,14540447,14540463,0,0,236,252
30538,14540453,14540463,14540494,0,0,10,41
30533,14539854,14540053,14542203,0,0,199,2349
30540,14541102,14542203,14542279,0,0,1101,1177
30542,14541238,14542279,14542332,0,0,1041,1094
30543,14541257,14542332,14542532,0,0,1075,1275
30544,14541493,14542532,14542582,0,0,1039,1089
30545,14541689,14542582,14542636,0,0,893,947
30539,14540554,14540554,14544158,0,0,0,3604
30547,14541886,14544158,14544296,0,0,2272,2410
30549,14542356,14544296,14544384,0,0,1940,2028
30550,14542450,14544384,14544529,0,0,1934,2079
30551,14542767,14544529,14544695,0,0,1762,1928
30552,14543066,14544695,14545859,0,0,1629,2793
30553,14543217,14545859,14545945,0,0,2642,2728
30554,14543599,14545945,14546094,0,0,2346,2495
30555,14543883,14546094,14546112,0,0,2211,2229
30556,14543910,14546112,14546247,0,0,2202,2337
30546,14541715,14542636,14546603,0,0,921,4888
30558,14544164,14546603,14546616,0,0,2439,2452
30557,14544055,14546247,14546684,0,0,2192,2629
30559,14544212,14546616,14546711,0,0,2404,2499
30560,14544217,14546684,14546716,0,0,2467,2499
30563,14544447,14546711,14546762,0,0,2264,2315
30564,14544563,14546716,14546815,0,0,2153,2252
30565,14544574,14546762,14546832,0,0,2188,2258
30567,14544667,14546815,14546867,0,0,2148,2200
30571,14544877,14546867,14546917,0,0,1990,2040
30523,14538981,14538981,14547679,0,0,0,8698
30572,14544979,14546917,14548849,0,0,1938,3870
30573,14545073,14548849,14548924,0,0,3776,3851
30577,14545270,14548924,14548992,0,0,3654,3722
30579,14545287,14548992,14549172,0,0,3705,3885
30580,14545296,14549172,14549375,0,0,3876,4079
30519,14538443,14538443,14549499,0,0,0,11056
30530,14539804,14549499,14549674,0,0,9695,9870
30492,14535198,14537014,14549840,0,0,1816,14642
30561,14544296,14549840,14549855,0,0,5544,5559
30574,14545132,14549855,14549869,0,0,4723,4737
30575,14545189,14549869,14549881,0,0,4680,4692
30576,14545263,14549881,14549893,0,0,4618,4630
30566,14544602,14549840,14549990,0,0,5238,5388
30570,14544841,14549840,14550010,0,0,4999,5169
30562,14544315,14549840,14550021,0,0,5525,5706
30585,14545961,14550021,14550036,0,0,4060,4075
30578,14545280,14549893,14550086,0,0,4613,4806
30582,14545605,14549990,14550087,0,0,4385,4482
30527,14539458,14547679,14550088,0,0,8221,10630
30584,14545852,14550010,14550101,0,0,4158,4249
30587,14546060,14550010,14550114,0,0,3950,4054
30588,14546425,14550086,14550170,0,0,3661,3745
30590,14546691,14550087,14550174,0,0,3396,3483
30589,14546517,14550086,14550196,0,0,3569,3679
30600,14547526,14550170,14550258,0,0,2644,2732
30601,14547548,14550174,14550307,0,0,2626,2759
30605,14547980,14550196,14550339,0,0,2216,2359
30594,14546888,14550088,14550358,0,0,3200,3470
30608,14548383,14550307,14550369,0,0,1924,1986
30610,14548609,14550358,14550390,0,0,1749,1781
30606,14548031,14550258,14550399,0,0,2227,2368
30609,14548581,14550339,14550407,0,0,1758,1826
30612,14548803,14550390,14550449,0,0,1587,1646
30614,14549068,14550407,14550468,0,0,1339,1400
30541,14541187,14549674,14550495,0,0,8487,9308
30592,14546781,14550495,14550509,0,0,3714,3728
30617,14549480,14550468,14550519,0,0,988,1039
30615,14549260,14550449,14550524,0,0,1189,1264
30618,14549653,14550519,14550571,0,0,866,918
30613,14548984,14550399,14550577,0,0,1415,1593
30619,14549826,14550524,14550577,0,0,698,751
30624,14549995,14550577,14550601,0,0,582,606
30625,14549996,14550577,14550616,0,0,581,620
30627,14550102,14550616,14550632,0,0,514,530
30629,14550202,14550632,14550685,0,0,430,483
30626,14550006,14550601,14550689,0,0,595,683
30593,14546800,14550509,14550699,0,0,3709,3899
30581,14545492,14549375,14550723,0,0,3883,5231
30583,14545712,14549990,14550767,0,0,4278,5055
30631,14550365,14550689,14550774,0,0,324,409
30586,14545981,14550036,14550784,0,0,4055,4803
30597,14547283,14550774,14550791,0,0,3491,3508
30602,14547556,14550791,14550802,0,0,3235,3246
30632,14550572,14550723,14550815,0,0,151,243
30595,14547022,14550699,14550830,0,0,3677,3808
30623,14549922,14550571,14550853,0,0,649,931
30598,14547303,14550784,14550903,0,0,3481,3600
30634,14550826,14550826,14550912,0,0,0,86
30620,14549850,14550912,14550966,0,0,1062,1116
30622,14549917,14550966,14551218,0,0,1049,1301
30616,14549437,14550903,14551298,0,0,1466,1861
30603,14547570,14550802,14551581,0,0,3232,4011
30591,14546768,14550088,14551586,0,0,3320,4818
30637,14551249,14551581,14551633,0,0,332,384
30636,14551037,14551581,14551669,0,0,544,632
30639,14551444,14551633,14551720,0,0,189,276
30638,14551272,14551586,14551726,0,0,314,454
30607,14548375,14550830,14551815,0,0,2455,3440
30640,14551789,14551789,14552211,0,0,0,422
30599,14547367,14550114,14552219,0,0,2747,4852
30641,14551859,14552211,14552262,0,0,352,403
30642,14552182,14552219,14552295,0,0,37,113
30643,14552511,14552511,14552577,0,0,0,66
30644,14552736,14552736,14552755,0,0,0,19
30646,14552832,14552832,14552847,0,0,0,15
30647,14553069,14553069,14553192,0,0,0,123
30648,14553309,14553309,14553355,0,0,0,46
30649,14553318,14553318,14553406,0,0,0,88
30534,14539961,14549499,14553429,0,0,9538,13468
30596,14547243,14550101,14553648,0,0,2858,6405
30633,14550579,14551298,14553686,0,0,719,3107
30650,14553440,14553648,14553706,0,0,208,266
30651,14553613,14553686,14553784,0,0,73,171
30652,14553861,14553861,14553913,0,0,0,52
30653,14554241,14554241,14554324,0,0,0,83
30526,14539358,14539358,14554372,0,0,0,15014
30656,14554478,14554478,14554698,0,0,0,220
30657,14554484,14554484,14554741,0,0,0,257
30635,14550856,14553429,14554853,0,0,2573,3997
30628,14550177,14551218,14555010,0,0,1041,4833
30645,14552804,14554372,14555306,0,0,1568,2502
30658,14555318,14555318,14555472,0,0,0,154
30660,14555588,14555588,14555658,0,0,0,70
30661,14555673,14555673,14555712,0,0,0,39
30662,14555732,14555732,14555749,0,0,0,17
30663,14555777,14555777,14555885,0,0,0,108
30667,14556000,14556000,14556024,0,0,0,24
30666,14555976,14555976,14556058,0,0,0,82
30669,14556108,14556108,14556120,0,0,0,12
30668,14556018,14556018,14556144,0,0,0,126
30671,14556415,14556415,14556437,0,0,0,22
30630,14550251,14550685,14556460,0,0,434,6209
30621,14549884,14551815,14556508,0,0,1931,6624
30674,14556904,14556904,14556936,0,0,0,32
30654,14554450,14554450,14556977,0,0,0,2527
30675,14557067,14557067,14557100,0,0,0,33
30676,14557239,14557239,14557262,0,0,0,23
30677,14557368,14557368,14557402,0,0,0,34
30655,14554467,14554853,14558508,0,0,386,4041
30548,14542233,14549840,14558835,0,0,7607,16602
30536,14540175,14549840,14559009,0,0,9665,18834
30672,14556545,14556545,14559801,0,0,0,3256
30611,14548630,14550369,14560190,0,0,1739,11560
30569,14544694,14546832,14560613,0,0,2138,15919
30664,14555786,14556508,14562311,0,0,722,6525
30568,14544674,14562311,14562367,0,0,17637,17693
30673,14556758,14556977,14564036,0,0,219,7278
30680,14563630,14564036,14564177,0,0,406,547
30681,14564169,14564177,14564387,0,0,8,218
30665,14555891,14558508,14564595,0,0,2617,8704
30682,14564693,14564693,14565361,0,0,0,668
30684,14565827,14565827,14565865,0,0,0,38
30685,14566078,14566078,14566652,0,0,0,574
30659,14555329,14555329,14567075,0,0,0,11746
30687,14566983,14566983,14567278,0,0,0,295
30686,14566717,14566717,14567565,0,0,0,848
30688,14567854,14567854,14568194,0,0,0,340
30689,14568927,14568927,14569291,0,0,0,364
30690,14569122,14569291,14569434,0,0,169,312
30679,14563499,14563499,14569839,0,0,0,6340
30691,14569365,14569434,14572766,0,0,69,3401
30670,14556165,14556165,14581057,0,0,0,24892
30678,14559232,14559232,14581059,0,0,0,21827
30683,14565204,14565204,14581063,0,0,0,15859
30692,14569473,14569839,14581481,0,0,366,12008
30693,14569947,14572766,14583879,0,0,2819,13932
30604,14547937,14562367,14587003,0,0,14430,39066
30695,14590867,14590867,14590896,0,0,0,29
30696,14591090,14591090,14591105,0,0,0,15
30697,14591274,14591274,14591288,0,0,0,14
30698,14591324,14591324,14591340,0,0,0,16
30699,14591892,14591892,14591909,0,0,0,17
30700,14592544,14592544,14592558,0,0,0,14
30701,14595262,14595262,14595276,0,0,0,14
30702,14595935,14595935,14595948,0,0,0,13
30703,14595953,14595953,14595962,0,0,0,9
30704,14595968,14595968,14595980,0,0,0,12
30705,14596056,14596056,14596065,0,0,0,9
30706,14596435,14596435,14596447,0,0,0,12
30707,14596453,14596453,14596462,0,0,0,9
30708,14596468,14596468,14596478,0,0,0,10
30709,14596552,14596552,14596561,0,0,0,9
30710,14596569,14596569,14596578,0,0,0,9
30711,14596584,14596584,14596598,0,0,0,14
30712,14596601,14596601,14596615,0,0,0,14
30694,14570968,14583879,14600735,0,0,12911,29767
30714,14601165,14601165,14601224,0,0,0,59
30715,14601224,14601224,14601285,0,0,0,61
30716,14601349,14601349,14601405,0,0,0,56
30717,14601349,14601349,14601406,0,0,0,57
30718,14601708,14601708,14601764,0,0,0,56
30719,14601708,14601708,14601765,0,0,0,57
30722,14601847,14601847,14601912,0,0,0,65
30720,14601789,14601789,14601970,0,0,0,181
30721,14601789,14601789,14601970,0,0,0,181
30723,14601910,14601910,14601970,0,0,0,60
30724,14601967,14601967,14602090,0,0,0,123
30727,14602087,14602087,14602153,0,0,0,66
30725,14601969,14601969,14602213,0,0,0,244
30726,14601970,14601970,14602213,0,0,0,243
30728,14602148,14602148,14602213,0,0,0,65
30729,14602207,14602207,14602269,0,0,0,62
30732,14602267,14602267,14602335,0,0,0,68
30733,14602330,14602330,14602388,0,0,0,58
30730,14602212,14602212,14602389,0,0,0,177
30731,14602213,14602213,14602389,0,0,0,176
30736,14602449,14602449,14602507,0,0,0,58
30734,14602388,14602388,14602508,0,0,0,120
30737,14602507,14602507,14602569,0,0,0,62
30735,14602388,14602388,14602570,0,0,0,182
30738,14602569,14602569,14602629,0,0,0,60
30739,14602628,14602628,14602687,0,0,0,59
30740,14602750,14602750,14602934,0,0,0,184
30741,14602750,14602750,14602934,0,0,0,184
30744,14602933,14602933,14603056,0,0,0,123
30742,14602930,14602930,14603057,0,0,0,127
30745,14602933,14602933,14603110,0,0,0,177
30743,14602930,14602930,14603111,0,0,0,181
30747,14603056,14603056,14603231,0,0,0,175
30746,14603053,14603053,14603388,0,0,0,335
30748,14603110,14603110,14603388,0,0,0,278
30751,14603287,14603287,14603393,0,0,0,106
30752,14603287,14603287,14603394,0,0,0,107
30750,14603230,14603230,14605873,0,0,0,2643
30749,14603110,14603110,14605874,0,0,0,2764
30756,14606059,14606059,14606198,0,0,0,139
30754,14606004,14606004,14606322,0,0,0,318
30755,14606004,14606004,14606377,0,0,0,373
30758,14606196,14606196,14606377,0,0,0,181
30757,14606065,14606065,14606437,0,0,0,372
30760,14606376,14606376,14606562,0,0,0,186
30759,14606321,14606321,14606624,0,0,0,303
30763,14606556,14606556,14606677,0,0,0,121
30761,14606376,14606376,14606678,0,0,0,302
30762,14606437,14606437,14606799,0,0,0,362
30765,14606676,14606676,14606870,0,0,0,194
30764,14606624,14606624,14606981,0,0,0,357
30766,14606677,14606677,14606981,0,0,0,304
30768,14606865,14606865,14607040,0,0,0,175
30771,14607037,14607037,14607157,0,0,0,120
30767,14606799,14606799,14607158,0,0,0,359
30769,14606980,14606980,14607247,0,0,0,267
30774,14607222,14607222,14607260,0,0,0,38
30770,14606980,14606980,14607306,0,0,0,326
30772,14607157,14607157,14607365,0,0,0,208
30777,14607364,14607364,14607495,0,0,0,131
30773,14607157,14607157,14607496,0,0,0,339
30775,14607247,14607247,14607596,0,0,0,349
30776,14607306,14607306,14607657,0,0,0,351
30778,14607495,14607495,14607657,0,0,0,162
30781,14607656,14607656,14607836,0,0,0,180
30779,14607495,14607495,14607896,0,0,0,401
30784,14607834,14607834,14607958,0,0,0,124
30780,14607596,14607596,14607959,0,0,0,363
30782,14607657,14607657,14608074,0,0,0,417
30786,14607957,14607957,14608137,0,0,0,180
30783,14607772,14607772,14608172,0,0,0,400
30785,14607896,14607896,14608259,0,0,0,363
30787,14607958,14607958,14608259,0,0,0,301
30789,14608132,14608132,14608283,0,0,0,151
30790,14608258,14608258,14608292,0,0,0,34
30788,14608074,14608074,14608389,0,0,0,315
30792,14608278,14608278,14608448,0,0,0,170
30791,14608259,14608259,14608573,0,0,0,314
30795,14608448,14608448,14608637,0,0,0,189
30793,14608291,14608291,14608658,0,0,0,367
30794,14608389,14608389,14608708,0,0,0,319
30797,14608636,14608636,14608835,0,0,0,199
30796,14608573,14608573,14608878,0,0,0,305
30801,14608827,14608827,14608999,0,0,0,172
30798,14608708,14608708,14609000,0,0,0,292
30799,14608708,14608708,14609000,0,0,0,292
30803,14608999,14608999,14609144,0,0,0,145
30802,14608877,14608877,14609203,0,0,0,326
30806,14609143,14609143,14609298,0,0,0,155
30804,14608999,14608999,14609324,0,0,0,325
30805,14608999,14608999,14609375,0,0,0,376
30809,14609298,14609298,14609484,0,0,0,186
30808,14609296,14609296,14609507,0,0,0,211
30807,14609202,14609202,14609564,0,0,0,362
30713,14598862,14598862,14609585,0,0,0,10723
30810,14609324,14609324,14609688,0,0,0,364
30813,14609482,14609482,14609698,0,0,0,216
30811,14609375,14609375,14609801,0,0,0,426
30816,14609696,14609696,14609832,0,0,0,136
30817,14609698,14609698,14609918,0,0,0,220
30814,14609564,14609564,14609995,0,0,0,431
30820,14609904,14609904,14610110,0,0,0,206
30815,14609688,14609688,14610111,0,0,0,423
30819,14609889,14609889,14610115,0,0,0,226
30818,14609801,14609801,14610279,0,0,0,478
30822,14610108,14610108,14610343,0,0,0,235
30821,14609995,14609995,14610344,0,0,0,349
30826,14610335,14610335,14610530,0,0,0,195
30823,14610110,14610110,14610531,0,0,0,421
30828,14610530,14610530,14610712,0,0,0,182
30824,14610279,14610279,14610713,0,0,0,434
30827,14610343,14610343,14610772,0,0,0,429
30830,14610710,14610710,14610847,0,0,0,137
30829,14610530,14610530,14610874,0,0,0,344
30833,14610848,14610848,14610890,0,0,0,42
30834,14610850,14610850,14611043,0,0,0,193
30831,14610712,14610712,14611044,0,0,0,332
30832,14610772,14610772,14611125,0,0,0,353
30839,14611126,14611126,14611183,0,0,0,57
30825,14610331,14610331,14611190,0,0,0,859
30836,14611041,14611041,14611275,0,0,0,234
30835,14610874,14610874,14611276,0,0,0,402
30844,14611393,14611393,14611470,0,0,0,77
30837,14611043,14611043,14611471,0,0,0,428
30838,14611125,14611125,14611471,0,0,0,346
30842,14611275,14611275,14611513,0,0,0,238
30843,14611275,14611275,14611601,0,0,0,326
30841,14611261,14611261,14611602,0,0,0,341
30848,14611513,14611513,14611738,0,0,0,225
30845,14611470,14611470,14611792,0,0,0,322
30851,14611601,14611601,14611866,0,0,0,265
30852,14611738,14611738,14611916,0,0,0,178
30853,14611791,14611792,14611916,0,0,1,125
30846,14611470,14611471,14611917,0,0,1,447
30812,14609403,14609403,14612073,0,0,0,2670
30856,14611915,14611916,14612078,0,0,1,163
30854,14611912,14611912,14612115,0,0,0,203
30850,14611583,14611917,14612125,0,0,334,542
30857,14612077,14612077,14612293,0,0,0,216
30859,14612104,14612104,14612369,0,0,0,265
30860,14612171,14612171,14612387,0,0,0,216
30862,14612318,14612369,14612599,0,0,51,281
30863,14612366,14612387,14612704,0,0,21,338
30800,14608745,14608745,14612749,0,0,0,4004
30865,14612548,14612704,14612958,0,0,156,410
30864,14612526,14612599,14612975,0,0,73,449
30858,14612097,14612749,14613021,0,0,652,924
30847,14611507,14611507,14613027,0,0,0,1520
30867,14612753,14613021,14613071,0,0,268,318
30855,14611912,14612125,14613074,0,0,213,1162
30866,14612681,14612958,14613135,0,0,277,454
30869,14612802,14612975,14613208,0,0,173,406
30873,14613034,14613135,14613321,0,0,101,287
30870,14612855,14613027,14613344,0,0,172,489
30875,14613172,14613208,14613359,0,0,36,187
30871,14612859,14613071,14613403,0,0,212,544
30861,14612291,14612293,14614076,0,0,2,1785
30876,14613220,14613321,14614078,0,0,101,858
30880,14614340,14614340,14614752,0,0,0,412
30753,14605633,14605633,14615216,0,0,0,9583
30879,14614053,14615216,14619006,0,0,1163,4953
30884,14615738,14619006,14619020,0,0,3268,3282
30889,14620317,14620317,14620348,0,0,0,31
30890,14621304,14621304,14621408,0,0,0,104
30840,14611171,14611171,14621784,0,0,0,10613
30878,14613677,14613677,14621814,0,0,0,8137
30868,14612778,14621784,14621903,0,0,9006,9125
30849,14611581,14611602,14621971,0,0,21,10390
30877,14613323,14613344,14622068,0,0,21,8745
30881,14615048,14615048,14622103,0,0,0,7055
30882,14615257,14615257,14622103,0,0,0,6846
30892,14622080,14622080,14622104,0,0,0,24
30894,14622112,14622112,14622136,0,0,0,24
30874,14613054,14613403,14622141,0,0,349,9087
30872,14612861,14613074,14622184,0,0,213,9323
30896,14622168,14622168,14622188,0,0,0,20
30897,14622199,14622199,14622231,0,0,0,32
30891,14622046,14622046,14622276,0,0,0,230
30901,14623032,14623032,14623203,0,0,0,171
30903,14623186,14623203,14623230,0,0,17,44
30895,14622155,14622155,14623510,0,0,0,1355
30893,14622086,14622103,14623515,0,0,17,1429
30902,14623112,14623112,14623622,0,0,0,510
30906,14623446,14623446,14623656,0,0,0,210
30904,14623278,14623278,14624071,0,0,0,793
30909,14623530,14623656,14624269,0,0,126,739
30887,14618874,14621903,14624926,0,0,3029,6052
30914,14624697,14624926,14624980,0,0,229,283
30913,14624327,14624926,14624985,0,0,599,658
30915,14624960,14624960,14624988,0,0,0,28
30900,14622901,14622901,14625117,0,0,0,2216
30916,14625199,14625199,14625227,0,0,0,28
30886,14618533,14621903,14625239,0,0,3370,6706
30918,14625343,14625343,14625369,0,0,0,26
30905,14623312,14623312,14625630,0,0,0,2318
30885,14618084,14621814,14625631,0,0,3730,7547
30921,14625613,14625613,14625638,0,0,0,25
30911,14623850,14624269,14625648,0,0,419,1798
30917,14625270,14625270,14625761,0,0,0,491
30883,14615298,14619006,14625810,0,0,3708,10512
30923,14625867,14625867,14625890,0,0,0,23
30924,14626057,14626057,14626079,0,0,0,22
30922,14625835,14625835,14626091,0,0,0,256
30899,14622607,14625648,14626106,0,0,3041,3499
30926,14626243,14626243,14626276,0,0,0,33
30927,14626249,14626276,14626338,0,0,27,89
30919,14625393,14625393,14626430,0,0,0,1037
30929,14626477,14626477,14626514,0,0,0,37
30928,14626465,14626465,14626611,0,0,0,146
30898,14622498,14622498,14626731,0,0,0,4233
30932,14626741,14626741,14626774,0,0,0,33
30933,14626913,14626913,14626925,0,0,0,12
30934,14626966,14626966,14626996,0,0,0,30
30935,14626989,14626996,14627028,0,0,7,39
30937,14627094,14627094,14627126,0,0,0,32
30939,14627160,14627160,14627199,0,0,0,39
30936,14627013,14627028,14627230,0,0,15,217
30940,14627229,14627229,14627252,0,0,0,23
30938,14627101,14627252,14627359,0,0,151,258
30941,14627328,14627359,14627392,0,0,31,64
30942,14627394,14627394,14627419,0,0,0,25
30930,14626509,14626514,14627456,0,0,5,947
30943,14627474,14627474,14627503,0,0,0,29
30946,14627535,14627535,14627567,0,0,0,32
30944,14627489,14627489,14627631,0,0,0,142
30945,14627505,14627505,14627815,0,0,0,310
30947,14627636,14627636,14628106,0,0,0,470
30949,14627964,14628106,14628174,0,0,142,210
30950,14628009,14628106,14628273,0,0,97,264
30952,14628159,14628273,14628314,0,0,114,155
30954,14628301,14628314,14628354,0,0,13,53
30957,14628786,14628786,14628831,0,0,0,45
30888,14620193,14621903,14628930,0,0,1710,8737
30907,14623472,14623515,14628966,0,0,43,5494
30953,14628289,14628966,14629079,0,0,677,790
30951,14628098,14628174,14629102,0,0,76,1004
30960,14628877,14629079,14629110,0,0,202,233
30962,14629041,14629079,14629116,0,0,38,75
30956,14628776,14628966,14629215,0,0,190,439
30963,14629098,14629102,14629524,0,0,4,426
30965,14629375,14629524,14629574,0,0,149,199
30958,14628801,14628831,14629625,0,0,30,824
30908,14623520,14623622,14629636,0,0,102,6116
30955,14628307,14629215,14629648,0,0,908,1341
30966,14629459,14629625,14629894,0,0,166,435
30968,14629639,14629894,14629930,0,0,255,291
30967,14629533,14629636,14629981,0,0,103,448
30920,14625430,14625430,14631397,0,0,0,5967
30971,14630004,14631397,14631431,0,0,1393,1427
30948,14627788,14627815,14631504,0,0,27,3716
30973,14630195,14631504,14631542,0,0,1309,1347
30974,14630271,14631542,14631560,0,0,1271,1289
30975,14630287,14631560,14631592,0,0,1273,1305
30972,14630172,14631431,14631848,0,0,1259,1676
30977,14630458,14631848,14631881,0,0,1390,1423
30978,14630509,14631881,14631915,0,0,1372,1406
30976,14630417,14631592,14631977,0,0,1175,1560
30981,14630722,14631977,14632009,0,0,1255,1287
30980,14630715,14631915,14632487,0,0,1200,1772
30983,14630892,14632487,14632531,0,0,1595,1639
30985,14631200,14632531,14632570,0,0,1331,1370
30987,14631324,14632570,14632874,0,0,1246,1550
30988,14631414,14632874,14632923,0,0,1460,1509
30989,14631518,14632923,14633004,0,0,1405,1486
30910,14623832,14626106,14633012,0,0,2274,9180
30990,14631608,14633004,14633040,0,0,1396,1432
30991,14631829,14633040,14633071,0,0,1211,1242
30992,14632000,14633071,14633106,0,0,1071,1106
30993,14632144,14633106,14633186,0,0,962,1042
30982,14630810,14632009,14633243,0,0,1199,2433
30994,14632407,14633186,14633680,0,0,779,1273
30996,14632609,14633680,14633751,0,0,1071,1142
30995,14632442,14633243,14634231,0,0,801,1789
30997,14632704,14633751,14634255,0,0,1047,1551
30998,14632782,14634231,14634264,0,0,1449,1482
30999,14632874,14634255,14634280,0,0,1381,1406
31000,14632996,14634264,14634301,0,0,1268,1305
31003,14633149,14634301,14634337,0,0,1152,1188
31004,14633258,14634337,14634358,0,0,1079,1100
31007,14633336,14634358,14634390,0,0,1022,1054
31008,14633451,14634390,14634446,0,0,939,995
31011,14633708,14634446,14634502,0,0,738,794
31013,14633904,14634502,14634529,0,0,598,625
31015,14633959,14634529,14634724,0,0,570,765
31017,14634189,14634724,14634755,0,0,535,566
31020,14634473,14634755,14634794,0,0,282,321
31022,14634595,14634794,14635087,0,0,199,492
31024,14634796,14635087,14635130,0,0,291,334
30925,14626077,14626091,14635612,0,0,14,9535
31025,14634806,14635130,14635870,0,0,324,1064
31028,14634982,14635870,14635904,0,0,888,922
30961,14628957,14629648,14643266,0,0,691,14309
30912,14624266,14633012,14646750,0,0,8746,22484
31002,14633094,14646750,14646807,0,0,13656,13713
31005,14633259,14646750,14646812,0,0,13491,13553
31009,14633510,14646812,14646872,0,0,13302,13362
31006,14633321,14646807,14646919,0,0,13486,13598
30959,14628814,14646750,14646994,0,0,17936,18180
31012,14633801,14646919,14647035,0,0,13118,13234
31010,14633570,14646872,14647045,0,0,13302,13475
31014,14633916,14646994,14647062,0,0,13078,13146
31018,14634226,14646994,14647067,0,0,12768,12841
31021,14634487,14647035,14647133,0,0,12548,12646
31029,14634984,14647067,14647143,0,0,12083,12159
31031,14635035,14647133,14647154,0,0,12098,12119
31016,14634056,14646994,14647165,0,0,12938,13109
31023,14634667,14647045,14647186,0,0,12378,12519
31019,14634298,14646994,14647190,0,0,12696,12892
31036,14635187,14647165,14647198,0,0,11978,12011
31026,14634808,14647062,14647238,0,0,12254,12430
31041,14635392,14647198,14647244,0,0,11806,11852
31038,14635248,14647190,14647249,0,0,11942,12001
31032,14635060,14647143,14647263,0,0,12083,12203
31040,14635306,14647238,14647384,0,0,11932,12078
31042,14635414,14647249,14647433,0,0,11835,12019
31034,14635158,14647154,14647718,0,0,11996,12560
31035,14635178,14647165,14647718,0,0,11987,12540
31049,14635938,14647718,14647775,0,0,11780,11837
31048,14635743,14647718,14647778,0,0,11975,12035
31050,14635997,14647775,14647823,0,0,11778,11826
31033,14635134,14647154,14647860,0,0,12020,12726
31052,14636249,14647823,14647884,0,0,11574,11635
31054,14636455,14647860,14647916,0,0,11405,11461
31058,14636667,14647916,14647979,0,0,11249,11312
31059,14636852,14647979,14648072,0,0,11127,11220
30931,14626719,14628930,14648199,0,0,2211,21480
31051,14636042,14647778,14648546,0,0,11736,12504
31046,14635520,14647384,14648780,0,0,11864,13260
30969,14629726,14643266,14648802,0,0,13540,19076
30964,14629288,14629981,14648829,0,0,693,19541
31061,14637476,14648802,14648904,0,0,11326,11428
31064,14637731,14648780,14648949,0,0,11049,11218
31062,14637578,14648829,14648984,0,0,11251,11406
31065,14637783,14648904,14649024,0,0,11121,11241
31066,14637903,14648984,14649164,0,0,11081,11261
31030,14635007,14635904,14649219,0,0,897,14212
31067,14638082,14649024,14649235,0,0,10942,11153
31071,14640967,14649235,14649290,0,0,8268,8323
31073,14642631,14649219,14649293,0,0,6588,6662
31001,14633011,14634280,14649647,0,0,1269,16636
30979,14630704,14646750,14650387,0,0,16046,19683
31027,14634880,14650387,14650770,0,0,15507,15890
31070,14640207,14649164,14651281,0,0,8957,11074
31072,14642343,14649235,14651283,0,0,6892,8940
31053,14636296,14650770,14651662,0,0,14474,15366
31068,14638697,14651662,14651849,0,0,12965,13152
30984,14631123,14635612,14652750,0,0,4489,21627
31075,14652251,14652251,14652864,0,0,0,613
31057,14636626,14648199,14653609,0,0,11573,16983
31074,14650472,14651281,14653816,0,0,809,3344
31077,14654493,14654493,14654570,0,0,0,77
31078,14654524,14654570,14654616,0,0,46,92
31079,14654800,14654800,14655438,0,0,0,638
31076,14654455,14654455,14655555,0,0,0,1100
31081,14655559,14655559,14655809,0,0,0,250
31082,14655807,14655809,14656079,0,0,2,272
31083,14656122,14656122,14656203,0,0,0,81
30970,14629768,14653609,14656569,0,0,23841,26801
30986,14631257,14656569,14657149,0,0,25312,25892
31039,14635305,14657149,14657651,0,0,21844,22346
31080,14655050,14655438,14658460,0,0,388,3410
31087,14658528,14658528,14658559,0,0,0,31
31060,14637408,14648072,14658988,0,0,10664,21580
31063,14637645,14648546,14659224,0,0,10901,21579
31056,14636507,14647884,14659700,0,0,11377,23193
31085,14656548,14658460,14660019,0,0,1912,3471
31044,14635507,14647263,14660020,0,0,11756,24513
31047,14635598,14647433,14660100,0,0,11835,24502
31043,14635452,14647244,14660175,0,0,11792,24723
31045,14635507,14647384,14660203,0,0,11877,24696
31037,14635195,14647186,14660251,0,0,11991,25056
31088,14658831,14660175,14663587,0,0,1344,4756
31084,14656257,14656257,14666115,0,0,0,9858
31086,14656768,14658988,14668963,0,0,2220,12195
31069,14638861,14648949,14674060,0,0,10088,35199
31055,14636472,14657651,14682488,0,0,21179,46016
31089,14686139,14686139,14686536,0,0,0,397
31090,14688203,14688203,14688326,0,0,0,123
31092,14697349,14697349,14697821,0,0,0,472
31094,14699707,14699707,14699897,0,0,0,190
31095,14699984,14699984,14700421,0,0,0,437
31096,14700832,14700832,14705050,0,0,0,4218
31098,14706601,14706601,14706655,0,0,0,54
31099,14707663,14707663,14707690,0,0,0,27
31101,14707807,14707807,14707865,0,0,0,58
31102,14707851,14707851,14707879,0,0,0,28
31103,14707959,14707959,14708008,0,0,0,49
31104,14708075,14708075,14708179,0,0,0,104
31106,14708145,14708145,14708196,0,0,0,51
31107,14708221,14708221,14708251,0,0,0,30
31108,14708339,14708339,14708369,0,0,0,30
31110,14709428,14709428,14709480,0,0,0,52
31100,14707687,14707687,14709639,0,0,0,1952
31111,14709714,14709714,14709796,0,0,0,82
31112,14709796,14709796,14709916,0,0,0,120
31117,14710016,14710016,14710065,0,0,0,49
31118,14710016,14710016,14710275,0,0,0,259
31093,14698518,14698518,14710372,0,0,0,11854
31123,14713459,14713459,14713563,0,0,0,104
31109,14709372,14709372,14714919,0,0,0,5547
31124,14715457,14715457,14715554,0,0,0,97
31125,14715482,14715554,14715596,0,0,72,114
31122,14711128,14711128,14718465,0,0,0,7337
31091,14694690,14694690,14720613,0,0,0,25923
31097,14705076,14705076,14721430,0,0,0,16354
31126,14715652,14715652,14723875,0,0,0,8223
31120,14710065,14710065,14723932,0,0,0,13867
31119,14710052,14710052,14723979,0,0,0,13927
31116,14709943,14709943,14723991,0,0,0,14048
31114,14709895,14709895,14723994,0,0,0,14099
31115,14709895,14709895,14723995,0,0,0,14100
31121,14710347,14710347,14724085,0,0,0,13738
31105,14708121,14708121,14724090,0,0,0,15969
31113,14709836,14709836,14724092,0,0,0,14256
31129,14724214,14724214,14724326,0,0,0,112
31128,14724212,14724212,14724333,0,0,0,121
31131,14724325,14724325,14724376,0,0,0,51
31132,14724376,14724376,14724439,0,0,0,63
31130,14724248,14724248,14724440,0,0,0,192
31133,14724439,14724439,14724556,0,0,0,117
31135,14724555,14724555,14724616,0,0,0,61
31136,14724676,14724676,14724802,0,0,0,126
31137,14724820,14724820,14724892,0,0,0,72
31139,14724947,14724947,14724964,0,0,0,17
31138,14724892,14724892,14725044,0,0,0,152
31141,14725066,14725066,14725084,0,0,0,18
31140,14725043,14725043,14725127,0,0,0,84
31142,14725126,14725126,14725246,0,0,0,120
31143,14725246,14725246,14725330,0,0,0,84
31144,14725330,14725330,14725450,0,0,0,120
31145,14725433,14725433,14725549,0,0,0,116
31127,14722126,14722126,14725807,0,0,0,3681
31147,14725649,14725649,14725854,0,0,0,205
31146,14725623,14725623,14726149,0,0,0,526
31149,14726783,14726783,14726796,0,0,0,13
31150,14726814,14726814,14726828,0,0,0,14
31151,14726894,14726894,14726910,0,0,0,16
31152,14726941,14726941,14726951,0,0,0,10
31153,14726949,14726949,14726959,0,0,0,10
31154,14726957,14726957,14726968,0,0,0,11
31157,14727897,14727897,14727922,0,0,0,25
31160,14728090,14728090,14728335,0,0,0,245
31164,14728361,14728361,14728376,0,0,0,15
31163,14728334,14728334,14728499,0,0,0,165
31158,14728048,14728048,14728546,0,0,0,498
31165,14728542,14728542,14728726,0,0,0,184
31166,14728723,14728723,14728841,0,0,0,118
31167,14728885,14728885,14728979,0,0,0,94
31134,14724439,14724439,14729175,0,0,0,4736
31168,14728979,14728979,14729175,0,0,0,196
31170,14729198,14729198,14729366,0,0,0,168
31169,14729174,14729174,14729367,0,0,0,193
31172,14729366,14729366,14730009,0,0,0,643
31174,14730009,14730009,14730484,0,0,0,475
31155,14727706,14727706,14730570,0,0,0,2864
31162,14728281,14728281,14731312,0,0,0,3031
31171,14729234,14729234,14731691,0,0,0,2457
31176,14731780,14731780,14731889,0,0,0,109
31148,14726289,14726289,14731923,0,0,0,5634
31177,14731860,14731860,14731954,0,0,0,94
31159,14728076,14728076,14732416,0,0,0,4340
31156,14727751,14727751,14733122,0,0,0,5371
31178,14733155,14733155,14733168,0,0,0,13
31179,14733652,14733652,14733663,0,0,0,11
31180,14733669,14733669,14733676,0,0,0,7
31181,14733681,14733681,14733689,0,0,0,8
31182,14733694,14733694,14733707,0,0,0,13
31175,14730483,14730483,14734838,0,0,0,4355
31183,14734920,14734920,14735085,0,0,0,165
31184,14735084,14735084,14735214,0,0,0,130
31185,14735235,14735235,14735501,0,0,0,266
31187,14735499,14735499,14735709,0,0,0,210
31188,14735708,14735708,14735863,0,0,0,155
31186,14735406,14735406,14735993,0,0,0,587
31189,14735863,14735863,14736169,0,0,0,306
31190,14736169,14736169,14736321,0,0,0,152
31191,14736320,14736320,14736474,0,0,0,154
31192,14736474,14736474,14736625,0,0,0,151
31193,14736624,14736624,14736780,0,0,0,156
31194,14736780,14736780,14736975,0,0,0,195
31195,14736974,14736974,14737127,0,0,0,153
31196,14737187,14737187,14737391,0,0,0,204
31197,14737391,14737391,14737601,0,0,0,210
31198,14737662,14737662,14737755,0,0,0,93
31199,14737754,14737754,14737837,0,0,0,83
31202,14744408,14744408,14744453,0,0,0,45
31204,14745531,14745531,14745542,0,0,0,11
31203,14745362,14745362,14745811,0,0,0,449
31205,14746776,14746776,14747128,0,0,0,352
31206,14747693,14747693,14747723,0,0,0,30
31207,14747751,14747751,14747784,0,0,0,33
31208,14748020,14748020,14748033,0,0,0,13
31209,14748053,14748053,14748516,0,0,0,463
31200,14741469,14741469,14748947,0,0,0,7478
31210,14749338,14749338,14749372,0,0,0,34
31211,14749436,14749436,14749462,0,0,0,26
31212,14749640,14749640,14749650,0,0,0,10
31214,14749851,14749851,14749892,0,0,0,41
31215,14749908,14749908,14750556,0,0,0,648
31213,14749706,14749706,14750617,0,0,0,911
31216,14751204,14751204,14751488,0,0,0,284
31217,14751467,14751467,14751595,0,0,0,128
31218,14752450,14752450,14752843,0,0,0,393
31219,14753895,14753895,14754311,0,0,0,416
31220,14753945,14753945,14754568,0,0,0,623
31221,14753964,14753964,14754773,0,0,0,809
31201,14742135,14742135,14765420,0,0,0,23285
31222,14765661,14765661,14765692,0,0,0,31
31223,14774596,14774596,14774998,0,0,0,402
31224,14775740,14775740,14776269,0,0,0,529
31226,14776872,14776872,14776883,0,0,0,11
31227,14777109,14777109,14777156,0,0,0,47
31225,14776533,14776533,14778212,0,0,0,1679
31228,14779109,14779109,14779120,0,0,0,11
31231,14779923,14779923,14780079,0,0,0,156
31232,14780186,14780186,14781897,0,0,0,1711
31161,14728274,14728274,14782098,0,0,0,53824
31173,14729366,14729366,14782100,0,0,0,52734
31236,14782119,14782119,14782196,0,0,0,77
31239,14782758,14782758,14782883,0,0,0,125
31237,14782510,14782510,14782940,0,0,0,430
31233,14780617,14780617,14783195,0,0,0,2578
31229,14779182,14779182,14783648,0,0,0,4466
31238,14782516,14783195,14784748,0,0,679,2232
31244,14783420,14783648,14785191,0,0,228,1771
31248,14784386,14785191,14785255,0,0,805,869
31251,14784594,14785255,14785302,0,0,661,708
31253,14784823,14785302,14785371,0,0,479,548
31241,14783105,14783105,14785880,0,0,0,2775
31256,14785023,14785371,14786109,0,0,348,1086
31272,14786421,14786421,14786476,0,0,0,55
31264,14785689,14785880,14787032,0,0,191,1343
31278,14786818,14787032,14787124,0,0,214,306
31281,14787030,14787124,14787208,0,0,94,178
31246,14783952,14785191,14788256,0,0,1239,4304
31242,14783166,14783648,14788322,0,0,482,5156
31287,14787380,14788256,14788377,0,0,876,997
31291,14787640,14788377,14788488,0,0,737,848
31293,14787805,14788488,14788865,0,0,683,1060
31234,14780958,14780958,14789699,0,0,0,8741
31276,14786739,14786739,14789711,0,0,0,2972
31247,14784350,14789699,14789737,0,0,5349,5387
31298,14788132,14788865,14789774,0,0,733,1642
31300,14788321,14789711,14789845,0,0,1390,1524
31249,14784388,14789737,14789863,0,0,5349,5475
31250,14784574,14789863,14789888,0,0,5289,5314
31310,14789233,14789845,14789898,0,0,612,665
31304,14788700,14789774,14789909,0,0,1074,1209
31313,14789524,14789898,14789980,0,0,374,456
31319,14789927,14789980,14790060,0,0,53,133
31252,14784598,14789888,14790075,0,0,5290,5477
31254,14784825,14790075,14790146,0,0,5250,5321
31262,14785597,14788322,14790199,0,0,2725,4602
31255,14784896,14790146,14790275,0,0,5250,5379
31324,14790200,14790200,14790294,0,0,0,94
31257,14785095,14790275,14790339,0,0,5180,5244
31325,14790342,14790342,14790387,0,0,0,45
31243,14783239,14784748,14790392,0,0,1509,7153
31258,14785159,14790339,14790456,0,0,5180,5297
31283,14787136,14787208,14790460,0,0,72,3324
31259,14785276,14790392,14790471,0,0,5116,5195
31327,14790428,14790428,14790479,0,0,0,51
31261,14785507,14790471,14790563,0,0,4964,5056
31260,14785354,14790456,14790576,0,0,5102,5222
31265,14785762,14790576,14790618,0,0,4814,4856
31331,14790584,14790584,14790628,0,0,0,44
31330,14790579,14790579,14790631,0,0,0,52
31263,14785598,14790563,14790656,0,0,4965,5058
31334,14790657,14790657,14790694,0,0,0,37
31266,14785803,14790618,14790757,0,0,4815,4954
31268,14786000,14790757,14790818,0,0,4757,4818
31337,14790773,14790773,14790822,0,0,0,49
31338,14790782,14790822,14790906,0,0,40,124
31340,14790920,14790920,14790928,0,0,0,8
31269,14786060,14790818,14790943,0,0,4758,4883
31341,14790948,14790948,14790992,0,0,0,44
31270,14786185,14790943,14791058,0,0,4758,4873
31333,14790644,14790644,14791094,0,0,0,450
31271,14786300,14791058,14791180,0,0,4758,4880
31267,14785838,14790656,14791214,0,0,4818,5376
31273,14786479,14791180,14791241,0,0,4701,4762
31274,14786540,14791214,14791332,0,0,4674,4792
31275,14786719,14791241,14791336,0,0,4522,4617
31277,14786812,14791332,14791365,0,0,4520,4553
31279,14786901,14791336,14791384,0,0,4435,4483
31282,14787102,14791384,14791433,0,0,4282,4331
31280,14786948,14791365,14791521,0,0,4417,4573
31284,14787151,14791433,14791552,0,0,4282,4401
31285,14787319,14791521,14791586,0,0,4202,4267
31286,14787348,14791552,14791589,0,0,4204,4241
31289,14787567,14791589,14791635,0,0,4022,4068
31288,14787381,14791586,14791702,0,0,4205,4321
31230,14779887,14779887,14791718,0,0,0,11831
31345,14791257,14791718,14791769,0,0,461,512
31290,14787612,14791635,14791770,0,0,4023,4158
31292,14787759,14791702,14791783,0,0,3943,4024
31296,14788026,14791783,14791851,0,0,3757,3825
31294,14787841,14791770,14791896,0,0,3929,4055
31348,14791585,14791769,14791953,0,0,184,368
31297,14788094,14791851,14791962,0,0,3757,3868
31299,14788240,14791896,14791989,0,0,3656,3749
31301,14788332,14791962,14792088,0,0,3630,3756
31302,14788517,14791989,14792110,0,0,3472,3593
31303,14788638,14792088,14792149,0,0,3450,3511
31305,14788774,14792110,14792174,0,0,3336,3400
31306,14788838,14792149,14792238,0,0,3311,3400
31307,14788964,14792174,14792253,0,0,3210,3289
31308,14789043,14792238,14792400,0,0,3195,3357
31295,14787894,14790199,14792446,0,0,2305,4552
31311,14789235,14792400,14792534,0,0,3165,3299
31312,14789410,14792534,14792649,0,0,3124,3239
31314,14789525,14792649,14792734,0,0,3124,3209
31356,14792320,14792446,14792768,0,0,126,448
31315,14789671,14792734,14792811,0,0,3063,3140
31358,14792452,14792768,14792913,0,0,316,461
31316,14789748,14792811,14792931,0,0,3063,3183
31362,14792834,14792834,14792937,0,0,0,103
31317,14789868,14792931,14793001,0,0,3063,3133
31353,14792059,14792059,14793030,0,0,0,971
31363,14792896,14792913,14793078,0,0,17,182
31320,14789938,14793001,14793158,0,0,3063,3220
31366,14793058,14793058,14793645,0,0,0,587
31318,14789912,14789912,14793673,0,0,0,3761
31245,14783799,14783799,14793701,0,0,0,9902
31322,14790095,14793701,14793800,0,0,3606,3705
31235,14781432,14782098,14793935,0,0,666,12503
31323,14790193,14793800,14793953,0,0,3607,3760
31328,14790474,14793935,14794030,0,0,3461,3556
31332,14790599,14793935,14794041,0,0,3336,3442
31326,14790361,14793935,14794049,0,0,3574,3688
31336,14790725,14793953,14794097,0,0,3228,3372
31342,14790995,14794041,14794101,0,0,3046,3106
31339,14790907,14794030,14794119,0,0,3123,3212
31346,14791422,14794101,14794166,0,0,2679,2744
31343,14791097,14794049,14794171,0,0,2952,3074
31347,14791487,14794119,14794175,0,0,2632,2688
31349,14791588,14794166,14794237,0,0,2578,2649
31344,14791219,14794097,14794240,0,0,2878,3021
31351,14791834,14794175,14794263,0,0,2341,2429
31354,14792131,14794240,14794319,0,0,2109,2188
31350,14791658,14794171,14794347,0,0,2513,2689
31352,14791922,14794237,14794375,0,0,2315,2453
31355,14792210,14794263,14794387,0,0,2053,2177
31357,14792395,14794319,14794395,0,0,1924,2000
31364,14792942,14794395,14794493,0,0,1453,1551
31360,14792646,14794375,14794507,0,0,1729,1861
31361,14792777,14794387,14794507,0,0,1610,1730
31359,14792464,14794347,14794529,0,0,1883,2065
31369,14793542,14794507,14794617,0,0,965,1075
31365,14793040,14794493,14794636,0,0,1453,1596
31370,14793633,14794529,14794696,0,0,896,1063
31372,14793830,14794636,14794760,0,0,806,930
31371,14793755,14794617,14794885,0,0,862,1130
31376,14793954,14794760,14794893,0,0,806,939
31378,14794149,14794893,14794996,0,0,744,847
31379,14794249,14794996,14795174,0,0,747,925
31373,14793835,14794617,14795223,0,0,782,1388
31377,14794014,14794696,14795242,0,0,682,1228
31384,14795088,14795223,14795310,0,0,135,222
31381,14794691,14794885,14795441,0,0,194,750
31386,14795468,14795468,14795530,0,0,0,62
31389,14796559,14796559,14796658,0,0,0,99
31375,14793910,14794696,14796779,0,0,786,2869
31391,14796977,14796977,14797010,0,0,0,33
31388,14796129,14796129,14797108,0,0,0,979
31393,14797168,14797168,14797230,0,0,0,62
31382,14794981,14795174,14797332,0,0,193,2351
31385,14795135,14795242,14797370,0,0,107,2235
31392,14796983,14796983,14797662,0,0,0,679
31396,14797918,14797918,14798068,0,0,0,150
31367,14793182,14794507,14798444,0,0,1325,5262
31394,14797443,14797443,14798452,0,0,0,1009
31395,14797700,14797700,14798648,0,0,0,948
31335,14790693,14791094,14798962,0,0,401,8269
31403,14798904,14798962,14798993,0,0,58,89
31383,14795022,14795174,14799222,0,0,152,4200
31401,14798574,14798648,14799232,0,0,74,658
31387,14795990,14798452,14799279,0,0,2462,3289
31399,14798271,14798271,14799540,0,0,0,1269
31390,14796613,14799279,14800144,0,0,2666,3531
31406,14800123,14800123,14800206,0,0,0,83
31400,14798323,14800144,14800251,0,0,1821,1928
31404,14799910,14800251,14801100,0,0,341,1190
31405,14800044,14801100,14801209,0,0,1056,1165
31407,14800876,14801209,14801462,0,0,333,586
31374,14793872,14794617,14802091,0,0,745,8219
31402,14798878,14798962,14802127,0,0,84,3249
31397,14797932,14797932,14802620,0,0,0,4688
31410,14802946,14802946,14802974,0,0,0,28
31409,14802584,14802584,14803284,0,0,0,700
31411,14803422,14803422,14803456,0,0,0,34
31412,14803464,14803464,14803498,0,0,0,34
31413,14803637,14803637,14803667,0,0,0,30
31415,14803964,14803964,14803995,0,0,0,31
31418,14804180,14804180,14804210,0,0,0,30
31309,14789096,14792253,14804545,0,0,3157,15449
31420,14804560,14804560,14804593,0,0,0,33
31419,14804250,14804250,14804766,0,0,0,516
31421,14805022,14805022,14805050,0,0,0,28
31329,14790568,14793935,14805365,0,0,3367,14797
31321,14789967,14793158,14805426,0,0,3191,15459
31240,14782854,14782854,14806018,0,0,0,23164
31423,14806561,14806561,14806872,0,0,0,311
31426,14807278,14807278,14807305,0,0,0,27
31408,14801395,14801395,14808000,0,0,0,6605
31424,14806587,14806587,14808027,0,0,0,1440
31429,14808161,14808161,14808430,0,0,0,269
31428,14807894,14807894,14808830,0,0,0,936
31431,14809019,14809019,14809061,0,0,0,42
31432,14809096,14809096,14809370,0,0,0,274
31433,14809215,14809215,14809840,0,0,0,625
31437,14809617,14809840,14809884,0,0,223,267
31439,14809742,14809884,14809958,0,0,142,216
31414,14803649,14803649,14810838,0,0,0,7189
31442,14809999,14809999,14811155,0,0,0,1156
31430,14808282,14808430,14811629,0,0,148,3347
31422,14805466,14805466,14812092,0,0,0,6626
31445,14810403,14811629,14812353,0,0,1226,1950
31447,14811468,14812353,14812607,0,0,885,1139
31434,14809235,14809370,14812834,0,0,135,3599
31449,14812191,14812834,14812855,0,0,643,664
31416,14804145,14804145,14813043,0,0,0,8898
31436,14809523,14813043,14813127,0,0,3520,3604
31438,14809703,14813127,14813866,0,0,3424,4163
31448,14811975,14812607,14814594,0,0,632,2619
31417,14804151,14804151,14814673,0,0,0,10522
31443,14810021,14814673,14814783,0,0,4652,4762
31450,14812263,14812855,14815307,0,0,592,3044
31458,14815992,14815992,14816005,0,0,0,13
31453,14812886,14814783,14816270,0,0,1897,3384
31440,14809841,14813866,14816319,0,0,4025,6478
31456,14814368,14816270,14816379,0,0,1902,2011
31459,14816086,14816086,14816387,0,0,0,301
31462,14816333,14816379,14816390,0,0,46,57
31464,14816600,14816600,14816613,0,0,0,13
31427,14807370,14808000,14817029,0,0,630,9659
31435,14809394,14810838,14817229,0,0,1444,7835
31446,14811231,14812092,14817383,0,0,861,6152
31452,14812681,14817229,14817638,0,0,4548,4957
31465,14817648,14817648,14817697,0,0,0,49
31380,14794495,14805426,14817939,0,0,10931,23444
31457,14815775,14816319,14818217,0,0,544,2442
31398,14798189,14817939,14818427,0,0,19750,20238
31463,14816557,14816557,14818655,0,0,0,2098
31425,14806967,14818427,14818936,0,0,11460,11969
31466,14820551,14820551,14821020,0,0,0,469
31467,14821219,14821219,14821346,0,0,0,127
31468,14822398,14822398,14822827,0,0,0,429
31471,14823246,14823246,14823260,0,0,0,14
31469,14822913,14822913,14823355,0,0,0,442
31441,14809997,14817029,14823800,0,0,7032,13803
31444,14810257,14811155,14824264,0,0,898,14007
31461,14816236,14817638,14824455,0,0,1402,8219
31454,14813063,14824455,14824928,0,0,11392,11865
31460,14816128,14824928,14825059,0,0,8800,8931
31474,14824475,14825059,14825075,0,0,584,600
31472,14823471,14823471,14827079,0,0,0,3608
31473,14823751,14823800,14830003,0,0,49,6252
31470,14823192,14823192,14833725,0,0,0,10533
31475,14836223,14836223,14836476,0,0,0,253
31451,14812541,14818936,14843922,0,0,6395,31381
31455,14813744,14843922,14844015,0,0,30178,30271
31476,14837249,14837249,14860069,0,0,0,22820
31477,14862568,14862568,14872995,0,0,0,10427
31479,14874626,14874626,14879024,0,0,0,4398
31368,14793251,14793251,14879977,0,0,0,86726
31480,14879946,14879946,14879980,0,0,0,34
31478,14870926,14870926,14880824,0,0,0,9898
31482,14883817,14883817,14883852,0,0,0,35
31483,14883856,14883856,14883885,0,0,0,29
31484,14883890,14883890,14883919,0,0,0,29
31485,14883923,14883923,14883953,0,0,0,30
31486,14883957,14883957,14883986,0,0,0,29
31487,14883994,14883994,14884022,0,0,0,28
31488,14884027,14884027,14884057,0,0,0,30
31489,14884062,14884062,14884093,0,0,0,31
31490,14884096,14884096,14884125,0,0,0,29
31491,14884101,14884101,14884133,0,0,0,32
31492,14884132,14884132,14884162,0,0,0,30
31493,14884166,14884166,14884197,0,0,0,31
31494,14884197,14884197,14884230,0,0,0,33
31495,14884220,14884220,14884264,0,0,0,44
31496,14884261,14884261,14884294,0,0,0,33
31497,14884297,14884297,14884326,0,0,0,29
31498,14884302,14884302,14884335,0,0,0,33
31499,14884334,14884334,14884360,0,0,0,26
31500,14884369,14884369,14884400,0,0,0,31
31501,14884430,14884430,14884460,0,0,0,30
31502,14884465,14884465,14884494,0,0,0,29
31503,14884470,14884470,14884500,0,0,0,30
31504,14884501,14884501,14884533,0,0,0,32
31505,14884533,14884533,14884564,0,0,0,31
31506,14884567,14884567,14884597,0,0,0,30
31507,14884602,14884602,14884634,0,0,0,32
31508,14884638,14884638,14884669,0,0,0,31
31509,14884666,14884666,14884697,0,0,0,31
31510,14884702,14884702,14884732,0,0,0,30
31511,14884730,14884730,14884755,0,0,0,25
31512,14884766,14884766,14884796,0,0,0,30
31514,14884825,14884825,14884856,0,0,0,31
31515,14884830,14884830,14884862,0,0,0,32
31516,14884864,14884864,14884895,0,0,0,31
31517,14884898,14884898,14884929,0,0,0,31
31518,14884930,14884930,14884964,0,0,0,34
31519,14884964,14884964,14884993,0,0,0,29
31520,14884995,14884995,14885067,0,0,0,72
31513,14884773,14884773,14885360,0,0,0,587
31521,14885522,14885522,14885540,0,0,0,18
31481,14880928,14880928,14885927,0,0,0,4999
31522,14885663,14885663,14885943,0,0,0,280
31523,14887037,14887037,14887099,0,0,0,62
31524,14890394,14890394,14896805,0,0,0,6411
31525,14890577,14890577,14897698,0,0,0,7121
31530,14901170,14901170,14901662,0,0,0,492
31531,14901746,14901746,14901849,0,0,0,103
31532,14902147,14902147,14902281,0,0,0,134
31528,14899745,14899745,14902489,0,0,0,2744
31526,14897715,14897715,14904285,0,0,0,6570
31534,14904452,14904452,14904565,0,0,0,113
31535,14905162,14905162,14905312,0,0,0,150
31527,14899577,14899577,14905367,0,0,0,5790
31536,14905260,14905260,14905594,0,0,0,334
31538,14905574,14905574,14905976,0,0,0,402
31537,14905398,14905398,14906978,0,0,0,1580
31540,14907128,14907128,14907586,0,0,0,458
31541,14908488,14908488,14908645,0,0,0,157
31543,14909166,14909166,14909190,0,0,0,24
31542,14909042,14909042,14909395,0,0,0,353
31533,14904389,14904389,14909671,0,0,0,5282
31544,14909366,14909366,14909796,0,0,0,430
31529,14900900,14900900,14910110,0,0,0,9210
31547,14910254,14910254,14910370,0,0,0,116
31546,14910205,14910205,14910901,0,0,0,696
31548,14911151,14911151,14911163,0,0,0,12
31549,14911193,14911193,14911544,0,0,0,351
31551,14911547,14911547,14911609,0,0,0,62
31550,14911535,14911535,14911927,0,0,0,392
31552,14911791,14911791,14912049,0,0,0,258
31553,14912267,14912267,14912280,0,0,0,13
31555,14914215,14914215,14914398,0,0,0,183
31557,14914393,14914393,14914406,0,0,0,13
31558,14914409,14914409,14914423,0,0,0,14
31560,14915224,14915224,14915240,0,0,0,16
31561,14915249,14915249,14915259,0,0,0,10
31559,14915037,14915037,14915312,0,0,0,275
31562,14915740,14915740,14915755,0,0,0,15
31563,14915758,14915758,14915766,0,0,0,8
31564,14916611,14916611,14916895,0,0,0,284
31545,14910112,14910112,14916971,0,0,0,6859
31556,14914387,14914387,14916973,0,0,0,2586
31566,14917096,14917096,14917433,0,0,0,337
31565,14916970,14916971,14917846,0,0,1,876
31568,14917379,14917379,14918018,0,0,0,639
31569,14918022,14918022,14919138,0,0,0,1116
31570,14918278,14918278,14919574,0,0,0,1296
31572,14919961,14919961,14921702,0,0,0,1741
31571,14919584,14919584,14922073,0,0,0,2489
31573,14921436,14921436,14922736,0,0,0,1300
31554,14913606,14913606,14924382,0,0,0,10776
31574,14922078,14922078,14924595,0,0,0,2517
31577,14924961,14924961,14925832,0,0,0,871
31578,14925545,14925545,14926715,0,0,0,1170
31539,14906264,14906264,14927053,0,0,0,20789
31567,14917154,14917154,14928854,0,0,0,11700
31576,14924621,14924621,14931406,0,0,0,6785
31580,14932464,14932464,14933286,0,0,0,822
31581,14933568,14933568,14933628,0,0,0,60
31582,14933673,14933673,14933745,0,0,0,72
31575,14924382,14924382,14934918,0,0,0,10536
31579,14931407,14931407,14938172,0,0,0,6765
31584,14938174,14938174,14944863,0,0,0,6689
31583,14934920,14934920,14945669,0,0,0,10749
31587,14949541,14949541,14950850,0,0,0,1309
31585,14944867,14944867,14951753,0,0,0,6886
31589,14954145,14954145,14954319,0,0,0,174
31590,14954362,14954362,14954504,0,0,0,142
31592,14955041,14955041,14955454,0,0,0,413
31586,14945669,14945669,14956179,0,0,0,10510
31594,14955950,14956179,14956209,0,0,229,259
31593,14955454,14955454,14956457,0,0,0,1003
31597,14956485,14956485,14956509,0,0,0,24
31598,14957074,14957074,14957325,0,0,0,251
31588,14951756,14951756,14957329,0,0,0,5573
31591,14954735,14954735,14958246,0,0,0,3511
31600,14958277,14958277,14958509,0,0,0,232
31601,14958651,14958651,14959019,0,0,0,368
31599,14957332,14957332,14964110,0,0,0,6778
31604,14964487,14964487,14964913,0,0,0,426
31607,14965150,14965150,14965560,0,0,0,410
31602,14959721,14959721,14965723,0,0,0,6002
31605,14964543,14964543,14966104,0,0,0,1561
31608,14966361,14966361,14966507,0,0,0,146
31606,14964954,14965723,14966892,0,0,769,1938
31595,14956184,14956209,14966930,0,0,25,10746
31612,14967836,14967836,14967900,0,0,0,64
31613,14967852,14967900,14967922,0,0,48,70
31610,14966551,14966551,14967956,0,0,0,1405
31614,14967891,14967922,14968254,0,0,31,363
31615,14967913,14968254,14968287,0,0,341,374
31596,14956394,14956394,14968400,0,0,0,12006
31609,14966448,14966448,14968404,0,0,0,1956
31616,14968272,14968272,14969111,0,0,0,839
31603,14964111,14964111,14970970,0,0,0,6859
31621,14970672,14970672,14971619,0,0,0,947
31625,14971702,14971702,14971740,0,0,0,38
31620,14969527,14970970,14972287,0,0,1443,2760
31627,14973385,14973385,14973892,0,0,0,507
31628,14973419,14973892,14974525,0,0,473,1106
31626,14971819,14971819,14975345,0,0,0,3526
31619,14969473,14969473,14976794,0,0,0,7321
31611,14966906,14966906,14977457,0,0,0,10551
31624,14971440,14971440,14977995,0,0,0,6555
31630,14975935,14975935,14978731,0,0,0,2796
31638,14978744,14978744,14978813,0,0,0,69
31639,14979115,14979115,14979303,0,0,0,188
31623,14971343,14971343,14980103,0,0,0,8760
31633,14976819,14980103,14980163,0,0,3284,3344
31637,14978735,14978735,14980982,0,0,0,2247
31617,14968540,14968540,14981329,0,0,0,12789
31641,14981745,14981745,14981817,0,0,0,72
31629,14973924,14974525,14982659,0,0,601,8735
31643,14982584,14982584,14982781,0,0,0,197
31644,14982998,14982998,14983013,0,0,0,15
31645,14983016,14983016,14983045,0,0,0,29
31640,14981495,14981495,14983247,0,0,0,1752
31647,14983340,14983340,14983352,0,0,0,12
31649,14983648,14983648,14983661,0,0,0,13
31631,14976543,14976794,14984496,0,0,251,7953
31646,14983181,14983181,14985515,0,0,0,2334
31648,14983474,14984496,14987301,0,0,1022,3827
31634,14977457,14977457,14988298,0,0,0,10841
31653,14988443,14988443,14988605,0,0,0,162
31632,14976807,14977995,14988737,0,0,1188,11930
31636,14977838,14980163,14991007,0,0,2325,13169
31642,14982320,14982659,14991069,0,0,339,8749
31651,14987582,14991007,14991069,0,0,3425,3487
31618,14968658,14981329,14992725,0,0,12671,24067
31650,14987557,14988737,14993919,0,0,1180,6362
31657,14996299,14996299,14997089,0,0,0,790
31655,14992759,14993919,14997342,0,0,1160,4583
31622,14970977,14991069,14997871,0,0,20092,26894
31658,14998546,14998546,14998559,0,0,0,13
31652,14988289,14988289,14998828,0,0,0,10539
31660,14999008,14999008,14999388,0,0,0,380
31662,15000304,15000304,15000316,0,0,0,12
31661,14999949,14999949,15000413,0,0,0,464
31663,15000582,15000582,15000593,0,0,0,11
31664,15000730,15000730,15000739,0,0,0,9
31665,15001432,15001432,15001443,0,0,0,11
31666,15001581,15001581,15001590,0,0,0,9
31668,15001907,15001907,15001918,0,0,0,11
31669,15003058,15003058,15003071,0,0,0,13
31654,14991152,14992725,15003324,0,0,1573,12172
31670,15003308,15003308,15003325,0,0,0,17
31673,15004784,15004784,15004800,0,0,0,16
31672,15004777,15004777,15005154,0,0,0,377
31674,15005556,15005556,15005574,0,0,0,18
31675,15005953,15005953,15005974,0,0,0,21
31635,14977777,14992725,15006093,0,0,14948,28316
31676,15006091,15006091,15006130,0,0,0,39
31677,15006145,15006145,15006265,0,0,0,120
31679,15006584,15006584,15006601,0,0,0,17
31678,15006399,15006399,15007035,0,0,0,636
31680,15007603,15007603,15007636,0,0,0,33
31682,15007762,15007762,15007783,0,0,0,21
31681,15007656,15007656,15007835,0,0,0,179
31684,15008288,15008288,15008305,0,0,0,17
31667,15001752,15001752,15008493,0,0,0,6741
31685,15008588,15008588,15008604,0,0,0,16
31686,15009327,15009327,15009351,0,0,0,24
31659,14998840,14998840,15009582,0,0,0,10742
31683,15007776,15008493,15010163,0,0,717,2387
31690,15010164,15010164,15010176,0,0,0,12
31689,15009804,15010163,15010182,0,0,359,378
31691,15010659,15010659,15010670,0,0,0,11
31656,14996191,14997342,15010685,0,0,1151,14494
31692,15011604,15011604,15011616,0,0,0,12
31693,15011708,15011708,15011859,0,0,0,151
31695,15012032,15012032,15012059,0,0,0,27
31694,15011929,15011929,15012238,0,0,0,309
31697,15012364,15012364,15012376,0,0,0,12
31698,15012815,15012815,15012827,0,0,0,12
31699,15013087,15013087,15013164,0,0,0,77
31700,15013261,15013261,15013273,0,0,0,12
31701,15013401,15013401,15013411,0,0,0,10
31687,15009446,15009582,15016995,0,0,136,7549
31671,15004079,15004079,15017410,0,0,0,13331
31688,15009638,15010163,15020633,0,0,525,10995
31696,15012201,15012201,15023491,0,0,0,11290
31702,15016861,15016861,15024284,0,0,0,7423
31703,15020118,15020118,15030604,0,0,0,10486
31704,15024287,15024287,15031651,0,0,0,7364
31707,15034092,15034092,15034468,0,0,0,376
31709,15037388,15037388,15037425,0,0,0,37
31706,15031653,15031653,15038979,0,0,0,7326
31705,15030602,15030602,15041355,0,0,0,10753
31715,15042108,15042108,15042259,0,0,0,151
31708,15035667,15035667,15043074,0,0,0,7407
31716,15043327,15043327,15043369,0,0,0,42
31720,15047197,15047197,15047220,0,0,0,23
31721,15049751,15049751,15050208,0,0,0,457
31711,15038987,15038987,15050514,0,0,0,11527
31710,15038575,15038575,15050584,0,0,0,12009
31717,15043344,15050584,15050621,0,0,7240,7277
31712,15039560,15039560,15050649,0,0,0,11089
31714,15040870,15040870,15050720,0,0,0,9850
31723,15051367,15051367,15051582,0,0,0,215
31724,15051428,15051582,15051670,0,0,154,242
31725,15051516,15051670,15051847,0,0,154,331
31726,15051692,15051847,15052025,0,0,155,333
31727,15051869,15052025,15052147,0,0,156,278
31728,15051990,15052147,15052246,0,0,157,256
31729,15052088,15052246,15052338,0,0,158,250
31730,15052199,15052338,15052426,0,0,139,227
31732,15052275,15052426,15052450,0,0,151,175
31734,15052301,15052450,15052478,0,0,149,177
31735,15052342,15052478,15052514,0,0,136,172
31718,15045074,15045074,15052736,0,0,0,7662
31731,15052249,15052426,15052748,0,0,177,499
31740,15052641,15052736,15052822,0,0,95,181
31737,15052465,15052736,15052846,0,0,271,381
31742,15052836,15052846,15052875,0,0,10,39
31739,15052575,15052736,15052892,0,0,161,317
31741,15052790,15052822,15052902,0,0,32,112
31733,15052286,15052736,15052916,0,0,450,630
31743,15052869,15052875,15053059,0,0,6,190
31744,15053051,15053051,15053075,0,0,0,24
31745,15053104,15053104,15053184,0,0,0,80
31746,15053107,15053107,15053189,0,0,0,82
31747,15053178,15053178,15053310,0,0,0,132
31748,15053188,15053188,15053371,0,0,0,183
31751,15053426,15053426,15053461,0,0,0,35
31752,15053434,15053434,15053467,0,0,0,33
31750,15053401,15053401,15053528,0,0,0,127
31755,15053579,15053579,15053607,0,0,0,28
31754,15053528,15053528,15053674,0,0,0,146
31738,15052573,15052736,15053707,0,0,163,1134
31756,15053696,15053696,15053720,0,0,0,24
31757,15053698,15053698,15053824,0,0,0,126
31713,15039813,15043074,15053912,0,0,3261,14099
31758,15053824,15053824,15053997,0,0,0,173
31759,15053995,15053995,15054020,0,0,0,25
31760,15054007,15054007,15054101,0,0,0,94
31761,15054099,15054099,15054123,0,0,0,24
31762,15054101,15054101,15054306,0,0,0,205
31763,15054304,15054304,15054326,0,0,0,22
31764,15054330,15054330,15054448,0,0,0,118
31765,15054446,15054446,15054469,0,0,0,23
31766,15054448,15054448,15054605,0,0,0,157
31767,15054617,15054617,15054683,0,0,0,66
31768,15054687,15054687,15054783,0,0,0,96
31769,15054783,15054783,15054962,0,0,0,179
31771,15055020,15055020,15055097,0,0,0,77
31773,15055096,15055096,15055130,0,0,0,34
31774,15055097,15055097,15055175,0,0,0,78
31775,15055173,15055173,15055210,0,0,0,37
31777,15055238,15055238,15055288,0,0,0,50
31776,15055187,15055187,15055292,0,0,0,105
31779,15055327,15055327,15055375,0,0,0,48
31780,15055396,15055396,15055433,0,0,0,37
31781,15055429,15055429,15055468,0,0,0,39
31778,15055291,15055291,15055469,0,0,0,178
31785,15055868,15055868,15059479,0,0,0,3611
31786,15056001,15059479,15059559,0,0,3478,3558
31753,15053441,15053461,15061369,0,0,20,7928
31788,15058052,15059559,15063429,0,0,1507,5377
31784,15055516,15055516,15063999,0,0,0,8483
31770,15054873,15054873,15064001,0,0,0,9128
31794,15066356,15066356,15066398,0,0,0,42
31792,15066159,15066159,15066534,0,0,0,375
31795,15067675,15067675,15067708,0,0,0,33
31793,15066271,15066271,15068462,0,0,0,2191
31719,15047081,15050621,15069086,0,0,3540,22005
31722,15050589,15050649,15069329,0,0,60,18740
31796,15068837,15069329,15069822,0,0,492,985
31797,15070470,15070470,15070493,0,0,0,23
31798,15070519,15070519,15070529,0,0,0,10
31783,15055491,15055491,15070983,0,0,0,15492
31782,15055489,15055489,15071072,0,0,0,15583
31749,15053309,15053309,15071075,0,0,0,17766
31736,15052393,15052514,15071195,0,0,121,18802
31787,15057430,15071195,15074712,0,0,13765,17282
31790,15062423,15069086,15081179,0,0,6663,18756
31801,15072164,15081179,15081207,0,0,9015,9043
31802,15072198,15081179,15081208,0,0,8981,9010
31804,15072234,15081179,15081210,0,0,8945,8976
31806,15072310,15081179,15081210,0,0,8869,8900
31805,15072271,15081179,15081211,0,0,8908,8940
31800,15072158,15081179,15081212,0,0,9021,9054
31810,15072583,15081210,15081228,0,0,8627,8645
31808,15072350,15081207,15081232,0,0,8857,8882
31817,15073578,15081211,15081243,0,0,7633,7665
31821,15074524,15081243,15081256,0,0,6719,6732
31822,15074553,15081256,15081267,0,0,6703,6714
31823,15074570,15081267,15081277,0,0,6697,6707
31820,15074240,15081232,15081283,0,0,6992,7043
31825,15074587,15081283,15081293,0,0,6696,6706
31816,15073567,15081210,15081294,0,0,7643,7727
31826,15074605,15081293,15081304,0,0,6688,6699
31827,15074621,15081294,15081304,0,0,6673,6683
31828,15074637,15081304,15081314,0,0,6667,6677
31829,15074654,15081304,15081314,0,0,6650,6660
31830,15074671,15081314,15081324,0,0,6643,6653
31831,15074688,15081314,15081324,0,0,6626,6636
31799,15072096,15081179,15081330,0,0,9083,9234
31832,15074704,15081324,15081334,0,0,6620,6630
31833,15074722,15081324,15081334,0,0,6602,6612
31834,15074739,15081330,15081340,0,0,6591,6601
31837,15074776,15081334,15081344,0,0,6558,6568
31835,15074757,15081334,15081349,0,0,6577,6592
31839,15074794,15081344,15081360,0,0,6550,6566
31840,15074822,15081349,15081362,0,0,6527,6540
31841,15074851,15081360,15081370,0,0,6509,6519
31842,15074868,15081362,15081372,0,0,6494,6504
31843,15074885,15081370,15081380,0,0,6485,6495
31844,15074902,15081372,15081390,0,0,6470,6488
31838,15074789,15081340,15081391,0,0,6551,6602
31845,15074929,15081380,15081399,0,0,6451,6470
31846,15074958,15081390,15081409,0,0,6432,6451
31847,15074985,15081391,15081411,0,0,6406,6426
31824,15074575,15081277,15081417,0,0,6702,6842
31848,15075016,15081399,15081420,0,0,6383,6404
31849,15075046,15081409,15081429,0,0,6363,6383
31851,15075081,15081411,15081431,0,0,6330,6350
31852,15075109,15081417,15081435,0,0,6308,6326
31809,15072367,15081208,15081439,0,0,8841,9072
31853,15075139,15081420,15081439,0,0,6281,6300
31854,15075169,15081429,15081448,0,0,6260,6279
31855,15075196,15081431,15081450,0,0,6235,6254
31856,15075223,15081435,15081454,0,0,6212,6231
31857,15075250,15081439,15081457,0,0,6189,6207
31858,15075277,15081439,15081458,0,0,6162,6181
31860,15075332,15081450,15081468,0,0,6118,6136
31859,15075305,15081448,15081471,0,0,6143,6166
31861,15075360,15081454,15081473,0,0,6094,6113
31862,15075387,15081457,15081475,0,0,6070,6088
31863,15075414,15081458,15081477,0,0,6044,6063
31865,15075470,15081471,15081482,0,0,6001,6012
31866,15075488,15081473,15081483,0,0,5985,5995
31867,15075504,15081475,15081485,0,0,5971,5981
31864,15075442,15081468,15081487,0,0,6026,6045
31868,15075522,15081477,15081487,0,0,5955,5965
31869,15075539,15081482,15081492,0,0,5943,5953
31870,15075556,15081483,15081494,0,0,5927,5938
31871,15075573,15081485,15081495,0,0,5912,5922
31873,15075607,15081487,15081498,0,0,5880,5891
31872,15075590,15081487,15081500,0,0,5897,5910
31874,15075623,15081492,15081504,0,0,5869,5881
31875,15075642,15081494,15081505,0,0,5852,5863
31876,15075659,15081495,15081507,0,0,5836,5848
31877,15075677,15081498,15081508,0,0,5821,5831
31878,15075696,15081500,15081510,0,0,5804,5814
31879,15075713,15081504,15081516,0,0,5791,5803
31882,15075744,15081508,15081523,0,0,5764,5779
31881,15075734,15081507,15081526,0,0,5773,5792
31883,15075764,15081510,15081526,0,0,5746,5762
31884,15075793,15081516,15081531,0,0,5723,5738
31885,15075821,15081523,15081538,0,0,5702,5717
31886,15075850,15081526,15081540,0,0,5676,5690
31887,15075878,15081526,15081550,0,0,5648,5672
31890,15075944,15081540,15081559,0,0,5596,5615
31889,15075916,15081538,15081560,0,0,5622,5644
31888,15075886,15081531,15081582,0,0,5645,5696
31819,15074185,15081228,15081590,0,0,7043,7405
31893,15075976,15081560,15081594,0,0,5584,5618
31894,15076014,15081582,15081612,0,0,5568,5598
31895,15076051,15081590,15081620,0,0,5539,5569
31896,15076088,15081594,15081623,0,0,5506,5535
31897,15076126,15081612,15081641,0,0,5486,5515
31899,15076202,15081623,15081647,0,0,5421,5445
31898,15076164,15081620,15081649,0,0,5456,5485
31891,15075949,15081550,15081663,0,0,5601,5714
31901,15076230,15081647,15081666,0,0,5417,5436
31902,15076256,15081649,15081669,0,0,5393,5413
31903,15076283,15081663,15081682,0,0,5380,5399
31904,15076310,15081666,15081685,0,0,5356,5375
31905,15076337,15081669,15081688,0,0,5332,5351
31906,15076365,15081682,15081701,0,0,5317,5336
31907,15076392,15081685,15081704,0,0,5293,5312
31908,15076419,15081688,15081707,0,0,5269,5288
31911,15076502,15081707,15081717,0,0,5205,5215
31909,15076447,15081701,15081720,0,0,5254,5273
31910,15076474,15081704,15081723,0,0,5230,5249
31912,15076519,15081717,15081727,0,0,5198,5208
31913,15076535,15081720,15081730,0,0,5185,5195
31914,15076553,15081723,15081733,0,0,5170,5180
31915,15076569,15081727,15081738,0,0,5158,5169
31916,15076587,15081730,15081740,0,0,5143,5153
31917,15076604,15081733,15081748,0,0,5129,5144
31918,15076621,15081738,15081750,0,0,5117,5129
31900,15076208,15081641,15081751,0,0,5433,5543
31919,15076638,15081740,15081751,0,0,5102,5113
31923,15076711,15081751,15081760,0,0,5040,5049
31920,15076655,15081748,15081761,0,0,5093,5106
31922,15076694,15081751,15081761,0,0,5057,5067
31921,15076675,15081750,15081764,0,0,5075,5089
31924,15076727,15081760,15081771,0,0,5033,5044
31925,15076744,15081761,15081771,0,0,5017,5027
31926,15076760,15081761,15081772,0,0,5001,5012
31927,15076777,15081764,15081775,0,0,4987,4998
31928,15076793,15081771,15081781,0,0,4978,4988
31929,15076809,15081771,15081782,0,0,4962,4973
31930,15076826,15081772,15081783,0,0,4946,4957
31931,15076842,15081775,15081794,0,0,4933,4952
31932,15076869,15081781,15081800,0,0,4912,4931
31933,15076896,15081782,15081801,0,0,4886,4905
31934,15076924,15081783,15081802,0,0,4859,4878
31935,15076950,15081794,15081813,0,0,4844,4863
31936,15076979,15081800,15081820,0,0,4821,4841
31937,15077007,15081801,15081820,0,0,4794,4813
31938,15077034,15081802,15081821,0,0,4768,4787
31945,15078841,15081821,15081832,0,0,2980,2991
31944,15078813,15081820,15081836,0,0,3007,3023
31946,15078858,15081832,15081842,0,0,2974,2984
31947,15078874,15081836,15081847,0,0,2962,2973
31939,15077062,15081813,15081848,0,0,4751,4786
31948,15078891,15081842,15081852,0,0,2951,2961
31949,15078907,15081847,15081857,0,0,2940,2950
31950,15078923,15081848,15081862,0,0,2925,2939
31951,15078951,15081852,15081862,0,0,2901,2911
31952,15078968,15081857,15081868,0,0,2889,2900
31954,15079002,15081862,15081872,0,0,2860,2870
31953,15078984,15081862,15081873,0,0,2878,2889
31955,15079018,15081868,15081878,0,0,2850,2860
31956,15079035,15081872,15081882,0,0,2837,2847
31957,15079053,15081873,15081884,0,0,2820,2831
31958,15079070,15081878,15081888,0,0,2808,2818
31959,15079086,15081882,15081892,0,0,2796,2806
31960,15079103,15081884,15081894,0,0,2781,2791
31961,15079119,15081888,15081898,0,0,2769,2779
31962,15079136,15081892,15081902,0,0,2756,2766
31963,15079152,15081894,15081904,0,0,2742,2752
31964,15079169,15081898,15081919,0,0,2729,2750
31965,15079195,15081902,15081922,0,0,2707,2727
31966,15079222,15081904,15081923,0,0,2682,2701
31967,15079250,15081919,15081938,0,0,2669,2688
31968,15079277,15081922,15081941,0,0,2645,2664
31969,15079304,15081923,15081942,0,0,2619,2638
31880,15075729,15081505,15081951,0,0,5776,6222
31970,15079331,15081938,15081957,0,0,2607,2626
31971,15079358,15081941,15081960,0,0,2583,2602
31972,15079386,15081942,15081962,0,0,2556,2576
31973,15079412,15081951,15081972,0,0,2539,2560
31974,15079439,15081957,15081976,0,0,2518,2537
31975,15079466,15081960,15081979,0,0,2494,2513
31976,15079493,15081962,15081981,0,0,2469,2488
31977,15079521,15081972,15081992,0,0,2451,2471
31978,15079550,15081976,15081996,0,0,2426,2446
31979,15079578,15081979,15081998,0,0,2401,2420
31980,15079605,15081981,15082001,0,0,2376,2396
31984,15079713,15082001,15082011,0,0,2288,2298
31981,15079632,15081992,15082012,0,0,2360,2380
31982,15079658,15081996,15082016,0,0,2338,2358
31983,15079685,15081998,15082017,0,0,2313,2332
31985,15079729,15082011,15082021,0,0,2282,2292
31986,15079745,15082012,15082027,0,0,2267,2282
31987,15079764,15082016,15082032,0,0,2252,2268
31988,15079786,15082017,15082032,0,0,2231,2246
31989,15079806,15082021,15082036,0,0,2215,2230
31992,15079936,15082032,15082042,0,0,2096,2106
31991,15079919,15082032,15082043,0,0,2113,2124
31993,15079953,15082036,15082046,0,0,2083,2093
31994,15079969,15082042,15082052,0,0,2073,2083
31995,15079987,15082043,15082053,0,0,2056,2066
31996,15080004,15082046,15082056,0,0,2042,2052
31997,15080020,15082052,15082062,0,0,2032,2042
31998,15080037,15082053,15082064,0,0,2016,2027
31999,15080053,15082056,15082067,0,0,2003,2014
32000,15080070,15082062,15082073,0,0,1992,2003
32001,15080086,15082064,15082074,0,0,1978,1988
32002,15080102,15082067,15082077,0,0,1965,1975
32003,15080120,15082073,15082083,0,0,1953,1963
32004,15080137,15082074,15082093,0,0,1937,1956
32005,15080164,15082077,15082097,0,0,1913,1933
32006,15080191,15082083,15082102,0,0,1892,1911
32007,15080218,15082093,15082112,0,0,1875,1894
31990,15079826,15082027,15082114,0,0,2201,2288
32008,15080245,15082097,15082116,0,0,1852,1871
32009,15080272,15082102,15082121,0,0,1830,1849
32010,15080299,15082112,15082132,0,0,1813,1833
32011,15080326,15082114,15082134,0,0,1788,1808
32012,15080354,15082116,15082135,0,0,1762,1781
32013,15080380,15082121,15082141,0,0,1741,1761
32014,15080406,15082132,15082151,0,0,1726,1745
32015,15080433,15082134,15082153,0,0,1701,1720
32016,15080460,15082135,15082154,0,0,1675,1694
32017,15080486,15082141,15082164,0,0,1655,1678
31807,15072315,15082153,15082181,0,0,9838,9866
31811,15072610,15082164,15082201,0,0,9554,9591
31812,15072650,15082181,15082207,0,0,9531,9557
31813,15072928,15082201,15082223,0,0,9273,9295
31803,15072210,15081179,15082331,0,0,8969,10121
31814,15072954,15082207,15082845,0,0,9253,9891
31836,15074770,15082223,15084515,0,0,7453,9745
31772,15055036,15069086,15084694,0,0,14050,29658
31815,15073014,15084694,15085198,0,0,11680,12184
31818,15073907,15081212,15085233,0,0,7305,11326
32018,15080512,15085198,15085343,0,0,4686,4831
31892,15075969,15081559,15085503,0,0,5590,9534
32019,15082564,15085343,15086323,0,0,2779,3759
31850,15075072,15082845,15088135,0,0,7773,13063
31941,15077796,15084515,15088401,0,0,6719,10605
31940,15077075,15085198,15088624,0,0,8123,11549
32020,15084983,15084983,15089113,0,0,0,4130
31789,15058144,15074712,15089611,0,0,16568,31467
31942,15078058,15081820,15089818,0,0,3762,11760
32022,15089916,15089916,15089962,0,0,0,46
32023,15089966,15089966,15089989,0,0,0,23
32025,15090570,15090570,15090749,0,0,0,179
32026,15091324,15091324,15091338,0,0,0,14
32027,15091351,15091351,15091361,0,0,0,10
32028,15091369,15091369,15091379,0,0,0,10
32029,15091384,15091384,15091394,0,0,0,10
32030,15091400,15091400,15091412,0,0,0,12
32031,15091416,15091416,15091427,0,0,0,11
32032,15091432,15091432,15091442,0,0,0,10
32033,15091448,15091448,15091460,0,0,0,12
32034,15091464,15091464,15091475,0,0,0,11
32035,15091480,15091480,15091490,0,0,0,10
32036,15091496,15091496,15091507,0,0,0,11
32037,15091511,15091511,15091521,0,0,0,10
32038,15091527,15091527,15091538,0,0,0,11
32039,15091544,15091544,15091554,0,0,0,10
32040,15091559,15091559,15091570,0,0,0,11
32041,15091575,15091575,15091586,0,0,0,11
32042,15091591,15091591,15091601,0,0,0,10
32043,15091607,15091607,15091618,0,0,0,11
32044,15091623,15091623,15091633,0,0,0,10
32045,15091639,15091639,15091650,0,0,0,11
32047,15093326,15093326,15093341,0,0,0,15
32048,15093354,15093354,15093364,0,0,0,10
32049,15093372,15093372,15093382,0,0,0,10
32050,15093389,15093389,15093402,0,0,0,13
32051,15093406,15093406,15093417,0,0,0,11
32052,15093426,15093426,15093436,0,0,0,10
32053,15094064,15094064,15094088,0,0,0,24
32046,15092333,15092333,15094736,0,0,0,2403
32055,15095618,15095618,15096146,0,0,0,528
32056,15096293,15096293,15096324,0,0,0,31
32021,15085071,15085503,15096644,0,0,432,11573
32057,15096448,15096448,15096731,0,0,0,283
32059,15096850,15096850,15097032,0,0,0,182
32060,15097089,15097089,15097165,0,0,0,76
32061,15097538,15097538,15097655,0,0,0,117
31791,15062476,15089611,15097911,0,0,27135,35435
32063,15097903,15097903,15098069,0,0,0,166
32062,15097679,15097679,15098298,0,0,0,619
32065,15098347,15098347,15099198,0,0,0,851
32066,15099365,15099365,15100235,0,0,0,870
32054,15095027,15095027,15101121,0,0,0,6094
32067,15100587,15100587,15101275,0,0,0,688
32069,15101672,15101672,15103005,0,0,0,1333
32064,15098313,15098313,15104046,0,0,0,5733
32070,15103350,15103350,15104681,0,0,0,1331
32071,15104854,15104854,15106202,0,0,0,1348
32058,15096752,15096752,15107258,0,0,0,10506
32072,15104860,15104860,15108962,0,0,0,4102
31943,15078674,15088624,15111837,0,0,9950,33163
32024,15090474,15097911,15113369,0,0,7437,22895
32073,15107260,15107260,15117965,0,0,0,10705
32076,15118058,15118058,15118078,0,0,0,20
32077,15118084,15118084,15118103,0,0,0,19
32078,15118112,15118112,15118135,0,0,0,23
32079,15118138,15118138,15118159,0,0,0,21
32080,15118168,15118168,15118188,0,0,0,20
32081,15118196,15118196,15118216,0,0,0,20
32082,15118224,15118224,15118243,0,0,0,19
32083,15118251,15118251,15118271,0,0,0,20
32084,15118277,15118277,15118297,0,0,0,20
32085,15118304,15118304,15118324,0,0,0,20
32086,15118330,15118330,15118349,0,0,0,19
32087,15118358,15118358,15118378,0,0,0,20
32088,15118385,15118385,15118405,0,0,0,20
32089,15118412,15118412,15118432,0,0,0,20
32090,15118439,15118439,15118458,0,0,0,19
32091,15118465,15118465,15118485,0,0,0,20
32092,15118491,15118491,15118511,0,0,0,20
32093,15118517,15118517,15118536,0,0,0,19
32094,15118543,15118543,15118563,0,0,0,20
32095,15118569,15118569,15118585,0,0,0,16
32096,15118597,15118597,15118608,0,0,0,11
32097,15118613,15118613,15118624,0,0,0,11
32098,15118628,15118628,15118639,0,0,0,11
32099,15118644,15118644,15118655,0,0,0,11
32100,15118659,15118659,15118669,0,0,0,10
32101,15118675,15118675,15118686,0,0,0,11
32102,15118691,15118691,15118702,0,0,0,11
32103,15118706,15118706,15118716,0,0,0,10
32104,15118722,15118722,15118733,0,0,0,11
32105,15118738,15118738,15118749,0,0,0,11
32106,15118754,15118754,15118765,0,0,0,11
32107,15118769,15118769,15118779,0,0,0,10
32108,15118785,15118785,15118796,0,0,0,11
32109,15118801,15118801,15118813,0,0,0,12
32110,15118817,15118817,15118827,0,0,0,10
32111,15118832,15118832,15118843,0,0,0,11
32112,15118848,15118848,15118859,0,0,0,11
32113,15118864,15118864,15118875,0,0,0,11
32114,15118879,15118879,15118890,0,0,0,11
32068,15100729,15113369,15119229,0,0,12640,18500
32074,15108288,15111837,15119259,0,0,3549,10971
32115,15123290,15123290,15123393,0,0,0,103
32119,15128361,15128361,15128377,0,0,0,16
32075,15117965,15117965,15128459,0,0,0,10494
32116,15128007,15128007,15128468,0,0,0,461
32118,15128257,15128257,15128752,0,0,0,495
32117,15128157,15128157,15135065,0,0,0,6908
32124,15135328,15135328,15135450,0,0,0,122
32121,15132167,15132167,15136112,0,0,0,3945
32120,15131387,15131387,15139796,0,0,0,8409
32128,15139090,15139796,15139818,0,0,706,728
32127,15138217,15139796,15139822,0,0,1579,1605
32125,15137156,15139796,15139878,0,0,2640,2722
32126,15138121,15139796,15140001,0,0,1675,1880
32129,15140631,15140631,15140756,0,0,0,125
32131,15144633,15144633,15145392,0,0,0,759
32122,15134890,15134890,15147618,0,0,0,12728
32130,15142742,15142742,15149923,0,0,0,7181
32123,15134909,15136112,15152324,0,0,1203,17415
32133,15154441,15154441,15155442,0,0,0,1001
32132,15151267,15151267,15156161,0,0,0,4894
32134,15158675,15158675,15159053,0,0,0,378
32135,15159157,15159157,15159248,0,0,0,91
32136,15159301,15159301,15159699,0,0,0,398
32139,15159608,15159608,15159746,0,0,0,138
32140,15159775,15159775,15160006,0,0,0,231
32142,15159995,15159995,15160209,0,0,0,214
32144,15160162,15160162,15160242,0,0,0,80
32141,15159962,15159962,15160357,0,0,0,395
32147,15161483,15161483,15161578,0,0,0,95
32146,15161227,15161227,15161662,0,0,0,435
32150,15161980,15161980,15162065,0,0,0,85
32137,15159317,15159317,15162630,0,0,0,3313
32149,15161967,15161967,15162657,0,0,0,690
32145,15160618,15160618,15162740,0,0,0,2122
32148,15161593,15161593,15163184,0,0,0,1591
32143,15160108,15160108,15164341,0,0,0,4233
32152,15163624,15163624,15164912,0,0,0,1288
32156,15164693,15164693,15164934,0,0,0,241
32157,15165072,15165072,15165505,0,0,0,433
32158,15165351,15165351,15165782,0,0,0,431
32154,15164394,15164394,15167265,0,0,0,2871
32151,15162971,15162971,15167318,0,0,0,4347
32159,15165451,15165505,15169085,0,0,54,3634
32153,15164033,15164033,15172569,0,0,0,8536
32155,15164488,15164488,15172689,0,0,0,8201
32160,15167765,15167765,15174105,0,0,0,6340
32161,15170445,15170445,15176759,0,0,0,6314
32167,15176035,15176759,15176767,0,0,724,732
32165,15175572,15176759,15176770,0,0,1187,1198
32166,15175945,15176759,15176771,0,0,814,826
32168,15176093,15176767,15176776,0,0,674,683
32169,15176370,15176770,15176778,0,0,400,408
32170,15176567,15176771,15176779,0,0,204,212
32171,15176665,15176776,15176784,0,0,111,119
32164,15175027,15176759,15176831,0,0,1732,1804
32174,15178237,15178237,15178249,0,0,0,12
32175,15178250,15178250,15178311,0,0,0,61
32176,15178414,15178414,15178432,0,0,0,18
32162,15171118,15172569,15182926,0,0,1451,11808
32138,15159580,15159580,15184228,0,0,0,24648
32177,15184468,15184468,15184751,0,0,0,283
32178,15185313,15185313,15185596,0,0,0,283
32180,15186517,15186517,15186809,0,0,0,292
32181,15187193,15187193,15187481,0,0,0,288
32173,15177193,15177193,15187926,0,0,0,10733
32163,15172811,15174105,15189423,0,0,1294,16612
32179,15186201,15186201,15190280,0,0,0,4079
32172,15177020,15182926,15195688,0,0,5906,18668
32182,15187930,15187930,15198461,0,0,0,10531
32184,15207204,15207204,15207301,0,0,0,97
32183,15198462,15198462,15209220,0,0,0,10758
32186,15211145,15211145,15211149,0,0,0,4
32187,15213711,15213711,15221854,0,0,0,8143
32185,15209221,15209221,15222018,0,0,0,12797
32208,15219427,15219427,15223407,0,0,0,3980
32197,15217808,15217808,15223714,0,0,0,5906
32200,15218053,15223714,15223741,0,0,5661,5688
32201,15218061,15223741,15223785,0,0,5680,5724
32203,15218518,15223785,15223833,0,0,5267,5315
32204,15218806,15223833,15223855,0,0,5027,5049
32205,15218896,15223855,15223957,0,0,4959,5061
32213,15220743,15223407,15224893,0,0,2664,4150
32216,15220880,15224893,15224921,0,0,4013,4041
32217,15220995,15224921,15224941,0,0,3926,3946
32207,15219025,15223957,15226162,0,0,4932,7137
32209,15219638,15226162,15226467,0,0,6524,6829
32214,15220815,15226467,15226521,0,0,5652,5706
32215,15220869,15226521,15226648,0,0,5652,5779
32218,15221042,15226648,15226730,0,0,5606,5688
32219,15221076,15226730,15227472,0,0,5654,6396
32226,15221579,15224941,15227546,0,0,3362,5967
32220,15221123,15227472,15227565,0,0,6349,6442
32221,15221296,15227565,15227601,0,0,6269,6305
32222,15221332,15227601,15227659,0,0,6269,6327
32229,15221835,15227546,15227723,0,0,5711,5888
32224,15221425,15227659,15227733,0,0,6234,6308
32238,15222320,15227723,15227771,0,0,5403,5451
32225,15221499,15227733,15227859,0,0,6234,6360
32188,15214794,15214794,15227871,0,0,0,13077
32193,15216509,15227871,15227913,0,0,11362,11404
32227,15221683,15227859,15227919,0,0,6176,6236
32212,15220532,15222018,15227986,0,0,1486,7454
32228,15221743,15227919,15227996,0,0,6176,6253
32230,15221856,15227996,15228070,0,0,6140,6214
32231,15221930,15228070,15228136,0,0,6140,6206
32241,15222464,15227771,15228179,0,0,5307,5715
32246,15222651,15227986,15228196,0,0,5335,5545
32194,15217300,15227913,15228266,0,0,10613,10966
32195,15217592,15228266,15228460,0,0,10674,10868
32196,15217776,15228460,15228527,0,0,10684,10751
32260,15224909,15228196,15229614,0,0,3287,4705
32262,15224972,15229614,15230293,0,0,4642,5321
32264,15225221,15230293,15230730,0,0,5072,5509
32266,15225386,15230730,15231301,0,0,5344,5915
32233,15222013,15228136,15231319,0,0,6123,9306
32234,15222080,15231319,15231348,0,0,9239,9268
32268,15225436,15231301,15231375,0,0,5865,5939
32235,15222109,15231348,15231459,0,0,9239,9350
32236,15222231,15231459,15231513,0,0,9228,9282
32237,15222285,15231513,15231590,0,0,9228,9305
32270,15225544,15231375,15231776,0,0,5831,6232
32274,15226128,15231776,15231820,0,0,5648,5692
32275,15226188,15231820,15231857,0,0,5632,5669
32279,15226522,15231857,15231994,0,0,5335,5472
32282,15226598,15231994,15232269,0,0,5396,5671
32190,15216273,15216273,15232548,0,0,0,16275
32199,15217990,15232548,15232625,0,0,14558,14635
32202,15218089,15232625,15232781,0,0,14536,14692
32189,15215389,15221854,15233632,0,0,6465,18243
32255,15224382,15228179,15234225,0,0,3797,9843
32211,15220189,15233632,15234279,0,0,13443,14090
32206,15218951,15232781,15234304,0,0,13830,15353
32240,15222422,15234304,15234348,0,0,11882,11926
32232,15222007,15234279,15234350,0,0,12272,12343
32293,15227709,15234225,15234365,0,0,6516,6656
32242,15222466,15234304,15234446,0,0,11838,11980
32245,15222622,15234446,15234555,0,0,11824,11933
32296,15228014,15234365,15234678,0,0,6351,6664
32247,15222730,15234555,15234678,0,0,11825,11948
32300,15228159,15234678,15234711,0,0,6519,6552
32248,15222926,15234678,15234750,0,0,11752,11824
32249,15222986,15234750,15234849,0,0,11764,11863
32251,15223975,15234849,15234898,0,0,10874,10923
32239,15222360,15231590,15234933,0,0,9230,12573
32253,15224233,15234933,15235054,0,0,10700,10821
32252,15224023,15234898,15235060,0,0,10875,11037
32244,15222619,15234350,15235103,0,0,11731,12484
32254,15224354,15235054,15235155,0,0,10700,10801
32259,15224845,15235103,15235161,0,0,10258,10316
32256,15224518,15235060,15235202,0,0,10542,10684
32257,15224696,15235103,15235253,0,0,10407,10557
32265,15225314,15235202,15235287,0,0,9888,9973
32261,15224954,15235155,15235293,0,0,10201,10339
32267,15225399,15235253,15235298,0,0,9854,9899
32269,15225521,15235287,15235353,0,0,9766,9832
32263,15225091,15235161,15235358,0,0,10070,10267
32272,15225849,15235298,15235398,0,0,9449,9549
32276,15226310,15235358,15235434,0,0,9048,9124
32277,15226386,15235398,15235447,0,0,9012,9061
32271,15225587,15235293,15235493,0,0,9706,9906
32278,15226491,15235434,15235526,0,0,8943,9035
32281,15226582,15235447,15235589,0,0,8865,9007
32283,15226724,15235493,15235633,0,0,8769,8909
32273,15225948,15235353,15235636,0,0,9405,9688
32284,15226864,15235526,15235701,0,0,8662,8837
32287,15227072,15235633,15235737,0,0,8561,8665
32288,15227196,15235636,15235783,0,0,8440,8587
32289,15227385,15235701,15235805,0,0,8316,8420
32292,15227703,15235783,15235881,0,0,8080,8178
32294,15227801,15235805,15235884,0,0,8004,8083
32291,15227489,15235737,15235893,0,0,8248,8404
32297,15228016,15235884,15235957,0,0,7868,7941
32295,15227919,15235881,15235978,0,0,7962,8059
32299,15228129,15235957,15236053,0,0,7828,7924
32303,15228394,15236053,15236084,0,0,7659,7690
32301,15228233,15235978,15236120,0,0,7745,7887
32308,15229176,15236053,15236147,0,0,6877,6971
32311,15229418,15236084,15236199,0,0,6666,6781
32304,15228427,15236120,15236240,0,0,7693,7813
32305,15228547,15236240,15236340,0,0,7693,7793
32314,15229591,15236199,15236491,0,0,6608,6900
32315,15229670,15236491,15236598,0,0,6821,6928
32306,15228722,15236340,15236641,0,0,7618,7919
32307,15229009,15236641,15236802,0,0,7632,7793
32309,15229242,15236802,15236972,0,0,7560,7730
32310,15229366,15236972,15237093,0,0,7606,7727
32191,15216339,15227871,15237264,0,0,11532,20925
32298,15228062,15235893,15237276,0,0,7831,9214
32313,15229552,15237093,15237342,0,0,7541,7790
32258,15224731,15237264,15237388,0,0,12533,12657
32320,15230349,15237342,15237432,0,0,6993,7083
32318,15230045,15237342,15237448,0,0,7297,7403
32280,15226544,15237388,15237504,0,0,10844,10960
32325,15230974,15237432,15237587,0,0,6458,6613
32316,15229797,15237276,15237603,0,0,7479,7806
32329,15231286,15237448,15237614,0,0,6162,6328
32334,15231714,15237587,15237636,0,0,5873,5922
32337,15231936,15237614,15237665,0,0,5678,5729
32341,15232193,15237665,15237719,0,0,5472,5526
32319,15230215,15237603,15237780,0,0,7388,7565
32285,15227044,15232269,15237792,0,0,5225,10748
32312,15229463,15236147,15237843,0,0,6684,8380
32345,15232513,15237792,15237858,0,0,5279,5345
32351,15233191,15237843,15237868,0,0,4652,4677
32352,15233221,15237858,15237887,0,0,4637,4666
32354,15233414,15237868,15237903,0,0,4454,4489
32321,15230350,15237780,15237914,0,0,7430,7564
32342,15232225,15237719,15237965,0,0,5494,5740
32317,15230013,15236598,15238065,0,0,6585,8052
32322,15230534,15237914,15238069,0,0,7380,7535
32323,15230686,15238069,15238155,0,0,7383,7469
32192,15216498,15227871,15238175,0,0,11373,21677
32324,15230805,15238155,15238283,0,0,7350,7478
32326,15230977,15238283,15238405,0,0,7306,7428
32367,15234367,15238065,15238406,0,0,3698,4039
32223,15221423,15238175,15238426,0,0,16752,17003
32327,15231113,15238405,15238551,0,0,7292,7438
32328,15231250,15238551,15238639,0,0,7301,7389
32330,15231382,15238639,15238747,0,0,7257,7365
32331,15231490,15238747,15238897,0,0,7257,7407
32250,15223015,15238426,15238913,0,0,15411,15898
32335,15231826,15238913,15238975,0,0,7087,7149
32333,15231700,15238913,15239040,0,0,7213,7340
32339,15231959,15238913,15239067,0,0,6954,7108
32338,15231958,15237636,15239083,0,0,5678,7125
32340,15232112,15238975,15239087,0,0,6863,6975
32375,15235047,15239083,15239110,0,0,4036,4063
32344,15232439,15239067,15239177,0,0,6628,6738
32379,15235552,15239110,15239188,0,0,3558,3636
32343,15232277,15239040,15239203,0,0,6763,6926
32346,15232648,15239087,15239211,0,0,6439,6563
32383,15235991,15239188,15239217,0,0,3197,3226
32347,15232771,15239177,15239240,0,0,6406,6469
32349,15233048,15239211,15239295,0,0,6163,6247
32353,15233365,15239295,15239338,0,0,5930,5973
32348,15232892,15239203,15239359,0,0,6311,6467
32385,15236268,15239217,15239408,0,0,2949,3140
32350,15233190,15239240,15239415,0,0,6050,6225
32358,15233574,15239359,15239431,0,0,5785,5857
32356,15233452,15239338,15239460,0,0,5886,6008
32363,15233816,15239431,15239495,0,0,5615,5679
32362,15233694,15239415,15239537,0,0,5721,5843
32365,15234227,15239495,15239596,0,0,5268,5369
32366,15234328,15239537,15239671,0,0,5209,5343
32369,15234461,15239596,15239715,0,0,5135,5254
32364,15233932,15239460,15239755,0,0,5528,5823
32371,15234770,15239715,15239778,0,0,4945,5008
32370,15234641,15239671,15239800,0,0,5030,5159
32373,15234857,15239755,15239879,0,0,4898,5022
32376,15235233,15239800,15239922,0,0,4567,4689
32374,15234981,15239778,15239943,0,0,4797,4962
32377,15235355,15239879,15239991,0,0,4524,4636
32380,15235623,15239943,15240018,0,0,4320,4395
32378,15235525,15239922,15240021,0,0,4397,4496
32210,15219675,15233632,15240158,0,0,13957,20483
32381,15235749,15239991,15240169,0,0,4242,4420
32336,15231927,15238913,15240391,0,0,6986,8464
32387,15236327,15239408,15240608,0,0,3081,4281
32394,15238327,15240608,15240640,0,0,2281,2313
32360,15233648,15237965,15240943,0,0,4317,7295
32396,15239779,15240943,15240969,0,0,1164,1190
32395,15239114,15240640,15241052,0,0,1526,1938
32397,15240523,15240969,15241070,0,0,446,547
32398,15240568,15241052,15241181,0,0,484,613
32399,15241006,15241070,15241323,0,0,64,317
32393,15238112,15241323,15241370,0,0,3211,3258
32388,15236490,15240391,15241456,0,0,3901,4966
32302,15228336,15234711,15241780,0,0,6375,13444
32403,15241679,15241679,15241920,0,0,0,241
32405,15241795,15241920,15242036,0,0,125,241
32355,15233428,15240158,15242419,0,0,6730,8991
32408,15242635,15242635,15242651,0,0,0,16
32409,15242742,15242742,15242771,0,0,0,29
32410,15242761,15242771,15242878,0,0,10,117
32404,15241726,15241780,15242970,0,0,54,1244
32411,15242818,15242878,15243042,0,0,60,224
32243,15222476,15234348,15243361,0,0,11872,20885
32406,15242124,15243042,15243854,0,0,918,1730
32412,15242935,15243854,15243953,0,0,919,1018
32407,15242334,15243361,15244070,0,0,1027,1736
32416,15243148,15244070,15244159,0,0,922,1011
32414,15243130,15244070,15244330,0,0,940,1200
32419,15243714,15244330,15244465,0,0,616,751
32424,15244427,15244465,15244531,0,0,38,104
32413,15243059,15243953,15244632,0,0,894,1573
32391,15237832,15240391,15244662,0,0,2559,6830
32384,15236231,15240021,15244666,0,0,3790,8435
32425,15244508,15244531,15244722,0,0,23,214
32427,15244635,15244666,15244734,0,0,31,99
32286,15227069,15235589,15244753,0,0,8520,17684
32418,15243403,15244159,15244840,0,0,756,1437
32426,15244518,15244662,15244844,0,0,144,326
32357,15233493,15237887,15245017,0,0,4394,11524
32198,15217953,15228527,15245033,0,0,10574,27080
32428,15244654,15244722,15245248,0,0,68,594
32432,15245211,15245248,15245260,0,0,37,49
32434,15245459,15245459,15245522,0,0,0,63
32435,15245494,15245522,15245600,0,0,28,106
32430,15244781,15244840,15245744,0,0,59,963
32437,15245626,15245744,15245908,0,0,118,282
32439,15245812,15245908,15245933,0,0,96,121
32386,15236290,15240169,15245967,0,0,3879,9677
32441,15245916,15245933,15246045,0,0,17,129
32415,15243134,15244632,15246135,0,0,1498,3001
32382,15235926,15240018,15246138,0,0,4092,10212
32431,15244942,15245017,15246160,0,0,75,1218
32444,15246131,15246160,15246232,0,0,29,101
32443,15246100,15246138,15246238,0,0,38,138
32445,15246203,15246232,15246348,0,0,29,145
32446,15246288,15246288,15246393,0,0,0,105
32447,15246318,15246348,15246449,0,0,30,131
32449,15246419,15246419,15246450,0,0,0,31
32420,15243765,15246450,15246814,0,0,2685,3049
32401,15241592,15241592,15246817,0,0,0,5225
32450,15246481,15246817,15246924,0,0,336,443
32455,15246842,15246924,15247022,0,0,82,180
32457,15246922,15247022,15247059,0,0,100,137
32459,15247052,15247059,15247176,0,0,7,124
32421,15243842,15246814,15247383,0,0,2972,3541
32433,15245370,15247383,15247420,0,0,2013,2050
32461,15247270,15247270,15247765,0,0,0,495
32436,15245530,15247420,15247917,0,0,1890,2387
32464,15247419,15247765,15247926,0,0,346,507
32467,15247636,15247926,15248084,0,0,290,448
32472,15247813,15248084,15248293,0,0,271,480
32400,15241475,15246045,15248372,0,0,4570,6897
32442,15246085,15246135,15248507,0,0,50,2422
32473,15247819,15248293,15248603,0,0,474,784
32451,15246482,15248507,15248674,0,0,2025,2192
32392,15238066,15245033,15248684,0,0,6967,10618
32476,15247940,15248603,15248714,0,0,663,774
32452,15246648,15248674,15248734,0,0,2026,2086
32454,15246819,15248684,15248780,0,0,1865,1961
32453,15246708,15248684,15248796,0,0,1976,2088
32458,15247020,15248780,15248814,0,0,1760,1794
32460,15247234,15248796,15248833,0,0,1562,1599
32456,15246914,15248734,15248841,0,0,1820,1927
32462,15247271,15248814,15248885,0,0,1543,1614
32465,15247430,15248841,15248895,0,0,1411,1465
32463,15247341,15248833,15248923,0,0,1492,1582
32468,15247638,15248895,15249022,0,0,1257,1384
32466,15247484,15248885,15249040,0,0,1401,1556
32469,15247638,15248923,15249051,0,0,1285,1413
32490,15248956,15248956,15249064,0,0,0,108
32470,15247765,15249022,15249088,0,0,1257,1323
32475,15247891,15249088,15249139,0,0,1197,1248
32474,15247831,15249051,15249163,0,0,1220,1332
32290,15227416,15237504,15249165,0,0,10088,21749
32471,15247765,15249040,15249167,0,0,1275,1402
32480,15248115,15249165,15249241,0,0,1050,1126
32477,15247953,15249139,15249242,0,0,1186,1289
32479,15248055,15249165,15249302,0,0,1110,1247
32483,15248455,15249242,15249303,0,0,787,848
32478,15247953,15249163,15249325,0,0,1210,1372
32485,15248456,15249303,15249363,0,0,847,907
32484,15248455,15249302,15249364,0,0,847,909
32488,15248806,15249364,15249425,0,0,558,619
32481,15248191,15249167,15249432,0,0,976,1241
32487,15248693,15249363,15249477,0,0,670,784
32486,15248516,15249325,15249503,0,0,809,987
32482,15248191,15249241,15249506,0,0,1050,1315
32489,15248930,15249425,15249524,0,0,495,594
32494,15249488,15249506,15249567,0,0,18,79
32491,15249029,15249432,15249591,0,0,403,562
32492,15249187,15249477,15249598,0,0,290,411
32493,15249308,15249503,15249623,0,0,195,315
32495,15249667,15249667,15249788,0,0,0,121
32496,15249787,15249788,15249893,0,0,1,106
32497,15249819,15249819,15249907,0,0,0,88
32498,15249909,15249909,15250027,0,0,0,118
32499,15250027,15250027,15250147,0,0,0,120
32500,15250209,15250209,15250345,0,0,0,136
32502,15250374,15250374,15250505,0,0,0,131
32503,15250504,15250505,15250627,0,0,1,123
32504,15250674,15250674,15250808,0,0,0,134
32390,15237659,15244753,15250896,0,0,7094,13237
32361,15233654,15242419,15251004,0,0,8765,17350
32505,15250869,15250869,15251045,0,0,0,176
32501,15250346,15250346,15251056,0,0,0,710
32506,15251136,15251136,15251197,0,0,0,61
32507,15251197,15251197,15251316,0,0,0,119
32402,15241638,15241638,15251386,0,0,0,9748
32508,15251377,15251377,15251445,0,0,0,68
32509,15251445,15251445,15251500,0,0,0,55
32510,15251500,15251500,15251618,0,0,0,118
32511,15251618,15251618,15251738,0,0,0,120
32512,15251800,15251800,15251900,0,0,0,100
32513,15251919,15251919,15251978,0,0,0,59
32514,15251978,15251978,15252159,0,0,0,181
32515,15252159,15252159,15252279,0,0,0,120
32516,15252279,15252279,15252400,0,0,0,121
32517,15252400,15252400,15252458,0,0,0,58
32372,15234855,15238406,15252504,0,0,3551,17649
32518,15252458,15252458,15252578,0,0,0,120
32359,15233590,15237903,15252609,0,0,4313,19019
32332,15231563,15238897,15252672,0,0,7334,21109
32519,15252639,15252639,15252702,0,0,0,63
32520,15252702,15252702,15252758,0,0,0,56
32521,15252758,15252758,15252879,0,0,0,121
32522,15252879,15252879,15252992,0,0,0,113
32523,15252991,15252991,15253110,0,0,0,119
32524,15253109,15253109,15253134,0,0,0,25
32368,15234416,15253134,15253253,0,0,18718,18837
32417,15243258,15253253,15253387,0,0,9995,10129
32422,15244098,15253387,15255140,0,0,9289,11042
32448,15246350,15248372,15258224,0,0,2022,11874
32526,15253253,15258224,15258283,0,0,4971,5030
32525,15253164,15258224,15258313,0,0,5060,5149
32527,15253373,15258283,15258345,0,0,4910,4972
32528,15253434,15258313,15258431,0,0,4879,4997
32529,15253614,15258345,15258464,0,0,4731,4850
32530,15253733,15258431,15258550,0,0,4698,4817
32531,15253882,15258464,15258586,0,0,4582,4704
32533,15254003,15258586,15258764,0,0,4583,4761
32534,15254181,15258764,15258885,0,0,4583,4704
32535,15254302,15258885,15258949,0,0,4583,4647
32536,15254364,15258949,15259066,0,0,4585,4702
32537,15254481,15259066,15259246,0,0,4585,4765
32538,15254721,15259246,15259366,0,0,4525,4645
32539,15254841,15259366,15259534,0,0,4525,4693
32423,15244122,15255140,15259659,0,0,11018,15537
32540,15255008,15259534,15259671,0,0,4526,4663
32542,15255145,15259671,15259853,0,0,4526,4708
32543,15255326,15259853,15259956,0,0,4527,4630
32544,15255429,15259956,15260156,0,0,4527,4727
32545,15255629,15260156,15260251,0,0,4527,4622
32548,15255725,15260251,15260281,0,0,4526,4556
32546,15255682,15260251,15260290,0,0,4569,4608
32550,15255773,15260281,15260436,0,0,4508,4663
32562,15257076,15260436,15260552,0,0,3360,3476
32566,15257296,15260552,15260590,0,0,3256,3294
32558,15256593,15260290,15260658,0,0,3697,4065
32574,15258335,15260658,15260695,0,0,2323,2360
32567,15257351,15260590,15260728,0,0,3239,3377
32575,15258377,15260695,15260730,0,0,2318,2353
32576,15258448,15260728,15260874,0,0,2280,2426
32532,15253928,15258550,15263739,0,0,4622,9811
32549,15255728,15263739,15263919,0,0,8011,8191
32551,15255990,15263919,15263982,0,0,7929,7992
32552,15256053,15263982,15264039,0,0,7929,7986
32553,15256176,15264039,15264135,0,0,7863,7959
32555,15256272,15264135,15264194,0,0,7863,7922
32556,15256392,15264194,15264253,0,0,7802,7861
32429,15244676,15259659,15264292,0,0,14983,19616
32557,15256451,15264253,15264469,0,0,7802,8018
32559,15256667,15264469,15264592,0,0,7802,7925
32440,15245874,15264292,15264637,0,0,18418,18763
32560,15256788,15264592,15264769,0,0,7804,7981
32561,15257029,15264769,15264819,0,0,7740,7790
32563,15257078,15264819,15264892,0,0,7741,7814
32564,15257198,15264892,15264981,0,0,7694,7783
32389,15237475,15249598,15265009,0,0,12123,27534
32565,15257287,15264981,15265175,0,0,7694,7888
32568,15257480,15265175,15265309,0,0,7695,7829
32569,15257613,15265309,15265491,0,0,7696,7878
32570,15257795,15265491,15265608,0,0,7696,7813
32571,15257912,15265608,15265790,0,0,7696,7878
32572,15258121,15265790,15265911,0,0,7669,7790
32573,15258241,15265911,15266105,0,0,7670,7864
32579,15259289,15260730,15267375,0,0,1441,8086
32438,15245661,15247917,15268008,0,0,2256,22347
32541,15255010,15264637,15269040,0,0,9627,14030
32578,15259235,15269040,15270595,0,0,9805,11360
32577,15258806,15266105,15273143,0,0,7299,14337
32580,15259417,15270595,15276181,0,0,11178,16764
32585,15277246,15277246,15277402,0,0,0,156
32586,15277862,15277862,15278028,0,0,0,166
32587,15279117,15279117,15279282,0,0,0,165
32584,15269166,15269166,15279644,0,0,0,10478
32554,15256211,15268008,15279917,0,0,11797,23706
32588,15280061,15280061,15280211,0,0,0,150
32581,15259435,15276181,15280423,0,0,16746,20988
32589,15280839,15280839,15280985,0,0,0,146
32547,15255708,15265009,15287673,0,0,9301,31965
32582,15261379,15280423,15302777,0,0,19044,41398
32592,15295532,15302777,15302836,0,0,7245,7304
32594,15295832,15302777,15302837,0,0,6945,7005
32596,15296072,15302777,15302837,0,0,6705,6765
32598,15296313,15302837,15302896,0,0,6524,6583
32595,15295891,15302777,15302899,0,0,6886,7008
32591,15292948,15302777,15302932,0,0,9829,9984
32593,15295591,15302777,15302957,0,0,7186,7366
32597,15296131,15302836,15302957,0,0,6705,6826
32599,15296371,15302837,15302962,0,0,6466,6591
32601,15296644,15302899,15303016,0,0,6255,6372
32600,15296515,15302896,15303025,0,0,6381,6510
32603,15296944,15302957,15303074,0,0,6013,6130
32606,15297385,15303016,15303076,0,0,5631,5691
32605,15297206,15302962,15303081,0,0,5756,5875
32604,15297060,15302957,15303103,0,0,5897,6043
32602,15296761,15302932,15303115,0,0,6171,6354
32612,15298012,15303081,15303140,0,0,5069,5128
32614,15298244,15303115,15303171,0,0,4871,4927
32607,15297445,15303025,15303206,0,0,5580,5761
32608,15297652,15303074,15303221,0,0,5422,5569
32610,15297799,15303076,15303229,0,0,5277,5430
32615,15298256,15303140,15303247,0,0,4884,4991
32613,15298071,15303103,15303270,0,0,5032,5199
32621,15298915,15303229,15303290,0,0,4314,4375
32617,15298603,15303206,15303299,0,0,4603,4696
32616,15298363,15303171,15303353,0,0,4808,4990
32619,15298695,15303221,15303383,0,0,4526,4688
32623,15299159,15303270,15303387,0,0,4111,4228
32625,15299479,15303299,15303419,0,0,3820,3940
32622,15298976,15303247,15303430,0,0,4271,4454
32624,15299275,15303290,15303440,0,0,4015,4165
32627,15299781,15303383,15303460,0,0,3602,3679
32639,15301048,15303440,15303461,0,0,2392,2413
32626,15299599,15303353,15303473,0,0,3754,3874
32629,15300050,15303419,15303527,0,0,3369,3477
32633,15300361,15303473,15303576,0,0,3112,3215
32628,15299857,15303387,15303581,0,0,3530,3724
32630,15300158,15303430,15303633,0,0,3272,3475
32636,15300803,15303581,15303642,0,0,2778,2839
32634,15300464,15303527,15303687,0,0,3063,3223
32635,15300683,15303576,15303696,0,0,2893,3013
32640,15301048,15303633,15303714,0,0,2585,2666
32645,15301490,15303687,15303747,0,0,2197,2257
32648,15301491,15303714,15303773,0,0,2223,2282
32653,15301911,15303747,15303809,0,0,1836,1898
32656,15301912,15303773,15303834,0,0,1861,1922
32641,15301048,15303461,15303843,0,0,2413,2795
32642,15301048,15303642,15304024,0,0,2594,2976
32647,15301490,15303696,15304063,0,0,2206,2573
32649,15301491,15303714,15304080,0,0,2223,2589
32661,15302276,15304024,15304082,0,0,1748,1806
32631,15300158,15303440,15304086,0,0,3282,3928
32632,15300158,15303460,15304106,0,0,3302,3948
32655,15301911,15303809,15304113,0,0,1898,2202
32662,15302276,15304063,15304122,0,0,1787,1846
32657,15301912,15303834,15304136,0,0,1922,2224
32671,15302666,15304080,15304139,0,0,1414,1473
32668,15302665,15304113,15304173,0,0,1448,1508
32664,15302277,15304024,15304355,0,0,1747,2078
32663,15302276,15304106,15304439,0,0,1830,2163
32658,15302021,15303843,15304585,0,0,1822,2564
32679,15305070,15305070,15305157,0,0,0,87
32678,15304775,15304775,15306466,0,0,0,1691
32683,15307246,15307246,15307363,0,0,0,117
32684,15308864,15308864,15309356,0,0,0,492
32688,15309511,15309511,15309533,0,0,0,22
32583,15266083,15287673,15309541,0,0,21590,43458
32689,15309553,15309553,15309575,0,0,0,22
32690,15309564,15309564,15309606,0,0,0,42
32637,15300864,15309541,15309663,0,0,8677,8799
32674,15302920,15304086,15309744,0,0,1166,6824
32638,15300985,15309663,15309808,0,0,8678,8823
32694,15309826,15309826,15309856,0,0,0,30
32670,15302665,15304122,15309865,0,0,1457,7200
32643,15301189,15309808,15309870,0,0,8619,8681
32646,15301490,15309870,15309931,0,0,8380,8441
32672,15302666,15304082,15309945,0,0,1416,7279
32695,15309908,15309945,15309996,0,0,37,88
32644,15301250,15309865,15310044,0,0,8615,8794
32697,15310013,15310013,15310089,0,0,0,76
32650,15301549,15309931,15310113,0,0,8382,8564
32652,15301856,15310113,15310169,0,0,8257,8313
32651,15301730,15310044,15310170,0,0,8314,8440
32620,15298783,15309541,15310180,0,0,10758,11397
32660,15302214,15310180,15310243,0,0,7966,8029
32698,15310049,15310089,15310270,0,0,40,221
32654,15301911,15310169,15310281,0,0,8258,8370
32701,15310052,15310270,15310313,0,0,218,261
32659,15302022,15310170,15310362,0,0,8148,8340
32665,15302334,15310243,15310362,0,0,7909,8028
32666,15302501,15310281,15310388,0,0,7780,7887
32667,15302608,15310362,15310420,0,0,7754,7812
32669,15302665,15310362,15310463,0,0,7697,7798
32673,15302766,15310388,15310547,0,0,7622,7781
32702,15310052,15310313,15310555,0,0,261,503
32704,15310303,15310555,15310640,0,0,252,337
32706,15310349,15310640,15310666,0,0,291,317
32708,15310349,15310666,15310843,0,0,317,494
32709,15310378,15310843,15310887,0,0,465,509
32677,15303567,15304136,15311093,0,0,569,7526
32675,15302996,15310420,15311099,0,0,7424,8103
32712,15310588,15311093,15311468,0,0,505,880
32590,15288018,15302777,15311560,0,0,14759,23542
32713,15310975,15311468,15311624,0,0,493,649
32714,15310977,15311624,15311679,0,0,647,702
32699,15310050,15311560,15311804,0,0,1510,1754
32700,15310051,15311804,15311849,0,0,1753,1798
32710,15310411,15310887,15312067,0,0,476,1656
32717,15310988,15311679,15312083,0,0,691,1095
32718,15311029,15312067,15312126,0,0,1038,1097
32722,15311244,15312126,15312148,0,0,882,904
32609,15297725,15304355,15312168,0,0,6630,14443
32724,15311451,15312148,15312181,0,0,697,730
32676,15303485,15310463,15312191,0,0,6978,8706
32707,15310349,15312168,15312194,0,0,1819,1845
32715,15310987,15312191,15312236,0,0,1204,1249
32725,15311451,15312236,15312270,0,0,785,819
32705,15310348,15312168,15312348,0,0,1820,2000
32730,15311604,15312348,15312374,0,0,744,770
32733,15311874,15312374,15312430,0,0,500,556
32727,15311451,15312181,15312485,0,0,730,1034
32711,15310587,15312191,15312568,0,0,1604,1981
32728,15311451,15312270,15312574,0,0,819,1123
32716,15310987,15312194,15312599,0,0,1207,1612
32741,15312231,15312574,15312638,0,0,343,407
32742,15312237,15312599,15312657,0,0,362,420
32736,15311929,15312485,15312788,0,0,556,859
32740,15312128,15312574,15312801,0,0,446,673
32745,15312295,15312638,15312811,0,0,343,516
32737,15311929,15312568,15312872,0,0,639,943
32743,15312237,15312657,15312888,0,0,420,651
32755,15312780,15312888,15312930,0,0,108,150
32748,15312520,15312788,15313008,0,0,268,488
32749,15312520,15312872,15313093,0,0,352,573
32759,15312801,15312930,15313144,0,0,129,343
32764,15313034,15313144,15313205,0,0,110,171
32762,15313009,15313009,15313326,0,0,0,317
32757,15312780,15313093,15313329,0,0,313,549
32758,15312801,15313329,15313349,0,0,528,548
32767,15313094,15313205,15313418,0,0,111,324
32753,15312664,15312811,15313484,0,0,147,820
32751,15312656,15312801,15313607,0,0,145,951
32719,15311058,15312083,15313610,0,0,1025,2552
32765,15313034,15313349,15313622,0,0,315,588
32774,15313345,15313607,15313644,0,0,262,299
32766,15313086,15313622,15313650,0,0,536,564
32729,15311483,15312348,15313653,0,0,865,2170
32781,15313567,15313644,15313703,0,0,77,136
32768,15313097,15313326,15313752,0,0,229,655
32771,15313274,15313484,15313775,0,0,210,501
32776,15313347,15313610,15313785,0,0,263,438
32786,15313756,15313756,15313819,0,0,0,63
32773,15313341,15313650,15313832,0,0,309,491
32787,15313822,15313822,15313849,0,0,0,27
32775,15313347,15313785,15313879,0,0,438,532
32782,15313580,15313653,15313888,0,0,73,308
32778,15313565,15313832,15313893,0,0,267,328
32783,15313623,15313703,15313918,0,0,80,295
32769,15313128,15313418,15313969,0,0,290,841
32793,15313925,15313925,15314025,0,0,0,100
32790,15313831,15313849,15314042,0,0,18,211
32789,15313831,15314025,15314054,0,0,194,223
32794,15314050,15314050,15314091,0,0,0,41
32788,15313822,15313893,15314096,0,0,71,274
32795,15314052,15314054,15314096,0,0,2,44
32780,15313565,15313879,15314130,0,0,314,565
32796,15314052,15314096,15314138,0,0,44,86
32797,15314052,15314054,15314254,0,0,2,202
32720,15311091,15314138,15314259,0,0,3047,3168
32798,15314052,15314096,15314297,0,0,44,245
32802,15314287,15314287,15314314,0,0,0,27
32721,15311212,15314259,15314378,0,0,3047,3166
32723,15311391,15314378,15314439,0,0,2987,3048
32803,15314314,15314314,15314452,0,0,0,138
32804,15314314,15314314,15314452,0,0,0,138
32791,15313846,15313888,15314523,0,0,42,677
32691,15309589,15311099,15314541,0,0,1510,4952
32806,15314478,15314478,15314546,0,0,0,68
32726,15311451,15314439,15314584,0,0,2988,3133
32731,15311623,15314541,15314672,0,0,2918,3049
32611,15297950,15309541,15314699,0,0,11591,16749
32805,15314477,15314477,15314700,0,0,0,223
32732,15311753,15314584,15314706,0,0,2831,2953
32735,15311927,15314672,15314727,0,0,2745,2800
32808,15314485,15314523,15314737,0,0,38,252
32807,15314478,15314700,15314768,0,0,222,290
32738,15311982,15314706,15314776,0,0,2724,2794
32744,15312294,15314776,15314855,0,0,2482,2561
32739,15312085,15314727,15314873,0,0,2642,2788
32812,15314760,15314760,15314878,0,0,0,118
32813,15314760,15314768,15314887,0,0,8,127
32750,15312576,15314887,15314969,0,0,2311,2393
32747,15312372,15314873,15315022,0,0,2501,2650
32752,15312658,15314969,15315051,0,0,2311,2393
32756,15312780,15315022,15315189,0,0,2242,2409
32760,15312947,15315051,15315218,0,0,2104,2271
32763,15313010,15315218,15315238,0,0,2208,2228
32746,15312370,15314855,15315354,0,0,2485,2984
32770,15313141,15315238,15315373,0,0,2097,2232
32777,15313464,15315373,15315476,0,0,1909,2012
32772,15313276,15315354,15315520,0,0,2078,2244
32692,15309653,15309653,15315621,0,0,0,5968
32779,15313565,15315476,15315621,0,0,1911,2056
32816,15314938,15315621,15315682,0,0,683,744
32785,15313732,15315621,15315749,0,0,1889,2017
32818,15314938,15315621,15315808,0,0,683,870
32784,15313724,15315520,15315843,0,0,1796,2119
32792,15313859,15315749,15315943,0,0,1890,2084
32799,15314093,15315843,15315946,0,0,1750,1853
32800,15314129,15315943,15316124,0,0,1814,1995
32801,15314195,15315946,15316140,0,0,1751,1945
32809,15314545,15316124,15316212,0,0,1579,1667
32811,15314632,15316212,15316279,0,0,1580,1647
32814,15314760,15316279,15316398,0,0,1519,1638
32815,15314878,15316398,15316519,0,0,1520,1641
32817,15314938,15316519,15316580,0,0,1581,1642
32824,15315141,15316580,15316608,0,0,1439,1467
32829,15315364,15316608,15316671,0,0,1244,1307
32819,15314938,15316519,15316707,0,0,1581,1769
32825,15315141,15316707,15316736,0,0,1566,1595
32827,15315145,15316580,15316760,0,0,1435,1615
32831,15315364,15316671,15316851,0,0,1307,1487
32826,15315141,15316736,15316920,0,0,1595,1779
32835,15315604,15316760,15316933,0,0,1156,1329
32830,15315364,15316920,15316984,0,0,1556,1620
32839,15315799,15316933,15316993,0,0,1134,1194
32842,15315859,15316993,15317093,0,0,1134,1234
32832,15315364,15316984,15317164,0,0,1620,1800
32844,15316018,15317093,15317274,0,0,1075,1256
32847,15316197,15317274,15317288,0,0,1077,1091
32754,15312708,15312888,15317308,0,0,180,4600
32849,15316240,15317288,15317316,0,0,1048,1076
32836,15315604,15317164,15317338,0,0,1560,1734
32855,15316449,15317316,15317361,0,0,867,912
32840,15315799,15317338,15317398,0,0,1539,1599
32820,15315010,15315682,15317431,0,0,672,2421
32859,15316554,15317431,15317452,0,0,877,898
32851,15316255,15317308,15317491,0,0,1053,1236
32861,15316761,15317452,15317510,0,0,691,749
32841,15315799,15317398,15317558,0,0,1599,1759
32867,15317104,15317510,15317561,0,0,406,457
32857,15316493,15317361,15317579,0,0,868,1086
32868,15317198,15317561,15317683,0,0,363,485
32845,15316018,15317558,15317740,0,0,1540,1722
32850,15316255,15317740,15317763,0,0,1485,1508
32870,15317326,15317579,15317812,0,0,253,486
32863,15316761,15317491,15317893,0,0,730,1132
32852,15316255,15317763,15317946,0,0,1508,1691
32874,15317361,15317893,15317949,0,0,532,588
32875,15317420,15317949,15317971,0,0,529,551
32823,15315139,15315808,15317999,0,0,669,2860
32876,15317453,15317971,15318097,0,0,518,644
32882,15317864,15318097,15318151,0,0,233,287
32884,15317868,15318151,15318172,0,0,283,304
32871,15317326,15317683,15318223,0,0,357,897
32881,15317651,15317999,15318237,0,0,348,586
32891,15318007,15318237,15318339,0,0,230,332
32892,15318074,15318339,15318514,0,0,265,440
32887,15317883,15318172,15318592,0,0,289,709
32899,15318313,15318592,15318628,0,0,279,315
32900,15318339,15318628,15318712,0,0,289,373
32903,15318354,15318712,15319014,0,0,358,660
32895,15318194,15318514,15319120,0,0,320,926
32873,15317338,15317812,15319141,0,0,474,1803
32910,15318842,15319120,15319249,0,0,278,407
32916,15319421,15319421,15319455,0,0,0,34
32914,15319186,15319186,15319540,0,0,0,354
32920,15319520,15319540,15319583,0,0,20,63
32921,15319539,15319583,15319605,0,0,44,66
32908,15318739,15319014,15319639,0,0,275,900
32918,15319454,15319455,15319679,0,0,1,225
32680,15305594,15314699,15319868,0,0,9105,14274
32821,15315022,15319868,15319970,0,0,4846,4948
32924,15319793,15319793,15319996,0,0,0,203
32925,15319854,15319996,15320021,0,0,142,167
32822,15315124,15319868,15320108,0,0,4744,4984
32833,15315426,15320108,15320166,0,0,4682,4740
32926,15320090,15320090,15320218,0,0,0,128
32838,15315784,15316851,15320350,0,0,1067,4566
32834,15315484,15320166,15320371,0,0,4682,4887
32927,15320338,15320338,15320397,0,0,0,59
32837,15315777,15320371,15320492,0,0,4594,4715
32843,15315898,15320492,15320674,0,0,4594,4776
32929,15320338,15320350,15320695,0,0,12,357
32846,15316098,15320674,15320793,0,0,4576,4695
32889,15317940,15318223,15320837,0,0,283,2897
32848,15316216,15320793,15321016,0,0,4577,4800
32935,15320702,15320702,15321089,0,0,0,387
32856,15316493,15321016,15321102,0,0,4523,4609
32936,15321084,15321084,15321130,0,0,0,46
32862,15316761,15321102,15321161,0,0,4341,4400
32877,15317473,15321161,15321275,0,0,3688,3802
32858,15316493,15321102,15321321,0,0,4609,4828
32885,15317872,15321321,15321367,0,0,3449,3495
32864,15316761,15321130,15321532,0,0,4369,4771
32901,15318339,15321532,15321617,0,0,3193,3278
32878,15317473,15321275,15321667,0,0,3802,4194
32886,15317872,15321367,15321799,0,0,3495,3927
32902,15318339,15321617,15321934,0,0,3278,3595
32919,15319454,15321799,15322023,0,0,2345,2569
32928,15320338,15322023,15322083,0,0,1685,1745
32682,15307207,15310547,15322235,0,0,3340,15028
32909,15318739,15321667,15322293,0,0,2928,3554
32938,15321214,15322293,15322326,0,0,1079,1112
32930,15320338,15322083,15322429,0,0,1745,2091
32939,15321214,15322429,15322462,0,0,1215,1248
32860,15316578,15322235,15322477,0,0,5657,5899
32865,15316818,15322477,15322624,0,0,5659,5806
32940,15321214,15322326,15322653,0,0,1112,1439
32942,15321216,15322653,15322679,0,0,1437,1463
32943,15321309,15322679,15322706,0,0,1370,1397
32931,15320404,15320404,15322765,0,0,0,2361
32941,15321214,15322462,15322790,0,0,1248,1576
32944,15321336,15322706,15322821,0,0,1370,1485
32866,15316964,15322624,15322822,0,0,5660,5858
32945,15321379,15322765,15322924,0,0,1386,1545
32869,15317200,15322822,15322954,0,0,5622,5754
32947,15321463,15322790,15323035,0,0,1327,1572
32950,15321708,15323035,15323085,0,0,1327,1377
32872,15317327,15322954,15323107,0,0,5627,5780
32951,15321753,15323085,15323179,0,0,1332,1426
32879,15317527,15323107,15323193,0,0,5580,5666
32880,15317612,15323193,15323385,0,0,5581,5773
32952,15321758,15323179,15323395,0,0,1421,1637
32883,15317864,15323385,15323463,0,0,5521,5599
32953,15321974,15323395,15323516,0,0,1421,1542
32954,15322095,15323516,15323577,0,0,1421,1482
32853,15316265,15317946,15323654,0,0,1681,7389
32890,15317941,15323463,15323684,0,0,5522,5743
32948,15321553,15322821,15323788,0,0,1268,2235
32894,15318187,15323684,15323799,0,0,5497,5612
32898,15318302,15323799,15323852,0,0,5497,5550
32957,15322207,15323788,15323910,0,0,1581,1703
32904,15318423,15323852,15323932,0,0,5429,5509
32956,15322156,15323577,15323947,0,0,1421,1791
32955,15322155,15323654,15324014,0,0,1499,1859
32958,15322329,15323910,15324055,0,0,1581,1726
32734,15311922,15312430,15324092,0,0,508,12170
32962,15322710,15324055,15324113,0,0,1345,1403
32906,15318503,15323932,15324169,0,0,5429,5666
32964,15322835,15324113,15324211,0,0,1278,1376
32960,15322492,15324014,15324232,0,0,1522,1740
32965,15323063,15324211,15324242,0,0,1148,1179
32907,15318739,15324169,15324276,0,0,5430,5537
32966,15323092,15324232,15324344,0,0,1140,1252
32963,15322804,15324092,15324351,0,0,1288,1547
32967,15323094,15324242,15324355,0,0,1148,1261
32968,15323206,15324344,15324417,0,0,1138,1211
32969,15323207,15324351,15324469,0,0,1144,1262
32911,15318846,15324276,15324478,0,0,5430,5632
32973,15323322,15324417,15324519,0,0,1095,1197
32912,15319040,15324478,15324611,0,0,5438,5571
32974,15323325,15324469,15324696,0,0,1144,1371
32971,15323278,15324355,15324753,0,0,1077,1475
32913,15319167,15324611,15324790,0,0,5444,5623
32976,15323552,15324696,15324819,0,0,1144,1267
32959,15322366,15323947,15324920,0,0,1581,2554
32915,15319345,15324790,15325010,0,0,5445,5665
32703,15310142,15311849,15325077,0,0,1707,14935
32978,15323675,15324819,15325105,0,0,1144,1430
32979,15323736,15324920,15325140,0,0,1184,1404
32696,15309919,15311560,15325231,0,0,1641,15312
32961,15322574,15324014,15325283,0,0,1440,2709
32982,15323960,15325105,15325289,0,0,1145,1329
32981,15323869,15325231,15325289,0,0,1362,1420
32985,15324154,15325140,15325295,0,0,986,1141
32986,15324308,15325283,15325327,0,0,975,1019
32983,15324040,15325289,15325350,0,0,1249,1310
32987,15324308,15325350,15325394,0,0,1042,1086
32988,15324308,15325289,15325426,0,0,981,1118
32975,15323420,15324519,15325492,0,0,1099,2072
32970,15323215,15325077,15325538,0,0,1862,2323
32991,15324445,15325327,15325559,0,0,882,1114
32994,15324734,15325492,15325573,0,0,758,839
32996,15325134,15325538,15325603,0,0,404,469
32997,15325198,15325559,15325608,0,0,361,410
32999,15325199,15325573,15325637,0,0,374,438
32990,15324329,15325295,15325644,0,0,966,1315
32989,15324308,15325394,15325764,0,0,1086,1456
33003,15325263,15325608,15325793,0,0,345,530
33001,15325245,15325603,15325807,0,0,358,562
32998,15325198,15325764,15325814,0,0,566,616
32995,15324814,15325538,15325858,0,0,724,1044
33010,15325746,15325807,15325865,0,0,61,119
33004,15325448,15325637,15325935,0,0,189,487
32993,15324582,15325426,15326035,0,0,844,1453
33000,15325204,15325814,15326059,0,0,610,855
33013,15325803,15325858,15326102,0,0,55,299
32977,15323577,15324753,15326126,0,0,1176,2549
33014,15325845,15325865,15326129,0,0,20,284
33016,15326108,15326108,15326166,0,0,0,58
33011,15325788,15326129,15326186,0,0,341,398
33002,15325260,15326035,15326246,0,0,775,986
32810,15314550,15316140,15326267,0,0,1590,11717
32937,15321143,15322293,15326285,0,0,1150,5142
33017,15326166,15326166,15326287,0,0,0,121
33018,15326287,15326287,15326349,0,0,0,62
33006,15325544,15326059,15326368,0,0,515,824
33015,15325856,15326246,15326373,0,0,390,517
33012,15325788,15326186,15326445,0,0,398,657
33019,15326349,15326349,15326589,0,0,0,240
33020,15326587,15326587,15326648,0,0,0,61
33021,15326587,15326587,15326649,0,0,0,62
33024,15326589,15326648,15326768,0,0,59,179
33022,15326587,15326589,15326819,0,0,2,232
33023,15326587,15326649,15326880,0,0,62,293
33025,15326709,15326768,15327035,0,0,59,326
33026,15326976,15326976,15327040,0,0,0,64
33009,15325672,15325793,15327095,0,0,121,1423
33027,15327040,15327040,15327155,0,0,0,115
32980,15323841,15327095,15327247,0,0,3254,3406
33028,15327155,15327155,15327278,0,0,0,123
32923,15319591,15321934,15327503,0,0,2343,7912
33029,15327278,15327278,15327539,0,0,0,261
33033,15327373,15327503,15327569,0,0,130,196
33038,15327538,15327569,15327693,0,0,31,155
33040,15327662,15327693,15327909,0,0,31,247
33041,15327785,15327909,15327953,0,0,124,168
33007,15325571,15325644,15327965,0,0,73,2394
33043,15327829,15327953,15328002,0,0,124,173
33045,15327894,15328002,15328033,0,0,108,139
33044,15327878,15327965,15328040,0,0,87,162
33036,15327438,15327539,15328054,0,0,101,616
33046,15327953,15328033,15328093,0,0,80,140
33047,15328013,15328040,15328110,0,0,27,97
33048,15328013,15328054,15328124,0,0,41,111
33050,15328082,15328093,15328147,0,0,11,65
33051,15328082,15328110,15328304,0,0,28,222
32933,15320569,15326373,15328316,0,0,5804,7747
33053,15328156,15328304,15328364,0,0,148,208
33054,15328156,15328364,15328424,0,0,208,268
32992,15324458,15328316,15328490,0,0,3858,4032
33030,15327281,15327503,15328598,0,0,222,1317
33057,15328216,15328598,15328658,0,0,382,442
33058,15328275,15328658,15328719,0,0,383,444
33060,15328335,15328719,15328766,0,0,384,431
33062,15328336,15328766,15329012,0,0,430,676
33056,15328215,15328424,15329290,0,0,209,1075
32917,15319451,15325010,15329292,0,0,5559,9841
33064,15328454,15329290,15329314,0,0,836,860
33034,15327409,15329292,15329321,0,0,1883,1912
33066,15328476,15329314,15329419,0,0,838,943
33068,15328580,15329419,15329456,0,0,839,876
33069,15328581,15329456,15329504,0,0,875,923
33032,15327366,15329292,15329510,0,0,1926,2144
33070,15328586,15329504,15329534,0,0,918,948
33072,15328629,15329534,15329616,0,0,905,987
33073,15328655,15329616,15329672,0,0,961,1017
33076,15328711,15329672,15329806,0,0,961,1095
33077,15328716,15329806,15329828,0,0,1090,1112
33035,15327409,15329321,15329866,0,0,1912,2457
33078,15328734,15329828,15330535,0,0,1094,1801
33080,15328804,15330535,15330576,0,0,1731,1772
33082,15328844,15330576,15330605,0,0,1732,1761
33083,15328873,15330605,15330812,0,0,1732,1939
32946,15321449,15322790,15330928,0,0,1341,9479
33084,15328914,15330812,15330935,0,0,1898,2021
33088,15329080,15330928,15330952,0,0,1848,1872
33089,15329080,15330935,15331052,0,0,1855,1972
33091,15329197,15331052,15331124,0,0,1855,1927
33092,15329197,15331124,15331348,0,0,1927,2151
33042,15327824,15329866,15331380,0,0,2042,3556
33049,15328013,15331380,15331451,0,0,3367,3438
33090,15329103,15330952,15331689,0,0,1849,2586
33052,15328082,15331451,15331705,0,0,3369,3623
33096,15329421,15331689,15331789,0,0,2268,2368
33097,15329462,15331789,15331847,0,0,2327,2385
33098,15329520,15331847,15331918,0,0,2327,2398
33099,15329590,15331918,15331984,0,0,2328,2394
33031,15327309,15328147,15332067,0,0,838,4758
33094,15329268,15331348,15332091,0,0,2080,2823
33102,15329656,15332091,15332127,0,0,2435,2471
33100,15329591,15331984,15332145,0,0,2393,2554
33103,15329691,15332127,15332187,0,0,2436,2496
33105,15329815,15332187,15332212,0,0,2372,2397
32949,15321697,15322924,15332256,0,0,1227,10559
33106,15329839,15332212,15332264,0,0,2373,2425
33108,15329890,15332264,15332295,0,0,2374,2405
33107,15329840,15332256,15332307,0,0,2416,2467
33104,15329751,15332145,15332441,0,0,2394,2690
33111,15330011,15332441,15332476,0,0,2430,2465
33055,15328156,15331705,15332630,0,0,3549,4474
33061,15328335,15332630,15332736,0,0,4295,4401
33065,15328454,15332736,15332864,0,0,4282,4410
33067,15328579,15332864,15332902,0,0,4285,4323
33071,15328614,15332902,15333000,0,0,4288,4386
33109,15329891,15332295,15333413,0,0,2404,3522
33113,15330046,15333413,15333451,0,0,3367,3405
33114,15330046,15333451,15333552,0,0,3405,3506
33115,15330059,15333552,15333576,0,0,3493,3517
33116,15330083,15333576,15333625,0,0,3493,3542
33117,15330131,15333625,15333679,0,0,3494,3548
32761,15312962,15315189,15333708,0,0,2227,20746
33075,15328710,15333708,15333802,0,0,4998,5092
33081,15328804,15333708,15333839,0,0,4904,5035
33085,15328935,15333802,15333894,0,0,4867,4959
33087,15329026,15333839,15333903,0,0,4813,4877
33063,15328450,15329012,15333918,0,0,562,5468
33093,15329268,15333894,15333931,0,0,4626,4663
33112,15330028,15332476,15333933,0,0,2448,3905
33121,15330210,15333933,15333969,0,0,3723,3759
33122,15330226,15333969,15333989,0,0,3743,3763
33110,15329902,15332307,15334027,0,0,2405,4125
33123,15330246,15333989,15334044,0,0,3743,3798
33074,15328677,15333000,15334059,0,0,4323,5382
33126,15330474,15334044,15334095,0,0,3570,3621
33125,15330301,15334027,15334107,0,0,3726,3806
33127,15330504,15334095,15334115,0,0,3591,3611
33129,15330524,15334115,15334180,0,0,3591,3656
33119,15330185,15333918,15334207,0,0,3733,4022
32922,15319564,15326267,15334223,0,0,6703,14659
33133,15330630,15334207,15334261,0,0,3577,3631
33128,15330504,15334107,15334287,0,0,3603,3783
33134,15330683,15334261,15334327,0,0,3578,3644
33137,15331025,15334327,15334367,0,0,3302,3342
33095,15329268,15333903,15334647,0,0,4635,5379
33124,15330285,15334647,15334869,0,0,4362,4584
33079,15328781,15334223,15334909,0,0,5442,6128
33130,15330589,15334869,15334964,0,0,4280,4375
33131,15330589,15334180,15335317,0,0,3591,4728
33086,15328977,15334909,15335370,0,0,5932,6393
33118,15330183,15333679,15335467,0,0,3496,5284
33138,15331044,15334367,15335590,0,0,3323,4546
33139,15331110,15335317,15335661,0,0,4207,4551
33145,15331791,15335661,15335771,0,0,3870,3980
33135,15330937,15334287,15335778,0,0,3350,4841
33146,15331954,15335771,15335815,0,0,3817,3861
33144,15331772,15335590,15335837,0,0,3818,4065
33136,15331003,15335370,15335875,0,0,4367,4872
32984,15324142,15327247,15335920,0,0,3105,11778
33149,15332338,15335837,15336010,0,0,3499,3672
33132,15330589,15334964,15336102,0,0,4375,5513
33150,15332422,15336010,15336112,0,0,3588,3690
33147,15332096,15335778,15336315,0,0,3682,4219
32828,15315160,15319970,15336650,0,0,4810,21490
33151,15332495,15336650,15336711,0,0,4155,4216
33157,15333845,15336711,15336813,0,0,2866,2968
33148,15332267,15335815,15336910,0,0,3548,4643
33159,15334654,15336910,15337059,0,0,2256,2405
33153,15332497,15336112,15337280,0,0,3615,4783
33163,15335535,15337280,15337525,0,0,1745,1990
33101,15329592,15333931,15337583,0,0,4339,7991
33161,15334777,15337583,15337609,0,0,2806,2832
33005,15325518,15328490,15337637,0,0,2972,12119
33165,15336303,15337637,15337697,0,0,1334,1394
33168,15336488,15337637,15337755,0,0,1149,1267
33152,15332496,15336650,15337819,0,0,4154,5323
33172,15336805,15337697,15337824,0,0,892,1019
33167,15336430,15337637,15337831,0,0,1207,1401
33169,15336545,15337819,15337879,0,0,1274,1334
33173,15336806,15337755,15337880,0,0,949,1074
33155,15333362,15336711,15337901,0,0,3349,4539
33176,15337497,15337880,15337942,0,0,383,445
33158,15334552,15336813,15337970,0,0,2261,3418
33177,15337497,15337901,15337988,0,0,404,491
33175,15337289,15337831,15338040,0,0,542,751
33171,15336605,15337637,15338041,0,0,1032,1436
33174,15337009,15337824,15338041,0,0,815,1032
33182,15337756,15337988,15338048,0,0,232,292
33185,15337940,15338041,15338097,0,0,101,157
33183,15337815,15338040,15338101,0,0,225,286
33184,15337876,15338041,15338106,0,0,165,230
33186,15337996,15338048,15338109,0,0,52,113
33178,15337497,15338106,15338193,0,0,609,696
33154,15332554,15336315,15338309,0,0,3761,5755
33160,15334654,15337059,15338326,0,0,2405,3672
33181,15337637,15337970,15338330,0,0,333,693
33170,15336545,15337879,15338344,0,0,1334,1799
33192,15338348,15338348,15338403,0,0,0,55
33193,15338348,15338348,15338403,0,0,0,55
33187,15337996,15338097,15338451,0,0,101,455
33196,15338349,15338403,15338457,0,0,54,108
33197,15338402,15338451,15338514,0,0,49,112
33164,15335709,15337525,15338622,0,0,1816,2913
33198,15338585,15338585,15338649,0,0,0,64
33180,15337559,15337942,15338733,0,0,383,1174
33199,15338703,15338703,15338749,0,0,0,46
33162,15334777,15337609,15338753,0,0,2832,3976
33194,15338348,15338403,15338804,0,0,55,456
33195,15338348,15338403,15338865,0,0,55,517
33201,15338809,15338809,15338870,0,0,0,61
33142,15331725,15335467,15338882,0,0,3742,7157
33190,15338240,15338326,15338896,0,0,86,656
33179,15337498,15338193,15338905,0,0,695,1407
33202,15338869,15338869,15338931,0,0,0,62
33203,15338869,15338869,15338931,0,0,0,62
33200,15338748,15338748,15338932,0,0,0,184
33204,15338869,15338896,15338959,0,0,27,90
33208,15338990,15338990,15339012,0,0,0,22
33209,15339000,15339012,15339034,0,0,12,34
33210,15339032,15339034,15339060,0,0,2,28
33211,15339043,15339060,15339089,0,0,17,46
33212,15339084,15339089,15339110,0,0,5,26
33207,15338931,15338931,15339134,0,0,0,203
33213,15339105,15339110,15339138,0,0,5,33
33141,15331652,15335920,15339290,0,0,4268,7638
33205,15338869,15338870,15339348,0,0,1,479
33206,15338869,15338905,15339383,0,0,36,514
33215,15339405,15339405,15339467,0,0,0,62
33188,15338218,15338959,15339484,0,0,741,1266
33214,15339238,15339238,15339526,0,0,0,288
33218,15339465,15339467,15339528,0,0,2,63
33039,15327584,15329510,15339554,0,0,1926,11970
33219,15339525,15339525,15339563,0,0,0,38
33221,15339563,15339563,15339595,0,0,0,32
33222,15339594,15339594,15339654,0,0,0,60
33223,15339653,15339653,15339675,0,0,0,22
33059,15328275,15332067,15339723,0,0,3792,11448
32888,15317885,15339723,15339734,0,0,21838,21849
33224,15339735,15339735,15339766,0,0,0,31
33217,15339464,15339464,15339843,0,0,0,379
33225,15339803,15339803,15339843,0,0,0,40
33216,15339405,15339405,15339844,0,0,0,439
33166,15336389,15338753,15339860,0,0,2364,3471
32897,15318300,15339734,15339906,0,0,21434,21606
33226,15339843,15339843,15339908,0,0,0,65
33229,15339906,15339906,15339963,0,0,0,57
33227,15339905,15339905,15339964,0,0,0,59
33230,15339906,15339906,15339964,0,0,0,58
33220,15339525,15339525,15340023,0,0,0,498
33232,15339963,15339963,15340023,0,0,0,60
33234,15340023,15340023,15340059,0,0,0,36
33235,15340059,15340059,15340119,0,0,0,60
33233,15340022,15340022,15340178,0,0,0,156
33236,15340119,15340119,15340178,0,0,0,59
33239,15340222,15340222,15340277,0,0,0,55
33228,15339905,15339905,15340338,0,0,0,433
33231,15339906,15339906,15340338,0,0,0,432
33240,15340277,15340277,15340338,0,0,0,61
33241,15340337,15340338,15340399,0,0,1,62
33243,15340398,15340398,15340468,0,0,0,70
33244,15340398,15340399,15340470,0,0,1,72
33247,15340519,15340519,15340584,0,0,0,65
33248,15340644,15340644,15340680,0,0,0,36
33250,15340683,15340683,15340719,0,0,0,36
33238,15340221,15340221,15340734,0,0,0,513
33251,15340711,15340719,15340805,0,0,8,94
33242,15340397,15340397,15340857,0,0,0,460
33246,15340458,15340468,15340867,0,0,10,409
33252,15340731,15340734,15340923,0,0,3,192
33245,15340398,15340857,15340928,0,0,459,530
33255,15340916,15340923,15340949,0,0,7,33
33253,15340915,15340915,15340952,0,0,0,37
33256,15340916,15340949,15340976,0,0,33,60
33259,15340952,15340976,15340998,0,0,24,46
33260,15340969,15340998,15341038,0,0,29,69
33261,15341008,15341038,15341065,0,0,30,57
33262,15341012,15341065,15341100,0,0,53,88
33263,15341087,15341100,15341126,0,0,13,39
33257,15340916,15340952,15341149,0,0,36,233
33264,15341110,15341126,15341197,0,0,16,87
33266,15341121,15341197,15341257,0,0,76,136
33254,15340915,15340928,15341313,0,0,13,398
33267,15341181,15341257,15341319,0,0,76,138
33258,15340916,15340952,15341335,0,0,36,419
33268,15341243,15341313,15341369,0,0,70,126
33269,15341359,15341359,15341420,0,0,0,61
33271,15341360,15341360,15341420,0,0,0,60
33265,15341110,15341149,15341459,0,0,39,349
33273,15341419,15341420,15341482,0,0,1,63
33275,15341480,15341482,15341540,0,0,2,60
33276,15341599,15341599,15341658,0,0,0,59
33272,15341360,15341369,15341728,0,0,9,368
33270,15341359,15341420,15341780,0,0,61,421
33277,15341719,15341719,15341781,0,0,0,62
33120,15330209,15334059,15341853,0,0,3850,11644
33274,15341419,15341459,15341940,0,0,40,521
33280,15341900,15341900,15342058,0,0,0,158
33278,15341781,15341781,15342140,0,0,0,359
33279,15341781,15341781,15342141,0,0,0,360
33281,15342082,15342082,15342370,0,0,0,288
33284,15342369,15342369,15342489,0,0,0,120
33140,15331508,15335875,15342575,0,0,4367,11067
33282,15342200,15342200,15342610,0,0,0,410
33283,15342200,15342200,15342610,0,0,0,410
33285,15342489,15342489,15342671,0,0,0,182
33286,15342668,15342668,15342730,0,0,0,62
33288,15342669,15342671,15342732,0,0,2,63
33289,15342669,15342732,15342909,0,0,63,240
33287,15342668,15342730,15343048,0,0,62,380
33292,15342985,15343048,15343110,0,0,63,125
33290,15342669,15342909,15343225,0,0,240,556
33189,15338228,15339290,15343292,0,0,1062,5064
33295,15343285,15343285,15343347,0,0,0,62
33291,15342893,15343048,15343440,0,0,155,547
33293,15343047,15343110,15343468,0,0,63,421
33296,15343405,15343405,15343627,0,0,0,222
33294,15343047,15343292,15343651,0,0,245,604
33301,15343587,15343627,15343689,0,0,40,102
33297,15343466,15343466,15343706,0,0,0,240
33299,15343467,15343467,15343706,0,0,0,239
33302,15343649,15343689,15343746,0,0,40,97
33303,15343727,15343727,15344004,0,0,0,277
33300,15343529,15343529,15344043,0,0,0,514
33298,15343466,15343651,15344228,0,0,185,762
33306,15344127,15344228,15344290,0,0,101,163
33305,15344003,15344003,15344358,0,0,0,355
33304,15343888,15344043,15344510,0,0,155,622
33308,15344127,15344228,15344517,0,0,101,390
33311,15344475,15344475,15344535,0,0,0,60
33310,15344358,15344358,15344536,0,0,0,178
33307,15344127,15344510,15344572,0,0,383,445
33312,15344475,15344572,15344633,0,0,97,158
33313,15344475,15344517,15344782,0,0,42,307
33315,15344535,15344535,15344784,0,0,0,249
33309,15344127,15344510,15344799,0,0,383,672
33143,15331739,15336102,15344885,0,0,4363,13146
33314,15344475,15344633,15344899,0,0,158,424
33318,15344783,15344784,15344923,0,0,1,140
33317,15344666,15344923,15345177,0,0,257,511
33319,15344840,15344840,15345423,0,0,0,583
33320,15344841,15344885,15345467,0,0,44,626
33191,15338266,15338266,15345687,0,0,0,7421
33323,15345543,15345543,15345793,0,0,0,250
33322,15345243,15345423,15345844,0,0,180,601
33326,15345693,15345793,15345850,0,0,100,157
33325,15345664,15345793,15345880,0,0,129,216
33327,15345750,15345844,15345886,0,0,94,136
33330,15345890,15345890,15345924,0,0,0,34
33329,15345831,15345880,15345940,0,0,49,109
33324,15345543,15345687,15345975,0,0,144,432
33328,15345750,15345850,15345991,0,0,100,241
33335,15345891,15345975,15346007,0,0,84,116
33336,15345923,15345991,15346052,0,0,68,129
33337,15345984,15346007,15346066,0,0,23,82
33338,15346060,15346060,15346105,0,0,0,45
33340,15346121,15346121,15346181,0,0,0,60
33339,15346105,15346105,15346182,0,0,0,77
33341,15346181,15346181,15346203,0,0,0,22
33342,15346203,15346203,15346261,0,0,0,58
33343,15346259,15346259,15346289,0,0,0,30
33332,15345890,15345924,15346295,0,0,34,405
32854,15316356,15319639,15346304,0,0,3283,29948
33333,15345890,15345940,15346312,0,0,50,422
33331,15345890,15346295,15346329,0,0,405,439
33347,15346333,15346333,15346379,0,0,0,46
33345,15346332,15346332,15346380,0,0,0,48
33348,15346333,15346379,15346426,0,0,46,93
33321,15344951,15345177,15346598,0,0,226,1647
33351,15346410,15346598,15346628,0,0,188,218
33350,15346379,15346598,15346629,0,0,219,250
33352,15346440,15346598,15346631,0,0,158,191
33357,15346588,15346629,15346657,0,0,41,69
33355,15346514,15346598,15346672,0,0,84,158
33334,15345890,15346304,15346676,0,0,414,786
33356,15346524,15346628,15346692,0,0,104,168
33359,15346616,15346631,15346693,0,0,15,77
33360,15346677,15346677,15346708,0,0,0,31
33344,15346259,15346261,15346711,0,0,2,452
33346,15346332,15346380,15346757,0,0,48,425
33349,15346333,15346426,15346802,0,0,93,469
33362,15346767,15346767,15346828,0,0,0,61
33364,15346768,15346802,15346861,0,0,34,93
33361,15346708,15346708,15346890,0,0,0,182
33366,15346827,15346890,15346953,0,0,63,126
33367,15346902,15346953,15346987,0,0,51,85
33358,15346615,15346672,15347053,0,0,57,438
33369,15346948,15347053,15347104,0,0,105,156
33370,15346999,15347053,15347112,0,0,54,113
33371,15347058,15347104,15347164,0,0,46,106
33373,15347134,15347134,15347201,0,0,0,67
33363,15346767,15346828,15347263,0,0,61,496
33365,15346768,15346861,15347294,0,0,93,526
33375,15347212,15347294,15347354,0,0,82,142
33376,15347271,15347354,15347415,0,0,83,144
33368,15346936,15346987,15347443,0,0,51,507
33374,15347197,15347263,15347485,0,0,66,288
33379,15347331,15347443,15347504,0,0,112,173
33380,15347391,15347504,15347661,0,0,113,270
33381,15347392,15347661,15347694,0,0,269,302
33377,15347271,15347415,15347798,0,0,144,527
33382,15347548,15347694,15347799,0,0,146,251
33386,15347714,15347799,15347858,0,0,85,144
33383,15347653,15347798,15347859,0,0,145,206
33378,15347271,15347485,15347868,0,0,214,597
33387,15347714,15347858,15347917,0,0,144,203
33384,15347713,15347868,15347929,0,0,155,216
33388,15347714,15347859,15348158,0,0,145,444
33390,15347773,15348158,15348219,0,0,385,446
33372,15347132,15347201,15348261,0,0,69,1129
33391,15347952,15348219,15348280,0,0,267,328
33393,15348029,15348261,15348305,0,0,232,276
33392,15348013,15348261,15348322,0,0,248,309
33389,15347714,15347917,15348339,0,0,203,625
33385,15347713,15347929,15348352,0,0,216,639
33395,15348073,15348305,15348367,0,0,232,294
33396,15348135,15348322,15348381,0,0,187,246
33399,15348194,15348339,15348401,0,0,145,207
33397,15348193,15348352,15348416,0,0,159,223
33400,15348194,15348367,15348430,0,0,173,236
33402,15348315,15348401,15348435,0,0,86,120
33403,15348348,15348430,15348489,0,0,82,141
33404,15348407,15348435,15348497,0,0,28,90
33405,15348469,15348489,15348536,0,0,20,67
33406,15348516,15348516,15348576,0,0,0,60
33410,15348576,15348576,15348636,0,0,0,60
33401,15348194,15348381,15348703,0,0,187,509
33398,15348193,15348416,15348740,0,0,223,547
33412,15348695,15348703,15348765,0,0,8,70
33394,15348029,15348280,15348768,0,0,251,739
33407,15348516,15348536,15348777,0,0,20,261
33408,15348575,15348740,15348801,0,0,165,226
33414,15348792,15348801,15348858,0,0,9,66
32905,15318496,15339906,15348860,0,0,21410,30364
33415,15348849,15348849,15348909,0,0,0,60
33416,15348909,15348909,15348968,0,0,0,59
33411,15348576,15348636,15349028,0,0,60,452
33417,15349000,15349000,15349061,0,0,0,61
33421,15349061,15349061,15349138,0,0,0,77
33423,15349079,15349079,15349138,0,0,0,59
33409,15348575,15348777,15349171,0,0,202,596
33424,15349138,15349138,15349190,0,0,0,52
33316,15344590,15344782,15349191,0,0,192,4601
33413,15348757,15348765,15349198,0,0,8,441
33418,15349000,15349171,15349233,0,0,171,233
33426,15349190,15349190,15349250,0,0,0,60
33427,15349250,15349250,15349309,0,0,0,59
33419,15349000,15349000,15349370,0,0,0,370
33425,15349189,15349189,15349370,0,0,0,181
33237,15340218,15340218,15349413,0,0,0,9195
33428,15349369,15349369,15349430,0,0,0,61
33430,15349370,15349370,15349430,0,0,0,60
33431,15349370,15349370,15349536,0,0,0,166
33420,15349000,15349191,15349562,0,0,191,562
33432,15349429,15349430,15349720,0,0,1,291
33433,15349536,15349536,15349758,0,0,0,222
33429,15349369,15349430,15349781,0,0,61,412
33436,15349758,15349758,15349786,0,0,0,28
33434,15349756,15349756,15349787,0,0,0,31
33422,15349063,15349233,15349887,0,0,170,824
33437,15349758,15349758,15350114,0,0,0,356
33435,15349756,15349781,15350139,0,0,25,383
33440,15350114,15350114,15350172,0,0,0,58
33438,15349786,15349786,15350173,0,0,0,387
33441,15350172,15350172,15350308,0,0,0,136
33442,15350172,15350172,15350431,0,0,0,259
33443,15350172,15350172,15350432,0,0,0,260
33445,15350431,15350431,15350488,0,0,0,57
33444,15350369,15350369,15350669,0,0,0,300
33448,15350669,15350669,15350789,0,0,0,120
33446,15350488,15350488,15350876,0,0,0,388
33447,15350488,15350488,15350877,0,0,0,389
33449,15350788,15350788,15350937,0,0,0,149
33453,15350937,15350937,15350996,0,0,0,59
33451,15350936,15350936,15350997,0,0,0,61
33454,15350937,15350937,15351176,0,0,0,239
33455,15350937,15350996,15351295,0,0,59,358
33452,15350936,15350997,15351298,0,0,61,362
33458,15351297,15351297,15351358,0,0,0,61
33456,15351176,15351176,15351537,0,0,0,361
33461,15351537,15351537,15351658,0,0,0,121
33457,15351296,15351298,15351723,0,0,2,427
33460,15351297,15351358,15351782,0,0,61,485
33459,15351297,15351723,15351784,0,0,426,487
33463,15351777,15351782,15351842,0,0,5,65
33464,15351777,15351784,15351844,0,0,7,67
33462,15351720,15351720,15352002,0,0,0,282
33467,15352001,15352002,15352120,0,0,1,119
33468,15352119,15352120,15352241,0,0,1,122
33465,15351777,15351842,15352244,0,0,65,467
33466,15351777,15351844,15352247,0,0,67,470
33470,15352240,15352241,15352302,0,0,1,62
33471,15352301,15352301,15352480,0,0,0,179
33472,15352301,15352302,15352580,0,0,1,279
33469,15352239,15352247,15352588,0,0,8,349
33475,15352641,15352641,15352699,0,0,0,58
33474,15352516,15352516,15352880,0,0,0,364
33479,15352880,15352880,15353001,0,0,0,121
33477,15352641,15352699,15353178,0,0,58,537
33480,15353001,15353001,15353231,0,0,0,230
33483,15353230,15353231,15353351,0,0,1,121
33484,15353350,15353351,15353470,0,0,1,120
33481,15353169,15353178,15353538,0,0,9,369
33353,15346471,15346711,15353699,0,0,240,7228
33485,15353469,15353470,15353711,0,0,1,242
33476,15352641,15353699,15353758,0,0,1058,1117
33486,15353591,15353591,15354020,0,0,0,429
33488,15353710,15353711,15354020,0,0,1,310
33490,15354019,15354020,15354047,0,0,1,28
33482,15353169,15353758,15354119,0,0,589,950
33492,15354046,15354046,15354126,0,0,0,80
33478,15352641,15353699,15354179,0,0,1058,1538
32934,15320644,15342610,15354288,0,0,21966,33644
33495,15354054,15354054,15354442,0,0,0,388
33496,15354125,15354126,15354443,0,0,1,318
33487,15353591,15354119,15354548,0,0,528,957
33498,15354502,15354502,15354564,0,0,0,62
33497,15354442,15354442,15354565,0,0,0,123
33491,15354045,15354179,15354577,0,0,134,532
33494,15354054,15354548,15354620,0,0,494,566
33499,15354502,15354577,15354639,0,0,75,137
33502,15354564,15354565,15354682,0,0,1,118
33500,15354502,15354564,15354864,0,0,62,362
33501,15354502,15354620,15354921,0,0,118,419
33503,15354741,15354741,15354922,0,0,0,181
33505,15354864,15354864,15354922,0,0,0,58
33507,15354982,15354982,15355281,0,0,0,299
33504,15354863,15354863,15355282,0,0,0,419
33506,15354922,15354922,15355282,0,0,0,360
33509,15355342,15355342,15355402,0,0,0,60
33508,15355281,15355281,15355403,0,0,0,122
33511,15355342,15355402,15355701,0,0,60,359
33513,15355463,15355463,15355765,0,0,0,302
33517,15355764,15355765,15355883,0,0,1,119
33518,15355881,15355883,15356003,0,0,2,122
33515,15355702,15355702,15356063,0,0,0,361
33520,15356122,15356122,15356185,0,0,0,63
33519,15356063,15356063,15356242,0,0,0,179
33523,15356123,15356185,15356543,0,0,62,420
33525,15356542,15356543,15356619,0,0,1,77
33524,15356241,15356242,15356620,0,0,1,379
33008,15325578,15348860,15356642,0,0,23282,31064
33354,15346510,15349413,15356664,0,0,2903,10154
33510,15355342,15356664,15356724,0,0,1322,1382
33529,15356618,15356620,15356738,0,0,2,120
33514,15355702,15356724,15356786,0,0,1022,1084
33512,15355342,15356664,15356964,0,0,1322,1622
33530,15356798,15356798,15356983,0,0,0,185
33527,15356542,15356619,15356994,0,0,77,452
33521,15356122,15356964,15357027,0,0,842,905
33533,15356983,15356983,15357036,0,0,0,53
33439,15349795,15349795,15357119,0,0,0,7324
33534,15356983,15356994,15357138,0,0,11,155
33516,15355702,15356786,15357148,0,0,1084,1446
33526,15356542,15357119,15357196,0,0,577,654
33536,15357127,15357138,15357279,0,0,11,152
33535,15356983,15357036,15357384,0,0,53,401
33522,15356122,15357027,15357387,0,0,905,1265
33532,15356979,15357387,15357445,0,0,408,466
33538,15357388,15357388,15357449,0,0,0,61
33528,15356542,15357148,15357524,0,0,606,982
33531,15356978,15357196,15357549,0,0,218,571
33537,15357331,15357331,15357569,0,0,0,238
33450,15350808,15350808,15357610,0,0,0,6802
33540,15357449,15357449,15357673,0,0,0,224
33539,15357388,15357445,15357731,0,0,57,343
33542,15357704,15357704,15357764,0,0,0,60
33543,15357704,15357704,15357765,0,0,0,61
33541,15357569,15357569,15357964,0,0,0,395
33544,15357704,15357704,15358026,0,0,0,322
33546,15357964,15357964,15358026,0,0,0,62
33545,15357704,15357704,15358028,0,0,0,324
33473,15352514,15352588,15358101,0,0,74,5587
33547,15358090,15358090,15358332,0,0,0,242
33548,15358090,15358090,15358332,0,0,0,242
33550,15358390,15358390,15358450,0,0,0,60
33551,15358390,15358390,15358450,0,0,0,60
33549,15358090,15358090,15358451,0,0,0,361
33554,15358449,15358449,15358570,0,0,0,121
33552,15358390,15358390,15358632,0,0,0,242
33555,15358570,15358570,15358632,0,0,0,62
33553,15358390,15358390,15358633,0,0,0,243
33556,15358631,15358631,15358932,0,0,0,301
33557,15358689,15358689,15358991,0,0,0,302
33558,15358690,15358690,15358991,0,0,0,301
33559,15358991,15358991,15359231,0,0,0,240
33561,15359050,15359050,15359289,0,0,0,239
33560,15359049,15359049,15359290,0,0,0,241
33562,15359231,15359231,15359350,0,0,0,119
33564,15359350,15359350,15359409,0,0,0,59
33565,15359350,15359350,15359410,0,0,0,60
33563,15359349,15359349,15359590,0,0,0,241
33566,15359350,15359350,15359590,0,0,0,240
33567,15359409,15359409,15359652,0,0,0,243
33568,15359651,15359651,15359832,0,0,0,181
33571,15359831,15359831,15359950,0,0,0,119
33569,15359709,15359709,15360010,0,0,0,301
33570,15359710,15359710,15360010,0,0,0,300
33572,15360010,15360010,15360250,0,0,0,240
33573,15360069,15360069,15360310,0,0,0,241
33574,15360069,15360069,15360310,0,0,0,241
33578,15360370,15360370,15360431,0,0,0,61
33576,15360369,15360369,15360432,0,0,0,63
33579,15360370,15360370,15360610,0,0,0,240
33575,15360250,15360250,15360611,0,0,0,361
33577,15360369,15360369,15360611,0,0,0,242
33580,15360610,15360610,15360671,0,0,0,61
33581,15360670,15360670,15360731,0,0,0,61
33582,15360670,15360670,15360732,0,0,0,62
33583,15360670,15360670,15360970,0,0,0,300
33585,15360731,15360731,15360970,0,0,0,239
33587,15361022,15361022,15361089,0,0,0,67
33589,15361023,15361023,15361089,0,0,0,66
33584,15360671,15360671,15361090,0,0,0,419
33591,15361088,15361088,15361233,0,0,0,145
33592,15361232,15361232,15361273,0,0,0,41
33590,15361023,15361023,15361274,0,0,0,251
33588,15361022,15361022,15361275,0,0,0,253
33249,15340682,15354288,15361404,0,0,13606,20722
33596,15361348,15361404,15361466,0,0,56,118
33594,15361347,15361404,15361467,0,0,57,120
33597,15361348,15361404,15361644,0,0,56,296
33598,15361348,15361404,15361644,0,0,56,296
33595,15361347,15361404,15361646,0,0,57,299
33599,15361648,15361648,15361710,0,0,0,62
33602,15361649,15361649,15361947,0,0,0,298
33600,15361648,15361648,15361948,0,0,0,300
33601,15361648,15361648,15361948,0,0,0,300
33604,15362009,15362009,15362070,0,0,0,61
33603,15361947,15361947,15362071,0,0,0,124
33605,15362009,15362009,15362071,0,0,0,62
33606,15362009,15362009,15362188,0,0,0,179
33607,15362010,15362010,15362188,0,0,0,178
33608,15362128,15362128,15362429,0,0,0,301
33609,15362427,15362427,15362492,0,0,0,65
33610,15362491,15362491,15362549,0,0,0,58
33489,15353764,15355282,15362604,0,0,1518,8840
33611,15362549,15362549,15362721,0,0,0,172
33612,15362781,15362781,15363023,0,0,0,242
33613,15363022,15363022,15363081,0,0,0,59
33614,15363141,15363141,15363322,0,0,0,181
33615,15363322,15363322,15363442,0,0,0,120
33616,15363442,15363442,15363563,0,0,0,121
33617,15363622,15363622,15363742,0,0,0,120
33493,15354052,15356642,15363861,0,0,2590,9809
33618,15363802,15363802,15364042,0,0,0,240
33619,15364042,15364042,15364102,0,0,0,60
33620,15364163,15364163,15364342,0,0,0,179
33621,15364341,15364341,15364463,0,0,0,122
33622,15364463,15364463,15364582,0,0,0,119
33623,15364582,15364582,15364764,0,0,0,182
33624,15364822,15364822,15365064,0,0,0,242
33625,15365063,15365063,15365122,0,0,0,59
33626,15365122,15365122,15365364,0,0,0,242
33627,15365363,15365363,15365422,0,0,0,59
33628,15365422,15365422,15365541,0,0,0,119
33629,15365601,15365601,15365782,0,0,0,181
33630,15365782,15365782,15366023,0,0,0,241
33631,15366023,15366023,15366082,0,0,0,59
33632,15366142,15366142,15366383,0,0,0,241
33633,15366383,15366383,15366442,0,0,0,59
33634,15366442,15366442,15366563,0,0,0,121
33635,15366622,15366622,15366802,0,0,0,180
33636,15366802,15366802,15367042,0,0,0,240
33637,15367042,15367042,15367102,0,0,0,60
33638,15367102,15367102,15367402,0,0,0,300
33639,15367401,15367401,15367463,0,0,0,62
33640,15367463,15367463,15367581,0,0,0,118
33641,15367581,15367581,15367763,0,0,0,182
32618,15298690,15363861,15367919,0,0,65171,69229
33586,15361020,15361020,15368330,0,0,0,7310
32681,15305783,15367919,15368387,0,0,62136,62604
33593,15361272,15361275,15368422,0,0,3,7150
33642,15367822,15367822,15368437,0,0,0,615
32685,15309225,15368387,15368492,0,0,59162,59267
33645,15368437,15368437,15368557,0,0,0,120
33646,15368618,15368618,15368861,0,0,0,243
33647,15368861,15368861,15368978,0,0,0,117
33648,15368978,15368978,15369039,0,0,0,61
33649,15369098,15369098,15369278,0,0,0,180
33650,15369340,15369340,15369518,0,0,0,178
33651,15369518,15369518,15369639,0,0,0,121
33652,15369698,15369698,15369880,0,0,0,182
33653,15369880,15369880,15369998,0,0,0,118
33654,15369998,15369998,15370118,0,0,0,120
33655,15370117,15370117,15370297,0,0,0,180
33656,15370358,15370358,15370540,0,0,0,182
33657,15370539,15370539,15370657,0,0,0,118
33658,15370657,15370657,15370899,0,0,0,242
33659,15370899,15370899,15371033,0,0,0,134
33660,15371033,15371033,15371092,0,0,0,59
33661,15371154,15371154,15371333,0,0,0,179
33662,15371392,15371392,15371516,0,0,0,124
33663,15371516,15371516,15371636,0,0,0,120
33664,15371693,15371693,15371873,0,0,0,180
33665,15371873,15371873,15371993,0,0,0,120
33666,15371992,15371992,15372112,0,0,0,120
33667,15372172,15372172,15372354,0,0,0,182
33668,15372354,15372354,15372534,0,0,0,180
33669,15372533,15372533,15372654,0,0,0,121
33670,15372713,15372713,15372894,0,0,0,181
32686,15309422,15368492,15372897,0,0,59070,63475
32687,15309503,15372897,15372923,0,0,63394,63420
33671,15372893,15372893,15373013,0,0,0,120
33672,15373013,15373013,15373133,0,0,0,120
33673,15373194,15373194,15373372,0,0,0,178
33674,15373372,15373372,15373613,0,0,0,241
33675,15373613,15373613,15373732,0,0,0,119
33676,15373732,15373732,15373915,0,0,0,183
33677,15373915,15373915,15374037,0,0,0,122
33678,15374037,15374037,15374156,0,0,0,119
33679,15374213,15374213,15374393,0,0,0,180
33680,15374393,15374393,15374633,0,0,0,240
33681,15374633,15374633,15374754,0,0,0,121
33682,15374753,15374753,15374993,0,0,0,240
33683,15374993,15374993,15375113,0,0,0,120
33684,15375113,15375113,15375173,0,0,0,60
33685,15375233,15375233,15375413,0,0,0,180
33686,15375473,15375473,15375655,0,0,0,182
33643,15368337,15368337,15375680,0,0,0,7343
33687,15375655,15375655,15375748,0,0,0,93
33688,15375808,15375808,15376048,0,0,0,240
33689,15376047,15376047,15376167,0,0,0,120
33690,15376167,15376167,15376228,0,0,0,61
33691,15376228,15376228,15376468,0,0,0,240
33692,15376467,15376467,15376708,0,0,0,241
33693,15376708,15376708,15376827,0,0,0,119
32693,15309665,15372923,15377212,0,0,63258,67547
33694,15376827,15376827,15377369,0,0,0,542
33695,15377368,15377368,15377489,0,0,0,121
33696,15377489,15377489,15377608,0,0,0,119
33697,15377607,15377607,15377789,0,0,0,182
33698,15377848,15377848,15378089,0,0,0,241
33699,15378148,15378148,15378448,0,0,0,300
33700,15378448,15378448,15378669,0,0,0,221
33701,15378669,15378669,15378908,0,0,0,239
33702,15378969,15378969,15379035,0,0,0,66
33703,15379035,15379035,15379149,0,0,0,114
33704,15379208,15379208,15379388,0,0,0,180
33705,15379449,15379449,15379631,0,0,0,182
33706,15379630,15379630,15379749,0,0,0,119
33707,15379809,15379809,15380406,0,0,0,597
33708,15380406,15380406,15380452,0,0,0,46
33710,15380452,15380452,15380644,0,0,0,192
33711,15380643,15380643,15380942,0,0,0,299
33712,15380942,15380942,15381363,0,0,0,421
33713,15381363,15381363,15381484,0,0,0,121
32893,15318186,15377212,15381513,0,0,59026,63327
32896,15318207,15381513,15381574,0,0,63306,63367
33715,15381663,15381663,15381723,0,0,0,60
33717,15381664,15381664,15381723,0,0,0,59
33714,15381543,15381543,15381784,0,0,0,241
33718,15381664,15381664,15381964,0,0,0,300
33716,15381663,15381663,15381965,0,0,0,302
33719,15382023,15382023,15382086,0,0,0,63
33720,15382023,15382023,15382203,0,0,0,180
33721,15382024,15382024,15382203,0,0,0,179
33725,15382263,15382263,15382323,0,0,0,60
33723,15382262,15382262,15382324,0,0,0,62
33726,15382263,15382323,15382670,0,0,60,407
33724,15382262,15382324,15382672,0,0,62,410
33728,15382445,15382672,15382729,0,0,227,284
33727,15382383,15382670,15382732,0,0,287,349
33729,15382502,15382672,15382733,0,0,170,231
33730,15382563,15382729,15382776,0,0,166,213
33732,15382627,15382733,15382793,0,0,106,166
33731,15382609,15382732,15382810,0,0,123,201
33733,15382686,15382776,15382845,0,0,90,159
33736,15382687,15382793,15382858,0,0,106,171
33739,15382784,15382858,15382900,0,0,74,116
33740,15382826,15382900,15382975,0,0,74,149
33742,15382901,15382975,15383036,0,0,74,135
33743,15382962,15383036,15383065,0,0,74,103
33737,15382687,15382810,15383086,0,0,123,399
33744,15382990,15383065,15383087,0,0,75,97
33747,15383012,15383087,15383163,0,0,75,151
33738,15382761,15382845,15383199,0,0,84,438
33750,15383087,15383199,15383255,0,0,112,168
33751,15383143,15383255,15383318,0,0,112,175
33752,15383205,15383318,15383378,0,0,113,173
33753,15383206,15383378,15383437,0,0,172,231
33754,15383265,15383437,15383496,0,0,172,231
33745,15383009,15383086,15383500,0,0,77,491
33756,15383386,15383500,15383541,0,0,114,155
33755,15383324,15383496,15383559,0,0,172,235
33757,15383386,15383541,15383582,0,0,155,196
33758,15383427,15383559,15383620,0,0,132,193
33749,15383024,15383163,15383627,0,0,139,603
33759,15383487,15383582,15383652,0,0,95,165
33761,15383551,15383627,15383687,0,0,76,136
33760,15383488,15383620,15383689,0,0,132,201
33764,15383552,15383652,15383710,0,0,100,158
33766,15383556,15383689,15383743,0,0,133,187
33767,15383610,15383710,15383770,0,0,100,160
33768,15383669,15383743,15383806,0,0,74,137
33769,15383670,15383770,15383832,0,0,100,162
33770,15383731,15383806,15383867,0,0,75,136
33771,15383732,15383832,15383891,0,0,100,159
33772,15383790,15383867,15383927,0,0,77,137
33773,15383791,15383891,15383950,0,0,100,159
33774,15383849,15383927,15383989,0,0,78,140
33775,15383911,15383950,15384010,0,0,39,99
33765,15383552,15383687,15384047,0,0,135,495
33776,15383911,15383989,15384049,0,0,78,138
33779,15383970,15384010,15384071,0,0,40,101
33780,15383970,15384047,15384108,0,0,77,138
33781,15383970,15384049,15384111,0,0,79,141
33783,15384031,15384108,15384168,0,0,77,137
33784,15384031,15384111,15384171,0,0,80,140
33786,15384158,15384171,15384225,0,0,13,67
33785,15384090,15384168,15384237,0,0,78,147
33788,15384211,15384237,15384257,0,0,26,46
33787,15384159,15384225,15384277,0,0,66,118
33790,15384231,15384277,15384337,0,0,46,106
33782,15383970,15384071,15384392,0,0,101,422
33791,15384291,15384337,15384400,0,0,46,109
33794,15384353,15384392,15384450,0,0,39,97
33795,15384353,15384400,15384459,0,0,47,106
33644,15368425,15368425,15384461,0,0,0,16036
33797,15384411,15384459,15384504,0,0,48,93
33734,15382686,15384461,15384533,0,0,1775,1847
33798,15384455,15384504,15384587,0,0,49,132
33748,15383023,15384533,15384598,0,0,1510,1575
33741,15382828,15384461,15384621,0,0,1633,1793
33789,15384211,15384257,15384646,0,0,46,435
33762,15383551,15384598,15384658,0,0,1047,1107
33800,15384597,15384597,15384660,0,0,0,63
33796,15384353,15384450,15384696,0,0,97,343
33801,15384599,15384646,15384707,0,0,47,108
33804,15384659,15384660,15384715,0,0,1,56
33777,15383969,15384658,15384721,0,0,689,752
33735,15382686,15384461,15384738,0,0,1775,2052
33805,15384659,15384696,15384751,0,0,37,92
33807,15384660,15384715,15384768,0,0,55,108
33808,15384713,15384751,15384771,0,0,38,58
33792,15384352,15384738,15384798,0,0,386,446
33810,15384733,15384771,15384843,0,0,38,110
33806,15384659,15384707,15384853,0,0,48,194
33811,15384743,15384843,15384904,0,0,100,161
33812,15384745,15384853,15384912,0,0,108,167
33746,15383011,15384461,15384939,0,0,1450,1928
33815,15384864,15384904,15384965,0,0,40,101
33816,15384864,15384912,15384974,0,0,48,110
33763,15383551,15384621,15384982,0,0,1070,1431
33802,15384658,15384939,15384996,0,0,281,338
33818,15384924,15384974,15385035,0,0,50,111
33778,15383969,15384721,15385044,0,0,752,1075
33793,15384352,15384798,15385045,0,0,446,693
33813,15384863,15384996,15385059,0,0,133,196
33820,15384985,15385045,15385074,0,0,60,89
33819,15384925,15385035,15385095,0,0,110,170
33822,15385026,15385045,15385104,0,0,19,78
33817,15384864,15384965,15385116,0,0,101,252
33803,15384658,15384982,15385129,0,0,324,471
33823,15385084,15385084,15385146,0,0,0,62
33824,15385084,15385084,15385146,0,0,0,62
33826,15385085,15385095,15385155,0,0,10,70
33814,15384863,15385044,15385196,0,0,181,333
33828,15385145,15385145,15385210,0,0,0,65
33830,15385210,15385210,15385257,0,0,0,47
33829,15385208,15385208,15385258,0,0,0,50
33827,15385085,15385104,15385277,0,0,19,192
33825,15385084,15385129,15385303,0,0,45,219
33831,15385257,15385257,15385318,0,0,0,61
33832,15385318,15385318,15385376,0,0,0,58
33833,15385376,15385376,15385440,0,0,0,64
33834,15385436,15385436,15385493,0,0,0,57
33809,15384732,15384768,15385583,0,0,36,851
33839,15385440,15385583,15385636,0,0,143,196
33841,15385492,15385636,15385693,0,0,144,201
33842,15385505,15385693,15385737,0,0,188,232
33843,15385549,15385737,15385780,0,0,188,231
33836,15385436,15385440,15385788,0,0,4,352
33845,15385673,15385788,15385808,0,0,115,135
33844,15385592,15385780,15385862,0,0,188,270
33847,15385713,15385808,15385879,0,0,95,166
33849,15385783,15385879,15385912,0,0,96,129
33848,15385723,15385862,15385922,0,0,139,199
33853,15385930,15385930,15386030,0,0,0,100
33854,15386059,15386059,15386116,0,0,0,57
33851,15385899,15385912,15386130,0,0,13,231
33855,15386116,15386116,15386339,0,0,0,223
33858,15386339,15386339,15386397,0,0,0,58
33859,15386397,15386397,15386457,0,0,0,60
33860,15386457,15386457,15386520,0,0,0,63
33857,15386277,15386277,15386563,0,0,0,286
33861,15386520,15386520,15386563,0,0,0,43
33862,15386563,15386563,15386625,0,0,0,62
33864,15386685,15386685,15386793,0,0,0,108
33863,15386624,15386624,15386886,0,0,0,262
33866,15386788,15386793,15386890,0,0,5,102
33867,15386885,15386886,15386945,0,0,1,60
33835,15385436,15386945,15387003,0,0,1509,1567
33837,15385436,15387003,15387352,0,0,1567,1916
33838,15385436,15385493,15391213,0,0,57,5777
33868,15387005,15391213,15391276,0,0,4208,4271
33870,15387005,15391276,15391500,0,0,4271,4495
33722,15382142,15382142,15391834,0,0,0,9692
33872,15387068,15391500,15391980,0,0,4432,4912
33846,15385711,15391834,15392020,0,0,6123,6309
33875,15387445,15391980,15392198,0,0,4535,4753
33877,15387548,15392198,15392252,0,0,4650,4704
33709,15380449,15380449,15392321,0,0,0,11872
33879,15387602,15392321,15392382,0,0,4719,4780
33880,15387663,15392382,15392439,0,0,4719,4776
32932,15320456,15381574,15392744,0,0,61118,72288
33881,15387720,15392439,15392803,0,0,4719,5083
33883,15387781,15392803,15392844,0,0,5022,5063
33884,15387781,15392844,15393065,0,0,5063,5284
33886,15388084,15393065,15393125,0,0,4981,5041
33887,15388143,15393125,15393353,0,0,4982,5210
33889,15388144,15393353,15393410,0,0,5209,5266
33891,15388471,15393410,15393471,0,0,4939,5000
33894,15388531,15393471,15393889,0,0,4940,5358
33895,15389015,15393889,15393982,0,0,4874,4967
33896,15389087,15393982,15394064,0,0,4895,4977
33898,15389087,15394064,15394359,0,0,4977,5272
33900,15389088,15394359,15394383,0,0,5271,5295
33901,15389234,15394383,15394425,0,0,5149,5191
33902,15389276,15394425,15394470,0,0,5149,5194
33903,15389321,15394470,15394530,0,0,5149,5209
33904,15389381,15394530,15394589,0,0,5149,5208
33905,15389440,15394589,15394620,0,0,5149,5180
33906,15389441,15394620,15394764,0,0,5179,5323
33907,15389470,15394764,15394800,0,0,5294,5330
33840,15385486,15387352,15394920,0,0,1866,9434
33909,15389470,15394800,15395102,0,0,5330,5632
33852,15385899,15394920,15395138,0,0,9021,9239
33912,15389506,15395102,15395151,0,0,5596,5645
33914,15389554,15395151,15395174,0,0,5597,5620
33915,15389577,15395174,15395231,0,0,5597,5654
33916,15389589,15395231,15395275,0,0,5642,5686
33917,15389633,15395275,15395298,0,0,5642,5665
33919,15389656,15395298,15395348,0,0,5642,5692
33920,15389667,15395348,15395387,0,0,5681,5720
33856,15386276,15395138,15395426,0,0,8862,9150
33921,15389705,15395387,15395433,0,0,5682,5728
33922,15389750,15395433,15395454,0,0,5683,5704
33923,15389771,15395454,15395475,0,0,5683,5704
33924,15389792,15395475,15395537,0,0,5683,5745
33925,15389853,15395537,15395558,0,0,5684,5705
33927,15389874,15395558,15395622,0,0,5684,5748
33865,15386685,15395426,15395627,0,0,8741,8942
33869,15387005,15395627,15395690,0,0,8622,8685
33929,15389937,15395622,15395867,0,0,5685,5930
33871,15387005,15395690,15395914,0,0,8685,8909
33930,15389938,15395867,15395925,0,0,5929,5987
33932,15390015,15395925,15395963,0,0,5910,5948
33933,15390053,15395963,15395992,0,0,5910,5939
33934,15390067,15395992,15396038,0,0,5925,5971
33874,15387445,15395914,15396072,0,0,8469,8627
33935,15390068,15396038,15396093,0,0,5970,6025
33882,15387780,15396072,15396115,0,0,8292,8335
33936,15390123,15396093,15396152,0,0,5970,6029
33937,15390182,15396152,15396209,0,0,5970,6027
33938,15390197,15396209,15396251,0,0,6012,6054
33939,15390239,15396251,15396323,0,0,6012,6084
33885,15387781,15396115,15396336,0,0,8334,8555
33940,15390257,15396323,15396376,0,0,6066,6119
33888,15388143,15396336,15396565,0,0,8193,8422
33892,15388471,15396565,15396626,0,0,8094,8155
33943,15390307,15396376,15396753,0,0,6069,6446
33944,15390309,15396753,15396779,0,0,6444,6470
33945,15390331,15396779,15396838,0,0,6448,6507
33946,15390334,15396838,15396887,0,0,6504,6553
33947,15390383,15396887,15396938,0,0,6504,6555
33893,15388471,15396626,15397105,0,0,8155,8634
33897,15389087,15397105,15397188,0,0,8018,8101
33899,15389087,15397188,15397483,0,0,8101,8396
33908,15389470,15397483,15397519,0,0,8013,8049
33910,15389470,15397519,15397821,0,0,8049,8351
33911,15389504,15397821,15397947,0,0,8317,8443
33918,15389654,15397947,15398082,0,0,8293,8428
33799,15384461,15385303,15398364,0,0,842,13903
33873,15387343,15398364,15399453,0,0,11021,12110
33890,15388432,15398364,15399487,0,0,9932,11055
33931,15390012,15399487,15399668,0,0,9475,9656
33878,15387600,15392252,15399698,0,0,4652,12098
33928,15389936,15399487,15399734,0,0,9551,9798
33942,15390306,15399734,15399764,0,0,9428,9458
33952,15390682,15399698,15399865,0,0,9016,9183
33953,15390855,15399865,15399999,0,0,9010,9144
33948,15390443,15399764,15400044,0,0,9321,9601
33941,15390305,15399668,15400047,0,0,9363,9742
33949,15390472,15400044,15400066,0,0,9572,9594
33954,15390865,15399999,15400115,0,0,9134,9250
33956,15390928,15400066,15400126,0,0,9138,9198
33958,15391105,15400126,15400197,0,0,9021,9092
33959,15391112,15400197,15400282,0,0,9085,9170
33960,15391148,15400197,15400285,0,0,9049,9137
33961,15391178,15400282,15400304,0,0,9104,9126
33962,15391200,15400285,15400330,0,0,9085,9130
33963,15391245,15400304,15400364,0,0,9059,9119
33964,15391364,15400330,15400392,0,0,8966,9028
33967,15391484,15400392,15400441,0,0,8908,8957
33965,15391475,15400364,15400454,0,0,8889,8979
33970,15391530,15400441,15400507,0,0,8911,8977
33955,15390927,15400047,15400547,0,0,9120,9620
33972,15391575,15400507,15400552,0,0,8932,8977
33913,15389551,15399453,15400569,0,0,9902,11018
33957,15390928,15400115,15400614,0,0,9187,9686
33975,15391742,15400614,15400669,0,0,8872,8927
33980,15391938,15400669,15400699,0,0,8731,8761
33974,15391688,15400552,15400717,0,0,8864,9029
33981,15391971,15400699,15400762,0,0,8728,8791
33971,15391532,15400454,15400784,0,0,8922,9252
33987,15392492,15400784,15400825,0,0,8292,8333
33968,15391494,15400547,15400916,0,0,9053,9422
33969,15391495,15400916,15400953,0,0,9421,9458
33950,15390501,15396938,15401003,0,0,6437,10502
33991,15392615,15401003,15401034,0,0,8388,8419
33983,15392034,15400717,15401066,0,0,8683,9032
33990,15392518,15400825,15401080,0,0,8307,8562
33992,15392868,15401034,15401091,0,0,8166,8223
33994,15392880,15401066,15401135,0,0,8186,8255
33999,15393102,15401091,15401162,0,0,7989,8060
34000,15393207,15401135,15401189,0,0,7928,7982
34002,15393409,15401162,15401223,0,0,7753,7814
34005,15393485,15401223,15401250,0,0,7738,7765
34006,15393678,15401250,15401291,0,0,7572,7613
34007,15393679,15401291,15401325,0,0,7612,7646
34004,15393470,15401189,15401371,0,0,7719,7901
34012,15393864,15401371,15401393,0,0,7507,7529
34014,15393934,15401393,15401418,0,0,7459,7484
34010,15393689,15401325,15401525,0,0,7636,7836
33998,15392928,15401080,15401535,0,0,8152,8607
34023,15394046,15401525,15401552,0,0,7479,7506
34025,15394173,15401535,15401555,0,0,7362,7382
34017,15393951,15401418,15401578,0,0,7467,7627
34031,15394443,15401578,15401613,0,0,7135,7170
34030,15394267,15401555,15401630,0,0,7288,7363
33951,15390666,15400569,15401647,0,0,9903,10981
34027,15394173,15401552,15401728,0,0,7379,7555
34035,15394731,15401728,15401798,0,0,6997,7067
34036,15394802,15401798,15401836,0,0,6996,7034
34032,15394445,15401613,15401854,0,0,7168,7409
34040,15395044,15401854,15401897,0,0,6810,6853
34034,15394683,15401630,15401949,0,0,6947,7266
34042,15395087,15401897,15401959,0,0,6810,6872
34046,15395148,15401949,15401994,0,0,6801,6846
34047,15395148,15401959,15402004,0,0,6811,6856
34048,15395192,15401994,15402021,0,0,6802,6829
34039,15394803,15401836,15402121,0,0,7033,7318
34051,15395218,15402121,15402194,0,0,6903,6976
34052,15395232,15402194,15402253,0,0,6962,7021
34049,15395192,15402004,15402270,0,0,6812,7078
34053,15395290,15402253,15402307,0,0,6963,7017
34054,15395339,15402270,15402326,0,0,6931,6987
34055,15395344,15402307,15402363,0,0,6963,7019
34056,15395400,15402326,15402384,0,0,6926,6984
34057,15395490,15402363,15402396,0,0,6873,6906
34061,15395523,15402396,15402422,0,0,6873,6899
34058,15395490,15402384,15402444,0,0,6894,6954
34063,15395599,15402444,15402467,0,0,6845,6868
34064,15395606,15402467,15402549,0,0,6861,6943
34065,15395610,15402549,15402621,0,0,6939,7011
34066,15395687,15402621,15402699,0,0,6934,7012
34067,15395706,15402699,15402758,0,0,6993,7052
34068,15395826,15402758,15402782,0,0,6932,6956
34062,15395523,15402422,15402809,0,0,6899,7286
34069,15395910,15402782,15402848,0,0,6872,6938
34071,15395974,15402809,15402867,0,0,6835,6893
34074,15395975,15402867,15402924,0,0,6892,6949
34075,15396039,15402924,15402980,0,0,6885,6941
34076,15396041,15402980,15403015,0,0,6939,6974
34077,15396088,15403015,15403043,0,0,6927,6955
34078,15396097,15403043,15403094,0,0,6946,6997
33966,15391483,15401647,15403112,0,0,10164,11629
33976,15391754,15403112,15403145,0,0,11358,11391
34073,15395974,15402848,15403180,0,0,6874,7206
33973,15391679,15400953,15403189,0,0,9274,11510
34080,15396148,15403180,15403204,0,0,7032,7056
33979,15391787,15403145,15403219,0,0,11358,11432
33988,15392517,15403219,15403262,0,0,10702,10745
34082,15396181,15403204,15403264,0,0,7023,7083
34084,15396306,15403264,15403325,0,0,6958,7019
34085,15396366,15403325,15403364,0,0,6959,6998
34088,15396367,15403364,15403402,0,0,6997,7035
33989,15392517,15403262,15403518,0,0,10745,11001
33982,15392031,15403189,15403541,0,0,11158,11510
33997,15392928,15403541,15403562,0,0,10613,10634
34089,15396367,15403402,15403738,0,0,7035,7371
34001,15393395,15403562,15403759,0,0,10167,10364
34090,15396405,15403738,15403797,0,0,7333,7392
34091,15396464,15403797,15403859,0,0,7333,7395
34092,15396584,15403859,15403921,0,0,7275,7337
34003,15393468,15403759,15403944,0,0,10291,10476
34093,15396587,15403921,15403977,0,0,7334,7390
34008,15393679,15403944,15403978,0,0,10265,10299
33995,15392880,15403518,15404022,0,0,10638,11142
34094,15396599,15403977,15404024,0,0,7378,7425
34015,15393948,15404022,15404044,0,0,10074,10096
34097,15396703,15404024,15404066,0,0,7321,7363
34098,15396703,15404066,15404109,0,0,7363,7406
34009,15393679,15403978,15404189,0,0,10299,10510
34016,15393949,15404044,15404207,0,0,10095,10258
34026,15394173,15404189,15404209,0,0,10016,10036
34099,15396703,15404109,15404372,0,0,7406,7669
34028,15394173,15404207,15404384,0,0,10034,10211
34037,15394802,15404384,15404422,0,0,9582,9620
34101,15396755,15404372,15404435,0,0,7617,7680
34033,15394445,15404209,15404450,0,0,9764,10005
33850,15385814,15392020,15404455,0,0,6206,18641
34102,15396817,15404435,15404494,0,0,7618,7677
34103,15396876,15404494,15404533,0,0,7618,7657
34041,15395083,15404450,15404554,0,0,9367,9471
34104,15396912,15404533,15404580,0,0,7621,7668
34043,15395147,15404554,15404601,0,0,9407,9454
34105,15396915,15404580,15404630,0,0,7665,7715
34106,15396965,15404630,15404687,0,0,7665,7722
34038,15394802,15404422,15404708,0,0,9620,9906
34107,15397021,15404687,15404748,0,0,7666,7727
34059,15395521,15404708,15404787,0,0,9187,9266
34110,15397022,15404748,15404808,0,0,7726,7786
34044,15395147,15404601,15404913,0,0,9454,9766
34111,15397022,15404808,15405106,0,0,7786,8084
34112,15397142,15405106,15405151,0,0,7964,8009
34060,15395521,15404787,15405178,0,0,9266,9657
34113,15397184,15405151,15405212,0,0,7967,8028
34072,15395974,15405178,15405237,0,0,9204,9263
34070,15395973,15404913,15405246,0,0,8940,9273
34114,15397187,15405212,15405278,0,0,8025,8091
34086,15396366,15405237,15405336,0,0,8871,8970
34095,15396702,15405336,15405381,0,0,8634,8679
32972,15323304,15392744,15405392,0,0,69440,82088
33978,15391772,15404455,15405553,0,0,12683,13781
34087,15396366,15405246,15405584,0,0,8880,9218
34096,15396702,15405381,15405645,0,0,8679,8943
34108,15397021,15405645,15405707,0,0,8624,8686
34117,15397375,15405278,15405812,0,0,7903,8437
34119,15397434,15405812,15405846,0,0,8378,8412
34120,15397436,15405846,15405883,0,0,8410,8447
34121,15397489,15405883,15405946,0,0,8394,8457
34122,15397491,15405946,15405971,0,0,8455,8480
34123,15397507,15405971,15405993,0,0,8464,8486
34109,15397021,15405707,15406007,0,0,8686,8986
34124,15397523,15405993,15406026,0,0,8470,8503
34126,15397718,15406026,15406050,0,0,8308,8332
34116,15397375,15406007,15406064,0,0,8632,8689
34118,15397375,15406064,15406599,0,0,8689,9224
34129,15397742,15406599,15406632,0,0,8857,8890
34128,15397731,15406599,15406644,0,0,8868,8913
34130,15397775,15406632,15406665,0,0,8857,8890
34131,15397838,15406644,15406669,0,0,8806,8831
34132,15397862,15406665,15406711,0,0,8803,8849
34133,15397906,15406669,15406721,0,0,8763,8815
34135,15397921,15406721,15406763,0,0,8800,8842
34134,15397908,15406711,15406766,0,0,8803,8858
34136,15397921,15406763,15406805,0,0,8842,8884
34127,15397729,15406050,15406819,0,0,8321,9090
34137,15397962,15406766,15406826,0,0,8804,8864
34138,15397962,15406805,15406866,0,0,8843,8904
34140,15398022,15406819,15406879,0,0,8797,8857
34143,15398141,15406879,15406906,0,0,8738,8765
34142,15398082,15406866,15406928,0,0,8784,8846
34144,15398144,15406906,15406938,0,0,8762,8794
34147,15398275,15406938,15406961,0,0,8663,8686
34146,15398238,15406928,15406965,0,0,8690,8727
34148,15398294,15406961,15407032,0,0,8667,8738
34149,15398298,15406965,15407039,0,0,8667,8741
34141,15398022,15406826,15407042,0,0,8804,9020
34150,15398309,15407032,15407094,0,0,8723,8785
34154,15398369,15407042,15407100,0,0,8673,8731
34151,15398309,15407039,15407101,0,0,8730,8792
34156,15398370,15407100,15407157,0,0,8730,8787
34157,15398426,15407101,15407166,0,0,8675,8740
34159,15398490,15407166,15407197,0,0,8676,8707
34158,15398427,15407157,15407221,0,0,8730,8794
34161,15398491,15407197,15407227,0,0,8706,8736
33977,15391767,15403145,15407739,0,0,11378,15972
34139,15397962,15407739,15408016,0,0,9777,10054
34145,15398223,15408016,15408219,0,0,9793,9996
34152,15398368,15408219,15408279,0,0,9851,9911
33037,15327447,15405392,15412441,0,0,77945,84994
34050,15395216,15402021,15415552,0,0,6805,20336
34079,15396114,15403094,15415651,0,0,6980,19537
34167,15398520,15415651,15415914,0,0,17131,17394
34166,15398514,15415552,15416036,0,0,17038,17522
34169,15398683,15416036,15416338,0,0,17353,17655
33926,15389861,15398082,15416857,0,0,8221,26996
34170,15398987,15416857,15416938,0,0,17870,17951
34174,15399369,15416938,15416986,0,0,17569,17617
33985,15392131,15400762,15417378,0,0,8631,25247
34155,15398369,15407094,15417397,0,0,8725,19028
34180,15408669,15417397,15417428,0,0,8728,8759
34100,15396743,15405584,15417476,0,0,8841,20733
34165,15398502,15407227,15417477,0,0,8725,18975
34162,15398491,15407221,15417480,0,0,8730,18989
34183,15409285,15417480,15417535,0,0,8195,8250
34182,15408922,15417477,15417605,0,0,8555,8683
34188,15409418,15417605,15417671,0,0,8187,8253
34184,15409287,15417535,15417883,0,0,8248,8596
34176,15406457,15416986,15417907,0,0,10529,11450
34191,15409482,15417671,15417914,0,0,8189,8432
34197,15409692,15417914,15417946,0,0,8222,8254
34193,15409560,15417907,15417960,0,0,8347,8400
34192,15409536,15417883,15418007,0,0,8347,8471
34199,15409761,15417960,15418163,0,0,8199,8402
34202,15409767,15418007,15418215,0,0,8240,8448
34198,15409692,15417946,15418312,0,0,8254,8620
34204,15410134,15418215,15418378,0,0,8081,8244
34205,15410135,15418312,15418470,0,0,8177,8335
34153,15398368,15408279,15418549,0,0,9911,20181
34208,15410297,15418470,15418550,0,0,8173,8253
34213,15410656,15418550,15418606,0,0,7894,7950
34214,15410672,15418606,15418628,0,0,7934,7956
34215,15410730,15418628,15418728,0,0,7898,7998
34216,15410817,15418728,15418747,0,0,7911,7930
34217,15411077,15418747,15418991,0,0,7670,7914
34207,15410296,15418378,15419237,0,0,8082,8941
34219,15411149,15419237,15419358,0,0,8088,8209
34220,15411441,15419358,15419392,0,0,7917,7951
34222,15411693,15419392,15419503,0,0,7699,7810
34223,15411771,15419503,15419532,0,0,7732,7761
34224,15411971,15419532,15419557,0,0,7561,7586
34225,15412020,15419557,15419696,0,0,7537,7676
34228,15412618,15419696,15419746,0,0,7078,7128
34229,15412668,15419746,15419768,0,0,7078,7100
34231,15412900,15419768,15419824,0,0,6868,6924
34234,15413013,15419824,15419883,0,0,6811,6870
34236,15413072,15419883,15419944,0,0,6811,6872
34238,15413133,15419944,15420008,0,0,6811,6875
34203,15409778,15418163,15420013,0,0,8385,10235
34244,15413349,15420013,15420041,0,0,6664,6692
34242,15413315,15420008,15420042,0,0,6693,6727
34250,15413416,15420042,15420063,0,0,6626,6647
34249,15413377,15420041,15420080,0,0,6664,6703
34252,15413580,15420063,15420096,0,0,6483,6516
34256,15413612,15420080,15420112,0,0,6468,6500
34259,15413643,15420096,15420125,0,0,6453,6482
34262,15413671,15420112,15420139,0,0,6441,6468
34267,15413726,15420139,15420159,0,0,6413,6433
34265,15413708,15420125,15420163,0,0,6417,6455
34268,15413744,15420159,15420221,0,0,6415,6477
34270,15413746,15420163,15420221,0,0,6417,6475
34274,15413811,15420221,15420247,0,0,6410,6436
34272,15413804,15420221,15420255,0,0,6417,6451
34275,15413837,15420247,15420307,0,0,6410,6470
34276,15413918,15420255,15420315,0,0,6337,6397
34277,15413918,15420307,15420368,0,0,6389,6450
34279,15413978,15420315,15420375,0,0,6337,6397
34283,15414099,15420368,15420411,0,0,6269,6312
34291,15420192,15420375,15420460,0,0,183,268
34186,15409293,15420460,15420583,0,0,11167,11290
34189,15409418,15420583,15420649,0,0,11165,11231
33156,15333380,15412441,15420809,0,0,79061,87429
34190,15409418,15420649,15420957,0,0,11231,11539
33986,15392210,15405553,15421131,0,0,13343,28921
33993,15392870,15421131,15421189,0,0,28261,28319
33996,15392927,15421189,15422248,0,0,28262,29321
34011,15393758,15422248,15422637,0,0,28490,28879
34013,15393870,15422637,15422696,0,0,28767,28826
34018,15393956,15422696,15422735,0,0,28740,28779
34019,15393970,15422735,15422755,0,0,28765,28785
34020,15393985,15422755,15422780,0,0,28770,28795
34021,15394002,15422780,15422844,0,0,28778,28842
34177,15406511,15417378,15422994,0,0,10867,16483
34181,15408762,15417428,15423017,0,0,8666,14255
34295,15421721,15423017,15423044,0,0,1296,1323
34297,15422173,15423044,15423066,0,0,871,893
34298,15422218,15423066,15423086,0,0,848,868
34293,15421188,15422994,15423274,0,0,1806,2086
34022,15394003,15422844,15423939,0,0,28841,29936
34301,15423092,15423092,15423979,0,0,0,887
34171,15399034,15416338,15425971,0,0,17304,26937
34168,15398520,15415914,15426144,0,0,17394,27624
34172,15399046,15416938,15426558,0,0,17892,27512
34218,15411126,15418991,15427804,0,0,7865,16678
34212,15410639,15427804,15427856,0,0,17165,17217
34286,15417246,15427856,15428033,0,0,10610,10787
34173,15399358,15417476,15428294,0,0,18118,28936
34294,15421660,15428294,15428477,0,0,6634,6817
34302,15423980,15428477,15429084,0,0,4497,5104
34179,15407856,15418549,15429299,0,0,10693,21443
34194,15409606,15420957,15431174,0,0,11351,21568
33821,15385013,15420809,15431953,0,0,35796,46940
34287,15417398,15428033,15431990,0,0,10635,14592
34045,15395147,15431990,15433085,0,0,36843,37938
34200,15409765,15423979,15434041,0,0,14214,24276
34083,15396240,15433085,15434221,0,0,36845,37981
34306,15433310,15434041,15434343,0,0,731,1033
34115,15397373,15434221,15435340,0,0,36848,37967
34201,15409766,15426144,15436205,0,0,16378,26439
34307,15433604,15434343,15437646,0,0,739,4042
34024,15394145,15423939,15438320,0,0,29794,44175
34029,15394178,15429299,15439576,0,0,35121,45398
34311,15436958,15436958,15439734,0,0,0,2776
34175,15403436,15439734,15441940,0,0,36298,38504
34185,15409287,15441940,15442288,0,0,32653,33001
34187,15409384,15442288,15442389,0,0,32904,33005
34195,15409690,15442389,15442424,0,0,32699,32734
34196,15409690,15442424,15442869,0,0,32734,33179
34206,15410138,15442869,15443028,0,0,32731,32890
34209,15410301,15443028,15443202,0,0,32727,32901
33876,15387519,15431953,15444201,0,0,44434,56682
34160,15398490,15435340,15445382,0,0,36850,46892
34210,15410301,15443202,15445461,0,0,32901,35160
34221,15411609,15445461,15445515,0,0,33852,33906
34211,15410398,15445382,15445535,0,0,34984,35137
34227,15412440,15445515,15445561,0,0,33075,33121
34232,15412900,15445535,15445592,0,0,32635,32692
34233,15413012,15445561,15445622,0,0,32549,32610
34235,15413013,15445592,15445652,0,0,32579,32639
34237,15413072,15445622,15445684,0,0,32550,32612
34239,15413133,15445652,15445717,0,0,32519,32584
34240,15413257,15445684,15445743,0,0,32427,32486
34241,15413257,15445717,15445776,0,0,32460,32519
34243,15413315,15445743,15445777,0,0,32428,32462
34245,15413349,15445776,15445804,0,0,32427,32455
34247,15413365,15445804,15445831,0,0,32439,32466
34246,15413363,15445777,15445845,0,0,32414,32482
34248,15413366,15445831,15445857,0,0,32465,32491
34251,15413416,15445845,15445866,0,0,32429,32450
34253,15413580,15445857,15445890,0,0,32277,32310
34254,15413584,15445866,15445894,0,0,32282,32310
34258,15413642,15445894,15445920,0,0,32252,32278
34257,15413612,15445890,15445922,0,0,32278,32310
34261,15413670,15445922,15445951,0,0,32252,32281
34260,15413654,15445920,15445965,0,0,32266,32311
34263,15413671,15445951,15445979,0,0,32280,32308
34266,15413708,15445979,15446018,0,0,32271,32310
34269,15413745,15446018,15446077,0,0,32273,32332
34271,15413803,15446077,15446112,0,0,32274,32309
34273,15413810,15446112,15446139,0,0,32302,32329
34278,15413918,15446139,15446200,0,0,32221,32282
34280,15413978,15446200,15446260,0,0,32222,32282
34281,15414098,15446260,15446305,0,0,32162,32207
34282,15414098,15446305,15446350,0,0,32207,32252
34284,15414150,15446350,15446423,0,0,32200,32273
34285,15414571,15446423,15446529,0,0,31852,31958
34264,15413696,15445965,15447236,0,0,32269,33540
34163,15398501,15438320,15448353,0,0,39819,49852
34296,15421950,15448353,15448725,0,0,26403,26775
34164,15398502,15439576,15449607,0,0,41074,51105
33984,15392120,15444201,15449911,0,0,52081,57791
34303,15424588,15448725,15450040,0,0,24137,25452
34288,15417576,15446529,15453110,0,0,28953,35534
34292,15421123,15447236,15453600,0,0,26113,32477
34304,15427497,15449607,15455533,0,0,22110,28036
34178,15406803,15455533,15455808,0,0,48730,49005
34226,15412414,15455808,15455841,0,0,43394,43427
34230,15412891,15455841,15456084,0,0,42950,43193
34255,15413609,15456084,15456612,0,0,42475,43003
34289,15417623,15456612,15457149,0,0,38989,39526
34299,15422579,15457149,15457301,0,0,34570,34722
34081,15396180,15449911,15461041,0,0,53731,64861
34125,15397525,15453110,15464045,0,0,55585,66520
34300,15423003,15457301,15464442,0,0,34298,41439
34309,15435525,15464442,15464877,0,0,28917,29352
34310,15436634,15464877,15467944,0,0,28243,31310
34308,15435147,15464045,15468195,0,0,28898,33048
34313,15439490,15468195,15468256,0,0,28705,28766
34314,15439550,15468256,15468316,0,0,28706,28766
34315,15439725,15468316,15468387,0,0,28591,28662
34312,15438523,15467944,15469194,0,0,29421,30671
34290,15420002,15461041,15472086,0,0,41039,52084
34321,15450746,15469194,15476832,0,0,18448,26086
34317,15441040,15468387,15478085,0,0,27347,37045
34326,15465010,15478085,15479349,0,0,13075,14339
34324,15462638,15478085,15482225,0,0,15447,19587
34334,15473242,15478085,15482744,0,0,4843,9502
34305,15431133,15472086,15483184,0,0,40953,52051
34316,15439733,15483184,15483598,0,0,43451,43865
34318,15442357,15483598,15483656,0,0,41241,41299
34319,15442415,15483656,15483717,0,0,41241,41302
34340,15478507,15482744,15484555,0,0,4237,6048
34323,15458386,15476832,15484889,0,0,18446,26503
34333,15469999,15479349,15486380,0,0,9350,16381
34338,15475627,15478085,15488586,0,0,2458,12959
34325,15464920,15478085,15488852,0,0,13165,23932
34336,15475138,15486380,15490763,0,0,11242,15625
34337,15475150,15490763,15490822,0,0,15613,15672
34341,15480285,15484555,15490887,0,0,4270,10602
34328,15466445,15484889,15493111,0,0,18444,26666
34342,15480683,15490822,15493143,0,0,10139,12460
34329,15466898,15493111,15494110,0,0,26213,27212
34345,15485236,15490822,15494286,0,0,5586,9050
34353,15493453,15494286,15494602,0,0,833,1149
34346,15485246,15490887,15494672,0,0,5641,9426
34320,15442596,15483717,15494868,0,0,41121,52272
34352,15492164,15492164,15494997,0,0,0,2833
34322,15453697,15494868,15495202,0,0,41171,41505
34349,15488930,15493143,15495602,0,0,4213,6672
34354,15493808,15494602,15495828,0,0,794,2020
34327,15465136,15495202,15496074,0,0,30066,30938
34330,15466899,15496074,15496118,0,0,29175,29219
34348,15488722,15495602,15496966,0,0,6880,8244
34350,15490280,15496966,15498340,0,0,6686,8060
34347,15486128,15488586,15499046,0,0,2458,12918
34335,15474669,15494110,15501848,0,0,19441,27179
34356,15495368,15499046,15503530,0,0,3678,8162
34361,15500519,15503530,15503540,0,0,3011,3021
34359,15500262,15503530,15503543,0,0,3268,3281
34362,15501191,15503530,15503545,0,0,2339,2354
34364,15501910,15503543,15503556,0,0,1633,1646
34365,15502382,15503545,15503562,0,0,1163,1180
34366,15502633,15503556,15503570,0,0,923,937
34367,15502844,15503562,15503574,0,0,718,730
34368,15502925,15503570,15503581,0,0,645,656
34363,15501524,15503540,15503589,0,0,2016,2065
34370,15503391,15503581,15503598,0,0,190,207
34369,15503122,15503574,15503600,0,0,452,478
34371,15503648,15503648,15503662,0,0,0,14
34372,15503942,15503942,15504026,0,0,0,84
34373,15504337,15504337,15504464,0,0,0,127
34374,15504790,15504790,15504932,0,0,0,142
34375,15505081,15505081,15505324,0,0,0,243
34376,15505500,15505500,15505627,0,0,0,127
34378,15506877,15506877,15506914,0,0,0,37
34379,15507161,15507161,15507195,0,0,0,34
34331,15467272,15496118,15507238,0,0,28846,39966
34380,15508671,15508671,15508700,0,0,0,29
34381,15508974,15508974,15509021,0,0,0,47
34355,15495309,15498340,15509079,0,0,3031,13770
34343,15482410,15501848,15509642,0,0,19438,27232
34382,15510024,15510024,15510057,0,0,0,33
34383,15510037,15510037,15510065,0,0,0,28
34360,15500410,15509079,15513404,0,0,8669,12994
34384,15510101,15513404,15513435,0,0,3303,3334
34358,15500110,15503530,15514265,0,0,3420,14155
34386,15512887,15512887,15515713,0,0,0,2826
34351,15491207,15509642,15517224,0,0,18435,26017
34332,15467290,15507238,15518384,0,0,39948,51094
34390,15519047,15519047,15519224,0,0,0,177
34389,15518996,15518996,15519313,0,0,0,317
34385,15510840,15510840,15521364,0,0,0,10524
34391,15519217,15519224,15527110,0,0,7,7893
34339,15478412,15518384,15529480,0,0,39972,51068
34357,15498791,15517224,15531630,0,0,18433,32839
34393,15521308,15521308,15532077,0,0,0,10769
34388,15516893,15532077,15535119,0,0,15184,18226
34394,15523991,15535119,15539975,0,0,11128,15984
34387,15513199,15531630,15542425,0,0,18431,29226
34344,15484477,15529480,15544676,0,0,45003,60199
34396,15527967,15539975,15549542,0,0,12008,21575
34397,15534909,15542425,15552986,0,0,7516,18077
34399,15545470,15545470,15556168,0,0,0,10698
34398,15541468,15549542,15556631,0,0,8074,15163
34400,15548560,15556168,15563222,0,0,7608,14662
34405,15558871,15563222,15563249,0,0,4351,4378
34408,15559950,15563222,15563419,0,0,3272,3469
34406,15558970,15563249,15563516,0,0,4279,4546
34401,15555613,15556631,15563706,0,0,1018,8093
34410,15560165,15563516,15567024,0,0,3351,6859
34377,15506818,15544676,15567064,0,0,37858,60246
34412,15562771,15567024,15567170,0,0,4253,4399
34407,15559138,15563222,15570027,0,0,4084,10889
34418,15570230,15570230,15570513,0,0,0,283
34411,15562695,15563706,15570740,0,0,1011,8045
34419,15571091,15571091,15571119,0,0,0,28
34420,15571924,15571924,15571958,0,0,0,34
34421,15572159,15572159,15572180,0,0,0,21
34422,15572253,15572253,15572267,0,0,0,14
34423,15572456,15572456,15572474,0,0,0,18
34416,15569455,15569455,15572811,0,0,0,3356
34424,15573417,15573417,15573453,0,0,0,36
34426,15573650,15573650,15573672,0,0,0,22
34404,15556228,15563222,15573759,0,0,6994,17531
34427,15573920,15573920,15573940,0,0,0,20
34428,15574034,15574034,15574048,0,0,0,14
34425,15573633,15573633,15576913,0,0,0,3280
34414,15566708,15566708,15577518,0,0,0,10810
34417,15569731,15570740,15577740,0,0,1009,8009
34433,15579740,15579740,15579761,0,0,0,21
34434,15579850,15579850,15579872,0,0,0,22
34430,15576921,15576921,15580469,0,0,0,3548
34435,15580450,15580450,15580486,0,0,0,36
34436,15580706,15580706,15580724,0,0,0,18
34437,15581659,15581659,15581687,0,0,0,28
34438,15581790,15581790,15581814,0,0,0,24
34392,15521191,15567064,15582132,0,0,45873,60941
34439,15583167,15583167,15583211,0,0,0,44
34440,15583652,15583652,15583694,0,0,0,42
34441,15583873,15583873,15583914,0,0,0,41
34442,15583955,15583955,15584023,0,0,0,68
34429,15576730,15577740,15584364,0,0,1010,7634
34443,15584323,15584323,15584409,0,0,0,86
34395,15527041,15582132,15584575,0,0,55091,57534
34446,15587296,15587296,15587356,0,0,0,60
34402,15556134,15584575,15587904,0,0,28441,31770
34431,15577518,15577518,15587991,0,0,0,10473
34447,15587692,15587692,15588079,0,0,0,387
34432,15578272,15580469,15588116,0,0,2197,9844
34449,15588215,15588215,15588486,0,0,0,271
34450,15588637,15588637,15588907,0,0,0,270
34451,15589176,15589176,15589699,0,0,0,523
34453,15590190,15590190,15590209,0,0,0,19
34452,15589854,15589854,15590390,0,0,0,536
34445,15585984,15585984,15591692,0,0,0,5708
34455,15591295,15591295,15592260,0,0,0,965
34459,15592497,15592497,15592516,0,0,0,19
34458,15592436,15592436,15592981,0,0,0,545
34444,15585940,15585940,15593050,0,0,0,7110
34460,15593092,15593092,15593122,0,0,0,30
34461,15593192,15593192,15593566,0,0,0,374
34464,15593943,15593943,15593964,0,0,0,21
34463,15593461,15593461,15594032,0,0,0,571
34462,15593282,15593282,15594473,0,0,0,1191
34465,15594584,15594584,15594600,0,0,0,16
34466,15594949,15594949,15595021,0,0,0,72
34468,15595359,15595359,15595379,0,0,0,20
34469,15595701,15595701,15595722,0,0,0,21
34470,15597106,15597106,15597293,0,0,0,187
34403,15556152,15587904,15597856,0,0,31752,41704
34471,15597424,15597424,15597949,0,0,0,525
34448,15588045,15588045,15598765,0,0,0,10720
34475,15601611,15601611,15601644,0,0,0,33
34474,15600372,15600372,15602021,0,0,0,1649
34476,15601740,15602021,15602067,0,0,281,327
34479,15603802,15603802,15603816,0,0,0,14
34481,15605203,15605203,15605299,0,0,0,96
34409,15560028,15597856,15605631,0,0,37828,45603
34413,15562898,15605631,15605813,0,0,42733,42915
34478,15602192,15602192,15606654,0,0,0,4462
34454,15591014,15591692,15607012,0,0,678,15998
34477,15601820,15607012,15607068,0,0,5192,5248
34480,15604607,15606654,15607263,0,0,2047,2656
34473,15598714,15598714,15609272,0,0,0,10558
34467,15595064,15595064,15609692,0,0,0,14628
34472,15598532,15607012,15610539,0,0,8480,12007
34415,15568189,15605813,15617114,0,0,37624,48925
34456,15592181,15617114,15617278,0,0,24933,25097
34482,15606335,15609272,15619572,0,0,2937,13237
34483,15609273,15609692,15620436,0,0,419,11163
34487,15619691,15619691,15626998,0,0,0,7307
34488,15620018,15620018,15630527,0,0,0,10509
34490,15627012,15627012,15634123,0,0,0,7111
34457,15592356,15617278,15638618,0,0,24922,46262
34493,15634126,15634126,15641210,0,0,0,7084
34491,15630528,15630528,15641440,0,0,0,10912
34485,15613592,15641440,15642991,0,0,27848,29399
34484,15613364,15638618,15644509,0,0,25254,31145
34486,15615245,15642991,15647436,0,0,27746,32191
34492,15632570,15647436,15647497,0,0,14866,14927
34489,15625588,15644509,15652330,0,0,18921,26742
34499,15643164,15652330,15652359,0,0,9166,9195
34500,15643194,15652330,15652359,0,0,9136,9165
34501,15643282,15652330,15652363,0,0,9048,9081
34497,15643142,15652330,15652366,0,0,9188,9224
34509,15644792,15652366,15652394,0,0,7574,7602
34507,15644438,15652359,15652395,0,0,7921,7957
34502,15643686,15652363,15652395,0,0,8677,8709
34510,15644878,15652394,15652407,0,0,7516,7529
34511,15644978,15652395,15652408,0,0,7417,7430
34504,15644056,15652395,15652428,0,0,8339,8372
34513,15645219,15652407,15652440,0,0,7188,7221
34515,15645840,15652440,15652576,0,0,6600,6736
34494,15641214,15647497,15652866,0,0,6283,11652
34508,15644545,15652359,15653345,0,0,7814,8800
34495,15643015,15652330,15653722,0,0,9315,10707
34516,15647444,15652576,15653768,0,0,5132,6324
34528,15650313,15653768,15654408,0,0,3455,4095
34505,15644155,15652428,15655031,0,0,8273,10876
34506,15644350,15655031,15655066,0,0,10681,10716
34518,15647780,15655066,15655096,0,0,7286,7316
34514,15645503,15652408,15655206,0,0,6905,9703
34531,15652170,15655206,15655223,0,0,3036,3053
34532,15652242,15655223,15655248,0,0,2981,3006
34519,15647796,15655096,15655251,0,0,7300,7455
34530,15651011,15655251,15655260,0,0,4240,4249
34534,15652499,15655248,15655396,0,0,2749,2897
34512,15645060,15655066,15655410,0,0,10006,10350
34539,15652923,15655396,15655420,0,0,2473,2497
34541,15653074,15655410,15655424,0,0,2336,2350
34543,15653316,15655410,15655444,0,0,2094,2128
34545,15653443,15655424,15655454,0,0,1981,2011
34547,15653615,15655454,15655506,0,0,1839,1891
34549,15653867,15655506,15655526,0,0,1639,1659
34503,15643882,15652359,15655680,0,0,8477,11798
34529,15650609,15654408,15655891,0,0,3799,5282
34551,15653995,15655891,15655914,0,0,1896,1919
34552,15654072,15655914,15655937,0,0,1842,1865
34553,15654182,15655937,15655963,0,0,1755,1781
34554,15654633,15655963,15655980,0,0,1330,1347
34556,15654874,15655980,15656003,0,0,1106,1129
34557,15654893,15656003,15656131,0,0,1110,1238
34560,15655149,15656131,15656150,0,0,982,1001
34562,15655335,15656150,15656168,0,0,815,833
34527,15649783,15653722,15656176,0,0,3939,6393
34564,15655591,15656168,15656191,0,0,577,600
34566,15655764,15656176,15656192,0,0,412,428
34521,15648064,15655680,15656254,0,0,7616,8190
34535,15652518,15655260,15656340,0,0,2742,3822
34570,15657125,15657125,15657142,0,0,0,17
34537,15652682,15655260,15657264,0,0,2578,4582
34571,15657304,15657304,15657318,0,0,0,14
34573,15657424,15657424,15657443,0,0,0,19
34572,15657335,15657335,15657479,0,0,0,144
34567,15655842,15656191,15657528,0,0,349,1686
34574,15657559,15657559,15657574,0,0,0,15
34576,15658062,15658062,15658078,0,0,0,16
34575,15657997,15657997,15658217,0,0,0,220
34577,15658168,15658168,15658256,0,0,0,88
34546,15653517,15655444,15658314,0,0,1927,4797
34525,15649063,15658314,15659203,0,0,9251,10140
34533,15652392,15659203,15659216,0,0,6811,6824
34520,15647810,15655251,15659290,0,0,7441,11480
34578,15658347,15659290,15659311,0,0,943,964
34580,15658913,15659311,15659550,0,0,398,637
34579,15658464,15659290,15660790,0,0,826,2326
34582,15660415,15660790,15661064,0,0,375,649
34583,15660524,15661064,15661114,0,0,540,590
34587,15660747,15661114,15661128,0,0,367,381
34568,15656069,15656192,15661216,0,0,123,5147
34589,15660901,15661216,15661246,0,0,315,345
34590,15661114,15661246,15661264,0,0,132,150
34592,15661463,15661463,15661485,0,0,0,22
34593,15661662,15661662,15661716,0,0,0,54
34526,15649641,15653345,15661727,0,0,3704,12086
34594,15661686,15661716,15661742,0,0,30,56
34581,15659208,15659550,15662132,0,0,342,2924
34597,15661727,15662132,15662380,0,0,405,653
34544,15653394,15655420,15662607,0,0,2026,9213
34599,15661794,15662607,15662910,0,0,813,1116
34601,15661904,15662910,15663181,0,0,1006,1277
34550,15653894,15655526,15663385,0,0,1632,9491
34602,15661920,15663181,15663543,0,0,1261,1623
34604,15661983,15663543,15663574,0,0,1560,1591
34605,15661999,15663574,15663691,0,0,1575,1692
34595,15661706,15661727,15663876,0,0,21,2170
34588,15660774,15661128,15664173,0,0,354,3399
34609,15662419,15664173,15664203,0,0,1754,1784
34608,15662316,15663876,15664273,0,0,1560,1957
34612,15662949,15664273,15664291,0,0,1324,1342
34615,15663168,15664291,15664309,0,0,1123,1141
34611,15662805,15664203,15664395,0,0,1398,1590
34617,15663309,15664395,15664412,0,0,1086,1103
34618,15663444,15664412,15664431,0,0,968,987
34603,15661975,15663385,15664690,0,0,1410,2715
34620,15663482,15664690,15664711,0,0,1208,1229
34619,15663475,15664431,15664777,0,0,956,1302
34623,15663852,15664777,15664799,0,0,925,947
34596,15661713,15661742,15664965,0,0,29,3252
34626,15663880,15664965,15664982,0,0,1085,1102
34627,15663989,15664982,15664996,0,0,993,1007
34628,15664136,15664996,15665012,0,0,860,876
34630,15664285,15665012,15665026,0,0,727,741
34632,15664387,15665026,15665048,0,0,639,661
34633,15664392,15665048,15665077,0,0,656,685
34624,15663863,15664799,15665288,0,0,936,1425
34634,15664425,15665077,15665298,0,0,652,873
34636,15664547,15665288,15665312,0,0,741,765
34638,15664757,15665312,15665333,0,0,555,576
34639,15664775,15665333,15665362,0,0,558,587
34640,15664923,15665362,15665377,0,0,439,454
34641,15665068,15665377,15665392,0,0,309,324
34522,15648149,15656254,15665686,0,0,8105,17537
34538,15652840,15665686,15665841,0,0,12846,13001
34496,15643029,15652866,15666000,0,0,9837,22971
34598,15661754,15662380,15666021,0,0,626,4267
34643,15665198,15666021,15666061,0,0,823,863
34644,15665226,15666061,15666076,0,0,835,850
34646,15665362,15666076,15666095,0,0,714,733
34606,15662049,15663691,15666191,0,0,1642,4142
34616,15663254,15664309,15666804,0,0,1055,3550
34654,15666141,15666804,15666824,0,0,663,683
34656,15666353,15666824,15666844,0,0,471,491
34660,15666980,15666980,15666994,0,0,0,14
34661,15667070,15667070,15667089,0,0,0,19
34662,15667179,15667179,15667189,0,0,0,10
34498,15643152,15666000,15667367,0,0,22848,24215
34663,15667335,15667335,15667399,0,0,0,64
34523,15648607,15667367,15667571,0,0,18760,18964
34542,15653112,15667571,15667853,0,0,14459,14741
34555,15654764,15667853,15667926,0,0,13089,13162
34558,15654996,15667926,15667987,0,0,12930,12991
34559,15655058,15667987,15668068,0,0,12929,13010
34561,15655234,15668068,15668118,0,0,12834,12884
34651,15665986,15666191,15668191,0,0,205,2205
34642,15665114,15665392,15668512,0,0,278,3398
34563,15655447,15668118,15668592,0,0,12671,13145
34584,15660547,15668512,15668631,0,0,7965,8084
34565,15655637,15668592,15668654,0,0,12955,13017
34585,15660633,15668654,15668748,0,0,8021,8115
34600,15661852,15668631,15668996,0,0,6779,7144
34665,15668074,15668074,15669061,0,0,0,987
34668,15668698,15669061,15669090,0,0,363,392
34648,15665578,15666095,15669223,0,0,517,3645
34671,15669426,15669426,15669452,0,0,0,26
34673,15669526,15669526,15669752,0,0,0,226
34548,15653686,15667571,15670625,0,0,13885,16939
34637,15664641,15665298,15670697,0,0,657,6056
34669,15668747,15669090,15670712,0,0,343,1965
34675,15669808,15670697,15670756,0,0,889,948
34678,15670129,15670756,15670780,0,0,627,651
34607,15662240,15670625,15670893,0,0,8385,8653
34677,15670036,15670712,15671153,0,0,676,1117
34674,15669782,15669782,15671225,0,0,0,1443
34613,15662956,15670893,15671291,0,0,7937,8335
34625,15663869,15670893,15671912,0,0,7024,8043
34679,15671143,15671143,15672147,0,0,0,1004
34657,15666616,15671912,15672463,0,0,5296,5847
34658,15666726,15672463,15672489,0,0,5737,5763
34517,15647548,15655066,15672890,0,0,7518,25342
34610,15662452,15668996,15673014,0,0,6544,10562
34666,15668121,15673014,15673042,0,0,4893,4921
34536,15652558,15659216,15673542,0,0,6658,20984
34614,15663033,15673542,15673915,0,0,10509,10882
34629,15664235,15673915,15673993,0,0,9680,9758
34621,15663726,15664711,15674460,0,0,985,10734
34653,15666058,15671291,15675225,0,0,5233,9167
34685,15671627,15675225,15675298,0,0,3598,3671
34688,15672177,15675298,15675313,0,0,3121,3136
34635,15664457,15673993,15675334,0,0,9536,10877
34524,15648807,15667367,15675372,0,0,18560,26565
34684,15671581,15675225,15675470,0,0,3644,3889
34672,15669462,15673042,15675507,0,0,3580,6045
34691,15674068,15675470,15675528,0,0,1402,1460
34689,15673686,15675313,15675582,0,0,1627,1896
34659,15666942,15672489,15676180,0,0,5547,9238
34687,15672146,15675507,15677078,0,0,3361,4932
34540,15652995,15665841,15678254,0,0,12846,25259
34650,15665766,15678254,15678303,0,0,12488,12537
34652,15666004,15678303,15678528,0,0,12299,12524
34696,15678043,15678043,15679082,0,0,0,1039
34647,15665381,15675334,15679451,0,0,9953,14070
34586,15660738,15668748,15679545,0,0,8010,18807
34655,15666194,15678528,15679565,0,0,12334,13371
34676,15669828,15679545,15679638,0,0,9717,9810
34569,15656816,15675372,15682924,0,0,18556,26108
34694,15674756,15675582,15684094,0,0,826,9338
34680,15671246,15672147,15684163,0,0,901,12917
34692,15674145,15675528,15684452,0,0,1383,10307
34695,15674766,15676180,15684682,0,0,1414,9916
34690,15673717,15684094,15685444,0,0,10377,11727
34683,15671551,15674460,15686058,0,0,2909,14507
34697,15685305,15686058,15686344,0,0,753,1039
34664,15667399,15672890,15688574,0,0,5491,21175
34649,15665713,15671225,15688601,0,0,5512,22888
34631,15664366,15682924,15690492,0,0,18558,26126
34682,15671524,15679638,15691129,0,0,8114,19605
34700,15689772,15691129,15691285,0,0,1357,1513
34681,15671290,15679565,15691303,0,0,8275,20013
34702,15690456,15691285,15691570,0,0,829,1114
34698,15686228,15686344,15692232,0,0,116,6004
34706,15692308,15692308,15692328,0,0,0,20
34701,15689833,15691570,15692588,0,0,1737,2755
34670,15669341,15679451,15693131,0,0,10110,23790
34707,15692446,15692446,15693553,0,0,0,1107
34693,15674361,15685444,15696197,0,0,11083,21836
34708,15693858,15696197,15698610,0,0,2339,4752
34719,15697010,15698610,15699521,0,0,1600,2511
34724,15698610,15699521,15699718,0,0,911,1108
34710,15694565,15698610,15699756,0,0,4045,5191
34711,15694637,15699756,15699787,0,0,5119,5150
34725,15699201,15699718,15699837,0,0,517,636
34699,15689034,15689034,15700062,0,0,0,11028
34713,15694795,15700062,15700321,0,0,5267,5526
34715,15696219,15700321,15700389,0,0,4102,4170
34714,15695982,15700321,15700477,0,0,4339,4495
34718,15696688,15700477,15700501,0,0,3789,3813
34720,15697246,15700501,15700536,0,0,3255,3290
34721,15697372,15700536,15700841,0,0,3164,3469
34717,15696445,15700389,15701189,0,0,3944,4744
34712,15694721,15699787,15701318,0,0,5066,6597
34686,15671940,15690492,15701513,0,0,18552,29573
34726,15702018,15702018,15702144,0,0,0,126
34727,15703123,15703123,15703144,0,0,0,21
34705,15691233,15693553,15703463,0,0,2320,12230
34728,15703926,15703926,15703962,0,0,0,36
34731,15705370,15705370,15705390,0,0,0,20
34716,15696298,15701189,15705714,0,0,4891,9416
34732,15706143,15706143,15706165,0,0,0,22
34703,15690920,15692588,15706205,0,0,1668,15285
34733,15706450,15706450,15706651,0,0,0,201
34734,15706829,15706829,15707122,0,0,0,293
34735,15707499,15707499,15707784,0,0,0,285
34709,15694201,15698610,15709201,0,0,4409,15000
34723,15697930,15703463,15713895,0,0,5533,15965
34730,15704795,15704795,15715361,0,0,0,10566
34729,15704539,15705714,15716778,0,0,1175,12239
34738,15722550,15722550,15722609,0,0,0,59
34737,15715606,15715606,15723169,0,0,0,7563
34739,15723851,15723851,15723981,0,0,0,130
34722,15697828,15701513,15724116,0,0,3685,26288
34740,15725170,15725170,15725246,0,0,0,76
34591,15661127,15723169,15725721,0,0,62042,64594
34741,15725941,15725941,15725962,0,0,0,21
34736,15715360,15715360,15726144,0,0,0,10784
34742,15726027,15726027,15726497,0,0,0,470
34743,15726487,15726487,15726829,0,0,0,342
34622,15663842,15725721,15727351,0,0,61879,63509
34667,15668394,15727351,15728148,0,0,58957,59754
34645,15665257,15726829,15744261,0,0,61572,79004
34744,15726841,15744261,15744600,0,0,17420,17759
34747,15731045,15744600,15745561,0,0,13555,14516
34749,15731802,15745561,15745716,0,0,13759,13914
34753,15732462,15745561,15745937,0,0,13099,13475
34755,15733146,15745561,15746123,0,0,12415,12977
34761,15734976,15745561,15746161,0,0,10585,11185
34760,15734664,15746123,15746229,0,0,11459,11565
34763,15735500,15746229,15746283,0,0,10729,10783
34764,15735574,15746283,15746612,0,0,10709,11038
34762,15735461,15746161,15746726,0,0,10700,11265
34757,15733942,15745937,15746742,0,0,11995,12800
34766,15736074,15746742,15746930,0,0,10668,10856
34745,15727936,15744600,15747082,0,0,16664,19146
34774,15737213,15746930,15747180,0,0,9717,9967
34770,15736521,15746726,15747236,0,0,10205,10715
34777,15737440,15747236,15747373,0,0,9796,9933
34752,15732305,15747082,15747445,0,0,14777,15140
34778,15738224,15747373,15747542,0,0,9149,9318
34765,15736056,15746612,15747555,0,0,10556,11499
34781,15739033,15747555,15747700,0,0,8522,8667
34772,15737013,15746930,15747715,0,0,9917,10702
34783,15739235,15747715,15748094,0,0,8480,8859
34776,15737310,15747180,15748581,0,0,9870,11271
34769,15736451,15746612,15748636,0,0,10161,12185
34784,15739719,15748094,15748644,0,0,8375,8925
34796,15741196,15748636,15748740,0,0,7440,7544
34754,15732792,15747445,15748820,0,0,14653,16028
34798,15741774,15748740,15748850,0,0,6966,7076
34799,15741784,15748850,15748948,0,0,7066,7164
34800,15742067,15748948,15749016,0,0,6881,6949
34782,15739201,15747700,15749019,0,0,8499,9818
34805,15742826,15749016,15749043,0,0,6190,6217
34807,15743149,15749019,15749132,0,0,5870,5983
34811,15744431,15749043,15749160,0,0,4612,4729
34797,15741277,15748644,15749289,0,0,7367,8012
34815,15745081,15749289,15749345,0,0,4208,4264
34759,15734400,15748820,15749639,0,0,14420,15239
34767,15736212,15749639,15750150,0,0,13427,13938
34768,15736300,15750150,15750456,0,0,13850,14156
34812,15744475,15749132,15750851,0,0,4657,6376
34820,15746675,15750851,15751456,0,0,4176,4781
34780,15738578,15747542,15751505,0,0,8964,12927
34821,15746996,15751456,15751961,0,0,4460,4965
34822,15747232,15751505,15752105,0,0,4273,4873
34826,15747575,15752105,15752185,0,0,4530,4610
34825,15747551,15751961,15752255,0,0,4410,4704
34830,15748481,15752255,15752519,0,0,3774,4038
34828,15748333,15752185,15752646,0,0,3852,4313
34832,15749302,15752519,15752713,0,0,3217,3411
34838,15750037,15752713,15752787,0,0,2676,2750
34839,15750253,15752787,15753137,0,0,2534,2884
34843,15750633,15753137,15753215,0,0,2504,2582
34704,15691139,15728148,15753320,0,0,37009,62181
34814,15744943,15749160,15753593,0,0,4217,8650
34847,15750746,15753215,15753655,0,0,2469,2909
34852,15751118,15753655,15753756,0,0,2537,2638
34849,15750964,15753593,15753765,0,0,2629,2801
34853,15751207,15753756,15753878,0,0,2549,2671
34859,15751997,15753878,15753924,0,0,1881,1927
34860,15752057,15753924,15753976,0,0,1867,1919
34856,15751599,15753765,15754015,0,0,2166,2416
34862,15752237,15753976,15754030,0,0,1739,1793
34758,15734383,15748820,15754043,0,0,14437,19660
34865,15752367,15754030,15754044,0,0,1663,1677
34748,15731120,15745561,15754118,0,0,14441,22998
34816,15745819,15749345,15754123,0,0,3526,8304
34870,15752788,15754123,15754137,0,0,1335,1349
34869,15752605,15754118,15754318,0,0,1513,1713
34874,15752957,15754137,15754334,0,0,1180,1377
34866,15752500,15754044,15754353,0,0,1544,1853
34878,15753233,15754353,15754364,0,0,1120,1131
34863,15752277,15754015,15754424,0,0,1738,2147
34880,15753518,15754424,15754436,0,0,906,918
34879,15753251,15754364,15754508,0,0,1113,1257
34877,15753220,15754334,15754550,0,0,1114,1330
34883,15753786,15754508,15754583,0,0,722,797
34884,15753819,15754550,15754634,0,0,731,815
34887,15754089,15754583,15754679,0,0,494,590
34890,15754409,15754679,15754704,0,0,270,295
34746,15729842,15753320,15754762,0,0,23478,24920
34891,15754449,15754704,15754770,0,0,255,321
34888,15754195,15754634,15754824,0,0,439,629
34892,15754473,15754770,15754865,0,0,297,392
34893,15754474,15754824,15754867,0,0,350,393
34876,15753027,15754318,15754926,0,0,1291,1899
34895,15754635,15754865,15754946,0,0,230,311
34775,15737229,15754043,15755005,0,0,16814,17776
34773,15737157,15754043,15755098,0,0,16886,17941
34896,15754707,15754867,15755193,0,0,160,486
34901,15754837,15755193,15755308,0,0,356,471
34833,15749307,15752646,15755371,0,0,3339,6064
34905,15755517,15755517,15755584,0,0,0,67
34786,15739914,15755098,15755611,0,0,15184,15697
34906,15755606,15755606,15755639,0,0,0,33
34898,15754732,15754946,15755711,0,0,214,979
34882,15753582,15754436,15756002,0,0,854,2420
34790,15740543,15755711,15756828,0,0,15168,16285
34794,15740752,15756828,15757746,0,0,16076,16994
34806,15743133,15757746,15757775,0,0,14613,14642
34813,15744753,15757775,15758312,0,0,13022,13559
34908,15755777,15756002,15758393,0,0,225,2616
34819,15746555,15758312,15759035,0,0,11757,12480
34779,15738558,15755005,15759545,0,0,16447,20987
34903,15755227,15755308,15759770,0,0,81,4543
34785,15739744,15748581,15759864,0,0,8837,20120
34910,15755844,15759770,15759954,0,0,3926,4110
34823,15747391,15759035,15760036,0,0,11644,12645
34829,15748414,15760036,15760097,0,0,11622,11683
34834,15749381,15760097,15760407,0,0,10716,11026
34835,15749670,15760407,15760410,0,0,10737,10740
34836,15749701,15760410,15760472,0,0,10709,10771
34913,15756244,15759954,15760489,0,0,3710,4245
34916,15757124,15760489,15760690,0,0,3365,3566
34917,15757604,15760690,15760718,0,0,3086,3114
34837,15749889,15760472,15761307,0,0,10583,11418
34827,15747832,15759545,15761384,0,0,11713,13552
34919,15757737,15760718,15761416,0,0,2981,3679
34771,15736850,15750456,15761593,0,0,13606,24743
34750,15731888,15754762,15761644,0,0,22874,29756
34920,15757836,15761416,15761741,0,0,3580,3905
34911,15756089,15759864,15761745,0,0,3775,5656
34842,15750513,15761384,15761893,0,0,10871,11380
34921,15758500,15761741,15762144,0,0,3241,3644
34909,15755826,15758393,15762332,0,0,2567,6506
34924,15759133,15762332,15762401,0,0,3199,3268
34923,15759084,15762144,15762426,0,0,3060,3342
34925,15759541,15762401,15762429,0,0,2860,2888
34926,15759565,15762426,15762488,0,0,2861,2923
34840,15750378,15761307,15762491,0,0,10929,12113
34928,15759580,15762488,15762518,0,0,2908,2938
34930,15759717,15762518,15762540,0,0,2801,2823
34922,15758955,15761745,15762557,0,0,2790,3602
34931,15759824,15762540,15762589,0,0,2716,2765
34927,15759577,15762429,15762616,0,0,2852,3039
34932,15759954,15762557,15762684,0,0,2603,2730
34846,15750711,15762491,15762772,0,0,11780,12061
34857,15751720,15762772,15763100,0,0,11052,11380
34937,15760054,15762616,15763445,0,0,2562,3391
34935,15760039,15762589,15763452,0,0,2550,3413
34942,15760970,15763452,15763506,0,0,2482,2536
34864,15752298,15763100,15763521,0,0,10802,11223
34943,15761045,15763506,15763620,0,0,2461,2575
34939,15760293,15762684,15763634,0,0,2391,3341
34941,15760486,15763445,15763640,0,0,2959,3154
34945,15761402,15763620,15763742,0,0,2218,2340
34751,15732042,15761644,15763759,0,0,29602,31717
34950,15762536,15763742,15763760,0,0,1206,1224
34897,15754716,15754926,15763764,0,0,210,9048
34791,15740548,15763759,15763768,0,0,23211,23220
34793,15740673,15763759,15763842,0,0,23086,23169
34952,15762674,15763764,15763901,0,0,1090,1227
34951,15762668,15763760,15763926,0,0,1092,1258
34955,15763653,15763901,15764028,0,0,248,375
34792,15740637,15763759,15764145,0,0,23122,23508
34789,15740311,15763759,15764482,0,0,23448,24171
34871,15752809,15764028,15764560,0,0,11219,11751
34872,15752824,15764560,15764620,0,0,11736,11796
34844,15750641,15761893,15764932,0,0,11252,14291
34900,15754806,15764932,15764986,0,0,10126,10180
34881,15753541,15764620,15765102,0,0,11079,11561
34795,15741165,15763768,15765232,0,0,22603,24067
34804,15742763,15764145,15765285,0,0,21382,22522
34818,15746397,15765285,15765355,0,0,18888,18958
34867,15752530,15763521,15765361,0,0,10991,12831
34907,15755633,15764986,15765602,0,0,9353,9969
34938,15760160,15765602,15766214,0,0,5442,6054
34918,15757719,15765361,15767028,0,0,7642,9309
34944,15761385,15766214,15767115,0,0,4829,5730
34915,15757018,15765102,15767892,0,0,8084,10874
34947,15761508,15767028,15768340,0,0,5520,6832
34954,15763398,15767892,15768527,0,0,4494,5129
34958,15765135,15768527,15768994,0,0,3392,3859
34756,15733241,15745716,15769256,0,0,12475,36015
34808,15743449,15764482,15769565,0,0,21033,26116
34855,15751582,15769565,15769697,0,0,17983,18115
34966,15768063,15768994,15769744,0,0,931,1681
34959,15765959,15769256,15770124,0,0,3297,4165
34858,15751734,15769697,15770202,0,0,17963,18468
34957,15764406,15768527,15770232,0,0,4121,5826
34956,15763814,15768340,15770247,0,0,4526,6433
34861,15752167,15770202,15770265,0,0,18035,18098
34949,15762069,15763640,15770313,0,0,1571,8244
34968,15769888,15770232,15770515,0,0,344,627
34967,15768977,15769744,15770527,0,0,767,1550
34970,15770492,15770492,15770541,0,0,0,49
34953,15763384,15767115,15771124,0,0,3731,7740
34976,15771790,15771790,15771831,0,0,0,41
34965,15768026,15770527,15772311,0,0,2501,4285
34971,15770641,15770641,15772326,0,0,0,1685
34788,15740268,15761593,15772677,0,0,21325,32409
34977,15772362,15772362,15772928,0,0,0,566
34948,15761834,15763634,15772929,0,0,1800,11095
34962,15766943,15770124,15772982,0,0,3181,6039
34979,15772652,15772928,15773333,0,0,276,681
34803,15742615,15763842,15774214,0,0,21227,31599
34980,15773134,15773134,15774439,0,0,0,1305
34983,15773672,15774439,15774473,0,0,767,801
34787,15739951,15755611,15774743,0,0,15660,34792
34817,15746108,15765232,15774960,0,0,19124,28852
34982,15773544,15774743,15775260,0,0,1199,1716
34904,15755393,15774960,15775315,0,0,19567,19922
34899,15754771,15773333,15775530,0,0,18562,20759
34912,15756199,15775315,15775600,0,0,19116,19401
34934,15760006,15775600,15775635,0,0,15594,15629
34960,15766023,15775635,15776543,0,0,9612,10520
34875,15753024,15770265,15777041,0,0,17241,24017
34986,15777076,15777076,15777234,0,0,0,158
34985,15776862,15776862,15777427,0,0,0,565
34987,15777424,15777424,15777447,0,0,0,23
34886,15753968,15772677,15778306,0,0,18709,24338
34988,15777801,15777801,15778431,0,0,0,630
34989,15778450,15778450,15778471,0,0,0,21
34990,15778456,15778456,15778496,0,0,0,40
34831,15749118,15765355,15778881,0,0,16237,29763
34963,15767405,15770247,15779053,0,0,2842,11648
34991,15778494,15778496,15779075,0,0,2,581
34978,15772433,15779075,15779095,0,0,6642,6662
34972,15771140,15771140,15779902,0,0,0,8762
34992,15778822,15778822,15779961,0,0,0,1139
34994,15780074,15780074,15780091,0,0,0,17
34961,15766367,15776543,15780471,0,0,10176,14104
34964,15767792,15777041,15780488,0,0,9249,12696
34975,15771600,15772311,15780596,0,0,711,8996
34993,15779899,15779899,15780768,0,0,0,869
34996,15780476,15780476,15780827,0,0,0,351
34995,15780261,15780261,15782192,0,0,0,1931
34902,15755224,15774214,15782221,0,0,18990,26997
34933,15759994,15775530,15783322,0,0,15536,23328
34998,15782745,15782745,15783505,0,0,0,760
34999,15783505,15783505,15786104,0,0,0,2599
34810,15744075,15780596,15789436,0,0,36521,45361
34974,15771257,15778881,15789774,0,0,7624,18517
34973,15771252,15778306,15789873,0,0,7054,18621
34873,15752918,15782221,15790719,0,0,29303,37801
34981,15773444,15789774,15791385,0,0,16330,17941
34801,15742444,15791385,15791886,0,0,48941,49442
34997,15781858,15781858,15792401,0,0,0,10543
34802,15742610,15791886,15792488,0,0,49276,49878
35000,15783855,15783855,15792824,0,0,0,8969
34809,15744045,15792488,15794500,0,0,48443,50455
34824,15747410,15794500,15796801,0,0,47090,49391
34841,15750499,15796801,15796901,0,0,46302,46402
34845,15750664,15796901,15797033,0,0,46237,46369
34848,15750816,15797033,15797181,0,0,46217,46365
34850,15750976,15797181,15797258,0,0,46205,46282
34851,15751091,15797258,15797686,0,0,46167,46595
34946,15761414,15789436,15798057,0,0,28022,36643
34868,15752567,15798057,15798214,0,0,45490,45647
34885,15753826,15798214,15798576,0,0,44388,44750
34854,15751531,15797686,15798681,0,0,46155,47150
34889,15754206,15798576,15798776,0,0,44370,44570
34894,15754623,15798681,15800529,0,0,44058,45906
34914,15756724,15798776,15800674,0,0,42052,43950
34929,15759681,15800529,15801252,0,0,40848,41571
34940,15760473,15801252,15808771,0,0,40779,48298
34969,15770044,15808771,15814445,0,0,38727,44401
34984,15773873,15814445,15815486,0,0,40572,41613
34936,15760047,15800674,15825955,0,0,40627,65908
